start;end;duration;jobs;njobs;days;ndays
252236693634;252255228699;18535065;9;1;1;1
252255228699;252255231136;2437;9;1;1;1
252255231136;252255278761;47625;9;1;1;1
252255278761;252255279736;975;9;1;1;1
252255279736;252255288220;8484;9;1;1;1
252255288220;252255315514;27294;9;1;1;1
252255315514;252255358575;43061;9;1;1;1
252255358575;252255410776;52201;9;1;1;1
252255410776;252255414529;3753;9;1;1;1
252255414529;252255421097;6568;9;1;1;1
252255421097;252255509995;88898;9;1;1;1
252255509995;252255560560;50565;9;1;1;1
252255560560;252255602413;41853;9;1;1;1
252255602413;252255610856;8443;9;1;1;1
252255610856;252255612828;1972;9;1;1;1
252255612828;252255616602;3774;9;1;1;1
252255616602;252255658620;42018;9;1;1;1
252255658620;252255720101;61481;9;1;1;1
252255720101;252255755673;35572;9;1;1;1
252255755673;252255757936;2263;9;1;1;1
252255757936;252255771537;13601;9;1;1;1
252255771537;252255784701;13164;9;1;1;1
252255784701;252255785155;454;9;1;1;1
252255785155;252255786234;1079;9;1;1;1
252255786234;252255873103;86869;9;1;1;1
252255873103;252255916337;43234;9;1;1;1
252255916337;252255949665;33328;9;1;1;1
252255949665;252255988593;38928;9;1;1;1
252255988593;252255999839;11246;9;1;1;1
252255999839;252256031915;32076;9;1;1;1
252256031915;252256063402;31487;9;1;1;1
252256063402;252256108300;44898;9;1;1;1
252256108300;252256148254;39954;9;1;1;1
252256148254;252256191707;43453;9;1;1;1
252256191707;252256254776;63069;9;1;1;1
252256254776;252256299220;44444;9;1;1;1
252256299220;252256339286;40066;9;1;1;1
252256339286;252256379499;40213;9;1;1;1
252256379499;252256380582;1083;9;1;1;1
252256380582;252256383321;2739;9;1;1;1
252256383321;252256414416;31095;9;1;1;1
252256414416;252256426422;12006;9;1;1;1
252256426422;252256442670;16248;9;1;1;1
252256442670;252256492188;49518;9;1;1;1
252256492188;252256499184;6996;9;1;1;1
252256499184;252256499630;446;9;1;1;1
252256499630;252256549871;50241;9;1;1;1
252256549871;252256587855;37984;9;1;1;1
252256587855;252256634169;46314;9;1;1;1
252256634169;252256656278;22109;9;1;1;1
252256656278;252256704259;47981;9;1;1;1
252256704259;252256736862;32603;9;1;1;1
252256736862;252256767507;30645;9;1;1;1
252256767507;252256769267;1760;9;1;1;1
252256769267;252256776123;6856;9;1;1;1
252256776123;252256796579;20456;9;1;1;1
252256796579;252256937314;140735;9;1;1;1
252256937314;252256977013;39699;9;1;1;1
252256977013;252257030063;53050;9;1;1;1
252257030063;252257070786;40723;9;1;1;1
252257070786;252257071082;296;9;1;1;1
252257071082;252257078351;7269;9;1;1;1
252257078351;252257081451;3100;9;1;1;1
252257081451;252257089463;8012;9;1;1;1
252257089463;252257101352;11889;9;1;1;1
252257101352;252257139572;38220;9;1;1;1
252257139572;252257145252;5680;9;1;1;1
252257145252;252257184485;39233;9;1;1;1
252257184485;252257186260;1775;9;1;1;1
252257186260;252257193525;7265;9;1;1;1
252257193525;252257222977;29452;9;1;1;1
252257222977;252257263168;40191;9;1;1;1
252257263168;252257311395;48227;9;1;1;1
252257311395;252257361884;50489;9;1;1;1
252257361884;252257396114;34230;9;1;1;1
252257396114;252257432803;36689;9;1;1;1
252257432803;252257441863;9060;9;1;1;1
252257441863;252257442696;833;9;1;1;1
252257442696;252257485130;42434;9;1;1;1
252257485130;252257486571;1441;9;1;1;1
252257486571;252257513796;27225;9;1;1;1
252257513796;252257557794;43998;9;1;1;1
252257557794;252257563295;5501;9;1;1;1
252257563295;252257569484;6189;9;1;1;1
252257569484;252257574790;5306;9;1;1;1
252257574790;252257598939;24149;9;1;1;1
252257598939;252257642863;43924;9;1;1;1
252257642863;252257706792;63929;9;1;1;1
252257706792;252257746187;39395;9;1;1;1
252257746187;252257755158;8971;9;1;1;1
252257755158;252257798195;43037;9;1;1;1
252257798195;252257800873;2678;9;1;1;1
252257800873;252257825259;24386;9;1;1;1
252257825259;252257833147;7888;9;1;1;1
252257833147;252257848926;15779;9;1;1;1
252257848926;252257865618;16692;9;1;1;1
252257865618;252257896185;30567;9;1;1;1
252257896185;252257940560;44375;9;1;1;1
252257940560;252258000074;59514;9;1;1;1
252258000074;252258007723;7649;9;1;1;1
252258007723;252258010559;2836;9;1;1;1
252258010559;252258016796;6237;9;1;1;1
252258016796;252258053944;37148;9;1;1;1
252258053944;252258097310;43366;9;1;1;1
252258097310;252258130813;33503;9;1;1;1
252258130813;252258170096;39283;9;1;1;1
252258170096;252258179399;9303;9;1;1;1
252258179399;252258179414;15;9;1;1;1
252258179414;252258179614;200;9;1;1;1
252258179614;252258180033;419;9;1;1;1
252258180033;252258210616;30583;9;1;1;1
252258210616;252258213962;3346;9;1;1;1
252258213962;252258219837;5875;9;1;1;1
252258219837;252258219936;99;9;1;1;1
252258219936;252258267870;47934;9;1;1;1
252258267870;252258273327;5457;9;1;1;1
252258273327;252258283394;10067;9;1;1;1
252258283394;252258283426;32;9;1;1;1
252258283426;252258338167;54741;9;1;1;1
252258338167;252258349162;10995;9;1;1;1
252258349162;252258384788;35626;9;1;1;1
252258384788;252258396964;12176;9;1;1;1
252258396964;252258397710;746;9;1;1;1
252258397710;252258414344;16634;9;1;1;1
252258414344;252258420233;5889;9;1;1;1
252258420233;252258441772;21539;9;1;1;1
252258441772;252258453228;11456;9;1;1;1
252258453228;252258465984;12756;9;1;1;1
252258465984;252258498836;32852;9;1;1;1
252258498836;252258540601;41765;9;1;1;1
252258540601;252258574029;33428;9;1;1;1
252258574029;252258637436;63407;9;1;1;1
252258637436;252258649114;11678;9;1;1;1
252258649114;252258693734;44620;9;1;1;1
252258693734;252258726623;32889;9;1;1;1
252258726623;252258766080;39457;9;1;1;1
252258766080;252258804838;38758;9;1;1;1
252258804838;252258837444;32606;9;1;1;1
252258837444;252258876583;39139;9;1;1;1
252258876583;252258952905;76322;9;1;1;1
252258952905;252258953967;1062;9;1;1;1
252258953967;252258963855;9888;9;1;1;1
252258963855;252259017975;54120;9;1;1;1
252259017975;252259058129;40154;9;1;1;1
252259058129;252259100047;41918;9;1;1;1
252259100047;252259146442;46395;9;1;1;1
252259146442;252259146875;433;9;1;1;1
252259146875;252259153214;6339;9;1;1;1
252259153214;252259183768;30554;9;1;1;1
252259183768;252259196915;13147;9;1;1;1
252259196915;252259202488;5573;9;1;1;1
252259202488;252259227999;25511;9;1;1;1
252259227999;252259292143;64144;9;1;1;1
252259292143;252259303143;11000;9;1;1;1
252259303143;252259303693;550;9;1;1;1
252259303693;252259338863;35170;9;1;1;1
252259338863;252259379468;40605;9;1;1;1
252259379468;252259385095;5627;9;1;1;1
252259385095;252259417427;32332;9;1;1;1
252259417427;252259418118;691;9;1;1;1
252259418118;252259426564;8446;9;1;1;1
252259426564;252259456850;30286;9;1;1;1
252259456850;252259497111;40261;9;1;1;1
252259497111;252259533453;36342;9;1;1;1
252259533453;252259607815;74362;9;1;1;1
252259607815;252259644226;36411;9;1;1;1
252259644226;252259688937;44711;9;1;1;1
252259688937;252259729601;40664;9;1;1;1
252259729601;252259814231;84630;9;1;1;1
252259814231;252259824663;10432;9;1;1;1
252259824663;252259824975;312;9;1;1;1
252259824975;252259825162;187;9;1;1;1
252259825162;252259864484;39322;9;1;1;1
252259864484;252259934304;69820;9;1;1;1
252259934304;252259934449;145;9;1;1;1
252259934449;252260032310;97861;9;1;1;1
252260032310;252260093958;61648;9;1;1;1
252260093958;252260138278;44320;9;1;1;1
252260138278;252260173913;35635;9;1;1;1
252260173913;252260180182;6269;9;1;1;1
252260180182;252260195782;15600;9;1;1;1
252260195782;252260238126;42344;9;1;1;1
252260238126;252260241171;3045;9;1;1;1
252260241171;252260248036;6865;9;1;1;1
252260248036;252260290946;42910;9;1;1;1
252260290946;252260361306;70360;9;1;1;1
252260361306;252260392575;31269;9;1;1;1
252260392575;252260428530;35955;9;1;1;1
252260428530;252260459351;30821;9;1;1;1
252260459351;252260500690;41339;9;1;1;1
252260500690;252260537956;37266;9;1;1;1
252260537956;252260545238;7282;9;1;1;1
252260545238;252260581910;36672;9;1;1;1
252260581910;252260582726;816;9;1;1;1
252260582726;252260609850;27124;9;1;1;1
252260609850;252260654400;44550;9;1;1;1
252260654400;252260661721;7321;9;1;1;1
252260661721;252260694352;32631;9;1;1;1
252260694352;252260762685;68333;9;1;1;1
252260762685;252260803867;41182;9;1;1;1
252260803867;252260813087;9220;9;1;1;1
252260813087;252260852241;39154;9;1;1;1
252260852241;252260895387;43146;9;1;1;1
252260895387;252260905646;10259;9;1;1;1
252260905646;252260906703;1057;9;1;1;1
252260906703;252260941427;34724;9;1;1;1
252260941427;252261030084;88657;9;1;1;1
252261030084;252261070295;40211;9;1;1;1
252261070295;252261130761;60466;9;1;1;1
252261130761;252261133713;2952;9;1;1;1
252261133713;252261168647;34934;9;1;1;1
252261168647;252261252039;83392;9;1;1;1
252261252039;252261302649;50610;9;1;1;1
252261302649;252261344160;41511;9;1;1;1
252261344160;252261385806;41646;9;1;1;1
252261385806;252261399868;14062;9;1;1;1
252261399868;252261400021;153;9;1;1;1
252261400021;252261400130;109;9;1;1;1
252261400130;252261423311;23181;9;1;1;1
252261423311;252261496300;72989;9;1;1;1
252261496300;252261542625;46325;9;1;1;1
252261542625;252261574528;31903;9;1;1;1
252261574528;252261577093;2565;9;1;1;1
252261577093;252261578750;1657;9;1;1;1
252261578750;252261583414;4664;9;1;1;1
252261583414;252261584383;969;9;1;1;1
252261584383;252261584785;402;9;1;1;1
252261584785;252261592802;8017;9;1;1;1
252261592802;252261593263;461;9;1;1;1
252261593263;252261642598;49335;9;1;1;1
252261642598;252261677419;34821;9;1;1;1
252261677419;252261682855;5436;9;1;1;1
252261682855;252261753241;70386;9;1;1;1
252261753241;252261765528;12287;9;1;1;1
252261765528;252261768139;2611;9;1;1;1
252261768139;252261768814;675;9;1;1;1
252261768814;252261796380;27566;9;1;1;1
252261796380;252261975961;179581;9;1;1;1
252261975961;252261987033;11072;9;1;1;1
252261987033;252262025686;38653;9;1;1;1
252262025686;252262048288;22602;9;1;1;1
252262048288;252262225947;177659;9;1;1;1
252262225947;252262230925;4978;9;1;1;1
252262230925;252262231401;476;9;1;1;1
252262231401;252262277271;45870;9;1;1;1
252262277271;252262307822;30551;9;1;1;1
252262307822;252262370820;62998;9;1;1;1
252262370820;252262408187;37367;9;1;1;1
252262408187;252262451642;43455;9;1;1;1
252262451642;252262466837;15195;9;1;1;1
252262466837;252262504874;38037;9;1;1;1
252262504874;252262550546;45672;9;1;1;1
252262550546;252262553598;3052;9;1;1;1
252262553598;252262570975;17377;9;1;1;1
252262570975;252262588193;17218;9;1;1;1
252262588193;252262632816;44623;9;1;1;1
252262632816;252262684902;52086;9;1;1;1
252262684902;252262756940;72038;9;1;1;1
252262756940;252262788805;31865;9;1;1;1
252262788805;252262820393;31588;9;1;1;1
252262820393;252262872848;52455;9;1;1;1
252262872848;252262872922;74;9;1;1;1
252262872922;252262883292;10370;9;1;1;1
252262883292;252262885933;2641;9;1;1;1
252262885933;252262895045;9112;9;1;1;1
252262895045;252262938514;43469;9;1;1;1
252262938514;252262985382;46868;9;1;1;1
252262985382;252262999350;13968;9;1;1;1
252262999350;252263013794;14444;9;1;1;1
252263013794;252263024470;10676;9;1;1;1
252263024470;252263098038;73568;9;1;1;1
252263098038;252263100270;2232;9;1;1;1
252263100270;252263106190;5920;9;1;1;1
252263106190;252263108573;2383;9;1;1;1
252263108573;252263115251;6678;9;1;1;1
252263115251;252263121917;6666;9;1;1;1
252263121917;252263142857;20940;9;1;1;1
252263142857;252263182008;39151;9;1;1;1
252263182008;252263216575;34567;9;1;1;1
252263216575;252263260638;44063;9;1;1;1
252263260638;252263297325;36687;9;1;1;1
252263297325;252263303150;5825;9;1;1;1
252263303150;252263337629;34479;9;1;1;1
252263337629;252263406604;68975;9;1;1;1
252263406604;252263417434;10830;9;1;1;1
252263417434;252263420927;3493;9;1;1;1
252263420927;252263462813;41886;9;1;1;1
252263462813;252263505399;42586;9;1;1;1
252263505399;252263512700;7301;9;1;1;1
252263512700;252263513775;1075;9;1;1;1
252263513775;252263520100;6325;9;1;1;1
252263520100;252263544375;24275;9;1;1;1
252263544375;252263585237;40862;9;1;1;1
252263585237;252263629209;43972;9;1;1;1
252263629209;252263670104;40895;9;1;1;1
252263670104;252263670413;309;9;1;1;1
252263670413;252263684684;14271;9;1;1;1
252263684684;252263734859;50175;9;1;1;1
252263734859;252263755189;20330;9;1;1;1
252263755189;252263797541;42352;9;1;1;1
252263797541;252263833373;35832;9;1;1;1
252263833373;252263837312;3939;9;1;1;1
252263837312;252263844939;7627;9;1;1;1
252263844939;252263846474;1535;9;1;1;1
252263846474;252263846594;120;9;1;1;1
252263846594;252263872541;25947;9;1;1;1
252263872541;252263929210;56669;9;1;1;1
252263929210;252263968499;39289;9;1;1;1
252263968499;252264028061;59562;9;1;1;1
252264028061;252264100577;72516;9;1;1;1
252264100577;252264101173;596;9;1;1;1
252264101173;252264110431;9258;9;1;1;1
252264110431;252264154198;43767;9;1;1;1
252264154198;252264193943;39745;9;1;1;1
252264193943;252264224853;30910;9;1;1;1
252264224853;252264256311;31458;9;1;1;1
252264256311;252264292380;36069;9;1;1;1
252264292380;252264332015;39635;9;1;1;1
252264332015;252264388907;56892;9;1;1;1
252264388907;252264399158;10251;9;1;1;1
252264399158;252264459272;60114;9;1;1;1
252264459272;252264462088;2816;9;1;1;1
252264462088;252264464936;2848;9;1;1;1
252264464936;252264473331;8395;9;1;1;1
252264473331;252264497162;23831;9;1;1;1
252264497162;252264540704;43542;9;1;1;1
252264540704;252264542319;1615;9;1;1;1
252264542319;252264550400;8081;9;1;1;1
252264550400;252264572761;22361;9;1;1;1
252264572761;252264617643;44882;9;1;1;1
252264617643;252264659459;41816;9;1;1;1
252264659459;252264740642;81183;9;1;1;1
252264740642;252264771716;31074;9;1;1;1
252264771716;252264772721;1005;9;1;1;1
252264772721;252264781438;8717;9;1;1;1
252264781438;252264820977;39539;9;1;1;1
252264820977;252264861967;40990;9;1;1;1
252264861967;252264904331;42364;9;1;1;1
252264904331;252264911871;7540;9;1;1;1
252264911871;252264933260;21389;9;1;1;1
252264933260;252264978528;45268;9;1;1;1
252264978528;252265042388;63860;9;1;1;1
252265042388;252265053558;11170;9;1;1;1
252265053558;252265093283;39725;9;1;1;1
252265093283;252265103314;10031;9;1;1;1
252265103314;252265103368;54;9;1;1;1
252265103368;252265133661;30293;9;1;1;1
252265133661;252265133736;75;9;1;1;1
252265133736;252265169611;35875;9;1;1;1
252265169611;252265171984;2373;9;1;1;1
252265171984;252265172411;427;9;1;1;1
252265172411;252265218333;45922;9;1;1;1
252265218333;252265219673;1340;9;1;1;1
252265219673;252265296383;76710;9;1;1;1
252265296383;252265464426;168043;9;1;1;1
252265464426;252265478848;14422;9;1;1;1
252265478848;252265480401;1553;9;1;1;1
252265480401;252265496127;15726;9;1;1;1
252265496127;252265504251;8124;9;1;1;1
252265504251;252265520029;15778;9;1;1;1
252265520029;252265545895;25866;9;1;1;1
252265545895;252265584329;38434;9;1;1;1
252265584329;252265606345;22016;9;1;1;1
252265606345;252265633000;26655;9;1;1;1
252265633000;252265673490;40490;9;1;1;1
252265673490;252265712723;39233;9;1;1;1
252265712723;252265774982;62259;9;1;1;1
252265774982;252265817166;42184;9;1;1;1
252265817166;252265853438;36272;9;1;1;1
252265853438;252265893115;39677;9;1;1;1
252265893115;252265929264;36149;9;1;1;1
252265929264;252265969207;39943;9;1;1;1
252265969207;252266000010;30803;9;1;1;1
252266000010;252266032359;32349;9;1;1;1
252266032359;252266062062;29703;9;1;1;1
252266062062;252266132509;70447;9;1;1;1
252266132509;252266174080;41571;9;1;1;1
252266174080;252266180570;6490;9;1;1;1
252266180570;252266219164;38594;9;1;1;1
252266219164;252266219441;277;9;1;1;1
252266219441;252266261905;42464;9;1;1;1
252266261905;252266305571;43666;9;1;1;1
252266305571;252266349489;43918;9;1;1;1
252266349489;252266411480;61991;9;1;1;1
252266411480;252266483490;72010;9;1;1;1
252266483490;252266508421;24931;9;1;1;1
252266508421;252266538961;30540;9;1;1;1
252266538961;252266551614;12653;9;1;1;1
252266551614;252266562712;11098;9;1;1;1
252266562712;252266593542;30830;9;1;1;1
252266593542;252266635264;41722;9;1;1;1
252266635264;252266676897;41633;9;1;1;1
252266676897;252266739777;62880;9;1;1;1
252266739777;252266748871;9094;9;1;1;1
252266748871;252266836468;87597;9;1;1;1
252266836468;252266855433;18965;9;1;1;1
252266855433;252266875994;20561;9;1;1;1
252266875994;252266876251;257;9;1;1;1
252266876251;252266925968;49717;9;1;1;1
252266925968;252267017423;91455;9;1;1;1
252267017423;252267025468;8045;9;1;1;1
252267025468;252267076830;51362;9;1;1;1
252267076830;252267130284;53454;9;1;1;1
252267130284;252267189915;59631;9;1;1;1
252267189915;252267197760;7845;9;1;1;1
252267197760;252267217025;19265;9;1;1;1
252267217025;252267226003;8978;9;1;1;1
252267226003;252267226142;139;9;1;1;1
252267226142;252267269851;43709;9;1;1;1
252267269851;252267328925;59074;9;1;1;1
252267328925;252267440702;111777;9;1;1;1
252267440702;252267486392;45690;9;1;1;1
252267486392;252267539100;52708;9;1;1;1
252267539100;252267577688;38588;9;1;1;1
252267577688;252267653717;76029;9;1;1;1
252267653717;252267656450;2733;9;1;1;1
252267656450;252267662164;5714;9;1;1;1
252267662164;252267662736;572;9;1;1;1
252267662736;252267698919;36183;9;1;1;1
252267698919;252267700448;1529;9;1;1;1
252267700448;252267799322;98874;9;1;1;1
252267799322;252267808034;8712;9;1;1;1
252267808034;252267818126;10092;9;1;1;1
252267818126;252267872973;54847;9;1;1;1
252267872973;252267952397;79424;9;1;1;1
252267952397;252267991120;38723;9;1;1;1
252267991120;252267999436;8316;9;1;1;1
252267999436;252268000343;907;9;1;1;1
252268000343;252268044172;43829;9;1;1;1
252268044172;252268103866;59694;9;1;1;1
252268103866;252268142328;38462;9;1;1;1
252268142328;252268148440;6112;9;1;1;1
252268148440;252268196243;47803;9;1;1;1
252268196243;252268242261;46018;9;1;1;1
252268242261;252268286544;44283;9;1;1;1
252268286544;252268316003;29459;9;1;1;1
252268316003;252268351957;35954;9;1;1;1
252268351957;252268387274;35317;9;1;1;1
252268387274;252268427703;40429;9;1;1;1
252268427703;252268448823;21120;9;1;1;1
252268448823;252268504907;56084;9;1;1;1
252268504907;252268570403;65496;9;1;1;1
252268570403;252268697132;126729;9;1;1;1
252268697132;252268704384;7252;9;1;1;1
252268704384;252268710844;6460;9;1;1;1
252268710844;252268797699;86855;9;1;1;1
252268797699;252268800160;2461;9;1;1;1
252268800160;252268812785;12625;9;1;1;1
252268812785;252268813526;741;9;1;1;1
252268813526;252268823753;10227;9;1;1;1
252268823753;252268855395;31642;9;1;1;1
252268855395;252268898425;43030;9;1;1;1
252268898425;252268937967;39542;9;1;1;1
252268937967;252269017990;80023;9;1;1;1
252269017990;252269018325;335;9;1;1;1
252269018325;252269027552;9227;9;1;1;1
252269027552;252269063215;35663;9;1;1;1
252269063215;252269064477;1262;9;1;1;1
252269064477;252269071353;6876;9;1;1;1
252269071353;252269102988;31635;9;1;1;1
252269102988;252269145647;42659;9;1;1;1
252269145647;252269240196;94549;9;1;1;1
252269240196;252269257068;16872;9;1;1;1
252269257068;252269266068;9000;9;1;1;1
252269266068;252269270170;4102;9;1;1;1
252269270170;252269307304;37134;9;1;1;1
252269307304;252269317230;9926;9;1;1;1
252269317230;252269426541;109311;9;1;1;1
252269426541;252269442088;15547;9;1;1;1
252269442088;252269474057;31969;9;1;1;1
252269474057;252269475644;1587;9;1;1;1
252269475644;252269475945;301;9;1;1;1
252269475945;252269585043;109098;9;1;1;1
252269585043;252269595975;10932;9;1;1;1
252269595975;252269597918;1943;9;1;1;1
252269597918;252269604373;6455;9;1;1;1
252269604373;252269612935;8562;9;1;1;1
252269612935;252269615883;2948;9;1;1;1
252269615883;252269653850;37967;9;1;1;1
252269653850;252269681593;27743;9;1;1;1
252269681593;252269736138;54545;9;1;1;1
252269736138;252269767003;30865;9;1;1;1
252269767003;252269777024;10021;9;1;1;1
252269777024;252269782733;5709;9;1;1;1
252269782733;252269787270;4537;9;1;1;1
252269787270;252269793141;5871;9;1;1;1
252269793141;252854455600;584662459;9;1;1;1
252854455600;252854635545;179945;2,9;2;1;1
252854635545;252854637114;1569;2,9;2;1;1
252854637114;252854773357;136243;2,9;2;1;1
252854773357;252855648564;875207;2,9;2;1;1
252855648564;252855667473;18909;2,9;2;1;1
252855667473;252855686123;18650;2,9;2;1;1
252855686123;252855691281;5158;2,9;2;1;1
252855691281;252855891191;199910;2,9;2;1;1
252855891191;252856121574;230383;2,9;2;1;1
252856121574;252856785101;663527;2,9;2;1;1
252856785101;252856786767;1666;2,9;2;1;1
252856786767;252856832423;45656;2,9;2;1;1
252856832423;252856916559;84136;2,9;2;1;1
252856916559;252856916570;11;2,9;2;1;1
252856916570;252856916587;17;2,9;2;1;1
252856916587;252856916617;30;2,9;2;1;1
252856916617;252856916633;16;2,9;2;1;1
252856916633;252856916663;30;2,9;2;1;1
252856916663;252856916717;54;2,9;2;1;1
252856916717;252856916742;25;2,9;2;1;1
252856916742;252856916802;60;2,9;2;1;1
252856916802;252856916815;13;2,9;2;1;1
252856916815;252856916830;15;2,9;2;1;1
252856916830;252856916860;30;2,9;2;1;1
252856916860;252856916874;14;2,9;2;1;1
252856916874;252856916908;34;2,9;2;1;1
252856916908;252856916963;55;2,9;2;1;1
252856916963;252856917007;44;2,9;2;1;1
252856917007;252856917041;34;2,9;2;1;1
252856917041;252856917092;51;2,9;2;1;1
252856917092;252856917109;17;2,9;2;1;1
252856917109;252856917125;16;2,9;2;1;1
252856917125;252856917137;12;2,9;2;1;1
252856917137;252856917187;50;2,9;2;1;1
252856917187;252856917218;31;2,9;2;1;1
252856917218;252856917233;15;2,9;2;1;1
252856917233;252856917249;16;2,9;2;1;1
252856917249;252856917292;43;2,9;2;1;1
252856917292;252856917306;14;2,9;2;1;1
252856917306;252856917321;15;2,9;2;1;1
252856917321;252856917350;29;2,9;2;1;1
252856917350;252856917396;46;2,9;2;1;1
252856917396;252856917413;17;2,9;2;1;1
252856917413;252856917433;20;2,9;2;1;1
252856917433;252856917457;24;2,9;2;1;1
252856917457;252856917506;49;2,9;2;1;1
252856917506;252856917559;53;2,9;2;1;1
252856917559;252856917611;52;2,9;2;1;1
252856917611;252856917644;33;2,9;2;1;1
252856917644;252856917665;21;2,9;2;1;1
252856917665;252856917696;31;2,9;2;1;1
252856917696;252856917708;12;2,9;2;1;1
252856917708;252856917727;19;2,9;2;1;1
252856917727;252856917735;8;2,9;2;1;1
252856917735;252856917755;20;2,9;2;1;1
252856917755;252856917772;17;2,9;2;1;1
252856917772;252856917817;45;2,9;2;1;1
252856917817;252856917841;24;2,9;2;1;1
252856917841;252856917859;18;2,9;2;1;1
252856917859;252856917869;10;2,9;2;1;1
252856917869;252856917894;25;2,9;2;1;1
252856917894;252856917897;3;2,9;2;1;1
252856917897;252856917956;59;2,9;2;1;1
252856917956;252856917963;7;2,9;2;1;1
252856917963;252856917997;34;2,9;2;1;1
252856917997;252856918018;21;2,9;2;1;1
252856918018;252856918042;24;2,9;2;1;1
252856918042;252856918101;59;2,9;2;1;1
252856918101;252856918118;17;2,9;2;1;1
252856918118;252856918127;9;2,9;2;1;1
252856918127;252856918152;25;2,9;2;1;1
252856918152;252856918181;29;2,9;2;1;1
252856918181;252856918235;54;2,9;2;1;1
252856918235;252856918239;4;2,9;2;1;1
252856918239;252856918249;10;2,9;2;1;1
252856918249;252856918273;24;2,9;2;1;1
252856918273;252856918290;17;2,9;2;1;1
252856918290;252856918337;47;2,9;2;1;1
252856918337;252856918344;7;2,9;2;1;1
252856918344;252856918350;6;2,9;2;1;1
252856918350;252856918369;19;2,9;2;1;1
252856918369;252856918388;19;2,9;2;1;1
252856918388;252856918398;10;2,9;2;1;1
252856918398;252856918408;10;2,9;2;1;1
252856918408;252856918446;38;2,9;2;1;1
252856918446;252856918472;26;2,9;2;1;1
252856918472;252856918725;253;2,9;2;1;1
252856918725;252856918767;42;2,9;2;1;1
252856918767;252856918803;36;2,9;2;1;1
252856918803;252856918828;25;2,9;2;1;1
252856918828;252856918883;55;2,9;2;1;1
252856918883;252856919022;139;2,9;2;1;1
252856919022;252856919037;15;2,9;2;1;1
252856919037;252856919091;54;2,9;2;1;1
252856919091;252856919179;88;2,9;2;1;1
252856919179;252856919198;19;2,9;2;1;1
252856919198;252856919217;19;2,9;2;1;1
252856919217;252856919247;30;2,9;2;1;1
252856919247;252856919266;19;2,9;2;1;1
252856919266;252856919370;104;2,9;2;1;1
252856919370;252856919480;110;2,9;2;1;1
252856919480;252856919664;184;2,9;2;1;1
252856919664;252856919682;18;2,9;2;1;1
252856919682;252856919777;95;2,9;2;1;1
252856919777;252856919809;32;2,9;2;1;1
252856919809;252856919832;23;2,9;2;1;1
252856919832;252856919937;105;2,9;2;1;1
252856919937;252856921361;1424;2,9;2;1;1
252856921361;252856921396;35;2,9;2;1;1
252856921396;252856921478;82;2,9;2;1;1
252856921478;252856921567;89;2,9;2;1;1
252856921567;252856921585;18;2,9;2;1;1
252856921585;252856921694;109;2,9;2;1;1
252856921694;252856921717;23;2,9;2;1;1
252856921717;252856921753;36;2,9;2;1;1
252856921753;252856921829;76;2,9;2;1;1
252856921829;252856921881;52;2,9;2;1;1
252856921881;252856922006;125;2,9;2;1;1
252856922006;252856922040;34;2,9;2;1;1
252856922040;252856922117;77;2,9;2;1;1
252856922117;252856922166;49;2,9;2;1;1
252856922166;252856922325;159;2,9;2;1;1
252856922325;252856922356;31;2,9;2;1;1
252856922356;252856922458;102;2,9;2;1;1
252856922458;252856922584;126;2,9;2;1;1
252856922584;252856922700;116;2,9;2;1;1
252856922700;252856922738;38;2,9;2;1;1
252856922738;252856922773;35;2,9;2;1;1
252856922773;252856922796;23;2,9;2;1;1
252856922796;252856922824;28;2,9;2;1;1
252856922824;252856922867;43;2,9;2;1;1
252856922867;252856922990;123;2,9;2;1;1
252856922990;252856923024;34;2,9;2;1;1
252856923024;252856924064;1040;2,9;2;1;1
252856924064;252856924116;52;2,9;2;1;1
252856924116;252856924863;747;2,9;2;1;1
252856924863;252856924969;106;2,9;2;1;1
252856924969;252856958937;33968;2,9;2;1;1
252856958937;252856958946;9;2,9;2;1;1
252856958946;252856958962;16;2,9;2;1;1
252856958962;252856958989;27;2,9;2;1;1
252856958989;252856959006;17;2,9;2;1;1
252856959006;252856959053;47;2,9;2;1;1
252856959053;252856959104;51;2,9;2;1;1
252856959104;252856959117;13;2,9;2;1;1
252856959117;252856960264;1147;2,9;2;1;1
252856960264;252856960353;89;2,9;2;1;1
252856960353;252856960408;55;2,9;2;1;1
252856960408;252856960518;110;2,9;2;1;1
252856960518;252856960557;39;2,9;2;1;1
252856960557;252856960688;131;2,9;2;1;1
252856960688;252856960720;32;2,9;2;1;1
252856960720;252856960749;29;2,9;2;1;1
252856960749;252856960778;29;2,9;2;1;1
252856960778;252856960799;21;2,9;2;1;1
252856960799;252856960911;112;2,9;2;1;1
252856960911;252856960940;29;2,9;2;1;1
252856960940;252856961057;117;2,9;2;1;1
252856961057;252856961100;43;2,9;2;1;1
252856961100;252856961113;13;2,9;2;1;1
252856961113;252856961121;8;2,9;2;1;1
252856961121;252856961141;20;2,9;2;1;1
252856961141;252856961178;37;2,9;2;1;1
252856961178;252856961192;14;2,9;2;1;1
252856961192;252856961197;5;2,9;2;1;1
252856961197;252856961216;19;2,9;2;1;1
252856961216;252856961222;6;2,9;2;1;1
252856961222;252856961228;6;2,9;2;1;1
252856961228;252856961238;10;2,9;2;1;1
252856961238;252856961246;8;2,9;2;1;1
252856961246;252856961255;9;2,9;2;1;1
252856961255;252856961257;2;2,9;2;1;1
252856961257;252856961265;8;2,9;2;1;1
252856961265;252856961307;42;2,9;2;1;1
252856961307;252856961331;24;2,9;2;1;1
252856961331;252856961379;48;2,9;2;1;1
252856961379;252856961386;7;2,9;2;1;1
252856961386;252856961387;1;2,9;2;1;1
252856961387;252856961409;22;2,9;2;1;1
252856961409;252856961413;4;2,9;2;1;1
252856961413;252856961416;3;2,9;2;1;1
252856961416;252856961418;2;2,9;2;1;1
252856961418;252856961426;8;2,9;2;1;1
252856961426;252856961449;23;2,9;2;1;1
252856961449;252856961454;5;2,9;2;1;1
252856961454;252856961637;183;2,9;2;1;1
252856961637;252856961674;37;2,9;2;1;1
252856961674;252856961700;26;2,9;2;1;1
252856961700;252856961742;42;2,9;2;1;1
252856961742;252856961805;63;2,9;2;1;1
252856961805;252856961822;17;2,9;2;1;1
252856961822;252856961848;26;2,9;2;1;1
252856961848;252856961850;2;2,9;2;1;1
252856961850;252856961875;25;2,9;2;1;1
252856961875;252856961891;16;2,9;2;1;1
252856961891;252856961908;17;2,9;2;1;1
252856961908;252856961916;8;2,9;2;1;1
252856961916;252856961947;31;2,9;2;1;1
252856961947;252856961969;22;2,9;2;1;1
252856961969;252856962021;52;2,9;2;1;1
252856962021;252856962022;1;2,9;2;1;1
252856962022;252856962046;24;2,9;2;1;1
252856962046;252856962057;11;2,9;2;1;1
252856962057;252856962073;16;2,9;2;1;1
252856962073;252856962082;9;2,9;2;1;1
252856962082;252856962103;21;2,9;2;1;1
252856962103;252856962112;9;2,9;2;1;1
252856962112;252856962119;7;2,9;2;1;1
252856962119;252856962120;1;2,9;2;1;1
252856962120;252856962138;18;2,9;2;1;1
252856962138;252856962139;1;2,9;2;1;1
252856962139;252856962147;8;2,9;2;1;1
252856962147;252856962162;15;2,9;2;1;1
252856962162;252856962167;5;2,9;2;1;1
252856962167;252856962171;4;2,9;2;1;1
252856962171;252856962174;3;2,9;2;1;1
252856962174;252856962179;5;2,9;2;1;1
252856962179;252856962183;4;2,9;2;1;1
252856962183;252856962184;1;2,9;2;1;1
252856962184;252856962186;2;2,9;2;1;1
252856962186;252856962188;2;2,9;2;1;1
252856962188;252856962201;13;2,9;2;1;1
252856962201;252856962209;8;2,9;2;1;1
252856962209;252856962217;8;2,9;2;1;1
252856962217;252856962219;2;2,9;2;1;1
252856962219;252856962225;6;2,9;2;1;1
252856962225;252856962242;17;2,9;2;1;1
252856962242;252856962247;5;2,9;2;1;1
252856962247;252856962250;3;2,9;2;1;1
252856962250;252856962285;35;2,9;2;1;1
252856962285;252856962294;9;2,9;2;1;1
252856962294;252856962311;17;2,9;2;1;1
252856962311;252856962318;7;2,9;2;1;1
252856962318;252856962339;21;2,9;2;1;1
252856962339;252856962342;3;2,9;2;1;1
252856962342;252856962356;14;2,9;2;1;1
252856962356;252856962379;23;2,9;2;1;1
252856962379;252856962405;26;2,9;2;1;1
252856962405;252856962409;4;2,9;2;1;1
252856962409;252856962412;3;2,9;2;1;1
252856962412;252856962425;13;2,9;2;1;1
252856962425;252856962428;3;2,9;2;1;1
252856962428;252856962443;15;2,9;2;1;1
252856962443;252856962453;10;2,9;2;1;1
252856962453;252856962457;4;2,9;2;1;1
252856962457;252856962463;6;2,9;2;1;1
252856962463;252856962492;29;2,9;2;1;1
252856962492;252856962525;33;2,9;2;1;1
252856962525;252856962527;2;2,9;2;1;1
252856962527;252856962558;31;2,9;2;1;1
252856962558;252856962562;4;2,9;2;1;1
252856962562;252856962578;16;2,9;2;1;1
252856962578;252856962583;5;2,9;2;1;1
252856962583;252856962596;13;2,9;2;1;1
252856962596;252856962605;9;2,9;2;1;1
252856962605;252856962610;5;2,9;2;1;1
252856962610;252856962651;41;2,9;2;1;1
252856962651;252856962670;19;2,9;2;1;1
252856962670;252856962694;24;2,9;2;1;1
252856962694;252856962714;20;2,9;2;1;1
252856962714;252856962767;53;2,9;2;1;1
252856962767;252856962789;22;2,9;2;1;1
252856962789;252856962804;15;2,9;2;1;1
252856962804;252856962847;43;2,9;2;1;1
252856962847;252856962863;16;2,9;2;1;1
252856962863;252856962884;21;2,9;2;1;1
252856962884;252856962890;6;2,9;2;1;1
252856962890;252856962895;5;2,9;2;1;1
252856962895;252856962915;20;2,9;2;1;1
252856962915;252856962956;41;2,9;2;1;1
252856962956;252856963135;179;2,9;2;1;1
252856963135;252856963445;310;2,9;2;1;1
252856963445;252856963675;230;2,9;2;1;1
252856963675;252856963708;33;2,9;2;1;1
252856963708;252856963728;20;2,9;2;1;1
252856963728;252856963752;24;2,9;2;1;1
252856963752;252856963767;15;2,9;2;1;1
252856963767;252856963800;33;2,9;2;1;1
252856963800;252856963820;20;2,9;2;1;1
252856963820;252856963828;8;2,9;2;1;1
252856963828;252856964012;184;2,9;2;1;1
252856964012;252856964022;10;2,9;2;1;1
252856964022;252856964054;32;2,9;2;1;1
252856964054;252856964085;31;2,9;2;1;1
252856964085;252856964104;19;2,9;2;1;1
252856964104;252856964112;8;2,9;2;1;1
252856964112;252856964117;5;2,9;2;1;1
252856964117;252856964125;8;2,9;2;1;1
252856964125;252856964152;27;2,9;2;1;1
252856964152;252856964167;15;2,9;2;1;1
252856964167;252856964202;35;2,9;2;1;1
252856964202;252856964225;23;2,9;2;1;1
252856964225;252856964228;3;2,9;2;1;1
252856964228;252856964230;2;2,9;2;1;1
252856964230;252856964254;24;2,9;2;1;1
252856964254;252856964283;29;2,9;2;1;1
252856964283;252856964293;10;2,9;2;1;1
252856964293;252856964306;13;2,9;2;1;1
252856964306;252856964312;6;2,9;2;1;1
252856964312;252856964314;2;2,9;2;1;1
252856964314;252856964348;34;2,9;2;1;1
252856964348;252856964365;17;2,9;2;1;1
252856964365;252856964367;2;2,9;2;1;1
252856964367;252856964375;8;2,9;2;1;1
252856964375;252856964395;20;2,9;2;1;1
252856964395;252856964403;8;2,9;2;1;1
252856964403;252856964415;12;2,9;2;1;1
252856964415;252856964418;3;2,9;2;1;1
252856964418;252856964430;12;2,9;2;1;1
252856964430;252856964437;7;2,9;2;1;1
252856964437;252856964455;18;2,9;2;1;1
252856964455;252856964460;5;2,9;2;1;1
252856964460;252856964461;1;2,9;2;1;1
252856964461;252856964464;3;2,9;2;1;1
252856964464;252856964471;7;2,9;2;1;1
252856964471;252856964485;14;2,9;2;1;1
252856964485;252856964495;10;2,9;2;1;1
252856964495;252856964504;9;2,9;2;1;1
252856964504;252856964505;1;2,9;2;1;1
252856964505;252856964514;9;2,9;2;1;1
252856964514;252856964528;14;2,9;2;1;1
252856964528;252856964530;2;2,9;2;1;1
252856964530;252856964555;25;2,9;2;1;1
252856964555;252856964560;5;2,9;2;1;1
252856964560;252856964567;7;2,9;2;1;1
252856964567;252856964645;78;2,9;2;1;1
252856964645;252856964648;3;2,9;2;1;1
252856964648;252856964662;14;2,9;2;1;1
252856964662;252856964666;4;2,9;2;1;1
252856964666;252856964689;23;2,9;2;1;1
252856964689;252856964710;21;2,9;2;1;1
252856964710;252856964725;15;2,9;2;1;1
252856964725;252856964731;6;2,9;2;1;1
252856964731;252856964763;32;2,9;2;1;1
252856964763;252856964777;14;2,9;2;1;1
252856964777;252856964780;3;2,9;2;1;1
252856964780;252856964794;14;2,9;2;1;1
252856964794;252856964800;6;2,9;2;1;1
252856964800;252856964802;2;2,9;2;1;1
252856964802;252856964813;11;2,9;2;1;1
252856964813;252856964825;12;2,9;2;1;1
252856964825;252856964830;5;2,9;2;1;1
252856964830;252856964839;9;2,9;2;1;1
252856964839;252856964867;28;2,9;2;1;1
252856964867;252856964891;24;2,9;2;1;1
252856964891;252856964906;15;2,9;2;1;1
252856964906;252856964924;18;2,9;2;1;1
252856964924;252856964926;2;2,9;2;1;1
252856964926;252856964966;40;2,9;2;1;1
252856964966;252856964971;5;2,9;2;1;1
252856964971;252856964986;15;2,9;2;1;1
252856964986;252856964988;2;2,9;2;1;1
252856964988;252856964989;1;2,9;2;1;1
252856964989;252856964992;3;2,9;2;1;1
252856964992;252856965008;16;2,9;2;1;1
252856965008;252856965009;1;2,9;2;1;1
252856965009;252856965016;7;2,9;2;1;1
252856965016;252856965020;4;2,9;2;1;1
252856965020;252856965025;5;2,9;2;1;1
252856965025;252856965039;14;2,9;2;1;1
252856965039;252856965042;3;2,9;2;1;1
252856965042;252856965050;8;2,9;2;1;1
252856965050;252856965059;9;2,9;2;1;1
252856965059;252856965061;2;2,9;2;1;1
252856965061;252856965075;14;2,9;2;1;1
252856965075;252856965091;16;2,9;2;1;1
252856965091;252856965101;10;2,9;2;1;1
252856965101;252856965112;11;2,9;2;1;1
252856965112;252856965113;1;2,9;2;1;1
252856965113;252856965133;20;2,9;2;1;1
252856965133;252856965137;4;2,9;2;1;1
252856965137;252856965142;5;2,9;2;1;1
252856965142;252856965156;14;2,9;2;1;1
252856965156;252856965165;9;2,9;2;1;1
252856965165;252856965168;3;2,9;2;1;1
252856965168;252856965174;6;2,9;2;1;1
252856965174;252856965202;28;2,9;2;1;1
252856965202;252856965216;14;2,9;2;1;1
252856965216;252856965223;7;2,9;2;1;1
252856965223;252856965226;3;2,9;2;1;1
252856965226;252856965242;16;2,9;2;1;1
252856965242;252856965260;18;2,9;2;1;1
252856965260;252856965267;7;2,9;2;1;1
252856965267;252856965283;16;2,9;2;1;1
252856965283;252856965327;44;2,9;2;1;1
252856965327;252856965338;11;2,9;2;1;1
252856965338;252856965346;8;2,9;2;1;1
252856965346;252856965380;34;2,9;2;1;1
252856965380;252856965404;24;2,9;2;1;1
252856965404;252856965428;24;2,9;2;1;1
252856965428;252856965433;5;2,9;2;1;1
252856965433;252856965436;3;2,9;2;1;1
252856965436;252856965457;21;2,9;2;1;1
252856965457;252856965462;5;2,9;2;1;1
252856965462;252856965464;2;2,9;2;1;1
252856965464;252856965483;19;2,9;2;1;1
252856965483;252856965492;9;2,9;2;1;1
252856965492;252856965539;47;2,9;2;1;1
252856965539;252856965541;2;2,9;2;1;1
252856965541;252856965547;6;2,9;2;1;1
252856965547;252856965556;9;2,9;2;1;1
252856965556;252856965563;7;2,9;2;1;1
252856965563;252856965576;13;2,9;2;1;1
252856965576;252856965581;5;2,9;2;1;1
252856965581;252856965595;14;2,9;2;1;1
252856965595;252856965602;7;2,9;2;1;1
252856965602;252856965608;6;2,9;2;1;1
252856965608;252856965619;11;2,9;2;1;1
252856965619;252856965628;9;2,9;2;1;1
252856965628;252856965629;1;2,9;2;1;1
252856965629;252856965644;15;2,9;2;1;1
252856965644;252856965645;1;2,9;2;1;1
252856965645;252856965651;6;2,9;2;1;1
252856965651;252856965660;9;2,9;2;1;1
252856965660;252856965663;3;2,9;2;1;1
252856965663;252856965681;18;2,9;2;1;1
252856965681;252856965692;11;2,9;2;1;1
252856965692;252856965696;4;2,9;2;1;1
252856965696;252856965697;1;2,9;2;1;1
252856965697;252856965700;3;2,9;2;1;1
252856965700;252856965705;5;2,9;2;1;1
252856965705;252856965724;19;2,9;2;1;1
252856965724;252856965732;8;2,9;2;1;1
252856965732;252856965733;1;2,9;2;1;1
252856965733;252856965757;24;2,9;2;1;1
252856965757;252856965765;8;2,9;2;1;1
252856965765;252856965788;23;2,9;2;1;1
252856965788;252856965801;13;2,9;2;1;1
252856965801;252856965814;13;2,9;2;1;1
252856965814;252856965827;13;2,9;2;1;1
252856965827;252856965852;25;2,9;2;1;1
252856965852;252856965869;17;2,9;2;1;1
252856965869;252856965870;1;2,9;2;1;1
252856965870;252856965874;4;2,9;2;1;1
252856965874;252856965880;6;2,9;2;1;1
252856965880;252856965882;2;2,9;2;1;1
252856965882;252856965890;8;2,9;2;1;1
252856965890;252856965908;18;2,9;2;1;1
252856965908;252856965910;2;2,9;2;1;1
252856965910;252856965916;6;2,9;2;1;1
252856965916;252856965925;9;2,9;2;1;1
252856965925;252856965933;8;2,9;2;1;1
252856965933;252856965946;13;2,9;2;1;1
252856965946;252856965964;18;2,9;2;1;1
252856965964;252856965985;21;2,9;2;1;1
252856965985;252856965986;1;2,9;2;1;1
252856965986;252856965987;1;2,9;2;1;1
252856965987;252856965995;8;2,9;2;1;1
252856965995;252856965999;4;2,9;2;1;1
252856965999;252856966006;7;2,9;2;1;1
252856966006;252856966009;3;2,9;2;1;1
252856966009;252856966017;8;2,9;2;1;1
252856966017;252856966022;5;2,9;2;1;1
252856966022;252856966028;6;2,9;2;1;1
252856966028;252856966032;4;2,9;2;1;1
252856966032;252856966036;4;2,9;2;1;1
252856966036;252856966051;15;2,9;2;1;1
252856966051;252856966058;7;2,9;2;1;1
252856966058;252856966068;10;2,9;2;1;1
252856966068;252856966096;28;2,9;2;1;1
252856966096;252856966142;46;2,9;2;1;1
252856966142;252856966149;7;2,9;2;1;1
252856966149;252856966152;3;2,9;2;1;1
252856966152;252856966155;3;2,9;2;1;1
252856966155;252856966156;1;2,9;2;1;1
252856966156;252856966164;8;2,9;2;1;1
252856966164;252856966166;2;2,9;2;1;1
252856966166;252856966209;43;2,9;2;1;1
252856966209;252856966214;5;2,9;2;1;1
252856966214;252856966233;19;2,9;2;1;1
252856966233;252856966240;7;2,9;2;1;1
252856966240;252856966249;9;2,9;2;1;1
252856966249;252856966290;41;2,9;2;1;1
252856966290;252856966292;2;2,9;2;1;1
252856966292;252856966306;14;2,9;2;1;1
252856966306;252856966310;4;2,9;2;1;1
252856966310;252856966317;7;2,9;2;1;1
252856966317;252856966332;15;2,9;2;1;1
252856966332;252856966357;25;2,9;2;1;1
252856966357;252856966359;2;2,9;2;1;1
252856966359;252856966386;27;2,9;2;1;1
252856966386;252856966390;4;2,9;2;1;1
252856966390;252856966421;31;2,9;2;1;1
252856966421;252856966426;5;2,9;2;1;1
252856966426;252856966432;6;2,9;2;1;1
252856966432;252856966442;10;2,9;2;1;1
252856966442;252856966455;13;2,9;2;1;1
252856966455;252856966467;12;2,9;2;1;1
252856966467;252856966476;9;2,9;2;1;1
252856966476;252856966495;19;2,9;2;1;1
252856966495;252856966500;5;2,9;2;1;1
252856966500;252856966501;1;2,9;2;1;1
252856966501;252856966506;5;2,9;2;1;1
252856966506;252856966526;20;2,9;2;1;1
252856966526;252856966532;6;2,9;2;1;1
252856966532;252856966539;7;2,9;2;1;1
252856966539;252856966546;7;2,9;2;1;1
252856966546;252856966568;22;2,9;2;1;1
252856966568;252856966604;36;2,9;2;1;1
252856966604;252856966612;8;2,9;2;1;1
252856966612;252856966624;12;2,9;2;1;1
252856966624;252856966635;11;2,9;2;1;1
252856966635;252856966643;8;2,9;2;1;1
252856966643;252856966660;17;2,9;2;1;1
252856966660;252856966663;3;2,9;2;1;1
252856966663;252856966665;2;2,9;2;1;1
252856966665;252856966683;18;2,9;2;1;1
252856966683;252856966689;6;2,9;2;1;1
252856966689;252856966709;20;2,9;2;1;1
252856966709;252856966715;6;2,9;2;1;1
252856966715;252856966722;7;2,9;2;1;1
252856966722;252856966728;6;2,9;2;1;1
252856966728;252856966734;6;2,9;2;1;1
252856966734;252856966755;21;2,9;2;1;1
252856966755;252856966764;9;2,9;2;1;1
252856966764;252856966774;10;2,9;2;1;1
252856966774;252856966779;5;2,9;2;1;1
252856966779;252856966796;17;2,9;2;1;1
252856966796;252856966818;22;2,9;2;1;1
252856966818;252856966825;7;2,9;2;1;1
252856966825;252856966837;12;2,9;2;1;1
252856966837;252856966842;5;2,9;2;1;1
252856966842;252856966861;19;2,9;2;1;1
252856966861;252856966863;2;2,9;2;1;1
252856966863;252856966867;4;2,9;2;1;1
252856966867;252856966872;5;2,9;2;1;1
252856966872;252856966882;10;2,9;2;1;1
252856966882;252856966884;2;2,9;2;1;1
252856966884;252856966893;9;2,9;2;1;1
252856966893;252856966906;13;2,9;2;1;1
252856966906;252856966912;6;2,9;2;1;1
252856966912;252856966916;4;2,9;2;1;1
252856966916;252856966933;17;2,9;2;1;1
252856966933;252856966935;2;2,9;2;1;1
252856966935;252856966944;9;2,9;2;1;1
252856966944;252856966963;19;2,9;2;1;1
252856966963;252856966969;6;2,9;2;1;1
252856966969;252856966974;5;2,9;2;1;1
252856966974;252856967003;29;2,9;2;1;1
252856967003;252856967004;1;2,9;2;1;1
252856967004;252856967005;1;2,9;2;1;1
252856967005;252856967023;18;2,9;2;1;1
252856967023;252856967025;2;2,9;2;1;1
252856967025;252856967049;24;2,9;2;1;1
252856967049;252856967058;9;2,9;2;1;1
252856967058;252856967069;11;2,9;2;1;1
252856967069;252856967080;11;2,9;2;1;1
252856967080;252856967081;1;2,9;2;1;1
252856967081;252856967099;18;2,9;2;1;1
252856967099;252856967141;42;2,9;2;1;1
252856967141;252856967151;10;2,9;2;1;1
252856967151;252856967162;11;2,9;2;1;1
252856967162;252856967165;3;2,9;2;1;1
252856967165;252856967173;8;2,9;2;1;1
252856967173;252856967178;5;2,9;2;1;1
252856967178;252856967184;6;2,9;2;1;1
252856967184;252856967192;8;2,9;2;1;1
252856967192;252856967194;2;2,9;2;1;1
252856967194;252856967214;20;2,9;2;1;1
252856967214;252856967233;19;2,9;2;1;1
252856967233;252856967236;3;2,9;2;1;1
252856967236;252856967237;1;2,9;2;1;1
252856967237;252856967256;19;2,9;2;1;1
252856967256;252856967257;1;2,9;2;1;1
252856967257;252856967261;4;2,9;2;1;1
252856967261;252856967287;26;2,9;2;1;1
252856967287;252856967290;3;2,9;2;1;1
252856967290;252856967297;7;2,9;2;1;1
252856967297;252856967306;9;2,9;2;1;1
252856967306;252856967307;1;2,9;2;1;1
252856967307;252856967316;9;2,9;2;1;1
252856967316;252856967324;8;2,9;2;1;1
252856967324;252856967339;15;2,9;2;1;1
252856967339;252856967362;23;2,9;2;1;1
252856967362;252856967371;9;2,9;2;1;1
252856967371;252856967374;3;2,9;2;1;1
252856967374;252856967388;14;2,9;2;1;1
252856967388;252856967389;1;2,9;2;1;1
252856967389;252856967397;8;2,9;2;1;1
252856967397;252856967405;8;2,9;2;1;1
252856967405;252856967407;2;2,9;2;1;1
252856967407;252856967417;10;2,9;2;1;1
252856967417;252856967430;13;2,9;2;1;1
252856967430;252856967431;1;2,9;2;1;1
252856967431;252856967432;1;2,9;2;1;1
252856967432;252856967438;6;2,9;2;1;1
252856967438;252856967443;5;2,9;2;1;1
252856967443;252856967449;6;2,9;2;1;1
252856967449;252856967478;29;2,9;2;1;1
252856967478;252856967493;15;2,9;2;1;1
252856967493;252856967499;6;2,9;2;1;1
252856967499;252856967500;1;2,9;2;1;1
252856967500;252856967514;14;2,9;2;1;1
252856967514;252856967532;18;2,9;2;1;1
252856967532;252856967545;13;2,9;2;1;1
252856967545;252856967579;34;2,9;2;1;1
252856967579;252856967585;6;2,9;2;1;1
252856967585;252856967600;15;2,9;2;1;1
252856967600;252856967609;9;2,9;2;1;1
252856967609;252856967616;7;2,9;2;1;1
252856967616;252856967633;17;2,9;2;1;1
252856967633;252856967635;2;2,9;2;1;1
252856967635;252856967637;2;2,9;2;1;1
252856967637;252856967644;7;2,9;2;1;1
252856967644;252856967662;18;2,9;2;1;1
252856967662;252856967665;3;2,9;2;1;1
252856967665;252856967670;5;2,9;2;1;1
252856967670;252856967684;14;2,9;2;1;1
252856967684;252856967709;25;2,9;2;1;1
252856967709;252856967724;15;2,9;2;1;1
252856967724;252856967733;9;2,9;2;1;1
252856967733;252856967757;24;2,9;2;1;1
252856967757;252856967763;6;2,9;2;1;1
252856967763;252856967776;13;2,9;2;1;1
252856967776;252856967783;7;2,9;2;1;1
252856967783;252856967807;24;2,9;2;1;1
252856967807;252856967822;15;2,9;2;1;1
252856967822;252856967825;3;2,9;2;1;1
252856967825;252856967826;1;2,9;2;1;1
252856967826;252856967827;1;2,9;2;1;1
252856967827;252856967851;24;2,9;2;1;1
252856967851;252856967852;1;2,9;2;1;1
252856967852;252856967861;9;2,9;2;1;1
252856967861;252856967867;6;2,9;2;1;1
252856967867;252856967873;6;2,9;2;1;1
252856967873;252856967888;15;2,9;2;1;1
252856967888;252856967895;7;2,9;2;1;1
252856967895;252856967905;10;2,9;2;1;1
252856967905;252856967923;18;2,9;2;1;1
252856967923;252856967930;7;2,9;2;1;1
252856967930;252856967932;2;2,9;2;1;1
252856967932;252856967938;6;2,9;2;1;1
252856967938;252856967959;21;2,9;2;1;1
252856967959;252856967985;26;2,9;2;1;1
252856967985;252856967990;5;2,9;2;1;1
252856967990;252856967995;5;2,9;2;1;1
252856967995;252856968003;8;2,9;2;1;1
252856968003;252856968005;2;2,9;2;1;1
252856968005;252856968006;1;2,9;2;1;1
252856968006;252856968029;23;2,9;2;1;1
252856968029;252856968032;3;2,9;2;1;1
252856968032;252856968035;3;2,9;2;1;1
252856968035;252856968037;2;2,9;2;1;1
252856968037;252856968057;20;2,9;2;1;1
252856968057;252856968067;10;2,9;2;1;1
252856968067;252856968068;1;2,9;2;1;1
252856968068;252856968090;22;2,9;2;1;1
252856968090;252856968098;8;2,9;2;1;1
252856968098;252856968128;30;2,9;2;1;1
252856968128;252856968151;23;2,9;2;1;1
252856968151;252856968175;24;2,9;2;1;1
252856968175;252856968186;11;2,9;2;1;1
252856968186;252856968204;18;2,9;2;1;1
252856968204;252856968209;5;2,9;2;1;1
252856968209;252856968234;25;2,9;2;1;1
252856968234;252856968242;8;2,9;2;1;1
252856968242;252856968287;45;2,9;2;1;1
252856968287;252856968289;2;2,9;2;1;1
252856968289;252856968290;1;2,9;2;1;1
252856968290;252856968299;9;2,9;2;1;1
252856968299;252856968307;8;2,9;2;1;1
252856968307;252856968328;21;2,9;2;1;1
252856968328;252856968331;3;2,9;2;1;1
252856968331;252856968334;3;2,9;2;1;1
252856968334;252856968337;3;2,9;2;1;1
252856968337;252856968340;3;2,9;2;1;1
252856968340;252856968359;19;2,9;2;1;1
252856968359;252856968361;2;2,9;2;1;1
252856968361;252856968365;4;2,9;2;1;1
252856968365;252856968366;1;2,9;2;1;1
252856968366;252856968370;4;2,9;2;1;1
252856968370;252856968373;3;2,9;2;1;1
252856968373;252856968374;1;2,9;2;1;1
252856968374;252856968384;10;2,9;2;1;1
252856968384;252856968386;2;2,9;2;1;1
252856968386;252856968392;6;2,9;2;1;1
252856968392;252856968393;1;2,9;2;1;1
252856968393;252856968402;9;2,9;2;1;1
252856968402;252856968410;8;2,9;2;1;1
252856968410;252856968414;4;2,9;2;1;1
252856968414;252856968420;6;2,9;2;1;1
252856968420;252856968421;1;2,9;2;1;1
252856968421;252856968429;8;2,9;2;1;1
252856968429;252856968444;15;2,9;2;1;1
252856968444;252856968454;10;2,9;2;1;1
252856968454;252856968459;5;2,9;2;1;1
252856968459;252856968465;6;2,9;2;1;1
252856968465;252856968467;2;2,9;2;1;1
252856968467;252856968470;3;2,9;2;1;1
252856968470;252856968475;5;2,9;2;1;1
252856968475;252856968478;3;2,9;2;1;1
252856968478;252856968493;15;2,9;2;1;1
252856968493;252856968497;4;2,9;2;1;1
252856968497;252856968506;9;2,9;2;1;1
252856968506;252856968508;2;2,9;2;1;1
252856968508;252856968513;5;2,9;2;1;1
252856968513;252856968518;5;2,9;2;1;1
252856968518;252856968534;16;2,9;2;1;1
252856968534;252856968550;16;2,9;2;1;1
252856968550;252856968553;3;2,9;2;1;1
252856968553;252856968555;2;2,9;2;1;1
252856968555;252856968558;3;2,9;2;1;1
252856968558;252856968569;11;2,9;2;1;1
252856968569;252856968571;2;2,9;2;1;1
252856968571;252856968578;7;2,9;2;1;1
252856968578;252856968591;13;2,9;2;1;1
252856968591;252856968599;8;2,9;2;1;1
252856968599;252856968601;2;2,9;2;1;1
252856968601;252856968602;1;2,9;2;1;1
252856968602;252856968612;10;2,9;2;1;1
252856968612;252856968617;5;2,9;2;1;1
252856968617;252856968618;1;2,9;2;1;1
252856968618;252856968623;5;2,9;2;1;1
252856968623;252856968631;8;2,9;2;1;1
252856968631;252856968634;3;2,9;2;1;1
252856968634;252856968648;14;2,9;2;1;1
252856968648;252856968650;2;2,9;2;1;1
252856968650;252856968654;4;2,9;2;1;1
252856968654;252856968658;4;2,9;2;1;1
252856968658;252856968660;2;2,9;2;1;1
252856968660;252856968664;4;2,9;2;1;1
252856968664;252856968669;5;2,9;2;1;1
252856968669;252856968673;4;2,9;2;1;1
252856968673;252856968678;5;2,9;2;1;1
252856968678;252856968686;8;2,9;2;1;1
252856968686;252856968688;2;2,9;2;1;1
252856968688;252856968691;3;2,9;2;1;1
252856968691;252856968698;7;2,9;2;1;1
252856968698;252856968699;1;2,9;2;1;1
252856968699;252856968705;6;2,9;2;1;1
252856968705;252856968715;10;2,9;2;1;1
252856968715;252856968716;1;2,9;2;1;1
252856968716;252856968718;2;2,9;2;1;1
252856968718;252856968724;6;2,9;2;1;1
252856968724;252856968725;1;2,9;2;1;1
252856968725;252856968745;20;2,9;2;1;1
252856968745;252856968748;3;2,9;2;1;1
252856968748;252856968753;5;2,9;2;1;1
252856968753;252856968755;2;2,9;2;1;1
252856968755;252856968760;5;2,9;2;1;1
252856968760;252856968762;2;2,9;2;1;1
252856968762;252856968770;8;2,9;2;1;1
252856968770;252856968773;3;2,9;2;1;1
252856968773;252856968782;9;2,9;2;1;1
252856968782;252856968783;1;2,9;2;1;1
252856968783;252856968789;6;2,9;2;1;1
252856968789;252856968802;13;2,9;2;1;1
252856968802;252856968803;1;2,9;2;1;1
252856968803;252856968808;5;2,9;2;1;1
252856968808;252856968813;5;2,9;2;1;1
252856968813;252856968816;3;2,9;2;1;1
252856968816;252856968817;1;2,9;2;1;1
252856968817;252856968822;5;2,9;2;1;1
252856968822;252856968829;7;2,9;2;1;1
252856968829;252856968833;4;2,9;2;1;1
252856968833;252856968836;3;2,9;2;1;1
252856968836;252856968837;1;2,9;2;1;1
252856968837;252856968849;12;2,9;2;1;1
252856968849;252856968867;18;2,9;2;1;1
252856968867;252856968873;6;2,9;2;1;1
252856968873;252856968880;7;2,9;2;1;1
252856968880;252856968883;3;2,9;2;1;1
252856968883;252856968902;19;2,9;2;1;1
252856968902;252856968903;1;2,9;2;1;1
252856968903;252856968905;2;2,9;2;1;1
252856968905;252856968916;11;2,9;2;1;1
252856968916;252856968925;9;2,9;2;1;1
252856968925;252856968931;6;2,9;2;1;1
252856968931;252856968935;4;2,9;2;1;1
252856968935;252856968954;19;2,9;2;1;1
252856968954;252856968961;7;2,9;2;1;1
252856968961;252856968962;1;2,9;2;1;1
252856968962;252856968972;10;2,9;2;1;1
252856968972;252856968973;1;2,9;2;1;1
252856968973;252856969000;27;2,9;2;1;1
252856969000;252856969008;8;2,9;2;1;1
252856969008;252856969010;2;2,9;2;1;1
252856969010;252856969023;13;2,9;2;1;1
252856969023;252856969025;2;2,9;2;1;1
252856969025;252856969051;26;2,9;2;1;1
252856969051;252856969070;19;2,9;2;1;1
252856969070;252856969081;11;2,9;2;1;1
252856969081;252856969084;3;2,9;2;1;1
252856969084;252856969100;16;2,9;2;1;1
252856969100;252856969106;6;2,9;2;1;1
252856969106;252856969125;19;2,9;2;1;1
252856969125;252856969130;5;2,9;2;1;1
252856969130;252856969165;35;2,9;2;1;1
252856969165;252856969173;8;2,9;2;1;1
252856969173;252856969174;1;2,9;2;1;1
252856969174;252856969176;2;2,9;2;1;1
252856969176;252856969183;7;2,9;2;1;1
252856969183;252856969197;14;2,9;2;1;1
252856969197;252856969215;18;2,9;2;1;1
252856969215;252856969218;3;2,9;2;1;1
252856969218;252856969221;3;2,9;2;1;1
252856969221;252856969245;24;2,9;2;1;1
252856969245;252856969254;9;2,9;2;1;1
252856969254;252856969257;3;2,9;2;1;1
252856969257;252856969258;1;2,9;2;1;1
252856969258;252856969263;5;2,9;2;1;1
252856969263;252856969266;3;2,9;2;1;1
252856969266;252856969270;4;2,9;2;1;1
252856969270;252856969275;5;2,9;2;1;1
252856969275;252856969279;4;2,9;2;1;1
252856969279;252856969288;9;2,9;2;1;1
252856969288;252856969291;3;2,9;2;1;1
252856969291;252856969302;11;2,9;2;1;1
252856969302;252856969310;8;2,9;2;1;1
252856969310;252856969324;14;2,9;2;1;1
252856969324;252856969334;10;2,9;2;1;1
252856969334;252856969376;42;2,9;2;1;1
252856969376;252856969387;11;2,9;2;1;1
252856969387;252856969391;4;2,9;2;1;1
252856969391;252856969392;1;2,9;2;1;1
252856969392;252856969408;16;2,9;2;1;1
252856969408;252856969410;2;2,9;2;1;1
252856969410;252856969427;17;2,9;2;1;1
252856969427;252856969451;24;2,9;2;1;1
252856969451;252856969463;12;2,9;2;1;1
252856969463;252856969480;17;2,9;2;1;1
252856969480;252856969525;45;2,9;2;1;1
252856969525;252856969536;11;2,9;2;1;1
252856969536;252856969539;3;2,9;2;1;1
252856969539;252856969551;12;2,9;2;1;1
252856969551;252856969554;3;2,9;2;1;1
252856969554;252856969572;18;2,9;2;1;1
252856969572;252856969588;16;2,9;2;1;1
252856969588;252856969592;4;2,9;2;1;1
252856969592;252856969596;4;2,9;2;1;1
252856969596;252856969629;33;2,9;2;1;1
252856969629;252856969654;25;2,9;2;1;1
252856969654;252856969658;4;2,9;2;1;1
252856969658;252856969676;18;2,9;2;1;1
252856969676;252856969687;11;2,9;2;1;1
252856969687;252856969694;7;2,9;2;1;1
252856969694;252856969724;30;2,9;2;1;1
252856969724;252856969740;16;2,9;2;1;1
252856969740;252856969757;17;2,9;2;1;1
252856969757;252856969758;1;2,9;2;1;1
252856969758;252856969791;33;2,9;2;1;1
252856969791;252856969798;7;2,9;2;1;1
252856969798;252856969829;31;2,9;2;1;1
252856969829;252856969830;1;2,9;2;1;1
252856969830;252856969846;16;2,9;2;1;1
252856969846;252856969854;8;2,9;2;1;1
252856969854;252856969869;15;2,9;2;1;1
252856969869;252856969909;40;2,9;2;1;1
252856969909;252856969917;8;2,9;2;1;1
252856969917;252856969919;2;2,9;2;1;1
252856969919;252856969940;21;2,9;2;1;1
252856969940;252856969942;2;2,9;2;1;1
252856969942;252856969950;8;2,9;2;1;1
252856969950;252856969951;1;2,9;2;1;1
252856969951;252856969990;39;2,9;2;1;1
252856969990;252856969998;8;2,9;2;1;1
252856969998;252856970000;2;2,9;2;1;1
252856970000;252856970005;5;2,9;2;1;1
252856970005;252856970008;3;2,9;2;1;1
252856970008;252856970009;1;2,9;2;1;1
252856970009;252856970039;30;2,9;2;1;1
252856970039;252856970044;5;2,9;2;1;1
252856970044;252856970048;4;2,9;2;1;1
252856970048;252856970076;28;2,9;2;1;1
252856970076;252856970088;12;2,9;2;1;1
252856970088;252856970100;12;2,9;2;1;1
252856970100;252856970149;49;2,9;2;1;1
252856970149;252856970158;9;2,9;2;1;1
252856970158;252856970178;20;2,9;2;1;1
252856970178;252856970199;21;2,9;2;1;1
252856970199;252856970202;3;2,9;2;1;1
252856970202;252856970204;2;2,9;2;1;1
252856970204;252856970205;1;2,9;2;1;1
252856970205;252856970229;24;2,9;2;1;1
252856970229;252856970251;22;2,9;2;1;1
252856970251;252856970270;19;2,9;2;1;1
252856970270;252856970279;9;2,9;2;1;1
252856970279;252856970295;16;2,9;2;1;1
252856970295;252856970299;4;2,9;2;1;1
252856970299;252856970304;5;2,9;2;1;1
252856970304;252856970306;2;2,9;2;1;1
252856970306;252856970317;11;2,9;2;1;1
252856970317;252856970332;15;2,9;2;1;1
252856970332;252856970342;10;2,9;2;1;1
252856970342;252856970366;24;2,9;2;1;1
252856970366;252856970368;2;2,9;2;1;1
252856970368;252856970376;8;2,9;2;1;1
252856970376;252856970380;4;2,9;2;1;1
252856970380;252856970392;12;2,9;2;1;1
252856970392;252856970394;2;2,9;2;1;1
252856970394;252856970418;24;2,9;2;1;1
252856970418;252856970419;1;2,9;2;1;1
252856970419;252856970423;4;2,9;2;1;1
252856970423;252856970428;5;2,9;2;1;1
252856970428;252856970446;18;2,9;2;1;1
252856970446;252856970447;1;2,9;2;1;1
252856970447;252856970453;6;2,9;2;1;1
252856970453;252856970464;11;2,9;2;1;1
252856970464;252856970475;11;2,9;2;1;1
252856970475;252856970477;2;2,9;2;1;1
252856970477;252856970489;12;2,9;2;1;1
252856970489;252856970495;6;2,9;2;1;1
252856970495;252856970496;1;2,9;2;1;1
252856970496;252856970514;18;2,9;2;1;1
252856970514;252856970533;19;2,9;2;1;1
252856970533;252856970541;8;2,9;2;1;1
252856970541;252856970559;18;2,9;2;1;1
252856970559;252856970572;13;2,9;2;1;1
252856970572;252856970585;13;2,9;2;1;1
252856970585;252856970593;8;2,9;2;1;1
252856970593;252856970594;1;2,9;2;1;1
252856970594;252856970600;6;2,9;2;1;1
252856970600;252856970601;1;2,9;2;1;1
252856970601;252856970603;2;2,9;2;1;1
252856970603;252856970616;13;2,9;2;1;1
252856970616;252856970617;1;2,9;2;1;1
252856970617;252856970631;14;2,9;2;1;1
252856970631;252856970633;2;2,9;2;1;1
252856970633;252856970643;10;2,9;2;1;1
252856970643;252856970652;9;2,9;2;1;1
252856970652;252856970654;2;2,9;2;1;1
252856970654;252856970656;2;2,9;2;1;1
252856970656;252856970679;23;2,9;2;1;1
252856970679;252856970686;7;2,9;2;1;1
252856970686;252856970701;15;2,9;2;1;1
252856970701;252856970708;7;2,9;2;1;1
252856970708;252856970709;1;2,9;2;1;1
252856970709;252856970710;1;2,9;2;1;1
252856970710;252856970711;1;2,9;2;1;1
252856970711;252856970725;14;2,9;2;1;1
252856970725;252856970735;10;2,9;2;1;1
252856970735;252856970738;3;2,9;2;1;1
252856970738;252856970740;2;2,9;2;1;1
252856970740;252856970746;6;2,9;2;1;1
252856970746;252856970749;3;2,9;2;1;1
252856970749;252856970765;16;2,9;2;1;1
252856970765;252856970767;2;2,9;2;1;1
252856970767;252856970770;3;2,9;2;1;1
252856970770;252856970804;34;2,9;2;1;1
252856970804;252856970814;10;2,9;2;1;1
252856970814;252856970815;1;2,9;2;1;1
252856970815;252856970816;1;2,9;2;1;1
252856970816;252856970843;27;2,9;2;1;1
252856970843;252856970856;13;2,9;2;1;1
252856970856;252856970869;13;2,9;2;1;1
252856970869;252856970898;29;2,9;2;1;1
252856970898;252856970900;2;2,9;2;1;1
252856970900;252856970911;11;2,9;2;1;1
252856970911;252856970912;1;2,9;2;1;1
252856970912;252856970916;4;2,9;2;1;1
252856970916;252856970932;16;2,9;2;1;1
252856970932;252856970940;8;2,9;2;1;1
252856970940;252856970965;25;2,9;2;1;1
252856970965;252856970974;9;2,9;2;1;1
252856970974;252856970985;11;2,9;2;1;1
252856970985;252856970992;7;2,9;2;1;1
252856970992;252856970998;6;2,9;2;1;1
252856970998;252856970999;1;2,9;2;1;1
252856970999;252856971013;14;2,9;2;1;1
252856971013;252856971017;4;2,9;2;1;1
252856971017;252856971019;2;2,9;2;1;1
252856971019;252856971035;16;2,9;2;1;1
252856971035;252856971042;7;2,9;2;1;1
252856971042;252856971057;15;2,9;2;1;1
252856971057;252856971083;26;2,9;2;1;1
252856971083;252856971103;20;2,9;2;1;1
252856971103;252856971106;3;2,9;2;1;1
252856971106;252856971110;4;2,9;2;1;1
252856971110;252856971133;23;2,9;2;1;1
252856971133;252856971135;2;2,9;2;1;1
252856971135;252856971138;3;2,9;2;1;1
252856971138;252856971153;15;2,9;2;1;1
252856971153;252856971168;15;2,9;2;1;1
252856971168;252856971171;3;2,9;2;1;1
252856971171;252856971173;2;2,9;2;1;1
252856971173;252856971174;1;2,9;2;1;1
252856971174;252856971189;15;2,9;2;1;1
252856971189;252856971192;3;2,9;2;1;1
252856971192;252856971200;8;2,9;2;1;1
252856971200;252856971202;2;2,9;2;1;1
252856971202;252856971222;20;2,9;2;1;1
252856971222;252856971231;9;2,9;2;1;1
252856971231;252856971237;6;2,9;2;1;1
252856971237;252856971256;19;2,9;2;1;1
252856971256;252856971286;30;2,9;2;1;1
252856971286;252856971299;13;2,9;2;1;1
252856971299;252856971308;9;2,9;2;1;1
252856971308;252856971309;1;2,9;2;1;1
252856971309;252856971313;4;2,9;2;1;1
252856971313;252856971316;3;2,9;2;1;1
252856971316;252856971327;11;2,9;2;1;1
252856971327;252856971332;5;2,9;2;1;1
252856971332;252856971339;7;2,9;2;1;1
252856971339;252856971348;9;2,9;2;1;1
252856971348;252856971352;4;2,9;2;1;1
252856971352;252856971354;2;2,9;2;1;1
252856971354;252856971372;18;2,9;2;1;1
252856971372;252856971382;10;2,9;2;1;1
252856971382;252856971383;1;2,9;2;1;1
252856971383;252856971401;18;2,9;2;1;1
252856971401;252856971407;6;2,9;2;1;1
252856971407;252856971413;6;2,9;2;1;1
252856971413;252856971421;8;2,9;2;1;1
252856971421;252856971431;10;2,9;2;1;1
252856971431;252856971441;10;2,9;2;1;1
252856971441;252856971448;7;2,9;2;1;1
252856971448;252856971451;3;2,9;2;1;1
252856971451;252856971458;7;2,9;2;1;1
252856971458;252856971480;22;2,9;2;1;1
252856971480;252856971481;1;2,9;2;1;1
252856971481;252856971482;1;2,9;2;1;1
252856971482;252856971487;5;2,9;2;1;1
252856971487;252856971492;5;2,9;2;1;1
252856971492;252856971498;6;2,9;2;1;1
252856971498;252856971508;10;2,9;2;1;1
252856971508;252856971514;6;2,9;2;1;1
252856971514;252856971534;20;2,9;2;1;1
252856971534;252856971537;3;2,9;2;1;1
252856971537;252856971541;4;2,9;2;1;1
252856971541;252856971546;5;2,9;2;1;1
252856971546;252856971562;16;2,9;2;1;1
252856971562;252856971567;5;2,9;2;1;1
252856971567;252856971571;4;2,9;2;1;1
252856971571;252856971582;11;2,9;2;1;1
252856971582;252856971613;31;2,9;2;1;1
252856971613;252856971623;10;2,9;2;1;1
252856971623;252856971632;9;2,9;2;1;1
252856971632;252856971645;13;2,9;2;1;1
252856971645;252856971651;6;2,9;2;1;1
252856971651;252856971677;26;2,9;2;1;1
252856971677;252856971703;26;2,9;2;1;1
252856971703;252856971705;2;2,9;2;1;1
252856971705;252856971710;5;2,9;2;1;1
252856971710;252856971715;5;2,9;2;1;1
252856971715;252856971746;31;2,9;2;1;1
252856971746;252856971755;9;2,9;2;1;1
252856971755;252856971759;4;2,9;2;1;1
252856971759;252856971764;5;2,9;2;1;1
252856971764;252856971768;4;2,9;2;1;1
252856971768;252856971786;18;2,9;2;1;1
252856971786;252856971793;7;2,9;2;1;1
252856971793;252856971807;14;2,9;2;1;1
252856971807;252856971809;2;2,9;2;1;1
252856971809;252856971820;11;2,9;2;1;1
252856971820;252856971825;5;2,9;2;1;1
252856971825;252856971843;18;2,9;2;1;1
252856971843;252856971848;5;2,9;2;1;1
252856971848;252856971861;13;2,9;2;1;1
252856971861;252856971871;10;2,9;2;1;1
252856971871;252856971875;4;2,9;2;1;1
252856971875;252856971879;4;2,9;2;1;1
252856971879;252856971887;8;2,9;2;1;1
252856971887;252856971893;6;2,9;2;1;1
252856971893;252856971900;7;2,9;2;1;1
252856971900;252856971921;21;2,9;2;1;1
252856971921;252856971923;2;2,9;2;1;1
252856971923;252856971930;7;2,9;2;1;1
252856971930;252856971933;3;2,9;2;1;1
252856971933;252856971943;10;2,9;2;1;1
252856971943;252856971949;6;2,9;2;1;1
252856971949;252856971952;3;2,9;2;1;1
252856971952;252856971953;1;2,9;2;1;1
252856971953;252856971959;6;2,9;2;1;1
252856971959;252856971969;10;2,9;2;1;1
252856971969;252856971989;20;2,9;2;1;1
252856971989;252856971997;8;2,9;2;1;1
252856971997;252856972006;9;2,9;2;1;1
252856972006;252856972013;7;2,9;2;1;1
252856972013;252856972036;23;2,9;2;1;1
252856972036;252856972041;5;2,9;2;1;1
252856972041;252856972044;3;2,9;2;1;1
252856972044;252856972061;17;2,9;2;1;1
252856972061;252856972071;10;2,9;2;1;1
252856972071;252856972079;8;2,9;2;1;1
252856972079;252856972083;4;2,9;2;1;1
252856972083;252856972084;1;2,9;2;1;1
252856972084;252856972097;13;2,9;2;1;1
252856972097;252856972109;12;2,9;2;1;1
252856972109;252856972116;7;2,9;2;1;1
252856972116;252856972117;1;2,9;2;1;1
252856972117;252856972123;6;2,9;2;1;1
252856972123;252856972141;18;2,9;2;1;1
252856972141;252856972150;9;2,9;2;1;1
252856972150;252856972161;11;2,9;2;1;1
252856972161;252856972170;9;2,9;2;1;1
252856972170;252856972176;6;2,9;2;1;1
252856972176;252856972189;13;2,9;2;1;1
252856972189;252856972197;8;2,9;2;1;1
252856972197;252856972198;1;2,9;2;1;1
252856972198;252856972204;6;2,9;2;1;1
252856972204;252856972219;15;2,9;2;1;1
252856972219;252856972227;8;2,9;2;1;1
252856972227;252856972229;2;2,9;2;1;1
252856972229;252856972230;1;2,9;2;1;1
252856972230;252856972235;5;2,9;2;1;1
252856972235;252856972247;12;2,9;2;1;1
252856972247;252856972248;1;2,9;2;1;1
252856972248;252856972252;4;2,9;2;1;1
252856972252;252856972258;6;2,9;2;1;1
252856972258;252856972264;6;2,9;2;1;1
252856972264;252856972278;14;2,9;2;1;1
252856972278;252856972294;16;2,9;2;1;1
252856972294;252856972299;5;2,9;2;1;1
252856972299;252856972306;7;2,9;2;1;1
252856972306;252856972334;28;2,9;2;1;1
252856972334;252856972335;1;2,9;2;1;1
252856972335;252856972342;7;2,9;2;1;1
252856972342;252856972356;14;2,9;2;1;1
252856972356;252856972359;3;2,9;2;1;1
252856972359;252856972362;3;2,9;2;1;1
252856972362;252856972363;1;2,9;2;1;1
252856972363;252856972366;3;2,9;2;1;1
252856972366;252856972395;29;2,9;2;1;1
252856972395;252856972398;3;2,9;2;1;1
252856972398;252856972420;22;2,9;2;1;1
252856972420;252856972426;6;2,9;2;1;1
252856972426;252856972437;11;2,9;2;1;1
252856972437;252856972440;3;2,9;2;1;1
252856972440;252856972450;10;2,9;2;1;1
252856972450;252856972462;12;2,9;2;1;1
252856972462;252856972465;3;2,9;2;1;1
252856972465;252856972496;31;2,9;2;1;1
252856972496;252856972498;2;2,9;2;1;1
252856972498;252856972513;15;2,9;2;1;1
252856972513;252856972515;2;2,9;2;1;1
252856972515;252856972523;8;2,9;2;1;1
252856972523;252856972533;10;2,9;2;1;1
252856972533;252856972538;5;2,9;2;1;1
252856972538;252856972540;2;2,9;2;1;1
252856972540;252856972549;9;2,9;2;1;1
252856972549;252856972551;2;2,9;2;1;1
252856972551;252856972562;11;2,9;2;1;1
252856972562;252856972566;4;2,9;2;1;1
252856972566;252856972569;3;2,9;2;1;1
252856972569;252856972579;10;2,9;2;1;1
252856972579;252856972589;10;2,9;2;1;1
252856972589;252856972610;21;2,9;2;1;1
252856972610;252856972613;3;2,9;2;1;1
252856972613;252856972623;10;2,9;2;1;1
252856972623;252856972626;3;2,9;2;1;1
252856972626;252856972641;15;2,9;2;1;1
252856972641;252856972642;1;2,9;2;1;1
252856972642;252856972656;14;2,9;2;1;1
252856972656;252856972660;4;2,9;2;1;1
252856972660;252856972661;1;2,9;2;1;1
252856972661;252856972679;18;2,9;2;1;1
252856972679;252856972680;1;2,9;2;1;1
252856972680;252856972701;21;2,9;2;1;1
252856972701;252856972706;5;2,9;2;1;1
252856972706;252856972720;14;2,9;2;1;1
252856972720;252856972724;4;2,9;2;1;1
252856972724;252856972728;4;2,9;2;1;1
252856972728;252856972731;3;2,9;2;1;1
252856972731;252856972738;7;2,9;2;1;1
252856972738;252856972739;1;2,9;2;1;1
252856972739;252856972742;3;2,9;2;1;1
252856972742;252856972754;12;2,9;2;1;1
252856972754;252856972776;22;2,9;2;1;1
252856972776;252856972777;1;2,9;2;1;1
252856972777;252856972778;1;2,9;2;1;1
252856972778;252856972779;1;2,9;2;1;1
252856972779;252856972783;4;2,9;2;1;1
252856972783;252856972793;10;2,9;2;1;1
252856972793;252856972804;11;2,9;2;1;1
252856972804;252856972806;2;2,9;2;1;1
252856972806;252856972823;17;2,9;2;1;1
252856972823;252856972829;6;2,9;2;1;1
252856972829;252856972836;7;2,9;2;1;1
252856972836;252856972844;8;2,9;2;1;1
252856972844;252856972847;3;2,9;2;1;1
252856972847;252856972848;1;2,9;2;1;1
252856972848;252856972859;11;2,9;2;1;1
252856972859;252856972863;4;2,9;2;1;1
252856972863;252856972870;7;2,9;2;1;1
252856972870;252856972877;7;2,9;2;1;1
252856972877;252856972885;8;2,9;2;1;1
252856972885;252856972890;5;2,9;2;1;1
252856972890;252856972898;8;2,9;2;1;1
252856972898;252856972902;4;2,9;2;1;1
252856972902;252856972906;4;2,9;2;1;1
252856972906;252856972919;13;2,9;2;1;1
252856972919;252856972927;8;2,9;2;1;1
252856972927;252856972928;1;2,9;2;1;1
252856972928;252856972932;4;2,9;2;1;1
252856972932;252856972935;3;2,9;2;1;1
252856972935;252856972942;7;2,9;2;1;1
252856972942;252856972944;2;2,9;2;1;1
252856972944;252856972961;17;2,9;2;1;1
252856972961;252856972968;7;2,9;2;1;1
252856972968;252856972970;2;2,9;2;1;1
252856972970;252856972977;7;2,9;2;1;1
252856972977;252856972984;7;2,9;2;1;1
252856972984;252856972988;4;2,9;2;1;1
252856972988;252856972989;1;2,9;2;1;1
252856972989;252856972996;7;2,9;2;1;1
252856972996;252856973000;4;2,9;2;1;1
252856973000;252856973003;3;2,9;2;1;1
252856973003;252856973007;4;2,9;2;1;1
252856973007;252856973025;18;2,9;2;1;1
252856973025;252856973042;17;2,9;2;1;1
252856973042;252856973046;4;2,9;2;1;1
252856973046;252856973047;1;2,9;2;1;1
252856973047;252856973055;8;2,9;2;1;1
252856973055;252856973059;4;2,9;2;1;1
252856973059;252856973062;3;2,9;2;1;1
252856973062;252856973073;11;2,9;2;1;1
252856973073;252856973077;4;2,9;2;1;1
252856973077;252856973087;10;2,9;2;1;1
252856973087;252856973090;3;2,9;2;1;1
252856973090;252856973092;2;2,9;2;1;1
252856973092;252856973095;3;2,9;2;1;1
252856973095;252856973099;4;2,9;2;1;1
252856973099;252856973105;6;2,9;2;1;1
252856973105;252856973116;11;2,9;2;1;1
252856973116;252856973133;17;2,9;2;1;1
252856973133;252856973141;8;2,9;2;1;1
252856973141;252856973142;1;2,9;2;1;1
252856973142;252856973144;2;2,9;2;1;1
252856973144;252856973158;14;2,9;2;1;1
252856973158;252856973160;2;2,9;2;1;1
252856973160;252856973168;8;2,9;2;1;1
252856973168;252856973170;2;2,9;2;1;1
252856973170;252856973172;2;2,9;2;1;1
252856973172;252856973182;10;2,9;2;1;1
252856973182;252856973197;15;2,9;2;1;1
252856973197;252856973208;11;2,9;2;1;1
252856973208;252856973219;11;2,9;2;1;1
252856973219;252856973220;1;2,9;2;1;1
252856973220;252856973226;6;2,9;2;1;1
252856973226;252856973227;1;2,9;2;1;1
252856973227;252856973236;9;2,9;2;1;1
252856973236;252856973248;12;2,9;2;1;1
252856973248;252856973252;4;2,9;2;1;1
252856973252;252856973254;2;2,9;2;1;1
252856973254;252856973268;14;2,9;2;1;1
252856973268;252856973274;6;2,9;2;1;1
252856973274;252856973279;5;2,9;2;1;1
252856973279;252856973299;20;2,9;2;1;1
252856973299;252856973311;12;2,9;2;1;1
252856973311;252856973322;11;2,9;2;1;1
252856973322;252856973323;1;2,9;2;1;1
252856973323;252856973332;9;2,9;2;1;1
252856973332;252856973359;27;2,9;2;1;1
252856973359;252856973360;1;2,9;2;1;1
252856973360;252856973362;2;2,9;2;1;1
252856973362;252856973396;34;2,9;2;1;1
252856973396;252856973398;2;2,9;2;1;1
252856973398;252856973441;43;2,9;2;1;1
252856973441;252856973458;17;2,9;2;1;1
252856973458;252856973459;1;2,9;2;1;1
252856973459;252856973466;7;2,9;2;1;1
252856973466;252856973468;2;2,9;2;1;1
252856973468;252856973471;3;2,9;2;1;1
252856973471;252856973488;17;2,9;2;1;1
252856973488;252856973501;13;2,9;2;1;1
252856973501;252856973505;4;2,9;2;1;1
252856973505;252856973516;11;2,9;2;1;1
252856973516;252856973537;21;2,9;2;1;1
252856973537;252856973544;7;2,9;2;1;1
252856973544;252856973551;7;2,9;2;1;1
252856973551;252856973572;21;2,9;2;1;1
252856973572;252856973591;19;2,9;2;1;1
252856973591;252856973596;5;2,9;2;1;1
252856973596;252856973599;3;2,9;2;1;1
252856973599;252856973606;7;2,9;2;1;1
252856973606;252856973616;10;2,9;2;1;1
252856973616;252856973625;9;2,9;2;1;1
252856973625;252856973629;4;2,9;2;1;1
252856973629;252856973639;10;2,9;2;1;1
252856973639;252856973647;8;2,9;2;1;1
252856973647;252856973655;8;2,9;2;1;1
252856973655;252856973664;9;2,9;2;1;1
252856973664;252856973683;19;2,9;2;1;1
252856973683;252856973705;22;2,9;2;1;1
252856973705;252856973714;9;2,9;2;1;1
252856973714;252856973718;4;2,9;2;1;1
252856973718;252856973729;11;2,9;2;1;1
252856973729;252856973732;3;2,9;2;1;1
252856973732;252856973738;6;2,9;2;1;1
252856973738;252856973741;3;2,9;2;1;1
252856973741;252856973755;14;2,9;2;1;1
252856973755;252856973761;6;2,9;2;1;1
252856973761;252856973764;3;2,9;2;1;1
252856973764;252856973792;28;2,9;2;1;1
252856973792;252856973818;26;2,9;2;1;1
252856973818;252856973823;5;2,9;2;1;1
252856973823;252856973830;7;2,9;2;1;1
252856973830;252856973840;10;2,9;2;1;1
252856973840;252856973851;11;2,9;2;1;1
252856973851;252856973855;4;2,9;2;1;1
252856973855;252856973878;23;2,9;2;1;1
252856973878;252856973889;11;2,9;2;1;1
252856973889;252856973922;33;2,9;2;1;1
252856973922;252856973932;10;2,9;2;1;1
252856973932;252856973951;19;2,9;2;1;1
252856973951;252856973962;11;2,9;2;1;1
252856973962;252856973966;4;2,9;2;1;1
252856973966;252856973979;13;2,9;2;1;1
252856973979;252856974026;47;2,9;2;1;1
252856974026;252856974041;15;2,9;2;1;1
252856974041;252856974054;13;2,9;2;1;1
252856974054;252856974080;26;2,9;2;1;1
252856974080;252856974083;3;2,9;2;1;1
252856974083;252856974084;1;2,9;2;1;1
252856974084;252856974116;32;2,9;2;1;1
252856974116;252856974132;16;2,9;2;1;1
252856974132;252856974186;54;2,9;2;1;1
252856974186;252856974216;30;2,9;2;1;1
252856974216;252856974230;14;2,9;2;1;1
252856974230;252856974276;46;2,9;2;1;1
252856974276;252856974287;11;2,9;2;1;1
252856974287;252856974298;11;2,9;2;1;1
252856974298;252856974303;5;2,9;2;1;1
252856974303;252856974311;8;2,9;2;1;1
252856974311;252856974331;20;2,9;2;1;1
252856974331;252856974343;12;2,9;2;1;1
252856974343;252856974348;5;2,9;2;1;1
252856974348;252856974365;17;2,9;2;1;1
252856974365;252856974366;1;2,9;2;1;1
252856974366;252856974371;5;2,9;2;1;1
252856974371;252856974400;29;2,9;2;1;1
252856974400;252856974407;7;2,9;2;1;1
252856974407;252856974410;3;2,9;2;1;1
252856974410;252856974432;22;2,9;2;1;1
252856974432;252856974433;1;2,9;2;1;1
252856974433;252856974435;2;2,9;2;1;1
252856974435;252856974441;6;2,9;2;1;1
252856974441;252856974455;14;2,9;2;1;1
252856974455;252856974458;3;2,9;2;1;1
252856974458;252856974470;12;2,9;2;1;1
252856974470;252856974474;4;2,9;2;1;1
252856974474;252856974480;6;2,9;2;1;1
252856974480;252856974497;17;2,9;2;1;1
252856974497;252856974523;26;2,9;2;1;1
252856974523;252856974527;4;2,9;2;1;1
252856974527;252856974544;17;2,9;2;1;1
252856974544;252856974564;20;2,9;2;1;1
252856974564;252856974566;2;2,9;2;1;1
252856974566;252856974570;4;2,9;2;1;1
252856974570;252856974591;21;2,9;2;1;1
252856974591;252856974594;3;2,9;2;1;1
252856974594;252856974603;9;2,9;2;1;1
252856974603;252856974614;11;2,9;2;1;1
252856974614;252856974625;11;2,9;2;1;1
252856974625;252856974641;16;2,9;2;1;1
252856974641;252856974664;23;2,9;2;1;1
252856974664;252856974674;10;2,9;2;1;1
252856974674;252856974686;12;2,9;2;1;1
252856974686;252856974688;2;2,9;2;1;1
252856974688;252856974690;2;2,9;2;1;1
252856974690;252856974708;18;2,9;2;1;1
252856974708;252856974710;2;2,9;2;1;1
252856974710;252856974712;2;2,9;2;1;1
252856974712;252856974723;11;2,9;2;1;1
252856974723;252856974754;31;2,9;2;1;1
252856974754;252856974757;3;2,9;2;1;1
252856974757;252856974791;34;2,9;2;1;1
252856974791;252856974793;2;2,9;2;1;1
252856974793;252856974801;8;2,9;2;1;1
252856974801;252856974811;10;2,9;2;1;1
252856974811;252856974817;6;2,9;2;1;1
252856974817;252856974820;3;2,9;2;1;1
252856974820;252856974854;34;2,9;2;1;1
252856974854;252856974856;2;2,9;2;1;1
252856974856;252856974866;10;2,9;2;1;1
252856974866;252856974889;23;2,9;2;1;1
252856974889;252856974899;10;2,9;2;1;1
252856974899;252856974916;17;2,9;2;1;1
252856974916;252856974919;3;2,9;2;1;1
252856974919;252856974927;8;2,9;2;1;1
252856974927;252856974933;6;2,9;2;1;1
252856974933;252856974944;11;2,9;2;1;1
252856974944;252856974948;4;2,9;2;1;1
252856974948;252856974951;3;2,9;2;1;1
252856974951;252856974952;1;2,9;2;1;1
252856974952;252856974958;6;2,9;2;1;1
252856974958;252856974968;10;2,9;2;1;1
252856974968;252856974970;2;2,9;2;1;1
252856974970;252856974990;20;2,9;2;1;1
252856974990;252856974991;1;2,9;2;1;1
252856974991;252856974992;1;2,9;2;1;1
252856974992;252856974994;2;2,9;2;1;1
252856974994;252856974996;2;2,9;2;1;1
252856974996;252856975000;4;2,9;2;1;1
252856975000;252856975018;18;2,9;2;1;1
252856975018;252856975024;6;2,9;2;1;1
252856975024;252856975029;5;2,9;2;1;1
252856975029;252856975034;5;2,9;2;1;1
252856975034;252856975035;1;2,9;2;1;1
252856975035;252856975038;3;2,9;2;1;1
252856975038;252856975053;15;2,9;2;1;1
252856975053;252856975070;17;2,9;2;1;1
252856975070;252856975073;3;2,9;2;1;1
252856975073;252856975078;5;2,9;2;1;1
252856975078;252856975112;34;2,9;2;1;1
252856975112;252856975127;15;2,9;2;1;1
252856975127;252856975130;3;2,9;2;1;1
252856975130;252856975136;6;2,9;2;1;1
252856975136;252856975142;6;2,9;2;1;1
252856975142;252856975157;15;2,9;2;1;1
252856975157;252856975176;19;2,9;2;1;1
252856975176;252856975183;7;2,9;2;1;1
252856975183;252856975196;13;2,9;2;1;1
252856975196;252856975209;13;2,9;2;1;1
252856975209;252856975221;12;2,9;2;1;1
252856975221;252856975233;12;2,9;2;1;1
252856975233;252856975251;18;2,9;2;1;1
252856975251;252856975253;2;2,9;2;1;1
252856975253;252856975255;2;2,9;2;1;1
252856975255;252856975260;5;2,9;2;1;1
252856975260;252856975289;29;2,9;2;1;1
252856975289;252856975293;4;2,9;2;1;1
252856975293;252856975309;16;2,9;2;1;1
252856975309;252856975312;3;2,9;2;1;1
252856975312;252856975317;5;2,9;2;1;1
252856975317;252856975329;12;2,9;2;1;1
252856975329;252856975331;2;2,9;2;1;1
252856975331;252856975332;1;2,9;2;1;1
252856975332;252856975336;4;2,9;2;1;1
252856975336;252856975343;7;2,9;2;1;1
252856975343;252856975348;5;2,9;2;1;1
252856975348;252856975366;18;2,9;2;1;1
252856975366;252856975367;1;2,9;2;1;1
252856975367;252856975370;3;2,9;2;1;1
252856975370;252856975373;3;2,9;2;1;1
252856975373;252856975378;5;2,9;2;1;1
252856975378;252856975386;8;2,9;2;1;1
252856975386;252856975387;1;2,9;2;1;1
252856975387;252856975389;2;2,9;2;1;1
252856975389;252856975404;15;2,9;2;1;1
252856975404;252856975411;7;2,9;2;1;1
252856975411;252856975412;1;2,9;2;1;1
252856975412;252856975415;3;2,9;2;1;1
252856975415;252856975423;8;2,9;2;1;1
252856975423;252856975426;3;2,9;2;1;1
252856975426;252856975427;1;2,9;2;1;1
252856975427;252856975429;2;2,9;2;1;1
252856975429;252856975437;8;2,9;2;1;1
252856975437;252856975438;1;2,9;2;1;1
252856975438;252856975444;6;2,9;2;1;1
252856975444;252856975450;6;2,9;2;1;1
252856975450;252856975453;3;2,9;2;1;1
252856975453;252856975455;2;2,9;2;1;1
252856975455;252856975456;1;2,9;2;1;1
252856975456;252856975467;11;2,9;2;1;1
252856975467;252856975469;2;2,9;2;1;1
252856975469;252856975479;10;2,9;2;1;1
252856975479;252856975484;5;2,9;2;1;1
252856975484;252856975490;6;2,9;2;1;1
252856975490;252856975497;7;2,9;2;1;1
252856975497;252856975512;15;2,9;2;1;1
252856975512;252856975513;1;2,9;2;1;1
252856975513;252856975536;23;2,9;2;1;1
252856975536;252856975559;23;2,9;2;1;1
252856975559;252856975575;16;2,9;2;1;1
252856975575;252856975586;11;2,9;2;1;1
252856975586;252856975597;11;2,9;2;1;1
252856975597;252856975601;4;2,9;2;1;1
252856975601;252856975622;21;2,9;2;1;1
252856975622;252856975630;8;2,9;2;1;1
252856975630;252856975642;12;2,9;2;1;1
252856975642;252856975647;5;2,9;2;1;1
252856975647;252856975650;3;2,9;2;1;1
252856975650;252856975657;7;2,9;2;1;1
252856975657;252856975661;4;2,9;2;1;1
252856975661;252856975669;8;2,9;2;1;1
252856975669;252856975672;3;2,9;2;1;1
252856975672;252856975682;10;2,9;2;1;1
252856975682;252856975689;7;2,9;2;1;1
252856975689;252856975696;7;2,9;2;1;1
252856975696;252856975698;2;2,9;2;1;1
252856975698;252856975702;4;2,9;2;1;1
252856975702;252856975713;11;2,9;2;1;1
252856975713;252856975718;5;2,9;2;1;1
252856975718;252856975729;11;2,9;2;1;1
252856975729;252856975734;5;2,9;2;1;1
252856975734;252856975743;9;2,9;2;1;1
252856975743;252856975744;1;2,9;2;1;1
252856975744;252856975751;7;2,9;2;1;1
252856975751;252856975764;13;2,9;2;1;1
252856975764;252856975766;2;2,9;2;1;1
252856975766;252856975770;4;2,9;2;1;1
252856975770;252856975778;8;2,9;2;1;1
252856975778;252856975786;8;2,9;2;1;1
252856975786;252856975788;2;2,9;2;1;1
252856975788;252856975797;9;2,9;2;1;1
252856975797;252856975809;12;2,9;2;1;1
252856975809;252856975813;4;2,9;2;1;1
252856975813;252856975824;11;2,9;2;1;1
252856975824;252856975829;5;2,9;2;1;1
252856975829;252856975849;20;2,9;2;1;1
252856975849;252856975850;1;2,9;2;1;1
252856975850;252856975853;3;2,9;2;1;1
252856975853;252856975870;17;2,9;2;1;1
252856975870;252856975872;2;2,9;2;1;1
252856975872;252856975876;4;2,9;2;1;1
252856975876;252856975879;3;2,9;2;1;1
252856975879;252856975883;4;2,9;2;1;1
252856975883;252856975890;7;2,9;2;1;1
252856975890;252856975894;4;2,9;2;1;1
252856975894;252856975901;7;2,9;2;1;1
252856975901;252856975902;1;2,9;2;1;1
252856975902;252856975904;2;2,9;2;1;1
252856975904;252856975913;9;2,9;2;1;1
252856975913;252856975919;6;2,9;2;1;1
252856975919;252856975928;9;2,9;2;1;1
252856975928;252856975929;1;2,9;2;1;1
252856975929;252856975939;10;2,9;2;1;1
252856975939;252856975944;5;2,9;2;1;1
252856975944;252856975952;8;2,9;2;1;1
252856975952;252856975955;3;2,9;2;1;1
252856975955;252856975959;4;2,9;2;1;1
252856975959;252856975965;6;2,9;2;1;1
252856975965;252856975970;5;2,9;2;1;1
252856975970;252856975973;3;2,9;2;1;1
252856975973;252856975974;1;2,9;2;1;1
252856975974;252856975988;14;2,9;2;1;1
252856975988;252856975994;6;2,9;2;1;1
252856975994;252856976004;10;2,9;2;1;1
252856976004;252856976019;15;2,9;2;1;1
252856976019;252856976020;1;2,9;2;1;1
252856976020;252856976021;1;2,9;2;1;1
252856976021;252856976027;6;2,9;2;1;1
252856976027;252856976030;3;2,9;2;1;1
252856976030;252856976031;1;2,9;2;1;1
252856976031;252856976037;6;2,9;2;1;1
252856976037;252856976044;7;2,9;2;1;1
252856976044;252856976050;6;2,9;2;1;1
252856976050;252856976055;5;2,9;2;1;1
252856976055;252856976056;1;2,9;2;1;1
252856976056;252856976062;6;2,9;2;1;1
252856976062;252856976064;2;2,9;2;1;1
252856976064;252856976065;1;2,9;2;1;1
252856976065;252856976082;17;2,9;2;1;1
252856976082;252856976091;9;2,9;2;1;1
252856976091;252856976093;2;2,9;2;1;1
252856976093;252856976103;10;2,9;2;1;1
252856976103;252856976107;4;2,9;2;1;1
252856976107;252856976110;3;2,9;2;1;1
252856976110;252856976113;3;2,9;2;1;1
252856976113;252856976124;11;2,9;2;1;1
252856976124;252856976127;3;2,9;2;1;1
252856976127;252856976130;3;2,9;2;1;1
252856976130;252856976145;15;2,9;2;1;1
252856976145;252856976150;5;2,9;2;1;1
252856976150;252856976159;9;2,9;2;1;1
252856976159;252856976164;5;2,9;2;1;1
252856976164;252856976166;2;2,9;2;1;1
252856976166;252856976167;1;2,9;2;1;1
252856976167;252856976168;1;2,9;2;1;1
252856976168;252856976180;12;2,9;2;1;1
252856976180;252856976184;4;2,9;2;1;1
252856976184;252856976193;9;2,9;2;1;1
252856976193;252856976197;4;2,9;2;1;1
252856976197;252856976198;1;2,9;2;1;1
252856976198;252856976203;5;2,9;2;1;1
252856976203;252856976204;1;2,9;2;1;1
252856976204;252856976210;6;2,9;2;1;1
252856976210;252856976214;4;2,9;2;1;1
252856976214;252856976219;5;2,9;2;1;1
252856976219;252856976220;1;2,9;2;1;1
252856976220;252856976232;12;2,9;2;1;1
252856976232;252856976242;10;2,9;2;1;1
252856976242;252856976245;3;2,9;2;1;1
252856976245;252856976246;1;2,9;2;1;1
252856976246;252856976259;13;2,9;2;1;1
252856976259;252856976260;1;2,9;2;1;1
252856976260;252856976261;1;2,9;2;1;1
252856976261;252856976269;8;2,9;2;1;1
252856976269;252856976275;6;2,9;2;1;1
252856976275;252856976282;7;2,9;2;1;1
252856976282;252856976287;5;2,9;2;1;1
252856976287;252856976291;4;2,9;2;1;1
252856976291;252856976300;9;2,9;2;1;1
252856976300;252856976302;2;2,9;2;1;1
252856976302;252856976303;1;2,9;2;1;1
252856976303;252856976311;8;2,9;2;1;1
252856976311;252856976315;4;2,9;2;1;1
252856976315;252856976326;11;2,9;2;1;1
252856976326;252856976329;3;2,9;2;1;1
252856976329;252856976346;17;2,9;2;1;1
252856976346;252856976347;1;2,9;2;1;1
252856976347;252856976349;2;2,9;2;1;1
252856976349;252856976353;4;2,9;2;1;1
252856976353;252856976355;2;2,9;2;1;1
252856976355;252856976367;12;2,9;2;1;1
252856976367;252856976371;4;2,9;2;1;1
252856976371;252856976375;4;2,9;2;1;1
252856976375;252856976377;2;2,9;2;1;1
252856976377;252856976378;1;2,9;2;1;1
252856976378;252856976383;5;2,9;2;1;1
252856976383;252856976387;4;2,9;2;1;1
252856976387;252856976389;2;2,9;2;1;1
252856976389;252856976396;7;2,9;2;1;1
252856976396;252856976402;6;2,9;2;1;1
252856976402;252856976405;3;2,9;2;1;1
252856976405;252856976408;3;2,9;2;1;1
252856976408;252856976426;18;2,9;2;1;1
252856976426;252856976429;3;2,9;2;1;1
252856976429;252856976431;2;2,9;2;1;1
252856976431;252856976439;8;2,9;2;1;1
252856976439;252856976440;1;2,9;2;1;1
252856976440;252856976443;3;2,9;2;1;1
252856976443;252856976450;7;2,9;2;1;1
252856976450;252856976455;5;2,9;2;1;1
252856976455;252856976470;15;2,9;2;1;1
252856976470;252856976473;3;2,9;2;1;1
252856976473;252856976479;6;2,9;2;1;1
252856976479;252856976487;8;2,9;2;1;1
252856976487;252856976489;2;2,9;2;1;1
252856976489;252856976495;6;2,9;2;1;1
252856976495;252856976499;4;2,9;2;1;1
252856976499;252856976501;2;2,9;2;1;1
252856976501;252856976509;8;2,9;2;1;1
252856976509;252856976511;2;2,9;2;1;1
252856976511;252856976519;8;2,9;2;1;1
252856976519;252856976521;2;2,9;2;1;1
252856976521;252856976524;3;2,9;2;1;1
252856976524;252856976529;5;2,9;2;1;1
252856976529;252856976545;16;2,9;2;1;1
252856976545;252856976551;6;2,9;2;1;1
252856976551;252856976552;1;2,9;2;1;1
252856976552;252856976556;4;2,9;2;1;1
252856976556;252856976558;2;2,9;2;1;1
252856976558;252856976561;3;2,9;2;1;1
252856976561;252856976563;2;2,9;2;1;1
252856976563;252856976573;10;2,9;2;1;1
252856976573;252856976578;5;2,9;2;1;1
252856976578;252856976581;3;2,9;2;1;1
252856976581;252856976582;1;2,9;2;1;1
252856976582;252856976586;4;2,9;2;1;1
252856976586;252856976602;16;2,9;2;1;1
252856976602;252856976603;1;2,9;2;1;1
252856976603;252856976605;2;2,9;2;1;1
252856976605;252856976608;3;2,9;2;1;1
252856976608;252856976615;7;2,9;2;1;1
252856976615;252856976616;1;2,9;2;1;1
252856976616;252856976619;3;2,9;2;1;1
252856976619;252856976626;7;2,9;2;1;1
252856976626;252856976633;7;2,9;2;1;1
252856976633;252856976648;15;2,9;2;1;1
252856976648;252856976661;13;2,9;2;1;1
252856976661;252856976662;1;2,9;2;1;1
252856976662;252856976666;4;2,9;2;1;1
252856976666;252856976667;1;2,9;2;1;1
252856976667;252856976670;3;2,9;2;1;1
252856976670;252856976677;7;2,9;2;1;1
252856976677;252856976693;16;2,9;2;1;1
252856976693;252856976698;5;2,9;2;1;1
252856976698;252856976705;7;2,9;2;1;1
252856976705;252856976721;16;2,9;2;1;1
252856976721;252856976726;5;2,9;2;1;1
252856976726;252856976728;2;2,9;2;1;1
252856976728;252856976735;7;2,9;2;1;1
252856976735;252856976736;1;2,9;2;1;1
252856976736;252856976762;26;2,9;2;1;1
252856976762;252856976776;14;2,9;2;1;1
252856976776;252856976777;1;2,9;2;1;1
252856976777;252856976793;16;2,9;2;1;1
252856976793;252856976795;2;2,9;2;1;1
252856976795;252856976797;2;2,9;2;1;1
252856976797;252856976801;4;2,9;2;1;1
252856976801;252856976812;11;2,9;2;1;1
252856976812;252856976825;13;2,9;2;1;1
252856976825;252856976833;8;2,9;2;1;1
252856976833;252856976843;10;2,9;2;1;1
252856976843;252856976855;12;2,9;2;1;1
252856976855;252856976857;2;2,9;2;1;1
252856976857;252856976860;3;2,9;2;1;1
252856976860;252856976868;8;2,9;2;1;1
252856976868;252856976873;5;2,9;2;1;1
252856976873;252856976879;6;2,9;2;1;1
252856976879;252856976884;5;2,9;2;1;1
252856976884;252856976893;9;2,9;2;1;1
252856976893;252856976895;2;2,9;2;1;1
252856976895;252856976899;4;2,9;2;1;1
252856976899;252856976906;7;2,9;2;1;1
252856976906;252856976914;8;2,9;2;1;1
252856976914;252856976916;2;2,9;2;1;1
252856976916;252856976919;3;2,9;2;1;1
252856976919;252856976921;2;2,9;2;1;1
252856976921;252856976925;4;2,9;2;1;1
252856976925;252856976929;4;2,9;2;1;1
252856976929;252856976943;14;2,9;2;1;1
252856976943;252856976950;7;2,9;2;1;1
252856976950;252856976958;8;2,9;2;1;1
252856976958;252856976970;12;2,9;2;1;1
252856976970;252856976972;2;2,9;2;1;1
252856976972;252856976980;8;2,9;2;1;1
252856976980;252856976983;3;2,9;2;1;1
252856976983;252856976984;1;2,9;2;1;1
252856976984;252856977011;27;2,9;2;1;1
252856977011;252856977018;7;2,9;2;1;1
252856977018;252856977036;18;2,9;2;1;1
252856977036;252856977041;5;2,9;2;1;1
252856977041;252856977082;41;2,9;2;1;1
252856977082;252856977086;4;2,9;2;1;1
252856977086;252856977096;10;2,9;2;1;1
252856977096;252856977122;26;2,9;2;1;1
252856977122;252856977125;3;2,9;2;1;1
252856977125;252856977131;6;2,9;2;1;1
252856977131;252856977141;10;2,9;2;1;1
252856977141;252856977163;22;2,9;2;1;1
252856977163;252856977183;20;2,9;2;1;1
252856977183;252856977186;3;2,9;2;1;1
252856977186;252856977190;4;2,9;2;1;1
252856977190;252856977196;6;2,9;2;1;1
252856977196;252856977201;5;2,9;2;1;1
252856977201;252856977202;1;2,9;2;1;1
252856977202;252856977204;2;2,9;2;1;1
252856977204;252856977207;3;2,9;2;1;1
252856977207;252856977214;7;2,9;2;1;1
252856977214;252856977220;6;2,9;2;1;1
252856977220;252856977235;15;2,9;2;1;1
252856977235;252856977252;17;2,9;2;1;1
252856977252;252856977278;26;2,9;2;1;1
252856977278;252856977280;2;2,9;2;1;1
252856977280;252856977287;7;2,9;2;1;1
252856977287;252856977297;10;2,9;2;1;1
252856977297;252856977304;7;2,9;2;1;1
252856977304;252856977311;7;2,9;2;1;1
252856977311;252856977331;20;2,9;2;1;1
252856977331;252856977333;2;2,9;2;1;1
252856977333;252856977340;7;2,9;2;1;1
252856977340;252856977349;9;2,9;2;1;1
252856977349;252856977352;3;2,9;2;1;1
252856977352;252856977353;1;2,9;2;1;1
252856977353;252856977366;13;2,9;2;1;1
252856977366;252856977368;2;2,9;2;1;1
252856977368;252856977369;1;2,9;2;1;1
252856977369;252856977379;10;2,9;2;1;1
252856977379;252856977386;7;2,9;2;1;1
252856977386;252856977403;17;2,9;2;1;1
252856977403;252856977405;2;2,9;2;1;1
252856977405;252856977417;12;2,9;2;1;1
252856977417;252856977422;5;2,9;2;1;1
252856977422;252856977426;4;2,9;2;1;1
252856977426;252856977433;7;2,9;2;1;1
252856977433;252856977435;2;2,9;2;1;1
252856977435;252856977439;4;2,9;2;1;1
252856977439;252856977444;5;2,9;2;1;1
252856977444;252856977456;12;2,9;2;1;1
252856977456;252856977458;2;2,9;2;1;1
252856977458;252856977461;3;2,9;2;1;1
252856977461;252856977480;19;2,9;2;1;1
252856977480;252856977483;3;2,9;2;1;1
252856977483;252856977488;5;2,9;2;1;1
252856977488;252856977507;19;2,9;2;1;1
252856977507;252856977521;14;2,9;2;1;1
252856977521;252856977522;1;2,9;2;1;1
252856977522;252856977523;1;2,9;2;1;1
252856977523;252856977530;7;2,9;2;1;1
252856977530;252856977532;2;2,9;2;1;1
252856977532;252856977538;6;2,9;2;1;1
252856977538;252856977551;13;2,9;2;1;1
252856977551;252856977560;9;2,9;2;1;1
252856977560;252856977565;5;2,9;2;1;1
252856977565;252856977568;3;2,9;2;1;1
252856977568;252856977571;3;2,9;2;1;1
252856977571;252856977585;14;2,9;2;1;1
252856977585;252856977587;2;2,9;2;1;1
252856977587;252856977588;1;2,9;2;1;1
252856977588;252856977592;4;2,9;2;1;1
252856977592;252856977623;31;2,9;2;1;1
252856977623;252856977625;2;2,9;2;1;1
252856977625;252856977649;24;2,9;2;1;1
252856977649;252856977655;6;2,9;2;1;1
252856977655;252856977656;1;2,9;2;1;1
252856977656;252856977661;5;2,9;2;1;1
252856977661;252856977662;1;2,9;2;1;1
252856977662;252856977664;2;2,9;2;1;1
252856977664;252856977665;1;2,9;2;1;1
252856977665;252856977679;14;2,9;2;1;1
252856977679;252856977706;27;2,9;2;1;1
252856977706;252856977721;15;2,9;2;1;1
252856977721;252856977725;4;2,9;2;1;1
252856977725;252856977736;11;2,9;2;1;1
252856977736;252856977743;7;2,9;2;1;1
252856977743;252856977746;3;2,9;2;1;1
252856977746;252856977761;15;2,9;2;1;1
252856977761;252856977767;6;2,9;2;1;1
252856977767;252856977787;20;2,9;2;1;1
252856977787;252856977803;16;2,9;2;1;1
252856977803;252856977808;5;2,9;2;1;1
252856977808;252856977812;4;2,9;2;1;1
252856977812;252856977825;13;2,9;2;1;1
252856977825;252856977826;1;2,9;2;1;1
252856977826;252856977828;2;2,9;2;1;1
252856977828;252856977830;2;2,9;2;1;1
252856977830;252856977835;5;2,9;2;1;1
252856977835;252856977839;4;2,9;2;1;1
252856977839;252856977854;15;2,9;2;1;1
252856977854;252856977856;2;2,9;2;1;1
252856977856;252856977862;6;2,9;2;1;1
252856977862;252856977883;21;2,9;2;1;1
252856977883;252856977887;4;2,9;2;1;1
252856977887;252856977897;10;2,9;2;1;1
252856977897;252856977904;7;2,9;2;1;1
252856977904;252856977927;23;2,9;2;1;1
252856977927;252856977928;1;2,9;2;1;1
252856977928;252856977937;9;2,9;2;1;1
252856977937;252856977944;7;2,9;2;1;1
252856977944;252856977952;8;2,9;2;1;1
252856977952;252856977971;19;2,9;2;1;1
252856977971;252856977972;1;2,9;2;1;1
252856977972;252856977979;7;2,9;2;1;1
252856977979;252856977983;4;2,9;2;1;1
252856977983;252856977986;3;2,9;2;1;1
252856977986;252856977993;7;2,9;2;1;1
252856977993;252856978005;12;2,9;2;1;1
252856978005;252856978009;4;2,9;2;1;1
252856978009;252856978014;5;2,9;2;1;1
252856978014;252856978015;1;2,9;2;1;1
252856978015;252856978023;8;2,9;2;1;1
252856978023;252856978032;9;2,9;2;1;1
252856978032;252856978042;10;2,9;2;1;1
252856978042;252856978052;10;2,9;2;1;1
252856978052;252856978053;1;2,9;2;1;1
252856978053;252856978058;5;2,9;2;1;1
252856978058;252856978064;6;2,9;2;1;1
252856978064;252856978068;4;2,9;2;1;1
252856978068;252856978070;2;2,9;2;1;1
252856978070;252856978077;7;2,9;2;1;1
252856978077;252856978089;12;2,9;2;1;1
252856978089;252856978102;13;2,9;2;1;1
252856978102;252856978112;10;2,9;2;1;1
252856978112;252856978113;1;2,9;2;1;1
252856978113;252856978118;5;2,9;2;1;1
252856978118;252856978119;1;2,9;2;1;1
252856978119;252856978133;14;2,9;2;1;1
252856978133;252856978142;9;2,9;2;1;1
252856978142;252856978145;3;2,9;2;1;1
252856978145;252856978148;3;2,9;2;1;1
252856978148;252856978149;1;2,9;2;1;1
252856978149;252856978158;9;2,9;2;1;1
252856978158;252856978159;1;2,9;2;1;1
252856978159;252856978160;1;2,9;2;1;1
252856978160;252856978169;9;2,9;2;1;1
252856978169;252856978180;11;2,9;2;1;1
252856978180;252856978185;5;2,9;2;1;1
252856978185;252856978186;1;2,9;2;1;1
252856978186;252856978192;6;2,9;2;1;1
252856978192;252856978197;5;2,9;2;1;1
252856978197;252856978199;2;2,9;2;1;1
252856978199;252856978201;2;2,9;2;1;1
252856978201;252856978213;12;2,9;2;1;1
252856978213;252856978219;6;2,9;2;1;1
252856978219;252856978225;6;2,9;2;1;1
252856978225;252856978228;3;2,9;2;1;1
252856978228;252856978234;6;2,9;2;1;1
252856978234;252856978241;7;2,9;2;1;1
252856978241;252856978244;3;2,9;2;1;1
252856978244;252856978247;3;2,9;2;1;1
252856978247;252856978251;4;2,9;2;1;1
252856978251;252856978256;5;2,9;2;1;1
252856978256;252856978261;5;2,9;2;1;1
252856978261;252856978278;17;2,9;2;1;1
252856978278;252856978291;13;2,9;2;1;1
252856978291;252856978297;6;2,9;2;1;1
252856978297;252856978299;2;2,9;2;1;1
252856978299;252856978303;4;2,9;2;1;1
252856978303;252856978315;12;2,9;2;1;1
252856978315;252856978316;1;2,9;2;1;1
252856978316;252856978329;13;2,9;2;1;1
252856978329;252856978333;4;2,9;2;1;1
252856978333;252856978337;4;2,9;2;1;1
252856978337;252856978352;15;2,9;2;1;1
252856978352;252856978353;1;2,9;2;1;1
252856978353;252856978354;1;2,9;2;1;1
252856978354;252856978365;11;2,9;2;1;1
252856978365;252856978366;1;2,9;2;1;1
252856978366;252856978385;19;2,9;2;1;1
252856978385;252856978389;4;2,9;2;1;1
252856978389;252856978391;2;2,9;2;1;1
252856978391;252856978395;4;2,9;2;1;1
252856978395;252856978398;3;2,9;2;1;1
252856978398;252856978411;13;2,9;2;1;1
252856978411;252856978417;6;2,9;2;1;1
252856978417;252856978429;12;2,9;2;1;1
252856978429;252856978434;5;2,9;2;1;1
252856978434;252856978455;21;2,9;2;1;1
252856978455;252856978460;5;2,9;2;1;1
252856978460;252856978462;2;2,9;2;1;1
252856978462;252856978479;17;2,9;2;1;1
252856978479;252856978486;7;2,9;2;1;1
252856978486;252856978487;1;2,9;2;1;1
252856978487;252856978492;5;2,9;2;1;1
252856978492;252856978496;4;2,9;2;1;1
252856978496;252856978499;3;2,9;2;1;1
252856978499;252856978500;1;2,9;2;1;1
252856978500;252856978518;18;2,9;2;1;1
252856978518;252856978522;4;2,9;2;1;1
252856978522;252856978530;8;2,9;2;1;1
252856978530;252856978532;2;2,9;2;1;1
252856978532;252856978535;3;2,9;2;1;1
252856978535;252856978547;12;2,9;2;1;1
252856978547;252856978549;2;2,9;2;1;1
252856978549;252856978563;14;2,9;2;1;1
252856978563;252856978573;10;2,9;2;1;1
252856978573;252856978577;4;2,9;2;1;1
252856978577;252856978599;22;2,9;2;1;1
252856978599;252856978600;1;2,9;2;1;1
252856978600;252856978608;8;2,9;2;1;1
252856978608;252856978609;1;2,9;2;1;1
252856978609;252856978610;1;2,9;2;1;1
252856978610;252856978614;4;2,9;2;1;1
252856978614;252856978620;6;2,9;2;1;1
252856978620;252856978625;5;2,9;2;1;1
252856978625;252856978632;7;2,9;2;1;1
252856978632;252856978637;5;2,9;2;1;1
252856978637;252856978644;7;2,9;2;1;1
252856978644;252856978654;10;2,9;2;1;1
252856978654;252856978664;10;2,9;2;1;1
252856978664;252856978667;3;2,9;2;1;1
252856978667;252856978674;7;2,9;2;1;1
252856978674;252856978680;6;2,9;2;1;1
252856978680;252856978683;3;2,9;2;1;1
252856978683;252856978685;2;2,9;2;1;1
252856978685;252856978703;18;2,9;2;1;1
252856978703;252856978704;1;2,9;2;1;1
252856978704;252856978706;2;2,9;2;1;1
252856978706;252856978711;5;2,9;2;1;1
252856978711;252856978713;2;2,9;2;1;1
252856978713;252856978714;1;2,9;2;1;1
252856978714;252856978716;2;2,9;2;1;1
252856978716;252856978725;9;2,9;2;1;1
252856978725;252856978726;1;2,9;2;1;1
252856978726;252856978728;2;2,9;2;1;1
252856978728;252856978756;28;2,9;2;1;1
252856978756;252856978786;30;2,9;2;1;1
252856978786;252856978789;3;2,9;2;1;1
252856978789;252856978793;4;2,9;2;1;1
252856978793;252856978795;2;2,9;2;1;1
252856978795;252856978796;1;2,9;2;1;1
252856978796;252856978797;1;2,9;2;1;1
252856978797;252856978821;24;2,9;2;1;1
252856978821;252856978828;7;2,9;2;1;1
252856978828;252856978829;1;2,9;2;1;1
252856978829;252856978860;31;2,9;2;1;1
252856978860;252856978863;3;2,9;2;1;1
252856978863;252856978872;9;2,9;2;1;1
252856978872;252856978874;2;2,9;2;1;1
252856978874;252856978886;12;2,9;2;1;1
252856978886;252856978893;7;2,9;2;1;1
252856978893;252856978898;5;2,9;2;1;1
252856978898;252856978914;16;2,9;2;1;1
252856978914;252856978951;37;2,9;2;1;1
252856978951;252856978952;1;2,9;2;1;1
252856978952;252856978961;9;2,9;2;1;1
252856978961;252856978974;13;2,9;2;1;1
252856978974;252856978977;3;2,9;2;1;1
252856978977;252856978981;4;2,9;2;1;1
252856978981;252856978984;3;2,9;2;1;1
252856978984;252856978987;3;2,9;2;1;1
252856978987;252856978992;5;2,9;2;1;1
252856978992;252856978994;2;2,9;2;1;1
252856978994;252856979009;15;2,9;2;1;1
252856979009;252856979012;3;2,9;2;1;1
252856979012;252856979017;5;2,9;2;1;1
252856979017;252856979021;4;2,9;2;1;1
252856979021;252856979031;10;2,9;2;1;1
252856979031;252856979049;18;2,9;2;1;1
252856979049;252856979079;30;2,9;2;1;1
252856979079;252856979081;2;2,9;2;1;1
252856979081;252856979092;11;2,9;2;1;1
252856979092;252856979093;1;2,9;2;1;1
252856979093;252856979094;1;2,9;2;1;1
252856979094;252856979096;2;2,9;2;1;1
252856979096;252856979130;34;2,9;2;1;1
252856979130;252856979147;17;2,9;2;1;1
252856979147;252856979149;2;2,9;2;1;1
252856979149;252856979160;11;2,9;2;1;1
252856979160;252856979164;4;2,9;2;1;1
252856979164;252856979171;7;2,9;2;1;1
252856979171;252856979173;2;2,9;2;1;1
252856979173;252856979190;17;2,9;2;1;1
252856979190;252856979196;6;2,9;2;1;1
252856979196;252856979221;25;2,9;2;1;1
252856979221;252856979228;7;2,9;2;1;1
252856979228;252856979234;6;2,9;2;1;1
252856979234;252856979250;16;2,9;2;1;1
252856979250;252856979252;2;2,9;2;1;1
252856979252;252856979257;5;2,9;2;1;1
252856979257;252856979264;7;2,9;2;1;1
252856979264;252856979271;7;2,9;2;1;1
252856979271;252856979279;8;2,9;2;1;1
252856979279;252856979290;11;2,9;2;1;1
252856979290;252856979315;25;2,9;2;1;1
252856979315;252856979318;3;2,9;2;1;1
252856979318;252856979384;66;2,9;2;1;1
252856979384;252856979387;3;2,9;2;1;1
252856979387;252856979391;4;2,9;2;1;1
252856979391;252856979398;7;2,9;2;1;1
252856979398;252856979415;17;2,9;2;1;1
252856979415;252856979429;14;2,9;2;1;1
252856979429;252856979472;43;2,9;2;1;1
252856979472;252856979491;19;2,9;2;1;1
252856979491;252856979493;2;2,9;2;1;1
252856979493;252856979504;11;2,9;2;1;1
252856979504;252856979510;6;2,9;2;1;1
252856979510;252856979518;8;2,9;2;1;1
252856979518;252856979526;8;2,9;2;1;1
252856979526;252856979542;16;2,9;2;1;1
252856979542;252856979554;12;2,9;2;1;1
252856979554;252856979555;1;2,9;2;1;1
252856979555;252856979560;5;2,9;2;1;1
252856979560;252856979566;6;2,9;2;1;1
252856979566;252856979568;2;2,9;2;1;1
252856979568;252856979583;15;2,9;2;1;1
252856979583;252856979584;1;2,9;2;1;1
252856979584;252856979586;2;2,9;2;1;1
252856979586;252856979596;10;2,9;2;1;1
252856979596;252856979627;31;2,9;2;1;1
252856979627;252856979631;4;2,9;2;1;1
252856979631;252856979637;6;2,9;2;1;1
252856979637;252856979640;3;2,9;2;1;1
252856979640;252856979641;1;2,9;2;1;1
252856979641;252856979652;11;2,9;2;1;1
252856979652;252856979653;1;2,9;2;1;1
252856979653;252856979662;9;2,9;2;1;1
252856979662;252856979664;2;2,9;2;1;1
252856979664;252856979667;3;2,9;2;1;1
252856979667;252856979669;2;2,9;2;1;1
252856979669;252856979670;1;2,9;2;1;1
252856979670;252856979679;9;2,9;2;1;1
252856979679;252856979681;2;2,9;2;1;1
252856979681;252856979694;13;2,9;2;1;1
252856979694;252856979695;1;2,9;2;1;1
252856979695;252856979699;4;2,9;2;1;1
252856979699;252856979708;9;2,9;2;1;1
252856979708;252856979709;1;2,9;2;1;1
252856979709;252856979711;2;2,9;2;1;1
252856979711;252856979716;5;2,9;2;1;1
252856979716;252856979740;24;2,9;2;1;1
252856979740;252856979743;3;2,9;2;1;1
252856979743;252856979747;4;2,9;2;1;1
252856979747;252856979748;1;2,9;2;1;1
252856979748;252856979750;2;2,9;2;1;1
252856979750;252856979756;6;2,9;2;1;1
252856979756;252856979760;4;2,9;2;1;1
252856979760;252856979769;9;2,9;2;1;1
252856979769;252856979777;8;2,9;2;1;1
252856979777;252856979778;1;2,9;2;1;1
252856979778;252856979784;6;2,9;2;1;1
252856979784;252856979794;10;2,9;2;1;1
252856979794;252856979802;8;2,9;2;1;1
252856979802;252856979804;2;2,9;2;1;1
252856979804;252856979811;7;2,9;2;1;1
252856979811;252856979825;14;2,9;2;1;1
252856979825;252856979826;1;2,9;2;1;1
252856979826;252856979835;9;2,9;2;1;1
252856979835;252856979836;1;2,9;2;1;1
252856979836;252856979844;8;2,9;2;1;1
252856979844;252856979846;2;2,9;2;1;1
252856979846;252856979850;4;2,9;2;1;1
252856979850;252856979853;3;2,9;2;1;1
252856979853;252856979863;10;2,9;2;1;1
252856979863;252856979864;1;2,9;2;1;1
252856979864;252856979868;4;2,9;2;1;1
252856979868;252856979873;5;2,9;2;1;1
252856979873;252856979874;1;2,9;2;1;1
252856979874;252856979885;11;2,9;2;1;1
252856979885;252856979888;3;2,9;2;1;1
252856979888;252856979889;1;2,9;2;1;1
252856979889;252856979890;1;2,9;2;1;1
252856979890;252856979895;5;2,9;2;1;1
252856979895;252856979896;1;2,9;2;1;1
252856979896;252856979911;15;2,9;2;1;1
252856979911;252856979916;5;2,9;2;1;1
252856979916;252856979917;1;2,9;2;1;1
252856979917;252856979946;29;2,9;2;1;1
252856979946;252856979955;9;2,9;2;1;1
252856979955;252856979962;7;2,9;2;1;1
252856979962;252856979973;11;2,9;2;1;1
252856979973;252856979979;6;2,9;2;1;1
252856979979;252856979985;6;2,9;2;1;1
252856979985;252856979989;4;2,9;2;1;1
252856979989;252856980016;27;2,9;2;1;1
252856980016;252856980038;22;2,9;2;1;1
252856980038;252856980044;6;2,9;2;1;1
252856980044;252856980059;15;2,9;2;1;1
252856980059;252856980066;7;2,9;2;1;1
252856980066;252856980075;9;2,9;2;1;1
252856980075;252856980090;15;2,9;2;1;1
252856980090;252856980104;14;2,9;2;1;1
252856980104;252856980109;5;2,9;2;1;1
252856980109;252856980116;7;2,9;2;1;1
252856980116;252856980126;10;2,9;2;1;1
252856980126;252856980131;5;2,9;2;1;1
252856980131;252856980158;27;2,9;2;1;1
252856980158;252856980163;5;2,9;2;1;1
252856980163;252856980174;11;2,9;2;1;1
252856980174;252856980220;46;2,9;2;1;1
252856980220;252856980221;1;2,9;2;1;1
252856980221;252856980228;7;2,9;2;1;1
252856980228;252856980229;1;2,9;2;1;1
252856980229;252856980230;1;2,9;2;1;1
252856980230;252856980237;7;2,9;2;1;1
252856980237;252856980240;3;2,9;2;1;1
252856980240;252856980242;2;2,9;2;1;1
252856980242;252856980243;1;2,9;2;1;1
252856980243;252856980256;13;2,9;2;1;1
252856980256;252856980269;13;2,9;2;1;1
252856980269;252856980285;16;2,9;2;1;1
252856980285;252856980296;11;2,9;2;1;1
252856980296;252856980297;1;2,9;2;1;1
252856980297;252856980301;4;2,9;2;1;1
252856980301;252856980337;36;2,9;2;1;1
252856980337;252856980353;16;2,9;2;1;1
252856980353;252856980354;1;2,9;2;1;1
252856980354;252856980364;10;2,9;2;1;1
252856980364;252856980371;7;2,9;2;1;1
252856980371;252856980373;2;2,9;2;1;1
252856980373;252856980388;15;2,9;2;1;1
252856980388;252856980401;13;2,9;2;1;1
252856980401;252856980403;2;2,9;2;1;1
252856980403;252856980407;4;2,9;2;1;1
252856980407;252856980416;9;2,9;2;1;1
252856980416;252856980423;7;2,9;2;1;1
252856980423;252856980431;8;2,9;2;1;1
252856980431;252856980450;19;2,9;2;1;1
252856980450;252856980452;2;2,9;2;1;1
252856980452;252856980475;23;2,9;2;1;1
252856980475;252856980478;3;2,9;2;1;1
252856980478;252856980480;2;2,9;2;1;1
252856980480;252856980494;14;2,9;2;1;1
252856980494;252856980503;9;2,9;2;1;1
252856980503;252856980506;3;2,9;2;1;1
252856980506;252856980519;13;2,9;2;1;1
252856980519;252856980525;6;2,9;2;1;1
252856980525;252856980561;36;2,9;2;1;1
252856980561;252856980568;7;2,9;2;1;1
252856980568;252856980570;2;2,9;2;1;1
252856980570;252856980576;6;2,9;2;1;1
252856980576;252856980587;11;2,9;2;1;1
252856980587;252856980588;1;2,9;2;1;1
252856980588;252856980596;8;2,9;2;1;1
252856980596;252856980598;2;2,9;2;1;1
252856980598;252856980600;2;2,9;2;1;1
252856980600;252856980616;16;2,9;2;1;1
252856980616;252856980618;2;2,9;2;1;1
252856980618;252856980626;8;2,9;2;1;1
252856980626;252856980645;19;2,9;2;1;1
252856980645;252856980651;6;2,9;2;1;1
252856980651;252856980660;9;2,9;2;1;1
252856980660;252856980663;3;2,9;2;1;1
252856980663;252856980672;9;2,9;2;1;1
252856980672;252856980681;9;2,9;2;1;1
252856980681;252856980682;1;2,9;2;1;1
252856980682;252856980690;8;2,9;2;1;1
252856980690;252856980692;2;2,9;2;1;1
252856980692;252856980708;16;2,9;2;1;1
252856980708;252856980711;3;2,9;2;1;1
252856980711;252856980719;8;2,9;2;1;1
252856980719;252856980723;4;2,9;2;1;1
252856980723;252856980739;16;2,9;2;1;1
252856980739;252856980742;3;2,9;2;1;1
252856980742;252856980746;4;2,9;2;1;1
252856980746;252856980751;5;2,9;2;1;1
252856980751;252856980760;9;2,9;2;1;1
252856980760;252856980766;6;2,9;2;1;1
252856980766;252856980767;1;2,9;2;1;1
252856980767;252856980771;4;2,9;2;1;1
252856980771;252856980774;3;2,9;2;1;1
252856980774;252856980778;4;2,9;2;1;1
252856980778;252856980784;6;2,9;2;1;1
252856980784;252856980786;2;2,9;2;1;1
252856980786;252856980790;4;2,9;2;1;1
252856980790;252856980813;23;2,9;2;1;1
252856980813;252856980822;9;2,9;2;1;1
252856980822;252856980825;3;2,9;2;1;1
252856980825;252856980833;8;2,9;2;1;1
252856980833;252856980851;18;2,9;2;1;1
252856980851;252856980856;5;2,9;2;1;1
252856980856;252856980859;3;2,9;2;1;1
252856980859;252856980863;4;2,9;2;1;1
252856980863;252856980865;2;2,9;2;1;1
252856980865;252856980881;16;2,9;2;1;1
252856980881;252856980895;14;2,9;2;1;1
252856980895;252856980899;4;2,9;2;1;1
252856980899;252856980908;9;2,9;2;1;1
252856980908;252856980916;8;2,9;2;1;1
252856980916;252856980923;7;2,9;2;1;1
252856980923;252856980926;3;2,9;2;1;1
252856980926;252856980927;1;2,9;2;1;1
252856980927;252856980934;7;2,9;2;1;1
252856980934;252856980943;9;2,9;2;1;1
252856980943;252856980946;3;2,9;2;1;1
252856980946;252856980957;11;2,9;2;1;1
252856980957;252856980973;16;2,9;2;1;1
252856980973;252856980983;10;2,9;2;1;1
252856980983;252856980984;1;2,9;2;1;1
252856980984;252856980986;2;2,9;2;1;1
252856980986;252856981002;16;2,9;2;1;1
252856981002;252856981005;3;2,9;2;1;1
252856981005;252856981009;4;2,9;2;1;1
252856981009;252856981017;8;2,9;2;1;1
252856981017;252856981038;21;2,9;2;1;1
252856981038;252856981053;15;2,9;2;1;1
252856981053;252856981056;3;2,9;2;1;1
252856981056;252856981069;13;2,9;2;1;1
252856981069;252856981075;6;2,9;2;1;1
252856981075;252856981076;1;2,9;2;1;1
252856981076;252856981080;4;2,9;2;1;1
252856981080;252856981088;8;2,9;2;1;1
252856981088;252856981107;19;2,9;2;1;1
252856981107;252856981108;1;2,9;2;1;1
252856981108;252856981114;6;2,9;2;1;1
252856981114;252856981115;1;2,9;2;1;1
252856981115;252856981124;9;2,9;2;1;1
252856981124;252856981125;1;2,9;2;1;1
252856981125;252856981128;3;2,9;2;1;1
252856981128;252856981135;7;2,9;2;1;1
252856981135;252856981136;1;2,9;2;1;1
252856981136;252856981141;5;2,9;2;1;1
252856981141;252856981152;11;2,9;2;1;1
252856981152;252856981170;18;2,9;2;1;1
252856981170;252856981184;14;2,9;2;1;1
252856981184;252856981187;3;2,9;2;1;1
252856981187;252856981204;17;2,9;2;1;1
252856981204;252856981205;1;2,9;2;1;1
252856981205;252856981211;6;2,9;2;1;1
252856981211;252856981215;4;2,9;2;1;1
252856981215;252856981224;9;2,9;2;1;1
252856981224;252856981227;3;2,9;2;1;1
252856981227;252856981231;4;2,9;2;1;1
252856981231;252856981232;1;2,9;2;1;1
252856981232;252856981242;10;2,9;2;1;1
252856981242;252856981244;2;2,9;2;1;1
252856981244;252856981245;1;2,9;2;1;1
252856981245;252856981251;6;2,9;2;1;1
252856981251;252856981260;9;2,9;2;1;1
252856981260;252856981266;6;2,9;2;1;1
252856981266;252856981279;13;2,9;2;1;1
252856981279;252856981281;2;2,9;2;1;1
252856981281;252856981282;1;2,9;2;1;1
252856981282;252856981309;27;2,9;2;1;1
252856981309;252856981310;1;2,9;2;1;1
252856981310;252856981315;5;2,9;2;1;1
252856981315;252856981337;22;2,9;2;1;1
252856981337;252856981338;1;2,9;2;1;1
252856981338;252856981345;7;2,9;2;1;1
252856981345;252856981361;16;2,9;2;1;1
252856981361;252856981364;3;2,9;2;1;1
252856981364;252856981372;8;2,9;2;1;1
252856981372;252856981377;5;2,9;2;1;1
252856981377;252856981384;7;2,9;2;1;1
252856981384;252856981415;31;2,9;2;1;1
252856981415;252856981418;3;2,9;2;1;1
252856981418;252856981427;9;2,9;2;1;1
252856981427;252856981432;5;2,9;2;1;1
252856981432;252856981434;2;2,9;2;1;1
252856981434;252856981445;11;2,9;2;1;1
252856981445;252856981446;1;2,9;2;1;1
252856981446;252856981456;10;2,9;2;1;1
252856981456;252856981470;14;2,9;2;1;1
252856981470;252856981472;2;2,9;2;1;1
252856981472;252856981474;2;2,9;2;1;1
252856981474;252856981495;21;2,9;2;1;1
252856981495;252856981501;6;2,9;2;1;1
252856981501;252856981505;4;2,9;2;1;1
252856981505;252856981512;7;2,9;2;1;1
252856981512;252856981514;2;2,9;2;1;1
252856981514;252856981522;8;2,9;2;1;1
252856981522;252856981532;10;2,9;2;1;1
252856981532;252856981539;7;2,9;2;1;1
252856981539;252856981544;5;2,9;2;1;1
252856981544;252856981547;3;2,9;2;1;1
252856981547;252856981560;13;2,9;2;1;1
252856981560;252856981564;4;2,9;2;1;1
252856981564;252856981586;22;2,9;2;1;1
252856981586;252856981612;26;2,9;2;1;1
252856981612;252856981613;1;2,9;2;1;1
252856981613;252856981651;38;2,9;2;1;1
252856981651;252856981663;12;2,9;2;1;1
252856981663;252856981673;10;2,9;2;1;1
252856981673;252856981704;31;2,9;2;1;1
252856981704;252856981708;4;2,9;2;1;1
252856981708;252856981715;7;2,9;2;1;1
252856981715;252856981717;2;2,9;2;1;1
252856981717;252856981733;16;2,9;2;1;1
252856981733;252856981740;7;2,9;2;1;1
252856981740;252856981745;5;2,9;2;1;1
252856981745;252856981752;7;2,9;2;1;1
252856981752;252856981768;16;2,9;2;1;1
252856981768;252856981774;6;2,9;2;1;1
252856981774;252856981775;1;2,9;2;1;1
252856981775;252856981784;9;2,9;2;1;1
252856981784;252856981802;18;2,9;2;1;1
252856981802;252856981813;11;2,9;2;1;1
252856981813;252856981832;19;2,9;2;1;1
252856981832;252856981839;7;2,9;2;1;1
252856981839;252856981861;22;2,9;2;1;1
252856981861;252856981867;6;2,9;2;1;1
252856981867;252856981874;7;2,9;2;1;1
252856981874;252856981890;16;2,9;2;1;1
252856981890;252856981911;21;2,9;2;1;1
252856981911;252856981917;6;2,9;2;1;1
252856981917;252856981920;3;2,9;2;1;1
252856981920;252856981932;12;2,9;2;1;1
252856981932;252856981948;16;2,9;2;1;1
252856981948;252856981960;12;2,9;2;1;1
252856981960;252856981970;10;2,9;2;1;1
252856981970;252856981975;5;2,9;2;1;1
252856981975;252856981983;8;2,9;2;1;1
252856981983;252856981987;4;2,9;2;1;1
252856981987;252856981993;6;2,9;2;1;1
252856981993;252856982001;8;2,9;2;1;1
252856982001;252856982008;7;2,9;2;1;1
252856982008;252856982009;1;2,9;2;1;1
252856982009;252856982014;5;2,9;2;1;1
252856982014;252856982019;5;2,9;2;1;1
252856982019;252856982026;7;2,9;2;1;1
252856982026;252856982027;1;2,9;2;1;1
252856982027;252856982030;3;2,9;2;1;1
252856982030;252856982034;4;2,9;2;1;1
252856982034;252856982040;6;2,9;2;1;1
252856982040;252856982047;7;2,9;2;1;1
252856982047;252856982049;2;2,9;2;1;1
252856982049;252856982051;2;2,9;2;1;1
252856982051;252856982058;7;2,9;2;1;1
252856982058;252856982065;7;2,9;2;1;1
252856982065;252856982066;1;2,9;2;1;1
252856982066;252856982070;4;2,9;2;1;1
252856982070;252856982071;1;2,9;2;1;1
252856982071;252856982079;8;2,9;2;1;1
252856982079;252856982080;1;2,9;2;1;1
252856982080;252856982086;6;2,9;2;1;1
252856982086;252856982087;1;2,9;2;1;1
252856982087;252856982095;8;2,9;2;1;1
252856982095;252856982105;10;2,9;2;1;1
252856982105;252856982114;9;2,9;2;1;1
252856982114;252856982123;9;2,9;2;1;1
252856982123;252856982132;9;2,9;2;1;1
252856982132;252856982143;11;2,9;2;1;1
252856982143;252856982148;5;2,9;2;1;1
252856982148;252856982149;1;2,9;2;1;1
252856982149;252856982166;17;2,9;2;1;1
252856982166;252856982169;3;2,9;2;1;1
252856982169;252856982190;21;2,9;2;1;1
252856982190;252856982197;7;2,9;2;1;1
252856982197;252856982198;1;2,9;2;1;1
252856982198;252856982205;7;2,9;2;1;1
252856982205;252856982212;7;2,9;2;1;1
252856982212;252856982214;2;2,9;2;1;1
252856982214;252856982217;3;2,9;2;1;1
252856982217;252856982231;14;2,9;2;1;1
252856982231;252856982232;1;2,9;2;1;1
252856982232;252856982239;7;2,9;2;1;1
252856982239;252856982245;6;2,9;2;1;1
252856982245;252856982261;16;2,9;2;1;1
252856982261;252856982271;10;2,9;2;1;1
252856982271;252856982277;6;2,9;2;1;1
252856982277;252856982280;3;2,9;2;1;1
252856982280;252856982296;16;2,9;2;1;1
252856982296;252856982300;4;2,9;2;1;1
252856982300;252856982313;13;2,9;2;1;1
252856982313;252856982314;1;2,9;2;1;1
252856982314;252856982326;12;2,9;2;1;1
252856982326;252856982328;2;2,9;2;1;1
252856982328;252856982335;7;2,9;2;1;1
252856982335;252856982351;16;2,9;2;1;1
252856982351;252856982374;23;2,9;2;1;1
252856982374;252856982378;4;2,9;2;1;1
252856982378;252856982393;15;2,9;2;1;1
252856982393;252856982397;4;2,9;2;1;1
252856982397;252856982401;4;2,9;2;1;1
252856982401;252856982407;6;2,9;2;1;1
252856982407;252856982413;6;2,9;2;1;1
252856982413;252856982419;6;2,9;2;1;1
252856982419;252856982430;11;2,9;2;1;1
252856982430;252856982446;16;2,9;2;1;1
252856982446;252856982457;11;2,9;2;1;1
252856982457;252856982458;1;2,9;2;1;1
252856982458;252856982464;6;2,9;2;1;1
252856982464;252856982478;14;2,9;2;1;1
252856982478;252856982494;16;2,9;2;1;1
252856982494;252856982499;5;2,9;2;1;1
252856982499;252856982500;1;2,9;2;1;1
252856982500;252856982506;6;2,9;2;1;1
252856982506;252856982518;12;2,9;2;1;1
252856982518;252856982523;5;2,9;2;1;1
252856982523;252856982542;19;2,9;2;1;1
252856982542;252856982552;10;2,9;2;1;1
252856982552;252856982553;1;2,9;2;1;1
252856982553;252856982566;13;2,9;2;1;1
252856982566;252856982579;13;2,9;2;1;1
252856982579;252856982585;6;2,9;2;1;1
252856982585;252856982600;15;2,9;2;1;1
252856982600;252856982605;5;2,9;2;1;1
252856982605;252856982609;4;2,9;2;1;1
252856982609;252856982611;2;2,9;2;1;1
252856982611;252856982618;7;2,9;2;1;1
252856982618;252856982619;1;2,9;2;1;1
252856982619;252856982633;14;2,9;2;1;1
252856982633;252856982639;6;2,9;2;1;1
252856982639;252856982676;37;2,9;2;1;1
252856982676;252856982680;4;2,9;2;1;1
252856982680;252856982689;9;2,9;2;1;1
252856982689;252856982693;4;2,9;2;1;1
252856982693;252856982707;14;2,9;2;1;1
252856982707;252856982708;1;2,9;2;1;1
252856982708;252856982712;4;2,9;2;1;1
252856982712;252856982724;12;2,9;2;1;1
252856982724;252856982726;2;2,9;2;1;1
252856982726;252856982728;2;2,9;2;1;1
252856982728;252856982739;11;2,9;2;1;1
252856982739;252856982756;17;2,9;2;1;1
252856982756;252856982758;2;2,9;2;1;1
252856982758;252856982767;9;2,9;2;1;1
252856982767;252856982768;1;2,9;2;1;1
252856982768;252856982785;17;2,9;2;1;1
252856982785;252856982789;4;2,9;2;1;1
252856982789;252856982803;14;2,9;2;1;1
252856982803;252856982805;2;2,9;2;1;1
252856982805;252856982810;5;2,9;2;1;1
252856982810;252856982821;11;2,9;2;1;1
252856982821;252856982841;20;2,9;2;1;1
252856982841;252856982845;4;2,9;2;1;1
252856982845;252856982847;2;2,9;2;1;1
252856982847;252856982871;24;2,9;2;1;1
252856982871;252856982872;1;2,9;2;1;1
252856982872;252856982878;6;2,9;2;1;1
252856982878;252856982882;4;2,9;2;1;1
252856982882;252856982890;8;2,9;2;1;1
252856982890;252856982896;6;2,9;2;1;1
252856982896;252856982907;11;2,9;2;1;1
252856982907;252856982908;1;2,9;2;1;1
252856982908;252856982910;2;2,9;2;1;1
252856982910;252856982917;7;2,9;2;1;1
252856982917;252856982918;1;2,9;2;1;1
252856982918;252856982936;18;2,9;2;1;1
252856982936;252856982939;3;2,9;2;1;1
252856982939;252856982960;21;2,9;2;1;1
252856982960;252856982965;5;2,9;2;1;1
252856982965;252856982983;18;2,9;2;1;1
252856982983;252856982984;1;2,9;2;1;1
252856982984;252856983002;18;2,9;2;1;1
252856983002;252856983004;2;2,9;2;1;1
252856983004;252856983008;4;2,9;2;1;1
252856983008;252856983021;13;2,9;2;1;1
252856983021;252856983028;7;2,9;2;1;1
252856983028;252856983041;13;2,9;2;1;1
252856983041;252856983044;3;2,9;2;1;1
252856983044;252856983045;1;2,9;2;1;1
252856983045;252856983057;12;2,9;2;1;1
252856983057;252856983064;7;2,9;2;1;1
252856983064;252856983073;9;2,9;2;1;1
252856983073;252856983077;4;2,9;2;1;1
252856983077;252856983119;42;2,9;2;1;1
252856983119;252856983120;1;2,9;2;1;1
252856983120;252856983126;6;2,9;2;1;1
252856983126;252856983139;13;2,9;2;1;1
252856983139;252856983140;1;2,9;2;1;1
252856983140;252856983142;2;2,9;2;1;1
252856983142;252856983146;4;2,9;2;1;1
252856983146;252856983150;4;2,9;2;1;1
252856983150;252856983151;1;2,9;2;1;1
252856983151;252856983155;4;2,9;2;1;1
252856983155;252856983167;12;2,9;2;1;1
252856983167;252856983172;5;2,9;2;1;1
252856983172;252856983174;2;2,9;2;1;1
252856983174;252856983189;15;2,9;2;1;1
252856983189;252856983205;16;2,9;2;1;1
252856983205;252856983223;18;2,9;2;1;1
252856983223;252856983235;12;2,9;2;1;1
252856983235;252856983238;3;2,9;2;1;1
252856983238;252856983239;1;2,9;2;1;1
252856983239;252856983241;2;2,9;2;1;1
252856983241;252856983251;10;2,9;2;1;1
252856983251;252856983265;14;2,9;2;1;1
252856983265;252856983271;6;2,9;2;1;1
252856983271;252856983291;20;2,9;2;1;1
252856983291;252856983294;3;2,9;2;1;1
252856983294;252856983300;6;2,9;2;1;1
252856983300;252856983311;11;2,9;2;1;1
252856983311;252856983329;18;2,9;2;1;1
252856983329;252856983332;3;2,9;2;1;1
252856983332;252856983336;4;2,9;2;1;1
252856983336;252856983343;7;2,9;2;1;1
252856983343;252856983365;22;2,9;2;1;1
252856983365;252856983366;1;2,9;2;1;1
252856983366;252856983377;11;2,9;2;1;1
252856983377;252856983391;14;2,9;2;1;1
252856983391;252856983401;10;2,9;2;1;1
252856983401;252856983420;19;2,9;2;1;1
252856983420;252856983421;1;2,9;2;1;1
252856983421;252856983428;7;2,9;2;1;1
252856983428;252856983448;20;2,9;2;1;1
252856983448;252856983467;19;2,9;2;1;1
252856983467;252856983471;4;2,9;2;1;1
252856983471;252856983474;3;2,9;2;1;1
252856983474;252856983503;29;2,9;2;1;1
252856983503;252856983504;1;2,9;2;1;1
252856983504;252856983506;2;2,9;2;1;1
252856983506;252856983511;5;2,9;2;1;1
252856983511;252856983517;6;2,9;2;1;1
252856983517;252856983537;20;2,9;2;1;1
252856983537;252856983538;1;2,9;2;1;1
252856983538;252856983544;6;2,9;2;1;1
252856983544;252856983564;20;2,9;2;1;1
252856983564;252856983570;6;2,9;2;1;1
252856983570;252856983573;3;2,9;2;1;1
252856983573;252856983579;6;2,9;2;1;1
252856983579;252856983596;17;2,9;2;1;1
252856983596;252856983603;7;2,9;2;1;1
252856983603;252856983609;6;2,9;2;1;1
252856983609;252856983613;4;2,9;2;1;1
252856983613;252856983617;4;2,9;2;1;1
252856983617;252856983634;17;2,9;2;1;1
252856983634;252856983635;1;2,9;2;1;1
252856983635;252856983646;11;2,9;2;1;1
252856983646;252856983666;20;2,9;2;1;1
252856983666;252856983670;4;2,9;2;1;1
252856983670;252856983675;5;2,9;2;1;1
252856983675;252856983690;15;2,9;2;1;1
252856983690;252856983698;8;2,9;2;1;1
252856983698;252856983736;38;2,9;2;1;1
252856983736;252856983757;21;2,9;2;1;1
252856983757;252856983760;3;2,9;2;1;1
252856983760;252856983787;27;2,9;2;1;1
252856983787;252856983812;25;2,9;2;1;1
252856983812;252856983818;6;2,9;2;1;1
252856983818;252856983820;2;2,9;2;1;1
252856983820;252856983831;11;2,9;2;1;1
252856983831;252856983835;4;2,9;2;1;1
252856983835;252856983848;13;2,9;2;1;1
252856983848;252856983854;6;2,9;2;1;1
252856983854;252856983867;13;2,9;2;1;1
252856983867;252856983881;14;2,9;2;1;1
252856983881;252856983896;15;2,9;2;1;1
252856983896;252856983899;3;2,9;2;1;1
252856983899;252856983905;6;2,9;2;1;1
252856983905;252856983906;1;2,9;2;1;1
252856983906;252856983924;18;2,9;2;1;1
252856983924;252856983927;3;2,9;2;1;1
252856983927;252856983935;8;2,9;2;1;1
252856983935;252856983955;20;2,9;2;1;1
252856983955;252856983963;8;2,9;2;1;1
252856983963;252856983977;14;2,9;2;1;1
252856983977;252856983987;10;2,9;2;1;1
252856983987;252856983989;2;2,9;2;1;1
252856983989;252856983993;4;2,9;2;1;1
252856983993;252856984009;16;2,9;2;1;1
252856984009;252856984011;2;2,9;2;1;1
252856984011;252856984018;7;2,9;2;1;1
252856984018;252856984026;8;2,9;2;1;1
252856984026;252856984037;11;2,9;2;1;1
252856984037;252856984049;12;2,9;2;1;1
252856984049;252856984052;3;2,9;2;1;1
252856984052;252856984053;1;2,9;2;1;1
252856984053;252856984061;8;2,9;2;1;1
252856984061;252856984072;11;2,9;2;1;1
252856984072;252856984074;2;2,9;2;1;1
252856984074;252856984081;7;2,9;2;1;1
252856984081;252856984083;2;2,9;2;1;1
252856984083;252856984104;21;2,9;2;1;1
252856984104;252856984109;5;2,9;2;1;1
252856984109;252856984110;1;2,9;2;1;1
252856984110;252856984123;13;2,9;2;1;1
252856984123;252856984126;3;2,9;2;1;1
252856984126;252856984134;8;2,9;2;1;1
252856984134;252856984153;19;2,9;2;1;1
252856984153;252856984173;20;2,9;2;1;1
252856984173;252856984196;23;2,9;2;1;1
252856984196;252856984201;5;2,9;2;1;1
252856984201;252856984213;12;2,9;2;1;1
252856984213;252856984215;2;2,9;2;1;1
252856984215;252856984217;2;2,9;2;1;1
252856984217;252856984230;13;2,9;2;1;1
252856984230;252856984239;9;2,9;2;1;1
252856984239;252856984249;10;2,9;2;1;1
252856984249;252856984262;13;2,9;2;1;1
252856984262;252856984283;21;2,9;2;1;1
252856984283;252856984284;1;2,9;2;1;1
252856984284;252856984316;32;2,9;2;1;1
252856984316;252856984348;32;2,9;2;1;1
252856984348;252856984358;10;2,9;2;1;1
252856984358;252856984371;13;2,9;2;1;1
252856984371;252856984393;22;2,9;2;1;1
252856984393;252856984397;4;2,9;2;1;1
252856984397;252856984418;21;2,9;2;1;1
252856984418;252856984424;6;2,9;2;1;1
252856984424;252856984435;11;2,9;2;1;1
252856984435;252856984472;37;2,9;2;1;1
252856984472;252856984478;6;2,9;2;1;1
252856984478;252856984495;17;2,9;2;1;1
252856984495;252856984540;45;2,9;2;1;1
252856984540;252856984541;1;2,9;2;1;1
252856984541;252856984542;1;2,9;2;1;1
252856984542;252856984548;6;2,9;2;1;1
252856984548;252856984563;15;2,9;2;1;1
252856984563;252856984570;7;2,9;2;1;1
252856984570;252856984575;5;2,9;2;1;1
252856984575;252856984583;8;2,9;2;1;1
252856984583;252856984589;6;2,9;2;1;1
252856984589;252856984622;33;2,9;2;1;1
252856984622;252856984660;38;2,9;2;1;1
252856984660;252856984670;10;2,9;2;1;1
252856984670;252856984744;74;2,9;2;1;1
252856984744;252856984810;66;2,9;2;1;1
252856984810;252856984837;27;2,9;2;1;1
252856984837;252856984845;8;2,9;2;1;1
252856984845;252856984891;46;2,9;2;1;1
252856984891;252856984893;2;2,9;2;1;1
252856984893;252856984917;24;2,9;2;1;1
252856984917;252856984919;2;2,9;2;1;1
252856984919;252856984959;40;2,9;2;1;1
252856984959;252856984961;2;2,9;2;1;1
252856984961;252856984969;8;2,9;2;1;1
252856984969;252856984977;8;2,9;2;1;1
252856984977;252856984979;2;2,9;2;1;1
252856984979;252856984989;10;2,9;2;1;1
252856984989;252856984996;7;2,9;2;1;1
252856984996;252856984999;3;2,9;2;1;1
252856984999;252856985009;10;2,9;2;1;1
252856985009;252856985053;44;2,9;2;1;1
252856985053;252856985057;4;2,9;2;1;1
252856985057;252856985058;1;2,9;2;1;1
252856985058;252856985081;23;2,9;2;1;1
252856985081;252856985086;5;2,9;2;1;1
252856985086;252856985087;1;2,9;2;1;1
252856985087;252856985091;4;2,9;2;1;1
252856985091;252856985119;28;2,9;2;1;1
252856985119;252856985122;3;2,9;2;1;1
252856985122;252856985127;5;2,9;2;1;1
252856985127;252856985147;20;2,9;2;1;1
252856985147;252856985163;16;2,9;2;1;1
252856985163;252856985174;11;2,9;2;1;1
252856985174;252856985182;8;2,9;2;1;1
252856985182;252856985190;8;2,9;2;1;1
252856985190;252856985202;12;2,9;2;1;1
252856985202;252856985204;2;2,9;2;1;1
252856985204;252856985206;2;2,9;2;1;1
252856985206;252856985229;23;2,9;2;1;1
252856985229;252856985232;3;2,9;2;1;1
252856985232;252856985237;5;2,9;2;1;1
252856985237;252856985243;6;2,9;2;1;1
252856985243;252856985250;7;2,9;2;1;1
252856985250;252856985256;6;2,9;2;1;1
252856985256;252856985283;27;2,9;2;1;1
252856985283;252856985284;1;2,9;2;1;1
252856985284;252856985289;5;2,9;2;1;1
252856985289;252856985299;10;2,9;2;1;1
252856985299;252856985317;18;2,9;2;1;1
252856985317;252856985332;15;2,9;2;1;1
252856985332;252856985339;7;2,9;2;1;1
252856985339;252856985340;1;2,9;2;1;1
252856985340;252856985348;8;2,9;2;1;1
252856985348;252856985373;25;2,9;2;1;1
252856985373;252856985378;5;2,9;2;1;1
252856985378;252856985385;7;2,9;2;1;1
252856985385;252856985387;2;2,9;2;1;1
252856985387;252856985398;11;2,9;2;1;1
252856985398;252856985406;8;2,9;2;1;1
252856985406;252856985412;6;2,9;2;1;1
252856985412;252856985420;8;2,9;2;1;1
252856985420;252856985424;4;2,9;2;1;1
252856985424;252856985427;3;2,9;2;1;1
252856985427;252856985451;24;2,9;2;1;1
252856985451;252856985454;3;2,9;2;1;1
252856985454;252856985455;1;2,9;2;1;1
252856985455;252856985463;8;2,9;2;1;1
252856985463;252856985481;18;2,9;2;1;1
252856985481;252856985482;1;2,9;2;1;1
252856985482;252856985493;11;2,9;2;1;1
252856985493;252856985508;15;2,9;2;1;1
252856985508;252856985511;3;2,9;2;1;1
252856985511;252856985539;28;2,9;2;1;1
252856985539;252856985561;22;2,9;2;1;1
252856985561;252856985565;4;2,9;2;1;1
252856985565;252856985573;8;2,9;2;1;1
252856985573;252856985580;7;2,9;2;1;1
252856985580;252856985595;15;2,9;2;1;1
252856985595;252856985606;11;2,9;2;1;1
252856985606;252856985623;17;2,9;2;1;1
252856985623;252856985639;16;2,9;2;1;1
252856985639;252856985642;3;2,9;2;1;1
252856985642;252856985661;19;2,9;2;1;1
252856985661;252856985663;2;2,9;2;1;1
252856985663;252856985669;6;2,9;2;1;1
252856985669;252856985671;2;2,9;2;1;1
252856985671;252856985689;18;2,9;2;1;1
252856985689;252856985708;19;2,9;2;1;1
252856985708;252856985728;20;2,9;2;1;1
252856985728;252856985742;14;2,9;2;1;1
252856985742;252856985747;5;2,9;2;1;1
252856985747;252856985768;21;2,9;2;1;1
252856985768;252856985772;4;2,9;2;1;1
252856985772;252856985775;3;2,9;2;1;1
252856985775;252856985779;4;2,9;2;1;1
252856985779;252856985797;18;2,9;2;1;1
252856985797;252856985799;2;2,9;2;1;1
252856985799;252856985811;12;2,9;2;1;1
252856985811;252856985822;11;2,9;2;1;1
252856985822;252856985837;15;2,9;2;1;1
252856985837;252856985838;1;2,9;2;1;1
252856985838;252856985856;18;2,9;2;1;1
252856985856;252856985858;2;2,9;2;1;1
252856985858;252856985884;26;2,9;2;1;1
252856985884;252856985885;1;2,9;2;1;1
252856985885;252856985902;17;2,9;2;1;1
252856985902;252856985910;8;2,9;2;1;1
252856985910;252856985911;1;2,9;2;1;1
252856985911;252856985918;7;2,9;2;1;1
252856985918;252856985936;18;2,9;2;1;1
252856985936;252856985945;9;2,9;2;1;1
252856985945;252856985951;6;2,9;2;1;1
252856985951;252856985957;6;2,9;2;1;1
252856985957;252856985958;1;2,9;2;1;1
252856985958;252856985973;15;2,9;2;1;1
252856985973;252856985996;23;2,9;2;1;1
252856985996;252856985998;2;2,9;2;1;1
252856985998;252856985999;1;2,9;2;1;1
252856985999;252856986001;2;2,9;2;1;1
252856986001;252856986012;11;2,9;2;1;1
252856986012;252856986025;13;2,9;2;1;1
252856986025;252856986040;15;2,9;2;1;1
252856986040;252856986041;1;2,9;2;1;1
252856986041;252856986042;1;2,9;2;1;1
252856986042;252856986046;4;2,9;2;1;1
252856986046;252856986048;2;2,9;2;1;1
252856986048;252856986054;6;2,9;2;1;1
252856986054;252856986056;2;2,9;2;1;1
252856986056;252856986085;29;2,9;2;1;1
252856986085;252856986087;2;2,9;2;1;1
252856986087;252856986090;3;2,9;2;1;1
252856986090;252856986096;6;2,9;2;1;1
252856986096;252856986108;12;2,9;2;1;1
252856986108;252856986129;21;2,9;2;1;1
252856986129;252856986131;2;2,9;2;1;1
252856986131;252856986136;5;2,9;2;1;1
252856986136;252856986148;12;2,9;2;1;1
252856986148;252856986149;1;2,9;2;1;1
252856986149;252856986152;3;2,9;2;1;1
252856986152;252856986185;33;2,9;2;1;1
252856986185;252856986194;9;2,9;2;1;1
252856986194;252856986221;27;2,9;2;1;1
252856986221;252856986246;25;2,9;2;1;1
252856986246;252856986277;31;2,9;2;1;1
252856986277;252856986284;7;2,9;2;1;1
252856986284;252856986289;5;2,9;2;1;1
252856986289;252856986294;5;2,9;2;1;1
252856986294;252856986314;20;2,9;2;1;1
252856986314;252856986316;2;2,9;2;1;1
252856986316;252856986360;44;2,9;2;1;1
252856986360;252856986371;11;2,9;2;1;1
252856986371;252856986374;3;2,9;2;1;1
252856986374;252856986392;18;2,9;2;1;1
252856986392;252856986402;10;2,9;2;1;1
252856986402;252856986406;4;2,9;2;1;1
252856986406;252856986432;26;2,9;2;1;1
252856986432;252856986443;11;2,9;2;1;1
252856986443;252856986444;1;2,9;2;1;1
252856986444;252856986464;20;2,9;2;1;1
252856986464;252856986470;6;2,9;2;1;1
252856986470;252856986480;10;2,9;2;1;1
252856986480;252856986482;2;2,9;2;1;1
252856986482;252856986514;32;2,9;2;1;1
252856986514;252856986520;6;2,9;2;1;1
252856986520;252856986523;3;2,9;2;1;1
252856986523;252856986538;15;2,9;2;1;1
252856986538;252856986539;1;2,9;2;1;1
252856986539;252856986560;21;2,9;2;1;1
252856986560;252856986562;2;2,9;2;1;1
252856986562;252856986568;6;2,9;2;1;1
252856986568;252856986587;19;2,9;2;1;1
252856986587;252856986598;11;2,9;2;1;1
252856986598;252856986599;1;2,9;2;1;1
252856986599;252856986613;14;2,9;2;1;1
252856986613;252856986648;35;2,9;2;1;1
252856986648;252856986659;11;2,9;2;1;1
252856986659;252856986660;1;2,9;2;1;1
252856986660;252856986671;11;2,9;2;1;1
252856986671;252856986680;9;2,9;2;1;1
252856986680;252856986684;4;2,9;2;1;1
252856986684;252856986706;22;2,9;2;1;1
252856986706;252856986708;2;2,9;2;1;1
252856986708;252856986710;2;2,9;2;1;1
252856986710;252856986730;20;2,9;2;1;1
252856986730;252856986751;21;2,9;2;1;1
252856986751;252856986754;3;2,9;2;1;1
252856986754;252856986792;38;2,9;2;1;1
252856986792;252856986807;15;2,9;2;1;1
252856986807;252856986811;4;2,9;2;1;1
252856986811;252856986815;4;2,9;2;1;1
252856986815;252856986819;4;2,9;2;1;1
252856986819;252856986831;12;2,9;2;1;1
252856986831;252856986844;13;2,9;2;1;1
252856986844;252856986849;5;2,9;2;1;1
252856986849;252856986869;20;2,9;2;1;1
252856986869;252856986872;3;2,9;2;1;1
252856986872;252856986903;31;2,9;2;1;1
252856986903;252856986905;2;2,9;2;1;1
252856986905;252856986928;23;2,9;2;1;1
252856986928;252856986931;3;2,9;2;1;1
252856986931;252856986945;14;2,9;2;1;1
252856986945;252856986952;7;2,9;2;1;1
252856986952;252856986956;4;2,9;2;1;1
252856986956;252856986971;15;2,9;2;1;1
252856986971;252856986984;13;2,9;2;1;1
252856986984;252856986993;9;2,9;2;1;1
252856986993;252856987003;10;2,9;2;1;1
252856987003;252856987046;43;2,9;2;1;1
252856987046;252856987064;18;2,9;2;1;1
252856987064;252856987085;21;2,9;2;1;1
252856987085;252856987096;11;2,9;2;1;1
252856987096;252856987119;23;2,9;2;1;1
252856987119;252856987121;2;2,9;2;1;1
252856987121;252856987123;2;2,9;2;1;1
252856987123;252856987124;1;2,9;2;1;1
252856987124;252856987129;5;2,9;2;1;1
252856987129;252856987156;27;2,9;2;1;1
252856987156;252856987160;4;2,9;2;1;1
252856987160;252856987163;3;2,9;2;1;1
252856987163;252856987192;29;2,9;2;1;1
252856987192;252856987206;14;2,9;2;1;1
252856987206;252856987226;20;2,9;2;1;1
252856987226;252856987238;12;2,9;2;1;1
252856987238;252856987247;9;2,9;2;1;1
252856987247;252856987251;4;2,9;2;1;1
252856987251;252856987269;18;2,9;2;1;1
252856987269;252856987276;7;2,9;2;1;1
252856987276;252856987282;6;2,9;2;1;1
252856987282;252856987285;3;2,9;2;1;1
252856987285;252856987325;40;2,9;2;1;1
252856987325;252856987326;1;2,9;2;1;1
252856987326;252856987334;8;2,9;2;1;1
252856987334;252856987345;11;2,9;2;1;1
252856987345;252856987355;10;2,9;2;1;1
252856987355;252856987364;9;2,9;2;1;1
252856987364;252856987370;6;2,9;2;1;1
252856987370;252856987372;2;2,9;2;1;1
252856987372;252856987393;21;2,9;2;1;1
252856987393;252856987394;1;2,9;2;1;1
252856987394;252856987421;27;2,9;2;1;1
252856987421;252856987446;25;2,9;2;1;1
252856987446;252856987451;5;2,9;2;1;1
252856987451;252856987459;8;2,9;2;1;1
252856987459;252856987480;21;2,9;2;1;1
252856987480;252856987482;2;2,9;2;1;1
252856987482;252856987514;32;2,9;2;1;1
252856987514;252856987528;14;2,9;2;1;1
252856987528;252856987551;23;2,9;2;1;1
252856987551;252856987565;14;2,9;2;1;1
252856987565;252856987586;21;2,9;2;1;1
252856987586;252856987617;31;2,9;2;1;1
252856987617;252856987627;10;2,9;2;1;1
252856987627;252856987629;2;2,9;2;1;1
252856987629;252856987646;17;2,9;2;1;1
252856987646;252856987671;25;2,9;2;1;1
252856987671;252856987688;17;2,9;2;1;1
252856987688;252856987690;2;2,9;2;1;1
252856987690;252856987692;2;2,9;2;1;1
252856987692;252856987700;8;2,9;2;1;1
252856987700;252856987722;22;2,9;2;1;1
252856987722;252856987738;16;2,9;2;1;1
252856987738;252856987766;28;2,9;2;1;1
252856987766;252856987778;12;2,9;2;1;1
252856987778;252856987800;22;2,9;2;1;1
252856987800;252856987820;20;2,9;2;1;1
252856987820;252856987856;36;2,9;2;1;1
252856987856;252856987871;15;2,9;2;1;1
252856987871;252856987880;9;2,9;2;1;1
252856987880;252856987882;2;2,9;2;1;1
252856987882;252856987919;37;2,9;2;1;1
252856987919;252856987960;41;2,9;2;1;1
252856987960;252856987999;39;2,9;2;1;1
252856987999;252856988010;11;2,9;2;1;1
252856988010;252856988028;18;2,9;2;1;1
252856988028;252856988037;9;2,9;2;1;1
252856988037;252856988039;2;2,9;2;1;1
252856988039;252856988063;24;2,9;2;1;1
252856988063;252856988065;2;2,9;2;1;1
252856988065;252856988119;54;2,9;2;1;1
252856988119;252856988168;49;2,9;2;1;1
252856988168;252856988240;72;2,9;2;1;1
252856988240;252856988269;29;2,9;2;1;1
252856988269;252856988303;34;2,9;2;1;1
252856988303;252856988341;38;2,9;2;1;1
252856988341;252856988368;27;2,9;2;1;1
252856988368;252856988393;25;2,9;2;1;1
252856988393;252856988451;58;2,9;2;1;1
252856988451;252856988499;48;2,9;2;1;1
252856988499;252856988533;34;2,9;2;1;1
252856988533;252856988548;15;2,9;2;1;1
252856988548;252856988559;11;2,9;2;1;1
252856988559;252856988603;44;2,9;2;1;1
252856988603;252856988605;2;2,9;2;1;1
252856988605;252856988606;1;2,9;2;1;1
252856988606;252856988634;28;2,9;2;1;1
252856988634;252856988662;28;2,9;2;1;1
252856988662;252856988688;26;2,9;2;1;1
252856988688;252856988699;11;2,9;2;1;1
252856988699;252856988710;11;2,9;2;1;1
252856988710;252856988727;17;2,9;2;1;1
252856988727;252856988768;41;2,9;2;1;1
252856988768;252856988778;10;2,9;2;1;1
252856988778;252856988796;18;2,9;2;1;1
252856988796;252856988797;1;2,9;2;1;1
252856988797;252856988801;4;2,9;2;1;1
252856988801;252856988816;15;2,9;2;1;1
252856988816;252856988818;2;2,9;2;1;1
252856988818;252856988824;6;2,9;2;1;1
252856988824;252856988829;5;2,9;2;1;1
252856988829;252856988835;6;2,9;2;1;1
252856988835;252856988859;24;2,9;2;1;1
252856988859;252856988868;9;2,9;2;1;1
252856988868;252856988895;27;2,9;2;1;1
252856988895;252856988908;13;2,9;2;1;1
252856988908;252856988934;26;2,9;2;1;1
252856988934;252856988935;1;2,9;2;1;1
252856988935;252856988954;19;2,9;2;1;1
252856988954;252856988990;36;2,9;2;1;1
252856988990;252856989025;35;2,9;2;1;1
252856989025;252856989054;29;2,9;2;1;1
252856989054;252856989059;5;2,9;2;1;1
252856989059;252856989083;24;2,9;2;1;1
252856989083;252856989087;4;2,9;2;1;1
252856989087;252856989093;6;2,9;2;1;1
252856989093;252856989114;21;2,9;2;1;1
252856989114;252856989124;10;2,9;2;1;1
252856989124;252856989142;18;2,9;2;1;1
252856989142;252856989160;18;2,9;2;1;1
252856989160;252856989175;15;2,9;2;1;1
252856989175;252856989191;16;2,9;2;1;1
252856989191;252856989205;14;2,9;2;1;1
252856989205;252856989216;11;2,9;2;1;1
252856989216;252856989220;4;2,9;2;1;1
252856989220;252856989243;23;2,9;2;1;1
252856989243;252856989261;18;2,9;2;1;1
252856989261;252856989287;26;2,9;2;1;1
252856989287;252856989376;89;2,9;2;1;1
252856989376;252856989394;18;2,9;2;1;1
252856989394;252856989422;28;2,9;2;1;1
252856989422;252856989455;33;2,9;2;1;1
252856989455;252856989481;26;2,9;2;1;1
252856989481;252856989523;42;2,9;2;1;1
252856989523;252856989546;23;2,9;2;1;1
252856989546;252856989646;100;2,9;2;1;1
252856989646;252856989665;19;2,9;2;1;1
252856989665;252856989705;40;2,9;2;1;1
252856989705;252856989755;50;2,9;2;1;1
252856989755;252856989774;19;2,9;2;1;1
252856989774;252856989804;30;2,9;2;1;1
252856989804;252856989864;60;2,9;2;1;1
252856989864;252856989901;37;2,9;2;1;1
252856989901;252856989978;77;2,9;2;1;1
252856989978;252856990009;31;2,9;2;1;1
252856990009;252856990011;2;2,9;2;1;1
252856990011;252856990038;27;2,9;2;1;1
252856990038;252856990086;48;2,9;2;1;1
252856990086;252856990942;856;2,9;2;1;1
252856990942;252856990971;29;2,9;2;1;1
252856990971;252856991078;107;2,9;2;1;1
252856991078;252856991178;100;2,9;2;1;1
252856991178;252856991218;40;2,9;2;1;1
252856991218;252856991245;27;2,9;2;1;1
252856991245;252856991288;43;2,9;2;1;1
252856991288;252856991350;62;2,9;2;1;1
252856991350;252856991378;28;2,9;2;1;1
252856991378;252856991402;24;2,9;2;1;1
252856991402;252856991428;26;2,9;2;1;1
252856991428;252856991648;220;2,9;2;1;1
252856991648;252856991690;42;2,9;2;1;1
252856991690;252856991721;31;2,9;2;1;1
252856991721;252856991774;53;2,9;2;1;1
252856991774;252856991806;32;2,9;2;1;1
252856991806;252856991862;56;2,9;2;1;1
252856991862;252856991889;27;2,9;2;1;1
252856991889;252856991918;29;2,9;2;1;1
252856991918;252857000692;8774;2,9;2;1;1
252857000692;252857000732;40;2,9;2;1;1
252857000732;252857000780;48;2,9;2;1;1
252857000780;252857001057;277;2,9;2;1;1
252857001057;252857004387;3330;2,9;2;1;1
252857004387;252857004675;288;2,9;2;1;1
252857004675;252857005017;342;2,9;2;1;1
252857005017;252857005183;166;2,9;2;1;1
252857005183;252857005321;138;2,9;2;1;1
252857005321;252857005359;38;2,9;2;1;1
252857005359;252857005412;53;2,9;2;1;1
252857005412;252857005492;80;2,9;2;1;1
252857005492;252857005536;44;2,9;2;1;1
252857005536;252857005719;183;2,9;2;1;1
252857005719;252857005759;40;2,9;2;1;1
252857005759;252857005806;47;2,9;2;1;1
252857005806;252857005834;28;2,9;2;1;1
252857005834;252857005879;45;2,9;2;1;1
252857005879;252857005921;42;2,9;2;1;1
252857005921;252857005960;39;2,9;2;1;1
252857005960;252857005991;31;2,9;2;1;1
252857005991;252857006034;43;2,9;2;1;1
252857006034;252857006199;165;2,9;2;1;1
252857006199;252857006243;44;2,9;2;1;1
252857006243;252857006283;40;2,9;2;1;1
252857006283;252857006328;45;2,9;2;1;1
252857006328;252857006395;67;2,9;2;1;1
252857006395;252857006432;37;2,9;2;1;1
252857006432;252857006479;47;2,9;2;1;1
252857006479;252857007016;537;2,9;2;1;1
252857007016;252857007666;650;2,9;2;1;1
252857007666;252857007743;77;2,9;2;1;1
252857007743;252857007771;28;2,9;2;1;1
252857007771;252857008344;573;2,9;2;1;1
252857008344;252857008441;97;2,9;2;1;1
252857008441;252857008509;68;2,9;2;1;1
252857008509;252857008550;41;2,9;2;1;1
252857008550;252857008565;15;2,9;2;1;1
252857008565;252857008619;54;2,9;2;1;1
252857008619;252857008673;54;2,9;2;1;1
252857008673;252857008728;55;2,9;2;1;1
252857008728;252857008782;54;2,9;2;1;1
252857008782;252857008835;53;2,9;2;1;1
252857008835;252857008890;55;2,9;2;1;1
252857008890;252857008946;56;2,9;2;1;1
252857008946;252857009004;58;2,9;2;1;1
252857009004;252857009103;99;2,9;2;1;1
252857009103;252857009155;52;2,9;2;1;1
252857009155;252857009205;50;2,9;2;1;1
252857009205;252857044593;35388;2,9;2;1;1
252857044593;252857044916;323;2,9;2;1;1
252857044916;252857045060;144;2,9;2;1;1
252857045060;252857045167;107;2,9;2;1;1
252857045167;252857045256;89;2,9;2;1;1
252857045256;252857045352;96;2,9;2;1;1
252857045352;252857045405;53;2,9;2;1;1
252857045405;252857045622;217;2,9;2;1;1
252857045622;252857045765;143;2,9;2;1;1
252857045765;252857046004;239;2,9;2;1;1
252857046004;252857046238;234;2,9;2;1;1
252857046238;252857046296;58;2,9;2;1;1
252857046296;252857046437;141;2,9;2;1;1
252857046437;252857046778;341;2,9;2;1;1
252857046778;252857046959;181;2,9;2;1;1
252857046959;252857047312;353;2,9;2;1;1
252857047312;252857047500;188;2,9;2;1;1
252857047500;252857047537;37;2,9;2;1;1
252857047537;252857047587;50;2,9;2;1;1
252857047587;252857047642;55;2,9;2;1;1
252857047642;252857047679;37;2,9;2;1;1
252857047679;252857048101;422;2,9;2;1;1
252857048101;252857048230;129;2,9;2;1;1
252857048230;252857048281;51;2,9;2;1;1
252857048281;252857048349;68;2,9;2;1;1
252857048349;252857048379;30;2,9;2;1;1
252857048379;252857048415;36;2,9;2;1;1
252857048415;252857048563;148;2,9;2;1;1
252857048563;252857048689;126;2,9;2;1;1
252857048689;252857048723;34;2,9;2;1;1
252857048723;252857048903;180;2,9;2;1;1
252857048903;252857048991;88;2,9;2;1;1
252857048991;252857049097;106;2,9;2;1;1
252857049097;252857049189;92;2,9;2;1;1
252857049189;252857049225;36;2,9;2;1;1
252857049225;252857049340;115;2,9;2;1;1
252857049340;252857049452;112;2,9;2;1;1
252857049452;252857049740;288;2,9;2;1;1
252857049740;252857049834;94;2,9;2;1;1
252857049834;252857049870;36;2,9;2;1;1
252857049870;252857049933;63;2,9;2;1;1
252857049933;252857049967;34;2,9;2;1;1
252857049967;252857050210;243;2,9;2;1;1
252857050210;252857050307;97;2,9;2;1;1
252857050307;252857050950;643;2,9;2;1;1
252857050950;252857051142;192;2,9;2;1;1
252857051142;252857051338;196;2,9;2;1;1
252857051338;252857051606;268;2,9;2;1;1
252857051606;252857051795;189;2,9;2;1;1
252857051795;252857052063;268;2,9;2;1;1
252857052063;252857052157;94;2,9;2;1;1
252857052157;252857052254;97;2,9;2;1;1
252857052254;252857052311;57;2,9;2;1;1
252857052311;252857052346;35;2,9;2;1;1
252857052346;252857052411;65;2,9;2;1;1
252857052411;252857052482;71;2,9;2;1;1
252857052482;252857052539;57;2,9;2;1;1
252857052539;252857052626;87;2,9;2;1;1
252857052626;252857052664;38;2,9;2;1;1
252857052664;252857052765;101;2,9;2;1;1
252857052765;252857052839;74;2,9;2;1;1
252857052839;252857052877;38;2,9;2;1;1
252857052877;252857052939;62;2,9;2;1;1
252857052939;252857052976;37;2,9;2;1;1
252857052976;252857063308;10332;2,9;2;1;1
252857063308;252857063466;158;2,9;2;1;1
252857063466;252857063720;254;2,9;2;1;1
252857063720;252857063729;9;2,9;2;1;1
252857063729;252857063758;29;2,9;2;1;1
252857063758;252857064098;340;2,9;2;1;1
252857064098;252857064292;194;2,9;2;1;1
252857064292;252857064297;5;2,9;2;1;1
252857064297;252857064304;7;2,9;2;1;1
252857064304;252857064333;29;2,9;2;1;1
252857064333;252857064354;21;2,9;2;1;1
252857064354;252857064379;25;2,9;2;1;1
252857064379;252857064445;66;2,9;2;1;1
252857064445;252857064502;57;2,9;2;1;1
252857064502;252857064540;38;2,9;2;1;1
252857064540;252857064551;11;2,9;2;1;1
252857064551;252857064571;20;2,9;2;1;1
252857064571;252857064583;12;2,9;2;1;1
252857064583;252857064589;6;2,9;2;1;1
252857064589;252857064622;33;2,9;2;1;1
252857064622;252857064641;19;2,9;2;1;1
252857064641;252857064642;1;2,9;2;1;1
252857064642;252857064671;29;2,9;2;1;1
252857064671;252857064689;18;2,9;2;1;1
252857064689;252857064726;37;2,9;2;1;1
252857064726;252857064731;5;2,9;2;1;1
252857064731;252857064762;31;2,9;2;1;1
252857064762;252857064768;6;2,9;2;1;1
252857064768;252857064792;24;2,9;2;1;1
252857064792;252857064793;1;2,9;2;1;1
252857064793;252857064809;16;2,9;2;1;1
252857064809;252857064828;19;2,9;2;1;1
252857064828;252857064842;14;2,9;2;1;1
252857064842;252857064844;2;2,9;2;1;1
252857064844;252857064862;18;2,9;2;1;1
252857064862;252857064868;6;2,9;2;1;1
252857064868;252857064892;24;2,9;2;1;1
252857064892;252857064904;12;2,9;2;1;1
252857064904;252857064936;32;2,9;2;1;1
252857064936;252857064977;41;2,9;2;1;1
252857064977;252857064987;10;2,9;2;1;1
252857064987;252857065040;53;2,9;2;1;1
252857065040;252857065073;33;2,9;2;1;1
252857065073;252857065095;22;2,9;2;1;1
252857065095;252857065098;3;2,9;2;1;1
252857065098;252857065108;10;2,9;2;1;1
252857065108;252857065114;6;2,9;2;1;1
252857065114;252857065137;23;2,9;2;1;1
252857065137;252857065197;60;2,9;2;1;1
252857065197;252857065248;51;2,9;2;1;1
252857065248;252857065257;9;2,9;2;1;1
252857065257;252857065276;19;2,9;2;1;1
252857065276;252857065296;20;2,9;2;1;1
252857065296;252857065332;36;2,9;2;1;1
252857065332;252857065344;12;2,9;2;1;1
252857065344;252857065348;4;2,9;2;1;1
252857065348;252857065371;23;2,9;2;1;1
252857065371;252857065397;26;2,9;2;1;1
252857065397;252857065403;6;2,9;2;1;1
252857065403;252857065458;55;2,9;2;1;1
252857065458;252857065467;9;2,9;2;1;1
252857065467;252857065485;18;2,9;2;1;1
252857065485;252857065495;10;2,9;2;1;1
252857065495;252857065505;10;2,9;2;1;1
252857065505;252857065506;1;2,9;2;1;1
252857065506;252857065526;20;2,9;2;1;1
252857065526;252857065535;9;2,9;2;1;1
252857065535;252857065585;50;2,9;2;1;1
252857065585;252857065600;15;2,9;2;1;1
252857065600;252857065611;11;2,9;2;1;1
252857065611;252857065629;18;2,9;2;1;1
252857065629;252857065658;29;2,9;2;1;1
252857065658;252857065660;2;2,9;2;1;1
252857065660;252857065672;12;2,9;2;1;1
252857065672;252857065816;144;2,9;2;1;1
252857065816;252857065855;39;2,9;2;1;1
252857065855;252857065872;17;2,9;2;1;1
252857065872;252857065896;24;2,9;2;1;1
252857065896;252857065932;36;2,9;2;1;1
252857065932;252857065953;21;2,9;2;1;1
252857065953;252857065990;37;2,9;2;1;1
252857065990;252857066032;42;2,9;2;1;1
252857066032;252857066069;37;2,9;2;1;1
252857066069;252857066156;87;2,9;2;1;1
252857066156;252857066194;38;2,9;2;1;1
252857066194;252857066200;6;2,9;2;1;1
252857066200;252857066206;6;2,9;2;1;1
252857066206;252857066225;19;2,9;2;1;1
252857066225;252857066226;1;2,9;2;1;1
252857066226;252857066227;1;2,9;2;1;1
252857066227;252857066232;5;2,9;2;1;1
252857066232;252857066245;13;2,9;2;1;1
252857066245;252857066249;4;2,9;2;1;1
252857066249;252857066279;30;2,9;2;1;1
252857066279;252857066286;7;2,9;2;1;1
252857066286;252857066295;9;2,9;2;1;1
252857066295;252857066356;61;2,9;2;1;1
252857066356;252857066362;6;2,9;2;1;1
252857066362;252857066382;20;2,9;2;1;1
252857066382;252857066387;5;2,9;2;1;1
252857066387;252857066403;16;2,9;2;1;1
252857066403;252857066426;23;2,9;2;1;1
252857066426;252857066428;2;2,9;2;1;1
252857066428;252857066439;11;2,9;2;1;1
252857066439;252857066451;12;2,9;2;1;1
252857066451;252857066466;15;2,9;2;1;1
252857066466;252857066475;9;2,9;2;1;1
252857066475;252857066504;29;2,9;2;1;1
252857066504;252857066513;9;2,9;2;1;1
252857066513;252857066515;2;2,9;2;1;1
252857066515;252857066527;12;2,9;2;1;1
252857066527;252857066555;28;2,9;2;1;1
252857066555;252857066556;1;2,9;2;1;1
252857066556;252857066598;42;2,9;2;1;1
252857066598;252857066648;50;2,9;2;1;1
252857066648;252857066675;27;2,9;2;1;1
252857066675;252857066676;1;2,9;2;1;1
252857066676;252857066690;14;2,9;2;1;1
252857066690;252857066697;7;2,9;2;1;1
252857066697;252857066704;7;2,9;2;1;1
252857066704;252857066709;5;2,9;2;1;1
252857066709;252857066718;9;2,9;2;1;1
252857066718;252857066724;6;2,9;2;1;1
252857066724;252857066726;2;2,9;2;1;1
252857066726;252857066735;9;2,9;2;1;1
252857066735;252857066758;23;2,9;2;1;1
252857066758;252857066759;1;2,9;2;1;1
252857066759;252857066762;3;2,9;2;1;1
252857066762;252857066821;59;2,9;2;1;1
252857066821;252857066843;22;2,9;2;1;1
252857066843;252857066875;32;2,9;2;1;1
252857066875;252857066877;2;2,9;2;1;1
252857066877;252857066918;41;2,9;2;1;1
252857066918;252857066921;3;2,9;2;1;1
252857066921;252857066931;10;2,9;2;1;1
252857066931;252857066939;8;2,9;2;1;1
252857066939;252857066943;4;2,9;2;1;1
252857066943;252857066959;16;2,9;2;1;1
252857066959;252857066963;4;2,9;2;1;1
252857066963;252857066968;5;2,9;2;1;1
252857066968;252857066989;21;2,9;2;1;1
252857066989;252857066997;8;2,9;2;1;1
252857066997;252857067010;13;2,9;2;1;1
252857067010;252857067016;6;2,9;2;1;1
252857067016;252857067028;12;2,9;2;1;1
252857067028;252857067038;10;2,9;2;1;1
252857067038;252857067048;10;2,9;2;1;1
252857067048;252857067105;57;2,9;2;1;1
252857067105;252857067128;23;2,9;2;1;1
252857067128;252857067180;52;2,9;2;1;1
252857067180;252857067196;16;2,9;2;1;1
252857067196;252857067209;13;2,9;2;1;1
252857067209;252857067223;14;2,9;2;1;1
252857067223;252857067266;43;2,9;2;1;1
252857067266;252857067268;2;2,9;2;1;1
252857067268;252857067296;28;2,9;2;1;1
252857067296;252857067416;120;2,9;2;1;1
252857067416;252857067421;5;2,9;2;1;1
252857067421;252857067455;34;2,9;2;1;1
252857067455;252857067481;26;2,9;2;1;1
252857067481;252857067511;30;2,9;2;1;1
252857067511;252857067532;21;2,9;2;1;1
252857067532;252857067551;19;2,9;2;1;1
252857067551;252857067557;6;2,9;2;1;1
252857067557;252857067569;12;2,9;2;1;1
252857067569;252857067611;42;2,9;2;1;1
252857067611;252857067636;25;2,9;2;1;1
252857067636;252857067643;7;2,9;2;1;1
252857067643;252857067688;45;2,9;2;1;1
252857067688;252857067737;49;2,9;2;1;1
252857067737;252857067739;2;2,9;2;1;1
252857067739;252857067767;28;2,9;2;1;1
252857067767;252857067772;5;2,9;2;1;1
252857067772;252857067777;5;2,9;2;1;1
252857067777;252857067793;16;2,9;2;1;1
252857067793;252857067797;4;2,9;2;1;1
252857067797;252857067800;3;2,9;2;1;1
252857067800;252857067802;2;2,9;2;1;1
252857067802;252857067816;14;2,9;2;1;1
252857067816;252857067837;21;2,9;2;1;1
252857067837;252857067858;21;2,9;2;1;1
252857067858;252857067911;53;2,9;2;1;1
252857067911;252857067921;10;2,9;2;1;1
252857067921;252857067938;17;2,9;2;1;1
252857067938;252857067941;3;2,9;2;1;1
252857067941;252857067953;12;2,9;2;1;1
252857067953;252857067961;8;2,9;2;1;1
252857067961;252857067968;7;2,9;2;1;1
252857067968;252857067979;11;2,9;2;1;1
252857067979;252857068005;26;2,9;2;1;1
252857068005;252857068008;3;2,9;2;1;1
252857068008;252857068014;6;2,9;2;1;1
252857068014;252857068037;23;2,9;2;1;1
252857068037;252857068047;10;2,9;2;1;1
252857068047;252857068066;19;2,9;2;1;1
252857068066;252857068086;20;2,9;2;1;1
252857068086;252857068128;42;2,9;2;1;1
252857068128;252857068163;35;2,9;2;1;1
252857068163;252857068183;20;2,9;2;1;1
252857068183;252857068187;4;2,9;2;1;1
252857068187;252857068230;43;2,9;2;1;1
252857068230;252857068231;1;2,9;2;1;1
252857068231;252857068241;10;2,9;2;1;1
252857068241;252857068277;36;2,9;2;1;1
252857068277;252857068287;10;2,9;2;1;1
252857068287;252857068321;34;2,9;2;1;1
252857068321;252857068349;28;2,9;2;1;1
252857068349;252857068368;19;2,9;2;1;1
252857068368;252857068373;5;2,9;2;1;1
252857068373;252857068428;55;2,9;2;1;1
252857068428;252857068442;14;2,9;2;1;1
252857068442;252857068462;20;2,9;2;1;1
252857068462;252857068473;11;2,9;2;1;1
252857068473;252857068476;3;2,9;2;1;1
252857068476;252857068477;1;2,9;2;1;1
252857068477;252857068485;8;2,9;2;1;1
252857068485;252857068500;15;2,9;2;1;1
252857068500;252857068508;8;2,9;2;1;1
252857068508;252857068509;1;2,9;2;1;1
252857068509;252857068516;7;2,9;2;1;1
252857068516;252857068524;8;2,9;2;1;1
252857068524;252857068530;6;2,9;2;1;1
252857068530;252857068532;2;2,9;2;1;1
252857068532;252857068544;12;2,9;2;1;1
252857068544;252857068568;24;2,9;2;1;1
252857068568;252857068571;3;2,9;2;1;1
252857068571;252857068572;1;2,9;2;1;1
252857068572;252857068583;11;2,9;2;1;1
252857068583;252857068585;2;2,9;2;1;1
252857068585;252857068597;12;2,9;2;1;1
252857068597;252857068618;21;2,9;2;1;1
252857068618;252857068622;4;2,9;2;1;1
252857068622;252857068629;7;2,9;2;1;1
252857068629;252857068635;6;2,9;2;1;1
252857068635;252857068638;3;2,9;2;1;1
252857068638;252857068639;1;2,9;2;1;1
252857068639;252857068640;1;2,9;2;1;1
252857068640;252857068652;12;2,9;2;1;1
252857068652;252857068662;10;2,9;2;1;1
252857068662;252857068665;3;2,9;2;1;1
252857068665;252857068670;5;2,9;2;1;1
252857068670;252857068674;4;2,9;2;1;1
252857068674;252857068675;1;2,9;2;1;1
252857068675;252857068678;3;2,9;2;1;1
252857068678;252857068681;3;2,9;2;1;1
252857068681;252857068684;3;2,9;2;1;1
252857068684;252857068706;22;2,9;2;1;1
252857068706;252857068711;5;2,9;2;1;1
252857068711;252857068722;11;2,9;2;1;1
252857068722;252857068728;6;2,9;2;1;1
252857068728;252857068733;5;2,9;2;1;1
252857068733;252857068736;3;2,9;2;1;1
252857068736;252857068741;5;2,9;2;1;1
252857068741;252857068744;3;2,9;2;1;1
252857068744;252857068751;7;2,9;2;1;1
252857068751;252857068754;3;2,9;2;1;1
252857068754;252857068762;8;2,9;2;1;1
252857068762;252857068772;10;2,9;2;1;1
252857068772;252857068783;11;2,9;2;1;1
252857068783;252857068785;2;2,9;2;1;1
252857068785;252857068787;2;2,9;2;1;1
252857068787;252857068792;5;2,9;2;1;1
252857068792;252857068802;10;2,9;2;1;1
252857068802;252857068803;1;2,9;2;1;1
252857068803;252857068815;12;2,9;2;1;1
252857068815;252857068817;2;2,9;2;1;1
252857068817;252857068838;21;2,9;2;1;1
252857068838;252857068845;7;2,9;2;1;1
252857068845;252857068848;3;2,9;2;1;1
252857068848;252857068867;19;2,9;2;1;1
252857068867;252857068871;4;2,9;2;1;1
252857068871;252857068896;25;2,9;2;1;1
252857068896;252857068904;8;2,9;2;1;1
252857068904;252857068923;19;2,9;2;1;1
252857068923;252857068929;6;2,9;2;1;1
252857068929;252857068942;13;2,9;2;1;1
252857068942;252857068944;2;2,9;2;1;1
252857068944;252857068945;1;2,9;2;1;1
252857068945;252857068972;27;2,9;2;1;1
252857068972;252857068973;1;2,9;2;1;1
252857068973;252857068975;2;2,9;2;1;1
252857068975;252857068988;13;2,9;2;1;1
252857068988;252857068993;5;2,9;2;1;1
252857068993;252857068995;2;2,9;2;1;1
252857068995;252857068997;2;2,9;2;1;1
252857068997;252857069027;30;2,9;2;1;1
252857069027;252857069028;1;2,9;2;1;1
252857069028;252857069036;8;2,9;2;1;1
252857069036;252857069046;10;2,9;2;1;1
252857069046;252857069052;6;2,9;2;1;1
252857069052;252857069056;4;2,9;2;1;1
252857069056;252857069075;19;2,9;2;1;1
252857069075;252857069079;4;2,9;2;1;1
252857069079;252857069081;2;2,9;2;1;1
252857069081;252857069096;15;2,9;2;1;1
252857069096;252857069104;8;2,9;2;1;1
252857069104;252857069116;12;2,9;2;1;1
252857069116;252857069133;17;2,9;2;1;1
252857069133;252857069160;27;2,9;2;1;1
252857069160;252857069168;8;2,9;2;1;1
252857069168;252857069220;52;2,9;2;1;1
252857069220;252857069224;4;2,9;2;1;1
252857069224;252857069233;9;2,9;2;1;1
252857069233;252857069247;14;2,9;2;1;1
252857069247;252857069266;19;2,9;2;1;1
252857069266;252857069280;14;2,9;2;1;1
252857069280;252857069290;10;2,9;2;1;1
252857069290;252857069300;10;2,9;2;1;1
252857069300;252857069304;4;2,9;2;1;1
252857069304;252857069313;9;2,9;2;1;1
252857069313;252857069318;5;2,9;2;1;1
252857069318;252857069330;12;2,9;2;1;1
252857069330;252857069338;8;2,9;2;1;1
252857069338;252857069347;9;2,9;2;1;1
252857069347;252857069377;30;2,9;2;1;1
252857069377;252857069380;3;2,9;2;1;1
252857069380;252857069389;9;2,9;2;1;1
252857069389;252857069397;8;2,9;2;1;1
252857069397;252857069400;3;2,9;2;1;1
252857069400;252857069406;6;2,9;2;1;1
252857069406;252857069407;1;2,9;2;1;1
252857069407;252857069420;13;2,9;2;1;1
252857069420;252857069421;1;2,9;2;1;1
252857069421;252857069431;10;2,9;2;1;1
252857069431;252857069435;4;2,9;2;1;1
252857069435;252857069474;39;2,9;2;1;1
252857069474;252857069510;36;2,9;2;1;1
252857069510;252857069514;4;2,9;2;1;1
252857069514;252857069519;5;2,9;2;1;1
252857069519;252857069522;3;2,9;2;1;1
252857069522;252857069530;8;2,9;2;1;1
252857069530;252857069542;12;2,9;2;1;1
252857069542;252857069554;12;2,9;2;1;1
252857069554;252857069557;3;2,9;2;1;1
252857069557;252857069565;8;2,9;2;1;1
252857069565;252857069569;4;2,9;2;1;1
252857069569;252857069579;10;2,9;2;1;1
252857069579;252857069581;2;2,9;2;1;1
252857069581;252857069600;19;2,9;2;1;1
252857069600;252857069606;6;2,9;2;1;1
252857069606;252857069626;20;2,9;2;1;1
252857069626;252857069635;9;2,9;2;1;1
252857069635;252857069639;4;2,9;2;1;1
252857069639;252857069661;22;2,9;2;1;1
252857069661;252857069664;3;2,9;2;1;1
252857069664;252857069682;18;2,9;2;1;1
252857069682;252857069688;6;2,9;2;1;1
252857069688;252857069691;3;2,9;2;1;1
252857069691;252857069699;8;2,9;2;1;1
252857069699;252857069701;2;2,9;2;1;1
252857069701;252857069728;27;2,9;2;1;1
252857069728;252857069740;12;2,9;2;1;1
252857069740;252857069746;6;2,9;2;1;1
252857069746;252857069751;5;2,9;2;1;1
252857069751;252857069773;22;2,9;2;1;1
252857069773;252857069789;16;2,9;2;1;1
252857069789;252857069794;5;2,9;2;1;1
252857069794;252857069797;3;2,9;2;1;1
252857069797;252857069801;4;2,9;2;1;1
252857069801;252857069804;3;2,9;2;1;1
252857069804;252857069820;16;2,9;2;1;1
252857069820;252857069826;6;2,9;2;1;1
252857069826;252857069835;9;2,9;2;1;1
252857069835;252857069839;4;2,9;2;1;1
252857069839;252857069850;11;2,9;2;1;1
252857069850;252857069855;5;2,9;2;1;1
252857069855;252857069864;9;2,9;2;1;1
252857069864;252857069878;14;2,9;2;1;1
252857069878;252857069907;29;2,9;2;1;1
252857069907;252857069908;1;2,9;2;1;1
252857069908;252857069920;12;2,9;2;1;1
252857069920;252857069925;5;2,9;2;1;1
252857069925;252857069947;22;2,9;2;1;1
252857069947;252857069954;7;2,9;2;1;1
252857069954;252857069963;9;2,9;2;1;1
252857069963;252857069964;1;2,9;2;1;1
252857069964;252857069980;16;2,9;2;1;1
252857069980;252857069985;5;2,9;2;1;1
252857069985;252857069987;2;2,9;2;1;1
252857069987;252857069992;5;2,9;2;1;1
252857069992;252857070011;19;2,9;2;1;1
252857070011;252857070017;6;2,9;2;1;1
252857070017;252857070018;1;2,9;2;1;1
252857070018;252857070027;9;2,9;2;1;1
252857070027;252857070040;13;2,9;2;1;1
252857070040;252857070049;9;2,9;2;1;1
252857070049;252857070052;3;2,9;2;1;1
252857070052;252857070056;4;2,9;2;1;1
252857070056;252857070069;13;2,9;2;1;1
252857070069;252857070075;6;2,9;2;1;1
252857070075;252857070076;1;2,9;2;1;1
252857070076;252857070077;1;2,9;2;1;1
252857070077;252857070098;21;2,9;2;1;1
252857070098;252857070101;3;2,9;2;1;1
252857070101;252857070108;7;2,9;2;1;1
252857070108;252857070121;13;2,9;2;1;1
252857070121;252857070128;7;2,9;2;1;1
252857070128;252857070140;12;2,9;2;1;1
252857070140;252857070162;22;2,9;2;1;1
252857070162;252857070181;19;2,9;2;1;1
252857070181;252857070186;5;2,9;2;1;1
252857070186;252857070187;1;2,9;2;1;1
252857070187;252857070191;4;2,9;2;1;1
252857070191;252857070196;5;2,9;2;1;1
252857070196;252857070201;5;2,9;2;1;1
252857070201;252857070209;8;2,9;2;1;1
252857070209;252857070215;6;2,9;2;1;1
252857070215;252857070218;3;2,9;2;1;1
252857070218;252857070219;1;2,9;2;1;1
252857070219;252857070221;2;2,9;2;1;1
252857070221;252857070237;16;2,9;2;1;1
252857070237;252857070239;2;2,9;2;1;1
252857070239;252857070242;3;2,9;2;1;1
252857070242;252857070243;1;2,9;2;1;1
252857070243;252857070245;2;2,9;2;1;1
252857070245;252857070248;3;2,9;2;1;1
252857070248;252857070251;3;2,9;2;1;1
252857070251;252857070255;4;2,9;2;1;1
252857070255;252857070259;4;2,9;2;1;1
252857070259;252857070265;6;2,9;2;1;1
252857070265;252857070273;8;2,9;2;1;1
252857070273;252857070275;2;2,9;2;1;1
252857070275;252857070280;5;2,9;2;1;1
252857070280;252857070284;4;2,9;2;1;1
252857070284;252857070293;9;2,9;2;1;1
252857070293;252857070295;2;2,9;2;1;1
252857070295;252857070299;4;2,9;2;1;1
252857070299;252857070306;7;2,9;2;1;1
252857070306;252857070307;1;2,9;2;1;1
252857070307;252857070319;12;2,9;2;1;1
252857070319;252857070324;5;2,9;2;1;1
252857070324;252857070336;12;2,9;2;1;1
252857070336;252857070340;4;2,9;2;1;1
252857070340;252857070345;5;2,9;2;1;1
252857070345;252857070351;6;2,9;2;1;1
252857070351;252857070356;5;2,9;2;1;1
252857070356;252857070359;3;2,9;2;1;1
252857070359;252857070367;8;2,9;2;1;1
252857070367;252857070379;12;2,9;2;1;1
252857070379;252857070389;10;2,9;2;1;1
252857070389;252857070391;2;2,9;2;1;1
252857070391;252857070396;5;2,9;2;1;1
252857070396;252857070413;17;2,9;2;1;1
252857070413;252857070417;4;2,9;2;1;1
252857070417;252857070421;4;2,9;2;1;1
252857070421;252857070422;1;2,9;2;1;1
252857070422;252857070426;4;2,9;2;1;1
252857070426;252857070432;6;2,9;2;1;1
252857070432;252857070438;6;2,9;2;1;1
252857070438;252857070441;3;2,9;2;1;1
252857070441;252857070442;1;2,9;2;1;1
252857070442;252857070447;5;2,9;2;1;1
252857070447;252857070450;3;2,9;2;1;1
252857070450;252857070460;10;2,9;2;1;1
252857070460;252857070461;1;2,9;2;1;1
252857070461;252857070475;14;2,9;2;1;1
252857070475;252857070485;10;2,9;2;1;1
252857070485;252857070495;10;2,9;2;1;1
252857070495;252857070498;3;2,9;2;1;1
252857070498;252857070502;4;2,9;2;1;1
252857070502;252857070538;36;2,9;2;1;1
252857070538;252857070539;1;2,9;2;1;1
252857070539;252857070549;10;2,9;2;1;1
252857070549;252857070550;1;2,9;2;1;1
252857070550;252857070551;1;2,9;2;1;1
252857070551;252857070552;1;2,9;2;1;1
252857070552;252857070556;4;2,9;2;1;1
252857070556;252857070567;11;2,9;2;1;1
252857070567;252857070578;11;2,9;2;1;1
252857070578;252857070581;3;2,9;2;1;1
252857070581;252857070585;4;2,9;2;1;1
252857070585;252857070597;12;2,9;2;1;1
252857070597;252857070606;9;2,9;2;1;1
252857070606;252857070607;1;2,9;2;1;1
252857070607;252857070617;10;2,9;2;1;1
252857070617;252857070627;10;2,9;2;1;1
252857070627;252857070628;1;2,9;2;1;1
252857070628;252857070631;3;2,9;2;1;1
252857070631;252857070634;3;2,9;2;1;1
252857070634;252857070639;5;2,9;2;1;1
252857070639;252857070652;13;2,9;2;1;1
252857070652;252857070660;8;2,9;2;1;1
252857070660;252857070663;3;2,9;2;1;1
252857070663;252857070670;7;2,9;2;1;1
252857070670;252857070678;8;2,9;2;1;1
252857070678;252857070683;5;2,9;2;1;1
252857070683;252857070688;5;2,9;2;1;1
252857070688;252857070701;13;2,9;2;1;1
252857070701;252857070715;14;2,9;2;1;1
252857070715;252857070716;1;2,9;2;1;1
252857070716;252857070721;5;2,9;2;1;1
252857070721;252857070724;3;2,9;2;1;1
252857070724;252857070729;5;2,9;2;1;1
252857070729;252857070739;10;2,9;2;1;1
252857070739;252857070746;7;2,9;2;1;1
252857070746;252857070762;16;2,9;2;1;1
252857070762;252857070764;2;2,9;2;1;1
252857070764;252857070768;4;2,9;2;1;1
252857070768;252857070769;1;2,9;2;1;1
252857070769;252857070787;18;2,9;2;1;1
252857070787;252857070789;2;2,9;2;1;1
252857070789;252857070804;15;2,9;2;1;1
252857070804;252857070806;2;2,9;2;1;1
252857070806;252857070812;6;2,9;2;1;1
252857070812;252857070828;16;2,9;2;1;1
252857070828;252857070831;3;2,9;2;1;1
252857070831;252857070839;8;2,9;2;1;1
252857070839;252857070840;1;2,9;2;1;1
252857070840;252857070846;6;2,9;2;1;1
252857070846;252857070854;8;2,9;2;1;1
252857070854;252857070855;1;2,9;2;1;1
252857070855;252857070856;1;2,9;2;1;1
252857070856;252857070874;18;2,9;2;1;1
252857070874;252857070882;8;2,9;2;1;1
252857070882;252857070890;8;2,9;2;1;1
252857070890;252857070891;1;2,9;2;1;1
252857070891;252857070908;17;2,9;2;1;1
252857070908;252857070933;25;2,9;2;1;1
252857070933;252857070944;11;2,9;2;1;1
252857070944;252857070953;9;2,9;2;1;1
252857070953;252857070980;27;2,9;2;1;1
252857070980;252857070982;2;2,9;2;1;1
252857070982;252857070986;4;2,9;2;1;1
252857070986;252857071004;18;2,9;2;1;1
252857071004;252857071008;4;2,9;2;1;1
252857071008;252857071021;13;2,9;2;1;1
252857071021;252857071026;5;2,9;2;1;1
252857071026;252857071027;1;2,9;2;1;1
252857071027;252857071037;10;2,9;2;1;1
252857071037;252857071038;1;2,9;2;1;1
252857071038;252857071060;22;2,9;2;1;1
252857071060;252857071063;3;2,9;2;1;1
252857071063;252857071064;1;2,9;2;1;1
252857071064;252857071066;2;2,9;2;1;1
252857071066;252857071077;11;2,9;2;1;1
252857071077;252857071082;5;2,9;2;1;1
252857071082;252857071084;2;2,9;2;1;1
252857071084;252857071112;28;2,9;2;1;1
252857071112;252857071124;12;2,9;2;1;1
252857071124;252857071137;13;2,9;2;1;1
252857071137;252857071147;10;2,9;2;1;1
252857071147;252857071148;1;2,9;2;1;1
252857071148;252857071155;7;2,9;2;1;1
252857071155;252857071164;9;2,9;2;1;1
252857071164;252857071168;4;2,9;2;1;1
252857071168;252857071169;1;2,9;2;1;1
252857071169;252857071174;5;2,9;2;1;1
252857071174;252857071184;10;2,9;2;1;1
252857071184;252857071195;11;2,9;2;1;1
252857071195;252857071198;3;2,9;2;1;1
252857071198;252857071203;5;2,9;2;1;1
252857071203;252857071211;8;2,9;2;1;1
252857071211;252857071214;3;2,9;2;1;1
252857071214;252857071222;8;2,9;2;1;1
252857071222;252857071239;17;2,9;2;1;1
252857071239;252857071245;6;2,9;2;1;1
252857071245;252857071246;1;2,9;2;1;1
252857071246;252857071249;3;2,9;2;1;1
252857071249;252857071257;8;2,9;2;1;1
252857071257;252857071265;8;2,9;2;1;1
252857071265;252857071270;5;2,9;2;1;1
252857071270;252857071271;1;2,9;2;1;1
252857071271;252857071280;9;2,9;2;1;1
252857071280;252857071294;14;2,9;2;1;1
252857071294;252857071297;3;2,9;2;1;1
252857071297;252857071300;3;2,9;2;1;1
252857071300;252857071304;4;2,9;2;1;1
252857071304;252857071311;7;2,9;2;1;1
252857071311;252857071318;7;2,9;2;1;1
252857071318;252857071339;21;2,9;2;1;1
252857071339;252857071351;12;2,9;2;1;1
252857071351;252857071353;2;2,9;2;1;1
252857071353;252857071375;22;2,9;2;1;1
252857071375;252857071376;1;2,9;2;1;1
252857071376;252857071384;8;2,9;2;1;1
252857071384;252857071391;7;2,9;2;1;1
252857071391;252857071397;6;2,9;2;1;1
252857071397;252857071408;11;2,9;2;1;1
252857071408;252857071411;3;2,9;2;1;1
252857071411;252857071431;20;2,9;2;1;1
252857071431;252857071433;2;2,9;2;1;1
252857071433;252857071450;17;2,9;2;1;1
252857071450;252857071451;1;2,9;2;1;1
252857071451;252857071456;5;2,9;2;1;1
252857071456;252857071473;17;2,9;2;1;1
252857071473;252857071474;1;2,9;2;1;1
252857071474;252857071481;7;2,9;2;1;1
252857071481;252857071487;6;2,9;2;1;1
252857071487;252857071514;27;2,9;2;1;1
252857071514;252857071517;3;2,9;2;1;1
252857071517;252857071533;16;2,9;2;1;1
252857071533;252857071536;3;2,9;2;1;1
252857071536;252857071542;6;2,9;2;1;1
252857071542;252857071543;1;2,9;2;1;1
252857071543;252857071546;3;2,9;2;1;1
252857071546;252857071555;9;2,9;2;1;1
252857071555;252857071563;8;2,9;2;1;1
252857071563;252857071575;12;2,9;2;1;1
252857071575;252857071576;1;2,9;2;1;1
252857071576;252857071581;5;2,9;2;1;1
252857071581;252857071591;10;2,9;2;1;1
252857071591;252857071598;7;2,9;2;1;1
252857071598;252857071599;1;2,9;2;1;1
252857071599;252857071603;4;2,9;2;1;1
252857071603;252857071609;6;2,9;2;1;1
252857071609;252857071614;5;2,9;2;1;1
252857071614;252857071615;1;2,9;2;1;1
252857071615;252857071616;1;2,9;2;1;1
252857071616;252857071630;14;2,9;2;1;1
252857071630;252857071642;12;2,9;2;1;1
252857071642;252857071649;7;2,9;2;1;1
252857071649;252857071650;1;2,9;2;1;1
252857071650;252857071653;3;2,9;2;1;1
252857071653;252857071665;12;2,9;2;1;1
252857071665;252857071671;6;2,9;2;1;1
252857071671;252857071675;4;2,9;2;1;1
252857071675;252857071676;1;2,9;2;1;1
252857071676;252857071680;4;2,9;2;1;1
252857071680;252857071696;16;2,9;2;1;1
252857071696;252857071697;1;2,9;2;1;1
252857071697;252857071709;12;2,9;2;1;1
252857071709;252857071729;20;2,9;2;1;1
252857071729;252857071730;1;2,9;2;1;1
252857071730;252857071735;5;2,9;2;1;1
252857071735;252857071738;3;2,9;2;1;1
252857071738;252857071739;1;2,9;2;1;1
252857071739;252857071749;10;2,9;2;1;1
252857071749;252857071759;10;2,9;2;1;1
252857071759;252857071766;7;2,9;2;1;1
252857071766;252857071767;1;2,9;2;1;1
252857071767;252857071772;5;2,9;2;1;1
252857071772;252857071773;1;2,9;2;1;1
252857071773;252857071777;4;2,9;2;1;1
252857071777;252857071807;30;2,9;2;1;1
252857071807;252857071816;9;2,9;2;1;1
252857071816;252857071818;2;2,9;2;1;1
252857071818;252857071819;1;2,9;2;1;1
252857071819;252857071826;7;2,9;2;1;1
252857071826;252857071827;1;2,9;2;1;1
252857071827;252857071837;10;2,9;2;1;1
252857071837;252857071847;10;2,9;2;1;1
252857071847;252857071850;3;2,9;2;1;1
252857071850;252857071851;1;2,9;2;1;1
252857071851;252857071853;2;2,9;2;1;1
252857071853;252857071855;2;2,9;2;1;1
252857071855;252857071866;11;2,9;2;1;1
252857071866;252857071877;11;2,9;2;1;1
252857071877;252857071884;7;2,9;2;1;1
252857071884;252857071888;4;2,9;2;1;1
252857071888;252857071892;4;2,9;2;1;1
252857071892;252857071900;8;2,9;2;1;1
252857071900;252857071906;6;2,9;2;1;1
252857071906;252857071913;7;2,9;2;1;1
252857071913;252857071915;2;2,9;2;1;1
252857071915;252857071916;1;2,9;2;1;1
252857071916;252857071920;4;2,9;2;1;1
252857071920;252857071925;5;2,9;2;1;1
252857071925;252857071928;3;2,9;2;1;1
252857071928;252857071930;2;2,9;2;1;1
252857071930;252857071934;4;2,9;2;1;1
252857071934;252857071939;5;2,9;2;1;1
252857071939;252857071945;6;2,9;2;1;1
252857071945;252857071947;2;2,9;2;1;1
252857071947;252857071952;5;2,9;2;1;1
252857071952;252857071955;3;2,9;2;1;1
252857071955;252857071965;10;2,9;2;1;1
252857071965;252857071969;4;2,9;2;1;1
252857071969;252857071972;3;2,9;2;1;1
252857071972;252857071974;2;2,9;2;1;1
252857071974;252857071979;5;2,9;2;1;1
252857071979;252857071980;1;2,9;2;1;1
252857071980;252857071982;2;2,9;2;1;1
252857071982;252857071989;7;2,9;2;1;1
252857071989;252857072004;15;2,9;2;1;1
252857072004;252857072010;6;2,9;2;1;1
252857072010;252857072015;5;2,9;2;1;1
252857072015;252857072016;1;2,9;2;1;1
252857072016;252857072017;1;2,9;2;1;1
252857072017;252857072021;4;2,9;2;1;1
252857072021;252857072024;3;2,9;2;1;1
252857072024;252857072027;3;2,9;2;1;1
252857072027;252857072031;4;2,9;2;1;1
252857072031;252857072032;1;2,9;2;1;1
252857072032;252857072039;7;2,9;2;1;1
252857072039;252857072041;2;2,9;2;1;1
252857072041;252857072044;3;2,9;2;1;1
252857072044;252857072045;1;2,9;2;1;1
252857072045;252857072048;3;2,9;2;1;1
252857072048;252857072054;6;2,9;2;1;1
252857072054;252857072063;9;2,9;2;1;1
252857072063;252857072066;3;2,9;2;1;1
252857072066;252857072070;4;2,9;2;1;1
252857072070;252857072071;1;2,9;2;1;1
252857072071;252857072078;7;2,9;2;1;1
252857072078;252857072080;2;2,9;2;1;1
252857072080;252857072094;14;2,9;2;1;1
252857072094;252857072097;3;2,9;2;1;1
252857072097;252857072100;3;2,9;2;1;1
252857072100;252857072103;3;2,9;2;1;1
252857072103;252857072119;16;2,9;2;1;1
252857072119;252857072125;6;2,9;2;1;1
252857072125;252857072131;6;2,9;2;1;1
252857072131;252857072133;2;2,9;2;1;1
252857072133;252857072134;1;2,9;2;1;1
252857072134;252857072150;16;2,9;2;1;1
252857072150;252857072154;4;2,9;2;1;1
252857072154;252857072161;7;2,9;2;1;1
252857072161;252857072180;19;2,9;2;1;1
252857072180;252857072188;8;2,9;2;1;1
252857072188;252857072195;7;2,9;2;1;1
252857072195;252857072196;1;2,9;2;1;1
252857072196;252857072202;6;2,9;2;1;1
252857072202;252857072208;6;2,9;2;1;1
252857072208;252857072212;4;2,9;2;1;1
252857072212;252857072214;2;2,9;2;1;1
252857072214;252857072215;1;2,9;2;1;1
252857072215;252857072222;7;2,9;2;1;1
252857072222;252857072228;6;2,9;2;1;1
252857072228;252857072237;9;2,9;2;1;1
252857072237;252857072243;6;2,9;2;1;1
252857072243;252857072247;4;2,9;2;1;1
252857072247;252857072248;1;2,9;2;1;1
252857072248;252857072249;1;2,9;2;1;1
252857072249;252857072251;2;2,9;2;1;1
252857072251;252857072252;1;2,9;2;1;1
252857072252;252857072259;7;2,9;2;1;1
252857072259;252857072269;10;2,9;2;1;1
252857072269;252857072271;2;2,9;2;1;1
252857072271;252857072273;2;2,9;2;1;1
252857072273;252857072275;2;2,9;2;1;1
252857072275;252857072280;5;2,9;2;1;1
252857072280;252857072281;1;2,9;2;1;1
252857072281;252857072297;16;2,9;2;1;1
252857072297;252857072298;1;2,9;2;1;1
252857072298;252857072303;5;2,9;2;1;1
252857072303;252857072311;8;2,9;2;1;1
252857072311;252857072312;1;2,9;2;1;1
252857072312;252857072313;1;2,9;2;1;1
252857072313;252857072314;1;2,9;2;1;1
252857072314;252857072329;15;2,9;2;1;1
252857072329;252857072331;2;2,9;2;1;1
252857072331;252857072339;8;2,9;2;1;1
252857072339;252857072340;1;2,9;2;1;1
252857072340;252857072342;2;2,9;2;1;1
252857072342;252857072353;11;2,9;2;1;1
252857072353;252857072357;4;2,9;2;1;1
252857072357;252857072386;29;2,9;2;1;1
252857072386;252857072398;12;2,9;2;1;1
252857072398;252857072399;1;2,9;2;1;1
252857072399;252857072404;5;2,9;2;1;1
252857072404;252857072410;6;2,9;2;1;1
252857072410;252857072422;12;2,9;2;1;1
252857072422;252857072425;3;2,9;2;1;1
252857072425;252857072436;11;2,9;2;1;1
252857072436;252857072446;10;2,9;2;1;1
252857072446;252857072462;16;2,9;2;1;1
252857072462;252857072463;1;2,9;2;1;1
252857072463;252857072485;22;2,9;2;1;1
252857072485;252857072495;10;2,9;2;1;1
252857072495;252857072496;1;2,9;2;1;1
252857072496;252857072516;20;2,9;2;1;1
252857072516;252857072517;1;2,9;2;1;1
252857072517;252857072528;11;2,9;2;1;1
252857072528;252857072545;17;2,9;2;1;1
252857072545;252857072558;13;2,9;2;1;1
252857072558;252857072564;6;2,9;2;1;1
252857072564;252857072567;3;2,9;2;1;1
252857072567;252857072583;16;2,9;2;1;1
252857072583;252857072584;1;2,9;2;1;1
252857072584;252857072587;3;2,9;2;1;1
252857072587;252857072598;11;2,9;2;1;1
252857072598;252857072606;8;2,9;2;1;1
252857072606;252857072611;5;2,9;2;1;1
252857072611;252857072614;3;2,9;2;1;1
252857072614;252857072617;3;2,9;2;1;1
252857072617;252857072618;1;2,9;2;1;1
252857072618;252857072619;1;2,9;2;1;1
252857072619;252857072628;9;2,9;2;1;1
252857072628;252857072629;1;2,9;2;1;1
252857072629;252857072632;3;2,9;2;1;1
252857072632;252857072643;11;2,9;2;1;1
252857072643;252857072646;3;2,9;2;1;1
252857072646;252857072648;2;2,9;2;1;1
252857072648;252857072660;12;2,9;2;1;1
252857072660;252857072661;1;2,9;2;1;1
252857072661;252857072668;7;2,9;2;1;1
252857072668;252857072671;3;2,9;2;1;1
252857072671;252857072672;1;2,9;2;1;1
252857072672;252857072677;5;2,9;2;1;1
252857072677;252857072680;3;2,9;2;1;1
252857072680;252857072686;6;2,9;2;1;1
252857072686;252857072692;6;2,9;2;1;1
252857072692;252857072694;2;2,9;2;1;1
252857072694;252857072698;4;2,9;2;1;1
252857072698;252857072702;4;2,9;2;1;1
252857072702;252857072705;3;2,9;2;1;1
252857072705;252857072725;20;2,9;2;1;1
252857072725;252857072726;1;2,9;2;1;1
252857072726;252857072731;5;2,9;2;1;1
252857072731;252857072736;5;2,9;2;1;1
252857072736;252857072740;4;2,9;2;1;1
252857072740;252857072744;4;2,9;2;1;1
252857072744;252857072756;12;2,9;2;1;1
252857072756;252857072758;2;2,9;2;1;1
252857072758;252857072766;8;2,9;2;1;1
252857072766;252857072780;14;2,9;2;1;1
252857072780;252857072781;1;2,9;2;1;1
252857072781;252857072782;1;2,9;2;1;1
252857072782;252857072790;8;2,9;2;1;1
252857072790;252857072792;2;2,9;2;1;1
252857072792;252857072793;1;2,9;2;1;1
252857072793;252857072794;1;2,9;2;1;1
252857072794;252857072798;4;2,9;2;1;1
252857072798;252857072801;3;2,9;2;1;1
252857072801;252857072802;1;2,9;2;1;1
252857072802;252857072812;10;2,9;2;1;1
252857072812;252857072817;5;2,9;2;1;1
252857072817;252857072819;2;2,9;2;1;1
252857072819;252857072826;7;2,9;2;1;1
252857072826;252857072830;4;2,9;2;1;1
252857072830;252857072833;3;2,9;2;1;1
252857072833;252857072842;9;2,9;2;1;1
252857072842;252857072855;13;2,9;2;1;1
252857072855;252857072856;1;2,9;2;1;1
252857072856;252857072865;9;2,9;2;1;1
252857072865;252857072867;2;2,9;2;1;1
252857072867;252857072871;4;2,9;2;1;1
252857072871;252857072881;10;2,9;2;1;1
252857072881;252857072882;1;2,9;2;1;1
252857072882;252857072891;9;2,9;2;1;1
252857072891;252857072893;2;2,9;2;1;1
252857072893;252857072901;8;2,9;2;1;1
252857072901;252857072902;1;2,9;2;1;1
252857072902;252857072905;3;2,9;2;1;1
252857072905;252857072907;2;2,9;2;1;1
252857072907;252857072910;3;2,9;2;1;1
252857072910;252857072917;7;2,9;2;1;1
252857072917;252857072927;10;2,9;2;1;1
252857072927;252857072936;9;2,9;2;1;1
252857072936;252857072937;1;2,9;2;1;1
252857072937;252857072945;8;2,9;2;1;1
252857072945;252857072948;3;2,9;2;1;1
252857072948;252857072959;11;2,9;2;1;1
252857072959;252857072970;11;2,9;2;1;1
252857072970;252857072977;7;2,9;2;1;1
252857072977;252857072979;2;2,9;2;1;1
252857072979;252857072980;1;2,9;2;1;1
252857072980;252857072983;3;2,9;2;1;1
252857072983;252857072985;2;2,9;2;1;1
252857072985;252857072987;2;2,9;2;1;1
252857072987;252857072988;1;2,9;2;1;1
252857072988;252857073012;24;2,9;2;1;1
252857073012;252857073014;2;2,9;2;1;1
252857073014;252857073015;1;2,9;2;1;1
252857073015;252857073026;11;2,9;2;1;1
252857073026;252857073027;1;2,9;2;1;1
252857073027;252857073031;4;2,9;2;1;1
252857073031;252857073034;3;2,9;2;1;1
252857073034;252857073040;6;2,9;2;1;1
252857073040;252857073043;3;2,9;2;1;1
252857073043;252857073053;10;2,9;2;1;1
252857073053;252857073054;1;2,9;2;1;1
252857073054;252857073056;2;2,9;2;1;1
252857073056;252857073062;6;2,9;2;1;1
252857073062;252857073063;1;2,9;2;1;1
252857073063;252857073066;3;2,9;2;1;1
252857073066;252857073081;15;2,9;2;1;1
252857073081;252857073086;5;2,9;2;1;1
252857073086;252857073087;1;2,9;2;1;1
252857073087;252857073096;9;2,9;2;1;1
252857073096;252857073103;7;2,9;2;1;1
252857073103;252857073107;4;2,9;2;1;1
252857073107;252857073109;2;2,9;2;1;1
252857073109;252857073122;13;2,9;2;1;1
252857073122;252857073132;10;2,9;2;1;1
252857073132;252857073134;2;2,9;2;1;1
252857073134;252857073135;1;2,9;2;1;1
252857073135;252857073149;14;2,9;2;1;1
252857073149;252857073156;7;2,9;2;1;1
252857073156;252857073159;3;2,9;2;1;1
252857073159;252857073163;4;2,9;2;1;1
252857073163;252857073166;3;2,9;2;1;1
252857073166;252857073168;2;2,9;2;1;1
252857073168;252857073175;7;2,9;2;1;1
252857073175;252857073176;1;2,9;2;1;1
252857073176;252857073184;8;2,9;2;1;1
252857073184;252857073192;8;2,9;2;1;1
252857073192;252857073201;9;2,9;2;1;1
252857073201;252857073205;4;2,9;2;1;1
252857073205;252857073214;9;2,9;2;1;1
252857073214;252857073217;3;2,9;2;1;1
252857073217;252857073223;6;2,9;2;1;1
252857073223;252857073224;1;2,9;2;1;1
252857073224;252857073231;7;2,9;2;1;1
252857073231;252857073233;2;2,9;2;1;1
252857073233;252857073244;11;2,9;2;1;1
252857073244;252857073245;1;2,9;2;1;1
252857073245;252857073246;1;2,9;2;1;1
252857073246;252857073264;18;2,9;2;1;1
252857073264;252857073267;3;2,9;2;1;1
252857073267;252857073272;5;2,9;2;1;1
252857073272;252857073275;3;2,9;2;1;1
252857073275;252857073287;12;2,9;2;1;1
252857073287;252857073288;1;2,9;2;1;1
252857073288;252857073296;8;2,9;2;1;1
252857073296;252857073298;2;2,9;2;1;1
252857073298;252857073306;8;2,9;2;1;1
252857073306;252857073317;11;2,9;2;1;1
252857073317;252857073322;5;2,9;2;1;1
252857073322;252857073325;3;2,9;2;1;1
252857073325;252857073327;2;2,9;2;1;1
252857073327;252857073334;7;2,9;2;1;1
252857073334;252857073336;2;2,9;2;1;1
252857073336;252857073347;11;2,9;2;1;1
252857073347;252857073351;4;2,9;2;1;1
252857073351;252857073352;1;2,9;2;1;1
252857073352;252857073358;6;2,9;2;1;1
252857073358;252857073365;7;2,9;2;1;1
252857073365;252857073369;4;2,9;2;1;1
252857073369;252857073392;23;2,9;2;1;1
252857073392;252857073395;3;2,9;2;1;1
252857073395;252857073400;5;2,9;2;1;1
252857073400;252857073403;3;2,9;2;1;1
252857073403;252857073415;12;2,9;2;1;1
252857073415;252857073427;12;2,9;2;1;1
252857073427;252857073428;1;2,9;2;1;1
252857073428;252857073435;7;2,9;2;1;1
252857073435;252857073440;5;2,9;2;1;1
252857073440;252857073443;3;2,9;2;1;1
252857073443;252857073453;10;2,9;2;1;1
252857073453;252857073465;12;2,9;2;1;1
252857073465;252857073469;4;2,9;2;1;1
252857073469;252857073484;15;2,9;2;1;1
252857073484;252857073485;1;2,9;2;1;1
252857073485;252857073494;9;2,9;2;1;1
252857073494;252857073517;23;2,9;2;1;1
252857073517;252857073522;5;2,9;2;1;1
252857073522;252857073531;9;2,9;2;1;1
252857073531;252857073552;21;2,9;2;1;1
252857073552;252857073569;17;2,9;2;1;1
252857073569;252857073570;1;2,9;2;1;1
252857073570;252857073573;3;2,9;2;1;1
252857073573;252857073574;1;2,9;2;1;1
252857073574;252857073585;11;2,9;2;1;1
252857073585;252857073604;19;2,9;2;1;1
252857073604;252857073610;6;2,9;2;1;1
252857073610;252857073611;1;2,9;2;1;1
252857073611;252857073622;11;2,9;2;1;1
252857073622;252857073624;2;2,9;2;1;1
252857073624;252857073640;16;2,9;2;1;1
252857073640;252857073657;17;2,9;2;1;1
252857073657;252857073667;10;2,9;2;1;1
252857073667;252857073672;5;2,9;2;1;1
252857073672;252857073675;3;2,9;2;1;1
252857073675;252857073680;5;2,9;2;1;1
252857073680;252857073685;5;2,9;2;1;1
252857073685;252857073701;16;2,9;2;1;1
252857073701;252857073702;1;2,9;2;1;1
252857073702;252857073704;2;2,9;2;1;1
252857073704;252857073719;15;2,9;2;1;1
252857073719;252857073723;4;2,9;2;1;1
252857073723;252857073728;5;2,9;2;1;1
252857073728;252857073739;11;2,9;2;1;1
252857073739;252857073746;7;2,9;2;1;1
252857073746;252857073755;9;2,9;2;1;1
252857073755;252857073756;1;2,9;2;1;1
252857073756;252857073757;1;2,9;2;1;1
252857073757;252857073758;1;2,9;2;1;1
252857073758;252857073770;12;2,9;2;1;1
252857073770;252857073777;7;2,9;2;1;1
252857073777;252857073780;3;2,9;2;1;1
252857073780;252857073782;2;2,9;2;1;1
252857073782;252857073783;1;2,9;2;1;1
252857073783;252857073793;10;2,9;2;1;1
252857073793;252857073798;5;2,9;2;1;1
252857073798;252857073809;11;2,9;2;1;1
252857073809;252857073813;4;2,9;2;1;1
252857073813;252857073824;11;2,9;2;1;1
252857073824;252857073830;6;2,9;2;1;1
252857073830;252857073833;3;2,9;2;1;1
252857073833;252857073836;3;2,9;2;1;1
252857073836;252857073838;2;2,9;2;1;1
252857073838;252857073839;1;2,9;2;1;1
252857073839;252857073848;9;2,9;2;1;1
252857073848;252857073850;2;2,9;2;1;1
252857073850;252857073852;2;2,9;2;1;1
252857073852;252857073873;21;2,9;2;1;1
252857073873;252857073882;9;2,9;2;1;1
252857073882;252857073887;5;2,9;2;1;1
252857073887;252857073889;2;2,9;2;1;1
252857073889;252857073890;1;2,9;2;1;1
252857073890;252857073893;3;2,9;2;1;1
252857073893;252857073895;2;2,9;2;1;1
252857073895;252857073899;4;2,9;2;1;1
252857073899;252857073911;12;2,9;2;1;1
252857073911;252857073913;2;2,9;2;1;1
252857073913;252857073917;4;2,9;2;1;1
252857073917;252857073923;6;2,9;2;1;1
252857073923;252857073927;4;2,9;2;1;1
252857073927;252857073931;4;2,9;2;1;1
252857073931;252857073938;7;2,9;2;1;1
252857073938;252857073939;1;2,9;2;1;1
252857073939;252857073950;11;2,9;2;1;1
252857073950;252857073964;14;2,9;2;1;1
252857073964;252857073978;14;2,9;2;1;1
252857073978;252857073988;10;2,9;2;1;1
252857073988;252857073992;4;2,9;2;1;1
252857073992;252857073994;2;2,9;2;1;1
252857073994;252857074016;22;2,9;2;1;1
252857074016;252857074018;2;2,9;2;1;1
252857074018;252857074022;4;2,9;2;1;1
252857074022;252857074035;13;2,9;2;1;1
252857074035;252857074039;4;2,9;2;1;1
252857074039;252857074050;11;2,9;2;1;1
252857074050;252857074059;9;2,9;2;1;1
252857074059;252857074064;5;2,9;2;1;1
252857074064;252857074068;4;2,9;2;1;1
252857074068;252857074089;21;2,9;2;1;1
252857074089;252857074097;8;2,9;2;1;1
252857074097;252857074102;5;2,9;2;1;1
252857074102;252857074113;11;2,9;2;1;1
252857074113;252857074121;8;2,9;2;1;1
252857074121;252857074137;16;2,9;2;1;1
252857074137;252857074138;1;2,9;2;1;1
252857074138;252857074145;7;2,9;2;1;1
252857074145;252857074149;4;2,9;2;1;1
252857074149;252857074153;4;2,9;2;1;1
252857074153;252857074157;4;2,9;2;1;1
252857074157;252857074167;10;2,9;2;1;1
252857074167;252857074174;7;2,9;2;1;1
252857074174;252857074177;3;2,9;2;1;1
252857074177;252857074184;7;2,9;2;1;1
252857074184;252857074194;10;2,9;2;1;1
252857074194;252857074197;3;2,9;2;1;1
252857074197;252857074202;5;2,9;2;1;1
252857074202;252857074219;17;2,9;2;1;1
252857074219;252857074247;28;2,9;2;1;1
252857074247;252857074260;13;2,9;2;1;1
252857074260;252857074262;2;2,9;2;1;1
252857074262;252857074266;4;2,9;2;1;1
252857074266;252857074280;14;2,9;2;1;1
252857074280;252857074293;13;2,9;2;1;1
252857074293;252857074304;11;2,9;2;1;1
252857074304;252857074312;8;2,9;2;1;1
252857074312;252857074318;6;2,9;2;1;1
252857074318;252857074320;2;2,9;2;1;1
252857074320;252857074324;4;2,9;2;1;1
252857074324;252857074334;10;2,9;2;1;1
252857074334;252857074340;6;2,9;2;1;1
252857074340;252857074347;7;2,9;2;1;1
252857074347;252857074350;3;2,9;2;1;1
252857074350;252857074362;12;2,9;2;1;1
252857074362;252857074363;1;2,9;2;1;1
252857074363;252857074373;10;2,9;2;1;1
252857074373;252857074403;30;2,9;2;1;1
252857074403;252857074407;4;2,9;2;1;1
252857074407;252857074414;7;2,9;2;1;1
252857074414;252857074419;5;2,9;2;1;1
252857074419;252857074450;31;2,9;2;1;1
252857074450;252857074470;20;2,9;2;1;1
252857074470;252857074492;22;2,9;2;1;1
252857074492;252857074507;15;2,9;2;1;1
252857074507;252857074512;5;2,9;2;1;1
252857074512;252857074514;2;2,9;2;1;1
252857074514;252857074532;18;2,9;2;1;1
252857074532;252857074535;3;2,9;2;1;1
252857074535;252857074536;1;2,9;2;1;1
252857074536;252857074543;7;2,9;2;1;1
252857074543;252857074565;22;2,9;2;1;1
252857074565;252857074567;2;2,9;2;1;1
252857074567;252857074581;14;2,9;2;1;1
252857074581;252857074583;2;2,9;2;1;1
252857074583;252857074584;1;2,9;2;1;1
252857074584;252857074599;15;2,9;2;1;1
252857074599;252857074608;9;2,9;2;1;1
252857074608;252857074621;13;2,9;2;1;1
252857074621;252857074623;2;2,9;2;1;1
252857074623;252857074634;11;2,9;2;1;1
252857074634;252857074636;2;2,9;2;1;1
252857074636;252857074646;10;2,9;2;1;1
252857074646;252857074654;8;2,9;2;1;1
252857074654;252857074656;2;2,9;2;1;1
252857074656;252857074657;1;2,9;2;1;1
252857074657;252857074668;11;2,9;2;1;1
252857074668;252857074678;10;2,9;2;1;1
252857074678;252857074684;6;2,9;2;1;1
252857074684;252857074689;5;2,9;2;1;1
252857074689;252857074706;17;2,9;2;1;1
252857074706;252857074718;12;2,9;2;1;1
252857074718;252857074722;4;2,9;2;1;1
252857074722;252857074738;16;2,9;2;1;1
252857074738;252857074741;3;2,9;2;1;1
252857074741;252857074760;19;2,9;2;1;1
252857074760;252857074778;18;2,9;2;1;1
252857074778;252857074797;19;2,9;2;1;1
252857074797;252857074804;7;2,9;2;1;1
252857074804;252857074805;1;2,9;2;1;1
252857074805;252857074815;10;2,9;2;1;1
252857074815;252857074825;10;2,9;2;1;1
252857074825;252857074841;16;2,9;2;1;1
252857074841;252857074846;5;2,9;2;1;1
252857074846;252857074853;7;2,9;2;1;1
252857074853;252857074870;17;2,9;2;1;1
252857074870;252857074884;14;2,9;2;1;1
252857074884;252857074886;2;2,9;2;1;1
252857074886;252857074892;6;2,9;2;1;1
252857074892;252857074924;32;2,9;2;1;1
252857074924;252857074932;8;2,9;2;1;1
252857074932;252857074933;1;2,9;2;1;1
252857074933;252857074952;19;2,9;2;1;1
252857074952;252857074953;1;2,9;2;1;1
252857074953;252857074977;24;2,9;2;1;1
252857074977;252857074978;1;2,9;2;1;1
252857074978;252857074989;11;2,9;2;1;1
252857074989;252857075014;25;2,9;2;1;1
252857075014;252857075026;12;2,9;2;1;1
252857075026;252857075040;14;2,9;2;1;1
252857075040;252857075042;2;2,9;2;1;1
252857075042;252857075055;13;2,9;2;1;1
252857075055;252857075058;3;2,9;2;1;1
252857075058;252857075067;9;2,9;2;1;1
252857075067;252857075071;4;2,9;2;1;1
252857075071;252857075072;1;2,9;2;1;1
252857075072;252857075077;5;2,9;2;1;1
252857075077;252857075078;1;2,9;2;1;1
252857075078;252857075088;10;2,9;2;1;1
252857075088;252857075096;8;2,9;2;1;1
252857075096;252857075098;2;2,9;2;1;1
252857075098;252857075106;8;2,9;2;1;1
252857075106;252857075117;11;2,9;2;1;1
252857075117;252857075118;1;2,9;2;1;1
252857075118;252857075119;1;2,9;2;1;1
252857075119;252857075130;11;2,9;2;1;1
252857075130;252857075141;11;2,9;2;1;1
252857075141;252857075147;6;2,9;2;1;1
252857075147;252857075150;3;2,9;2;1;1
252857075150;252857075157;7;2,9;2;1;1
252857075157;252857075160;3;2,9;2;1;1
252857075160;252857075161;1;2,9;2;1;1
252857075161;252857075162;1;2,9;2;1;1
252857075162;252857075168;6;2,9;2;1;1
252857075168;252857075170;2;2,9;2;1;1
252857075170;252857075173;3;2,9;2;1;1
252857075173;252857075176;3;2,9;2;1;1
252857075176;252857075177;1;2,9;2;1;1
252857075177;252857075179;2;2,9;2;1;1
252857075179;252857075186;7;2,9;2;1;1
252857075186;252857075193;7;2,9;2;1;1
252857075193;252857075202;9;2,9;2;1;1
252857075202;252857075203;1;2,9;2;1;1
252857075203;252857075206;3;2,9;2;1;1
252857075206;252857075207;1;2,9;2;1;1
252857075207;252857075219;12;2,9;2;1;1
252857075219;252857075220;1;2,9;2;1;1
252857075220;252857075227;7;2,9;2;1;1
252857075227;252857075228;1;2,9;2;1;1
252857075228;252857075229;1;2,9;2;1;1
252857075229;252857075231;2;2,9;2;1;1
252857075231;252857075235;4;2,9;2;1;1
252857075235;252857075245;10;2,9;2;1;1
252857075245;252857075251;6;2,9;2;1;1
252857075251;252857075255;4;2,9;2;1;1
252857075255;252857075264;9;2,9;2;1;1
252857075264;252857075268;4;2,9;2;1;1
252857075268;252857075280;12;2,9;2;1;1
252857075280;252857075284;4;2,9;2;1;1
252857075284;252857075293;9;2,9;2;1;1
252857075293;252857075297;4;2,9;2;1;1
252857075297;252857075304;7;2,9;2;1;1
252857075304;252857075306;2;2,9;2;1;1
252857075306;252857075311;5;2,9;2;1;1
252857075311;252857075313;2;2,9;2;1;1
252857075313;252857075318;5;2,9;2;1;1
252857075318;252857075321;3;2,9;2;1;1
252857075321;252857075322;1;2,9;2;1;1
252857075322;252857075323;1;2,9;2;1;1
252857075323;252857075334;11;2,9;2;1;1
252857075334;252857075337;3;2,9;2;1;1
252857075337;252857075341;4;2,9;2;1;1
252857075341;252857075350;9;2,9;2;1;1
252857075350;252857075352;2;2,9;2;1;1
252857075352;252857075356;4;2,9;2;1;1
252857075356;252857075357;1;2,9;2;1;1
252857075357;252857075359;2;2,9;2;1;1
252857075359;252857075368;9;2,9;2;1;1
252857075368;252857075377;9;2,9;2;1;1
252857075377;252857075384;7;2,9;2;1;1
252857075384;252857075392;8;2,9;2;1;1
252857075392;252857075397;5;2,9;2;1;1
252857075397;252857075400;3;2,9;2;1;1
252857075400;252857075402;2;2,9;2;1;1
252857075402;252857075404;2;2,9;2;1;1
252857075404;252857075412;8;2,9;2;1;1
252857075412;252857075422;10;2,9;2;1;1
252857075422;252857075426;4;2,9;2;1;1
252857075426;252857075429;3;2,9;2;1;1
252857075429;252857075434;5;2,9;2;1;1
252857075434;252857075437;3;2,9;2;1;1
252857075437;252857075446;9;2,9;2;1;1
252857075446;252857075458;12;2,9;2;1;1
252857075458;252857075465;7;2,9;2;1;1
252857075465;252857075466;1;2,9;2;1;1
252857075466;252857075482;16;2,9;2;1;1
252857075482;252857075485;3;2,9;2;1;1
252857075485;252857075498;13;2,9;2;1;1
252857075498;252857075506;8;2,9;2;1;1
252857075506;252857075509;3;2,9;2;1;1
252857075509;252857075534;25;2,9;2;1;1
252857075534;252857075538;4;2,9;2;1;1
252857075538;252857075547;9;2,9;2;1;1
252857075547;252857075564;17;2,9;2;1;1
252857075564;252857075566;2;2,9;2;1;1
252857075566;252857075572;6;2,9;2;1;1
252857075572;252857075573;1;2,9;2;1;1
252857075573;252857075580;7;2,9;2;1;1
252857075580;252857075581;1;2,9;2;1;1
252857075581;252857075594;13;2,9;2;1;1
252857075594;252857075600;6;2,9;2;1;1
252857075600;252857075615;15;2,9;2;1;1
252857075615;252857075616;1;2,9;2;1;1
252857075616;252857075621;5;2,9;2;1;1
252857075621;252857075622;1;2,9;2;1;1
252857075622;252857075636;14;2,9;2;1;1
252857075636;252857075643;7;2,9;2;1;1
252857075643;252857075644;1;2,9;2;1;1
252857075644;252857075650;6;2,9;2;1;1
252857075650;252857075671;21;2,9;2;1;1
252857075671;252857075672;1;2,9;2;1;1
252857075672;252857075674;2;2,9;2;1;1
252857075674;252857075684;10;2,9;2;1;1
252857075684;252857075693;9;2,9;2;1;1
252857075693;252857075697;4;2,9;2;1;1
252857075697;252857075705;8;2,9;2;1;1
252857075705;252857075710;5;2,9;2;1;1
252857075710;252857075722;12;2,9;2;1;1
252857075722;252857075724;2;2,9;2;1;1
252857075724;252857075726;2;2,9;2;1;1
252857075726;252857075730;4;2,9;2;1;1
252857075730;252857075742;12;2,9;2;1;1
252857075742;252857075749;7;2,9;2;1;1
252857075749;252857075761;12;2,9;2;1;1
252857075761;252857075763;2;2,9;2;1;1
252857075763;252857075767;4;2,9;2;1;1
252857075767;252857075776;9;2,9;2;1;1
252857075776;252857075784;8;2,9;2;1;1
252857075784;252857075792;8;2,9;2;1;1
252857075792;252857075797;5;2,9;2;1;1
252857075797;252857075804;7;2,9;2;1;1
252857075804;252857075809;5;2,9;2;1;1
252857075809;252857075815;6;2,9;2;1;1
252857075815;252857075817;2;2,9;2;1;1
252857075817;252857075829;12;2,9;2;1;1
252857075829;252857075831;2;2,9;2;1;1
252857075831;252857075837;6;2,9;2;1;1
252857075837;252857075847;10;2,9;2;1;1
252857075847;252857075849;2;2,9;2;1;1
252857075849;252857075872;23;2,9;2;1;1
252857075872;252857075875;3;2,9;2;1;1
252857075875;252857075882;7;2,9;2;1;1
252857075882;252857075889;7;2,9;2;1;1
252857075889;252857075907;18;2,9;2;1;1
252857075907;252857075910;3;2,9;2;1;1
252857075910;252857075912;2;2,9;2;1;1
252857075912;252857075930;18;2,9;2;1;1
252857075930;252857075951;21;2,9;2;1;1
252857075951;252857075952;1;2,9;2;1;1
252857075952;252857075957;5;2,9;2;1;1
252857075957;252857075958;1;2,9;2;1;1
252857075958;252857075965;7;2,9;2;1;1
252857075965;252857075979;14;2,9;2;1;1
252857075979;252857075982;3;2,9;2;1;1
252857075982;252857075983;1;2,9;2;1;1
252857075983;252857075993;10;2,9;2;1;1
252857075993;252857075998;5;2,9;2;1;1
252857075998;252857075999;1;2,9;2;1;1
252857075999;252857076007;8;2,9;2;1;1
252857076007;252857076023;16;2,9;2;1;1
252857076023;252857076025;2;2,9;2;1;1
252857076025;252857076026;1;2,9;2;1;1
252857076026;252857076028;2;2,9;2;1;1
252857076028;252857076038;10;2,9;2;1;1
252857076038;252857076053;15;2,9;2;1;1
252857076053;252857076056;3;2,9;2;1;1
252857076056;252857076064;8;2,9;2;1;1
252857076064;252857076068;4;2,9;2;1;1
252857076068;252857076083;15;2,9;2;1;1
252857076083;252857076097;14;2,9;2;1;1
252857076097;252857076108;11;2,9;2;1;1
252857076108;252857076109;1;2,9;2;1;1
252857076109;252857076113;4;2,9;2;1;1
252857076113;252857076119;6;2,9;2;1;1
252857076119;252857076140;21;2,9;2;1;1
252857076140;252857076163;23;2,9;2;1;1
252857076163;252857076167;4;2,9;2;1;1
252857076167;252857076169;2;2,9;2;1;1
252857076169;252857076184;15;2,9;2;1;1
252857076184;252857076192;8;2,9;2;1;1
252857076192;252857076199;7;2,9;2;1;1
252857076199;252857076219;20;2,9;2;1;1
252857076219;252857076220;1;2,9;2;1;1
252857076220;252857076221;1;2,9;2;1;1
252857076221;252857076223;2;2,9;2;1;1
252857076223;252857076246;23;2,9;2;1;1
252857076246;252857076251;5;2,9;2;1;1
252857076251;252857076261;10;2,9;2;1;1
252857076261;252857076266;5;2,9;2;1;1
252857076266;252857076274;8;2,9;2;1;1
252857076274;252857076279;5;2,9;2;1;1
252857076279;252857076299;20;2,9;2;1;1
252857076299;252857076315;16;2,9;2;1;1
252857076315;252857076319;4;2,9;2;1;1
252857076319;252857076357;38;2,9;2;1;1
252857076357;252857076373;16;2,9;2;1;1
252857076373;252857076380;7;2,9;2;1;1
252857076380;252857076382;2;2,9;2;1;1
252857076382;252857076385;3;2,9;2;1;1
252857076385;252857076404;19;2,9;2;1;1
252857076404;252857076408;4;2,9;2;1;1
252857076408;252857076409;1;2,9;2;1;1
252857076409;252857076432;23;2,9;2;1;1
252857076432;252857076455;23;2,9;2;1;1
252857076455;252857076473;18;2,9;2;1;1
252857076473;252857076475;2;2,9;2;1;1
252857076475;252857076484;9;2,9;2;1;1
252857076484;252857076488;4;2,9;2;1;1
252857076488;252857076493;5;2,9;2;1;1
252857076493;252857076526;33;2,9;2;1;1
252857076526;252857076530;4;2,9;2;1;1
252857076530;252857076531;1;2,9;2;1;1
252857076531;252857076572;41;2,9;2;1;1
252857076572;252857076578;6;2,9;2;1;1
252857076578;252857076606;28;2,9;2;1;1
252857076606;252857076616;10;2,9;2;1;1
252857076616;252857076644;28;2,9;2;1;1
252857076644;252857076648;4;2,9;2;1;1
252857076648;252857076665;17;2,9;2;1;1
252857076665;252857076673;8;2,9;2;1;1
252857076673;252857076684;11;2,9;2;1;1
252857076684;252857076691;7;2,9;2;1;1
252857076691;252857076693;2;2,9;2;1;1
252857076693;252857076704;11;2,9;2;1;1
252857076704;252857076711;7;2,9;2;1;1
252857076711;252857076713;2;2,9;2;1;1
252857076713;252857076714;1;2,9;2;1;1
252857076714;252857076725;11;2,9;2;1;1
252857076725;252857076752;27;2,9;2;1;1
252857076752;252857076754;2;2,9;2;1;1
252857076754;252857076760;6;2,9;2;1;1
252857076760;252857076773;13;2,9;2;1;1
252857076773;252857076780;7;2,9;2;1;1
252857076780;252857076801;21;2,9;2;1;1
252857076801;252857076803;2;2,9;2;1;1
252857076803;252857076806;3;2,9;2;1;1
252857076806;252857076820;14;2,9;2;1;1
252857076820;252857076835;15;2,9;2;1;1
252857076835;252857076846;11;2,9;2;1;1
252857076846;252857076852;6;2,9;2;1;1
252857076852;252857076869;17;2,9;2;1;1
252857076869;252857076871;2;2,9;2;1;1
252857076871;252857076876;5;2,9;2;1;1
252857076876;252857076882;6;2,9;2;1;1
252857076882;252857076892;10;2,9;2;1;1
252857076892;252857076896;4;2,9;2;1;1
252857076896;252857076915;19;2,9;2;1;1
252857076915;252857076955;40;2,9;2;1;1
252857076955;252857076981;26;2,9;2;1;1
252857076981;252857077010;29;2,9;2;1;1
252857077010;252857077040;30;2,9;2;1;1
252857077040;252857077089;49;2,9;2;1;1
252857077089;252857077100;11;2,9;2;1;1
252857077100;252857077111;11;2,9;2;1;1
252857077111;252857077142;31;2,9;2;1;1
252857077142;252857077158;16;2,9;2;1;1
252857077158;252857077177;19;2,9;2;1;1
252857077177;252857077187;10;2,9;2;1;1
252857077187;252857077215;28;2,9;2;1;1
252857077215;252857077216;1;2,9;2;1;1
252857077216;252857077218;2;2,9;2;1;1
252857077218;252857077231;13;2,9;2;1;1
252857077231;252857077236;5;2,9;2;1;1
252857077236;252857077251;15;2,9;2;1;1
252857077251;252857077261;10;2,9;2;1;1
252857077261;252857077264;3;2,9;2;1;1
252857077264;252857077280;16;2,9;2;1;1
252857077280;252857077305;25;2,9;2;1;1
252857077305;252857077309;4;2,9;2;1;1
252857077309;252857077330;21;2,9;2;1;1
252857077330;252857077343;13;2,9;2;1;1
252857077343;252857077360;17;2,9;2;1;1
252857077360;252857077371;11;2,9;2;1;1
252857077371;252857077383;12;2,9;2;1;1
252857077383;252857077394;11;2,9;2;1;1
252857077394;252857077396;2;2,9;2;1;1
252857077396;252857077403;7;2,9;2;1;1
252857077403;252857077424;21;2,9;2;1;1
252857077424;252857077425;1;2,9;2;1;1
252857077425;252857077426;1;2,9;2;1;1
252857077426;252857077445;19;2,9;2;1;1
252857077445;252857077458;13;2,9;2;1;1
252857077458;252857077474;16;2,9;2;1;1
252857077474;252857077477;3;2,9;2;1;1
252857077477;252857077498;21;2,9;2;1;1
252857077498;252857077517;19;2,9;2;1;1
252857077517;252857077547;30;2,9;2;1;1
252857077547;252857077574;27;2,9;2;1;1
252857077574;252857077595;21;2,9;2;1;1
252857077595;252857077622;27;2,9;2;1;1
252857077622;252857077667;45;2,9;2;1;1
252857077667;252857077698;31;2,9;2;1;1
252857077698;252857077713;15;2,9;2;1;1
252857077713;252857077718;5;2,9;2;1;1
252857077718;252857077736;18;2,9;2;1;1
252857077736;252857077749;13;2,9;2;1;1
252857077749;252857077768;19;2,9;2;1;1
252857077768;252857077781;13;2,9;2;1;1
252857077781;252857077790;9;2,9;2;1;1
252857077790;252857077810;20;2,9;2;1;1
252857077810;252857077818;8;2,9;2;1;1
252857077818;252857077843;25;2,9;2;1;1
252857077843;252857077846;3;2,9;2;1;1
252857077846;252857077864;18;2,9;2;1;1
252857077864;252857077879;15;2,9;2;1;1
252857077879;252857077882;3;2,9;2;1;1
252857077882;252857077917;35;2,9;2;1;1
252857077917;252857077937;20;2,9;2;1;1
252857077937;252857077938;1;2,9;2;1;1
252857077938;252857077956;18;2,9;2;1;1
252857077956;252857077957;1;2,9;2;1;1
252857077957;252857077980;23;2,9;2;1;1
252857077980;252857077986;6;2,9;2;1;1
252857077986;252857078007;21;2,9;2;1;1
252857078007;252857078010;3;2,9;2;1;1
252857078010;252857078026;16;2,9;2;1;1
252857078026;252857078032;6;2,9;2;1;1
252857078032;252857078050;18;2,9;2;1;1
252857078050;252857078052;2;2,9;2;1;1
252857078052;252857078069;17;2,9;2;1;1
252857078069;252857078090;21;2,9;2;1;1
252857078090;252857078116;26;2,9;2;1;1
252857078116;252857078136;20;2,9;2;1;1
252857078136;252857078153;17;2,9;2;1;1
252857078153;252857081228;3075;2,9;2;1;1
252857081228;252857081345;117;2,9;2;1;1
252857081345;252857081406;61;2,9;2;1;1
252857081406;252857081407;1;2,9;2;1;1
252857081407;252857081539;132;2,9;2;1;1
252857081539;252857081599;60;2,9;2;1;1
252857081599;252857081605;6;2,9;2;1;1
252857081605;252857081638;33;2,9;2;1;1
252857081638;252857081639;1;2,9;2;1;1
252857081639;252857081740;101;2,9;2;1;1
252857081740;252857081815;75;2,9;2;1;1
252857081815;252857081820;5;2,9;2;1;1
252857081820;252857081851;31;2,9;2;1;1
252857081851;252857081866;15;2,9;2;1;1
252857081866;252857081875;9;2,9;2;1;1
252857081875;252857081895;20;2,9;2;1;1
252857081895;252857081917;22;2,9;2;1;1
252857081917;252857081971;54;2,9;2;1;1
252857081971;252857081986;15;2,9;2;1;1
252857081986;252857082007;21;2,9;2;1;1
252857082007;252857082014;7;2,9;2;1;1
252857082014;252857082020;6;2,9;2;1;1
252857082020;252857082041;21;2,9;2;1;1
252857082041;252857082055;14;2,9;2;1;1
252857082055;252857082056;1;2,9;2;1;1
252857082056;252857082063;7;2,9;2;1;1
252857082063;252857082064;1;2,9;2;1;1
252857082064;252857082073;9;2,9;2;1;1
252857082073;252857082074;1;2,9;2;1;1
252857082074;252857082101;27;2,9;2;1;1
252857082101;252857082104;3;2,9;2;1;1
252857082104;252857082106;2;2,9;2;1;1
252857082106;252857082107;1;2,9;2;1;1
252857082107;252857082151;44;2,9;2;1;1
252857082151;252857082171;20;2,9;2;1;1
252857082171;252857082177;6;2,9;2;1;1
252857082177;252857082183;6;2,9;2;1;1
252857082183;252857082194;11;2,9;2;1;1
252857082194;252857082203;9;2,9;2;1;1
252857082203;252857082230;27;2,9;2;1;1
252857082230;252857082246;16;2,9;2;1;1
252857082246;252857082270;24;2,9;2;1;1
252857082270;252857082276;6;2,9;2;1;1
252857082276;252857082288;12;2,9;2;1;1
252857082288;252857082306;18;2,9;2;1;1
252857082306;252857082307;1;2,9;2;1;1
252857082307;252857082314;7;2,9;2;1;1
252857082314;252857082323;9;2,9;2;1;1
252857082323;252857082329;6;2,9;2;1;1
252857082329;252857082331;2;2,9;2;1;1
252857082331;252857082340;9;2,9;2;1;1
252857082340;252857082355;15;2,9;2;1;1
252857082355;252857082361;6;2,9;2;1;1
252857082361;252857082375;14;2,9;2;1;1
252857082375;252857082377;2;2,9;2;1;1
252857082377;252857082383;6;2,9;2;1;1
252857082383;252857082400;17;2,9;2;1;1
252857082400;252857082405;5;2,9;2;1;1
252857082405;252857082447;42;2,9;2;1;1
252857082447;252857082448;1;2,9;2;1;1
252857082448;252857082517;69;2,9;2;1;1
252857082517;252857082519;2;2,9;2;1;1
252857082519;252857082529;10;2,9;2;1;1
252857082529;252857082533;4;2,9;2;1;1
252857082533;252857082543;10;2,9;2;1;1
252857082543;252857082544;1;2,9;2;1;1
252857082544;252857082552;8;2,9;2;1;1
252857082552;252857082564;12;2,9;2;1;1
252857082564;252857082569;5;2,9;2;1;1
252857082569;252857082587;18;2,9;2;1;1
252857082587;252857082588;1;2,9;2;1;1
252857082588;252857082590;2;2,9;2;1;1
252857082590;252857082593;3;2,9;2;1;1
252857082593;252857082609;16;2,9;2;1;1
252857082609;252857082624;15;2,9;2;1;1
252857082624;252857082625;1;2,9;2;1;1
252857082625;252857082638;13;2,9;2;1;1
252857082638;252857082644;6;2,9;2;1;1
252857082644;252857082652;8;2,9;2;1;1
252857082652;252857082670;18;2,9;2;1;1
252857082670;252857082685;15;2,9;2;1;1
252857082685;252857082695;10;2,9;2;1;1
252857082695;252857082720;25;2,9;2;1;1
252857082720;252857082722;2;2,9;2;1;1
252857082722;252857082748;26;2,9;2;1;1
252857082748;252857082754;6;2,9;2;1;1
252857082754;252857082783;29;2,9;2;1;1
252857082783;252857082794;11;2,9;2;1;1
252857082794;252857082802;8;2,9;2;1;1
252857082802;252857082811;9;2,9;2;1;1
252857082811;252857082818;7;2,9;2;1;1
252857082818;252857082826;8;2,9;2;1;1
252857082826;252857082839;13;2,9;2;1;1
252857082839;252857082842;3;2,9;2;1;1
252857082842;252857082845;3;2,9;2;1;1
252857082845;252857082864;19;2,9;2;1;1
252857082864;252857082882;18;2,9;2;1;1
252857082882;252857082887;5;2,9;2;1;1
252857082887;252857082890;3;2,9;2;1;1
252857082890;252857082895;5;2,9;2;1;1
252857082895;252857082899;4;2,9;2;1;1
252857082899;252857082915;16;2,9;2;1;1
252857082915;252857082942;27;2,9;2;1;1
252857082942;252857082950;8;2,9;2;1;1
252857082950;252857082954;4;2,9;2;1;1
252857082954;252857082966;12;2,9;2;1;1
252857082966;252857082969;3;2,9;2;1;1
252857082969;252857082983;14;2,9;2;1;1
252857082983;252857082990;7;2,9;2;1;1
252857082990;252857082996;6;2,9;2;1;1
252857082996;252857083000;4;2,9;2;1;1
252857083000;252857083001;1;2,9;2;1;1
252857083001;252857083020;19;2,9;2;1;1
252857083020;252857083049;29;2,9;2;1;1
252857083049;252857083053;4;2,9;2;1;1
252857083053;252857083056;3;2,9;2;1;1
252857083056;252857083057;1;2,9;2;1;1
252857083057;252857083062;5;2,9;2;1;1
252857083062;252857083065;3;2,9;2;1;1
252857083065;252857083072;7;2,9;2;1;1
252857083072;252857083075;3;2,9;2;1;1
252857083075;252857083079;4;2,9;2;1;1
252857083079;252857083086;7;2,9;2;1;1
252857083086;252857083097;11;2,9;2;1;1
252857083097;252857083105;8;2,9;2;1;1
252857083105;252857083109;4;2,9;2;1;1
252857083109;252857083121;12;2,9;2;1;1
252857083121;252857083125;4;2,9;2;1;1
252857083125;252857083129;4;2,9;2;1;1
252857083129;252857083148;19;2,9;2;1;1
252857083148;252857083158;10;2,9;2;1;1
252857083158;252857083165;7;2,9;2;1;1
252857083165;252857083176;11;2,9;2;1;1
252857083176;252857083184;8;2,9;2;1;1
252857083184;252857083186;2;2,9;2;1;1
252857083186;252857083189;3;2,9;2;1;1
252857083189;252857083203;14;2,9;2;1;1
252857083203;252857083208;5;2,9;2;1;1
252857083208;252857083214;6;2,9;2;1;1
252857083214;252857083218;4;2,9;2;1;1
252857083218;252857083219;1;2,9;2;1;1
252857083219;252857083226;7;2,9;2;1;1
252857083226;252857083240;14;2,9;2;1;1
252857083240;252857083252;12;2,9;2;1;1
252857083252;252857083280;28;2,9;2;1;1
252857083280;252857083303;23;2,9;2;1;1
252857083303;252857083316;13;2,9;2;1;1
252857083316;252857083320;4;2,9;2;1;1
252857083320;252857083346;26;2,9;2;1;1
252857083346;252857083347;1;2,9;2;1;1
252857083347;252857083349;2;2,9;2;1;1
252857083349;252857083370;21;2,9;2;1;1
252857083370;252857083377;7;2,9;2;1;1
252857083377;252857083398;21;2,9;2;1;1
252857083398;252857083403;5;2,9;2;1;1
252857083403;252857083407;4;2,9;2;1;1
252857083407;252857083422;15;2,9;2;1;1
252857083422;252857083430;8;2,9;2;1;1
252857083430;252857083447;17;2,9;2;1;1
252857083447;252857083456;9;2,9;2;1;1
252857083456;252857083475;19;2,9;2;1;1
252857083475;252857083492;17;2,9;2;1;1
252857083492;252857083495;3;2,9;2;1;1
252857083495;252857083506;11;2,9;2;1;1
252857083506;252857083514;8;2,9;2;1;1
252857083514;252857083515;1;2,9;2;1;1
252857083515;252857083521;6;2,9;2;1;1
252857083521;252857083522;1;2,9;2;1;1
252857083522;252857083523;1;2,9;2;1;1
252857083523;252857083528;5;2,9;2;1;1
252857083528;252857083531;3;2,9;2;1;1
252857083531;252857083553;22;2,9;2;1;1
252857083553;252857083555;2;2,9;2;1;1
252857083555;252857083571;16;2,9;2;1;1
252857083571;252857083572;1;2,9;2;1;1
252857083572;252857083574;2;2,9;2;1;1
252857083574;252857083575;1;2,9;2;1;1
252857083575;252857083578;3;2,9;2;1;1
252857083578;252857083581;3;2,9;2;1;1
252857083581;252857083596;15;2,9;2;1;1
252857083596;252857083616;20;2,9;2;1;1
252857083616;252857083620;4;2,9;2;1;1
252857083620;252857083622;2;2,9;2;1;1
252857083622;252857083638;16;2,9;2;1;1
252857083638;252857083642;4;2,9;2;1;1
252857083642;252857083666;24;2,9;2;1;1
252857083666;252857083679;13;2,9;2;1;1
252857083679;252857083692;13;2,9;2;1;1
252857083692;252857083695;3;2,9;2;1;1
252857083695;252857083705;10;2,9;2;1;1
252857083705;252857083724;19;2,9;2;1;1
252857083724;252857083739;15;2,9;2;1;1
252857083739;252857083742;3;2,9;2;1;1
252857083742;252857083753;11;2,9;2;1;1
252857083753;252857083765;12;2,9;2;1;1
252857083765;252857083784;19;2,9;2;1;1
252857083784;252857083791;7;2,9;2;1;1
252857083791;252857083793;2;2,9;2;1;1
252857083793;252857083805;12;2,9;2;1;1
252857083805;252857083810;5;2,9;2;1;1
252857083810;252857083811;1;2,9;2;1;1
252857083811;252857083816;5;2,9;2;1;1
252857083816;252857083828;12;2,9;2;1;1
252857083828;252857083829;1;2,9;2;1;1
252857083829;252857083840;11;2,9;2;1;1
252857083840;252857083845;5;2,9;2;1;1
252857083845;252857083858;13;2,9;2;1;1
252857083858;252857083860;2;2,9;2;1;1
252857083860;252857083863;3;2,9;2;1;1
252857083863;252857083864;1;2,9;2;1;1
252857083864;252857083869;5;2,9;2;1;1
252857083869;252857083872;3;2,9;2;1;1
252857083872;252857083880;8;2,9;2;1;1
252857083880;252857083886;6;2,9;2;1;1
252857083886;252857083887;1;2,9;2;1;1
252857083887;252857083888;1;2,9;2;1;1
252857083888;252857083898;10;2,9;2;1;1
252857083898;252857083908;10;2,9;2;1;1
252857083908;252857083918;10;2,9;2;1;1
252857083918;252857083928;10;2,9;2;1;1
252857083928;252857083947;19;2,9;2;1;1
252857083947;252857083957;10;2,9;2;1;1
252857083957;252857083958;1;2,9;2;1;1
252857083958;252857083959;1;2,9;2;1;1
252857083959;252857083964;5;2,9;2;1;1
252857083964;252857083992;28;2,9;2;1;1
252857083992;252857083996;4;2,9;2;1;1
252857083996;252857084008;12;2,9;2;1;1
252857084008;252857084009;1;2,9;2;1;1
252857084009;252857084015;6;2,9;2;1;1
252857084015;252857084017;2;2,9;2;1;1
252857084017;252857084018;1;2,9;2;1;1
252857084018;252857084042;24;2,9;2;1;1
252857084042;252857084043;1;2,9;2;1;1
252857084043;252857084044;1;2,9;2;1;1
252857084044;252857084052;8;2,9;2;1;1
252857084052;252857084059;7;2,9;2;1;1
252857084059;252857084060;1;2,9;2;1;1
252857084060;252857084067;7;2,9;2;1;1
252857084067;252857084068;1;2,9;2;1;1
252857084068;252857084072;4;2,9;2;1;1
252857084072;252857084074;2;2,9;2;1;1
252857084074;252857084079;5;2,9;2;1;1
252857084079;252857084080;1;2,9;2;1;1
252857084080;252857084097;17;2,9;2;1;1
252857084097;252857084099;2;2,9;2;1;1
252857084099;252857084104;5;2,9;2;1;1
252857084104;252857084118;14;2,9;2;1;1
252857084118;252857084137;19;2,9;2;1;1
252857084137;252857084138;1;2,9;2;1;1
252857084138;252857084150;12;2,9;2;1;1
252857084150;252857084155;5;2,9;2;1;1
252857084155;252857084156;1;2,9;2;1;1
252857084156;252857084157;1;2,9;2;1;1
252857084157;252857084170;13;2,9;2;1;1
252857084170;252857084172;2;2,9;2;1;1
252857084172;252857084174;2;2,9;2;1;1
252857084174;252857084175;1;2,9;2;1;1
252857084175;252857084178;3;2,9;2;1;1
252857084178;252857084180;2;2,9;2;1;1
252857084180;252857084187;7;2,9;2;1;1
252857084187;252857084209;22;2,9;2;1;1
252857084209;252857084228;19;2,9;2;1;1
252857084228;252857084236;8;2,9;2;1;1
252857084236;252857084242;6;2,9;2;1;1
252857084242;252857084252;10;2,9;2;1;1
252857084252;252857084253;1;2,9;2;1;1
252857084253;252857084262;9;2,9;2;1;1
252857084262;252857084267;5;2,9;2;1;1
252857084267;252857084278;11;2,9;2;1;1
252857084278;252857084286;8;2,9;2;1;1
252857084286;252857084289;3;2,9;2;1;1
252857084289;252857084290;1;2,9;2;1;1
252857084290;252857084293;3;2,9;2;1;1
252857084293;252857084305;12;2,9;2;1;1
252857084305;252857084311;6;2,9;2;1;1
252857084311;252857084314;3;2,9;2;1;1
252857084314;252857084317;3;2,9;2;1;1
252857084317;252857084323;6;2,9;2;1;1
252857084323;252857084328;5;2,9;2;1;1
252857084328;252857084329;1;2,9;2;1;1
252857084329;252857084339;10;2,9;2;1;1
252857084339;252857084344;5;2,9;2;1;1
252857084344;252857084359;15;2,9;2;1;1
252857084359;252857084371;12;2,9;2;1;1
252857084371;252857084373;2;2,9;2;1;1
252857084373;252857084378;5;2,9;2;1;1
252857084378;252857084387;9;2,9;2;1;1
252857084387;252857084389;2;2,9;2;1;1
252857084389;252857084391;2;2,9;2;1;1
252857084391;252857084394;3;2,9;2;1;1
252857084394;252857084399;5;2,9;2;1;1
252857084399;252857084405;6;2,9;2;1;1
252857084405;252857084407;2;2,9;2;1;1
252857084407;252857084410;3;2,9;2;1;1
252857084410;252857084414;4;2,9;2;1;1
252857084414;252857084452;38;2,9;2;1;1
252857084452;252857084457;5;2,9;2;1;1
252857084457;252857084460;3;2,9;2;1;1
252857084460;252857084470;10;2,9;2;1;1
252857084470;252857084478;8;2,9;2;1;1
252857084478;252857084482;4;2,9;2;1;1
252857084482;252857084486;4;2,9;2;1;1
252857084486;252857084492;6;2,9;2;1;1
252857084492;252857084497;5;2,9;2;1;1
252857084497;252857084502;5;2,9;2;1;1
252857084502;252857084505;3;2,9;2;1;1
252857084505;252857084520;15;2,9;2;1;1
252857084520;252857084529;9;2,9;2;1;1
252857084529;252857084538;9;2,9;2;1;1
252857084538;252857084539;1;2,9;2;1;1
252857084539;252857084552;13;2,9;2;1;1
252857084552;252857084558;6;2,9;2;1;1
252857084558;252857084566;8;2,9;2;1;1
252857084566;252857084568;2;2,9;2;1;1
252857084568;252857084569;1;2,9;2;1;1
252857084569;252857084571;2;2,9;2;1;1
252857084571;252857084579;8;2,9;2;1;1
252857084579;252857084580;1;2,9;2;1;1
252857084580;252857084583;3;2,9;2;1;1
252857084583;252857084587;4;2,9;2;1;1
252857084587;252857084605;18;2,9;2;1;1
252857084605;252857084618;13;2,9;2;1;1
252857084618;252857084629;11;2,9;2;1;1
252857084629;252857084636;7;2,9;2;1;1
252857084636;252857084640;4;2,9;2;1;1
252857084640;252857084658;18;2,9;2;1;1
252857084658;252857084662;4;2,9;2;1;1
252857084662;252857084663;1;2,9;2;1;1
252857084663;252857084672;9;2,9;2;1;1
252857084672;252857084676;4;2,9;2;1;1
252857084676;252857084678;2;2,9;2;1;1
252857084678;252857084683;5;2,9;2;1;1
252857084683;252857084684;1;2,9;2;1;1
252857084684;252857084686;2;2,9;2;1;1
252857084686;252857084702;16;2,9;2;1;1
252857084702;252857084718;16;2,9;2;1;1
252857084718;252857084720;2;2,9;2;1;1
252857084720;252857084722;2;2,9;2;1;1
252857084722;252857084726;4;2,9;2;1;1
252857084726;252857084735;9;2,9;2;1;1
252857084735;252857084740;5;2,9;2;1;1
252857084740;252857084752;12;2,9;2;1;1
252857084752;252857084756;4;2,9;2;1;1
252857084756;252857084763;7;2,9;2;1;1
252857084763;252857084765;2;2,9;2;1;1
252857084765;252857084775;10;2,9;2;1;1
252857084775;252857084776;1;2,9;2;1;1
252857084776;252857084783;7;2,9;2;1;1
252857084783;252857084798;15;2,9;2;1;1
252857084798;252857084807;9;2,9;2;1;1
252857084807;252857084809;2;2,9;2;1;1
252857084809;252857084810;1;2,9;2;1;1
252857084810;252857084814;4;2,9;2;1;1
252857084814;252857084816;2;2,9;2;1;1
252857084816;252857084819;3;2,9;2;1;1
252857084819;252857084821;2;2,9;2;1;1
252857084821;252857084824;3;2,9;2;1;1
252857084824;252857084829;5;2,9;2;1;1
252857084829;252857084875;46;2,9;2;1;1
252857084875;252857084877;2;2,9;2;1;1
252857084877;252857084881;4;2,9;2;1;1
252857084881;252857084885;4;2,9;2;1;1
252857084885;252857084887;2;2,9;2;1;1
252857084887;252857084894;7;2,9;2;1;1
252857084894;252857084898;4;2,9;2;1;1
252857084898;252857084908;10;2,9;2;1;1
252857084908;252857084911;3;2,9;2;1;1
252857084911;252857084914;3;2,9;2;1;1
252857084914;252857084925;11;2,9;2;1;1
252857084925;252857084938;13;2,9;2;1;1
252857084938;252857084939;1;2,9;2;1;1
252857084939;252857084942;3;2,9;2;1;1
252857084942;252857084944;2;2,9;2;1;1
252857084944;252857084947;3;2,9;2;1;1
252857084947;252857084950;3;2,9;2;1;1
252857084950;252857084970;20;2,9;2;1;1
252857084970;252857084973;3;2,9;2;1;1
252857084973;252857084981;8;2,9;2;1;1
252857084981;252857084999;18;2,9;2;1;1
252857084999;252857085001;2;2,9;2;1;1
252857085001;252857085012;11;2,9;2;1;1
252857085012;252857085013;1;2,9;2;1;1
252857085013;252857085026;13;2,9;2;1;1
252857085026;252857085030;4;2,9;2;1;1
252857085030;252857085031;1;2,9;2;1;1
252857085031;252857085049;18;2,9;2;1;1
252857085049;252857085053;4;2,9;2;1;1
252857085053;252857085060;7;2,9;2;1;1
252857085060;252857085064;4;2,9;2;1;1
252857085064;252857085065;1;2,9;2;1;1
252857085065;252857085068;3;2,9;2;1;1
252857085068;252857085081;13;2,9;2;1;1
252857085081;252857085085;4;2,9;2;1;1
252857085085;252857085086;1;2,9;2;1;1
252857085086;252857085110;24;2,9;2;1;1
252857085110;252857085113;3;2,9;2;1;1
252857085113;252857085116;3;2,9;2;1;1
252857085116;252857085129;13;2,9;2;1;1
252857085129;252857085130;1;2,9;2;1;1
252857085130;252857085131;1;2,9;2;1;1
252857085131;252857085139;8;2,9;2;1;1
252857085139;252857085143;4;2,9;2;1;1
252857085143;252857085150;7;2,9;2;1;1
252857085150;252857085152;2;2,9;2;1;1
252857085152;252857085168;16;2,9;2;1;1
252857085168;252857085171;3;2,9;2;1;1
252857085171;252857085172;1;2,9;2;1;1
252857085172;252857085179;7;2,9;2;1;1
252857085179;252857085180;1;2,9;2;1;1
252857085180;252857085183;3;2,9;2;1;1
252857085183;252857085189;6;2,9;2;1;1
252857085189;252857085196;7;2,9;2;1;1
252857085196;252857085197;1;2,9;2;1;1
252857085197;252857085198;1;2,9;2;1;1
252857085198;252857085204;6;2,9;2;1;1
252857085204;252857085217;13;2,9;2;1;1
252857085217;252857085219;2;2,9;2;1;1
252857085219;252857085232;13;2,9;2;1;1
252857085232;252857085233;1;2,9;2;1;1
252857085233;252857085234;1;2,9;2;1;1
252857085234;252857085240;6;2,9;2;1;1
252857085240;252857085245;5;2,9;2;1;1
252857085245;252857085247;2;2,9;2;1;1
252857085247;252857085261;14;2,9;2;1;1
252857085261;252857085262;1;2,9;2;1;1
252857085262;252857085270;8;2,9;2;1;1
252857085270;252857085277;7;2,9;2;1;1
252857085277;252857085278;1;2,9;2;1;1
252857085278;252857085281;3;2,9;2;1;1
252857085281;252857085290;9;2,9;2;1;1
252857085290;252857085292;2;2,9;2;1;1
252857085292;252857085295;3;2,9;2;1;1
252857085295;252857085298;3;2,9;2;1;1
252857085298;252857085309;11;2,9;2;1;1
252857085309;252857085317;8;2,9;2;1;1
252857085317;252857085321;4;2,9;2;1;1
252857085321;252857085325;4;2,9;2;1;1
252857085325;252857085327;2;2,9;2;1;1
252857085327;252857085331;4;2,9;2;1;1
252857085331;252857085338;7;2,9;2;1;1
252857085338;252857085340;2;2,9;2;1;1
252857085340;252857085344;4;2,9;2;1;1
252857085344;252857085347;3;2,9;2;1;1
252857085347;252857085352;5;2,9;2;1;1
252857085352;252857085353;1;2,9;2;1;1
252857085353;252857085357;4;2,9;2;1;1
252857085357;252857085358;1;2,9;2;1;1
252857085358;252857085360;2;2,9;2;1;1
252857085360;252857085365;5;2,9;2;1;1
252857085365;252857085370;5;2,9;2;1;1
252857085370;252857085379;9;2,9;2;1;1
252857085379;252857085390;11;2,9;2;1;1
252857085390;252857085396;6;2,9;2;1;1
252857085396;252857085401;5;2,9;2;1;1
252857085401;252857085405;4;2,9;2;1;1
252857085405;252857085407;2;2,9;2;1;1
252857085407;252857085416;9;2,9;2;1;1
252857085416;252857085417;1;2,9;2;1;1
252857085417;252857085423;6;2,9;2;1;1
252857085423;252857085430;7;2,9;2;1;1
252857085430;252857085432;2;2,9;2;1;1
252857085432;252857085433;1;2,9;2;1;1
252857085433;252857085434;1;2,9;2;1;1
252857085434;252857085443;9;2,9;2;1;1
252857085443;252857085455;12;2,9;2;1;1
252857085455;252857085457;2;2,9;2;1;1
252857085457;252857085461;4;2,9;2;1;1
252857085461;252857085463;2;2,9;2;1;1
252857085463;252857085464;1;2,9;2;1;1
252857085464;252857085469;5;2,9;2;1;1
252857085469;252857085471;2;2,9;2;1;1
252857085471;252857085477;6;2,9;2;1;1
252857085477;252857085481;4;2,9;2;1;1
252857085481;252857085489;8;2,9;2;1;1
252857085489;252857085494;5;2,9;2;1;1
252857085494;252857085497;3;2,9;2;1;1
252857085497;252857085503;6;2,9;2;1;1
252857085503;252857085506;3;2,9;2;1;1
252857085506;252857085507;1;2,9;2;1;1
252857085507;252857085509;2;2,9;2;1;1
252857085509;252857085520;11;2,9;2;1;1
252857085520;252857085521;1;2,9;2;1;1
252857085521;252857085526;5;2,9;2;1;1
252857085526;252857085536;10;2,9;2;1;1
252857085536;252857085545;9;2,9;2;1;1
252857085545;252857085546;1;2,9;2;1;1
252857085546;252857085548;2;2,9;2;1;1
252857085548;252857085555;7;2,9;2;1;1
252857085555;252857085556;1;2,9;2;1;1
252857085556;252857085567;11;2,9;2;1;1
252857085567;252857085572;5;2,9;2;1;1
252857085572;252857085575;3;2,9;2;1;1
252857085575;252857085580;5;2,9;2;1;1
252857085580;252857085586;6;2,9;2;1;1
252857085586;252857085592;6;2,9;2;1;1
252857085592;252857085595;3;2,9;2;1;1
252857085595;252857085599;4;2,9;2;1;1
252857085599;252857085617;18;2,9;2;1;1
252857085617;252857085623;6;2,9;2;1;1
252857085623;252857085626;3;2,9;2;1;1
252857085626;252857085628;2;2,9;2;1;1
252857085628;252857085645;17;2,9;2;1;1
252857085645;252857085646;1;2,9;2;1;1
252857085646;252857085648;2;2,9;2;1;1
252857085648;252857085654;6;2,9;2;1;1
252857085654;252857085657;3;2,9;2;1;1
252857085657;252857085658;1;2,9;2;1;1
252857085658;252857085669;11;2,9;2;1;1
252857085669;252857085670;1;2,9;2;1;1
252857085670;252857085672;2;2,9;2;1;1
252857085672;252857085676;4;2,9;2;1;1
252857085676;252857085682;6;2,9;2;1;1
252857085682;252857085687;5;2,9;2;1;1
252857085687;252857085690;3;2,9;2;1;1
252857085690;252857085692;2;2,9;2;1;1
252857085692;252857085695;3;2,9;2;1;1
252857085695;252857085699;4;2,9;2;1;1
252857085699;252857085701;2;2,9;2;1;1
252857085701;252857085705;4;2,9;2;1;1
252857085705;252857085712;7;2,9;2;1;1
252857085712;252857085718;6;2,9;2;1;1
252857085718;252857085721;3;2,9;2;1;1
252857085721;252857085722;1;2,9;2;1;1
252857085722;252857085727;5;2,9;2;1;1
252857085727;252857085740;13;2,9;2;1;1
252857085740;252857085742;2;2,9;2;1;1
252857085742;252857085745;3;2,9;2;1;1
252857085745;252857085748;3;2,9;2;1;1
252857085748;252857085759;11;2,9;2;1;1
252857085759;252857085762;3;2,9;2;1;1
252857085762;252857085763;1;2,9;2;1;1
252857085763;252857085764;1;2,9;2;1;1
252857085764;252857085770;6;2,9;2;1;1
252857085770;252857085775;5;2,9;2;1;1
252857085775;252857085778;3;2,9;2;1;1
252857085778;252857085799;21;2,9;2;1;1
252857085799;252857085817;18;2,9;2;1;1
252857085817;252857085819;2;2,9;2;1;1
252857085819;252857085821;2;2,9;2;1;1
252857085821;252857085822;1;2,9;2;1;1
252857085822;252857085824;2;2,9;2;1;1
252857085824;252857085826;2;2,9;2;1;1
252857085826;252857085838;12;2,9;2;1;1
252857085838;252857085843;5;2,9;2;1;1
252857085843;252857085844;1;2,9;2;1;1
252857085844;252857085850;6;2,9;2;1;1
252857085850;252857085851;1;2,9;2;1;1
252857085851;252857085862;11;2,9;2;1;1
252857085862;252857085870;8;2,9;2;1;1
252857085870;252857085876;6;2,9;2;1;1
252857085876;252857085879;3;2,9;2;1;1
252857085879;252857085881;2;2,9;2;1;1
252857085881;252857085884;3;2,9;2;1;1
252857085884;252857085885;1;2,9;2;1;1
252857085885;252857085905;20;2,9;2;1;1
252857085905;252857085920;15;2,9;2;1;1
252857085920;252857085923;3;2,9;2;1;1
252857085923;252857085932;9;2,9;2;1;1
252857085932;252857085942;10;2,9;2;1;1
252857085942;252857085950;8;2,9;2;1;1
252857085950;252857085952;2;2,9;2;1;1
252857085952;252857085956;4;2,9;2;1;1
252857085956;252857085960;4;2,9;2;1;1
252857085960;252857085961;1;2,9;2;1;1
252857085961;252857085963;2;2,9;2;1;1
252857085963;252857085965;2;2,9;2;1;1
252857085965;252857085967;2;2,9;2;1;1
252857085967;252857085971;4;2,9;2;1;1
252857085971;252857085973;2;2,9;2;1;1
252857085973;252857085984;11;2,9;2;1;1
252857085984;252857085986;2;2,9;2;1;1
252857085986;252857085991;5;2,9;2;1;1
252857085991;252857085993;2;2,9;2;1;1
252857085993;252857086001;8;2,9;2;1;1
252857086001;252857086003;2;2,9;2;1;1
252857086003;252857086004;1;2,9;2;1;1
252857086004;252857086006;2;2,9;2;1;1
252857086006;252857086021;15;2,9;2;1;1
252857086021;252857086025;4;2,9;2;1;1
252857086025;252857086032;7;2,9;2;1;1
252857086032;252857086034;2;2,9;2;1;1
252857086034;252857086036;2;2,9;2;1;1
252857086036;252857086042;6;2,9;2;1;1
252857086042;252857086050;8;2,9;2;1;1
252857086050;252857086059;9;2,9;2;1;1
252857086059;252857086060;1;2,9;2;1;1
252857086060;252857086067;7;2,9;2;1;1
252857086067;252857086070;3;2,9;2;1;1
252857086070;252857086073;3;2,9;2;1;1
252857086073;252857086080;7;2,9;2;1;1
252857086080;252857086085;5;2,9;2;1;1
252857086085;252857086086;1;2,9;2;1;1
252857086086;252857086099;13;2,9;2;1;1
252857086099;252857086102;3;2,9;2;1;1
252857086102;252857086104;2;2,9;2;1;1
252857086104;252857086109;5;2,9;2;1;1
252857086109;252857086113;4;2,9;2;1;1
252857086113;252857086118;5;2,9;2;1;1
252857086118;252857086123;5;2,9;2;1;1
252857086123;252857086124;1;2,9;2;1;1
252857086124;252857086128;4;2,9;2;1;1
252857086128;252857086130;2;2,9;2;1;1
252857086130;252857086134;4;2,9;2;1;1
252857086134;252857086139;5;2,9;2;1;1
252857086139;252857086145;6;2,9;2;1;1
252857086145;252857086159;14;2,9;2;1;1
252857086159;252857086162;3;2,9;2;1;1
252857086162;252857086164;2;2,9;2;1;1
252857086164;252857086174;10;2,9;2;1;1
252857086174;252857086177;3;2,9;2;1;1
252857086177;252857086180;3;2,9;2;1;1
252857086180;252857086183;3;2,9;2;1;1
252857086183;252857086184;1;2,9;2;1;1
252857086184;252857086187;3;2,9;2;1;1
252857086187;252857086192;5;2,9;2;1;1
252857086192;252857086194;2;2,9;2;1;1
252857086194;252857086198;4;2,9;2;1;1
252857086198;252857086199;1;2,9;2;1;1
252857086199;252857086201;2;2,9;2;1;1
252857086201;252857086208;7;2,9;2;1;1
252857086208;252857086213;5;2,9;2;1;1
252857086213;252857086215;2;2,9;2;1;1
252857086215;252857086216;1;2,9;2;1;1
252857086216;252857086218;2;2,9;2;1;1
252857086218;252857086221;3;2,9;2;1;1
252857086221;252857086226;5;2,9;2;1;1
252857086226;252857086235;9;2,9;2;1;1
252857086235;252857086237;2;2,9;2;1;1
252857086237;252857086241;4;2,9;2;1;1
252857086241;252857086247;6;2,9;2;1;1
252857086247;252857086253;6;2,9;2;1;1
252857086253;252857086257;4;2,9;2;1;1
252857086257;252857086259;2;2,9;2;1;1
252857086259;252857086273;14;2,9;2;1;1
252857086273;252857086274;1;2,9;2;1;1
252857086274;252857086278;4;2,9;2;1;1
252857086278;252857086279;1;2,9;2;1;1
252857086279;252857086281;2;2,9;2;1;1
252857086281;252857086285;4;2,9;2;1;1
252857086285;252857086289;4;2,9;2;1;1
252857086289;252857086299;10;2,9;2;1;1
252857086299;252857086301;2;2,9;2;1;1
252857086301;252857086303;2;2,9;2;1;1
252857086303;252857086304;1;2,9;2;1;1
252857086304;252857086310;6;2,9;2;1;1
252857086310;252857086312;2;2,9;2;1;1
252857086312;252857086317;5;2,9;2;1;1
252857086317;252857086318;1;2,9;2;1;1
252857086318;252857086331;13;2,9;2;1;1
252857086331;252857086348;17;2,9;2;1;1
252857086348;252857086361;13;2,9;2;1;1
252857086361;252857086363;2;2,9;2;1;1
252857086363;252857086367;4;2,9;2;1;1
252857086367;252857086372;5;2,9;2;1;1
252857086372;252857086376;4;2,9;2;1;1
252857086376;252857086377;1;2,9;2;1;1
252857086377;252857086379;2;2,9;2;1;1
252857086379;252857086381;2;2,9;2;1;1
252857086381;252857086383;2;2,9;2;1;1
252857086383;252857086384;1;2,9;2;1;1
252857086384;252857086392;8;2,9;2;1;1
252857086392;252857086398;6;2,9;2;1;1
252857086398;252857086405;7;2,9;2;1;1
252857086405;252857086406;1;2,9;2;1;1
252857086406;252857086410;4;2,9;2;1;1
252857086410;252857086418;8;2,9;2;1;1
252857086418;252857086420;2;2,9;2;1;1
252857086420;252857086424;4;2,9;2;1;1
252857086424;252857086429;5;2,9;2;1;1
252857086429;252857086430;1;2,9;2;1;1
252857086430;252857086431;1;2,9;2;1;1
252857086431;252857086436;5;2,9;2;1;1
252857086436;252857086446;10;2,9;2;1;1
252857086446;252857086448;2;2,9;2;1;1
252857086448;252857086449;1;2,9;2;1;1
252857086449;252857086452;3;2,9;2;1;1
252857086452;252857086456;4;2,9;2;1;1
252857086456;252857086457;1;2,9;2;1;1
252857086457;252857086461;4;2,9;2;1;1
252857086461;252857086463;2;2,9;2;1;1
252857086463;252857086465;2;2,9;2;1;1
252857086465;252857086467;2;2,9;2;1;1
252857086467;252857086473;6;2,9;2;1;1
252857086473;252857086475;2;2,9;2;1;1
252857086475;252857086480;5;2,9;2;1;1
252857086480;252857086481;1;2,9;2;1;1
252857086481;252857086487;6;2,9;2;1;1
252857086487;252857086489;2;2,9;2;1;1
252857086489;252857086491;2;2,9;2;1;1
252857086491;252857086492;1;2,9;2;1;1
252857086492;252857086493;1;2,9;2;1;1
252857086493;252857086494;1;2,9;2;1;1
252857086494;252857086495;1;2,9;2;1;1
252857086495;252857086501;6;2,9;2;1;1
252857086501;252857086502;1;2,9;2;1;1
252857086502;252857086503;1;2,9;2;1;1
252857086503;252857086505;2;2,9;2;1;1
252857086505;252857086506;1;2,9;2;1;1
252857086506;252857086509;3;2,9;2;1;1
252857086509;252857086510;1;2,9;2;1;1
252857086510;252857086512;2;2,9;2;1;1
252857086512;252857086518;6;2,9;2;1;1
252857086518;252857086520;2;2,9;2;1;1
252857086520;252857086521;1;2,9;2;1;1
252857086521;252857086524;3;2,9;2;1;1
252857086524;252857086528;4;2,9;2;1;1
252857086528;252857086534;6;2,9;2;1;1
252857086534;252857086542;8;2,9;2;1;1
252857086542;252857086548;6;2,9;2;1;1
252857086548;252857086549;1;2,9;2;1;1
252857086549;252857086550;1;2,9;2;1;1
252857086550;252857086551;1;2,9;2;1;1
252857086551;252857086552;1;2,9;2;1;1
252857086552;252857086556;4;2,9;2;1;1
252857086556;252857086558;2;2,9;2;1;1
252857086558;252857086567;9;2,9;2;1;1
252857086567;252857086575;8;2,9;2;1;1
252857086575;252857086576;1;2,9;2;1;1
252857086576;252857086577;1;2,9;2;1;1
252857086577;252857086584;7;2,9;2;1;1
252857086584;252857086585;1;2,9;2;1;1
252857086585;252857086589;4;2,9;2;1;1
252857086589;252857086592;3;2,9;2;1;1
252857086592;252857086593;1;2,9;2;1;1
252857086593;252857086595;2;2,9;2;1;1
252857086595;252857086596;1;2,9;2;1;1
252857086596;252857086601;5;2,9;2;1;1
252857086601;252857086604;3;2,9;2;1;1
252857086604;252857086608;4;2,9;2;1;1
252857086608;252857086616;8;2,9;2;1;1
252857086616;252857086622;6;2,9;2;1;1
252857086622;252857086627;5;2,9;2;1;1
252857086627;252857086628;1;2,9;2;1;1
252857086628;252857086633;5;2,9;2;1;1
252857086633;252857086636;3;2,9;2;1;1
252857086636;252857086639;3;2,9;2;1;1
252857086639;252857086647;8;2,9;2;1;1
252857086647;252857086649;2;2,9;2;1;1
252857086649;252857086654;5;2,9;2;1;1
252857086654;252857086657;3;2,9;2;1;1
252857086657;252857086660;3;2,9;2;1;1
252857086660;252857086664;4;2,9;2;1;1
252857086664;252857086674;10;2,9;2;1;1
252857086674;252857086675;1;2,9;2;1;1
252857086675;252857086677;2;2,9;2;1;1
252857086677;252857086678;1;2,9;2;1;1
252857086678;252857086680;2;2,9;2;1;1
252857086680;252857086688;8;2,9;2;1;1
252857086688;252857086696;8;2,9;2;1;1
252857086696;252857086697;1;2,9;2;1;1
252857086697;252857086698;1;2,9;2;1;1
252857086698;252857086704;6;2,9;2;1;1
252857086704;252857086705;1;2,9;2;1;1
252857086705;252857086707;2;2,9;2;1;1
252857086707;252857086711;4;2,9;2;1;1
252857086711;252857086712;1;2,9;2;1;1
252857086712;252857086718;6;2,9;2;1;1
252857086718;252857086721;3;2,9;2;1;1
252857086721;252857086727;6;2,9;2;1;1
252857086727;252857086728;1;2,9;2;1;1
252857086728;252857086731;3;2,9;2;1;1
252857086731;252857086736;5;2,9;2;1;1
252857086736;252857086737;1;2,9;2;1;1
252857086737;252857086740;3;2,9;2;1;1
252857086740;252857086752;12;2,9;2;1;1
252857086752;252857086753;1;2,9;2;1;1
252857086753;252857086756;3;2,9;2;1;1
252857086756;252857086757;1;2,9;2;1;1
252857086757;252857086761;4;2,9;2;1;1
252857086761;252857086770;9;2,9;2;1;1
252857086770;252857086776;6;2,9;2;1;1
252857086776;252857086778;2;2,9;2;1;1
252857086778;252857086785;7;2,9;2;1;1
252857086785;252857086792;7;2,9;2;1;1
252857086792;252857086794;2;2,9;2;1;1
252857086794;252857086798;4;2,9;2;1;1
252857086798;252857086800;2;2,9;2;1;1
252857086800;252857086803;3;2,9;2;1;1
252857086803;252857086807;4;2,9;2;1;1
252857086807;252857086810;3;2,9;2;1;1
252857086810;252857086815;5;2,9;2;1;1
252857086815;252857086817;2;2,9;2;1;1
252857086817;252857086818;1;2,9;2;1;1
252857086818;252857086825;7;2,9;2;1;1
252857086825;252857086826;1;2,9;2;1;1
252857086826;252857086832;6;2,9;2;1;1
252857086832;252857086833;1;2,9;2;1;1
252857086833;252857086834;1;2,9;2;1;1
252857086834;252857086835;1;2,9;2;1;1
252857086835;252857086836;1;2,9;2;1;1
252857086836;252857086843;7;2,9;2;1;1
252857086843;252857086844;1;2,9;2;1;1
252857086844;252857086848;4;2,9;2;1;1
252857086848;252857086851;3;2,9;2;1;1
252857086851;252857086864;13;2,9;2;1;1
252857086864;252857086867;3;2,9;2;1;1
252857086867;252857086871;4;2,9;2;1;1
252857086871;252857086872;1;2,9;2;1;1
252857086872;252857086874;2;2,9;2;1;1
252857086874;252857086876;2;2,9;2;1;1
252857086876;252857086884;8;2,9;2;1;1
252857086884;252857086890;6;2,9;2;1;1
252857086890;252857086891;1;2,9;2;1;1
252857086891;252857086894;3;2,9;2;1;1
252857086894;252857086899;5;2,9;2;1;1
252857086899;252857086901;2;2,9;2;1;1
252857086901;252857086904;3;2,9;2;1;1
252857086904;252857086905;1;2,9;2;1;1
252857086905;252857086906;1;2,9;2;1;1
252857086906;252857086919;13;2,9;2;1;1
252857086919;252857086920;1;2,9;2;1;1
252857086920;252857086931;11;2,9;2;1;1
252857086931;252857086939;8;2,9;2;1;1
252857086939;252857086940;1;2,9;2;1;1
252857086940;252857086941;1;2,9;2;1;1
252857086941;252857086942;1;2,9;2;1;1
252857086942;252857086943;1;2,9;2;1;1
252857086943;252857086945;2;2,9;2;1;1
252857086945;252857086947;2;2,9;2;1;1
252857086947;252857086959;12;2,9;2;1;1
252857086959;252857086964;5;2,9;2;1;1
252857086964;252857086967;3;2,9;2;1;1
252857086967;252857086969;2;2,9;2;1;1
252857086969;252857086970;1;2,9;2;1;1
252857086970;252857086974;4;2,9;2;1;1
252857086974;252857086982;8;2,9;2;1;1
252857086982;252857086983;1;2,9;2;1;1
252857086983;252857086988;5;2,9;2;1;1
252857086988;252857086994;6;2,9;2;1;1
252857086994;252857086995;1;2,9;2;1;1
252857086995;252857086998;3;2,9;2;1;1
252857086998;252857087001;3;2,9;2;1;1
252857087001;252857087003;2;2,9;2;1;1
252857087003;252857087004;1;2,9;2;1;1
252857087004;252857087006;2;2,9;2;1;1
252857087006;252857087009;3;2,9;2;1;1
252857087009;252857087015;6;2,9;2;1;1
252857087015;252857087016;1;2,9;2;1;1
252857087016;252857087026;10;2,9;2;1;1
252857087026;252857087029;3;2,9;2;1;1
252857087029;252857087037;8;2,9;2;1;1
252857087037;252857087039;2;2,9;2;1;1
252857087039;252857087040;1;2,9;2;1;1
252857087040;252857087047;7;2,9;2;1;1
252857087047;252857087056;9;2,9;2;1;1
252857087056;252857087060;4;2,9;2;1;1
252857087060;252857087062;2;2,9;2;1;1
252857087062;252857087065;3;2,9;2;1;1
252857087065;252857087081;16;2,9;2;1;1
252857087081;252857087084;3;2,9;2;1;1
252857087084;252857087096;12;2,9;2;1;1
252857087096;252857087098;2;2,9;2;1;1
252857087098;252857087101;3;2,9;2;1;1
252857087101;252857087102;1;2,9;2;1;1
252857087102;252857087110;8;2,9;2;1;1
252857087110;252857087114;4;2,9;2;1;1
252857087114;252857087117;3;2,9;2;1;1
252857087117;252857087120;3;2,9;2;1;1
252857087120;252857087128;8;2,9;2;1;1
252857087128;252857087131;3;2,9;2;1;1
252857087131;252857087141;10;2,9;2;1;1
252857087141;252857087142;1;2,9;2;1;1
252857087142;252857087143;1;2,9;2;1;1
252857087143;252857087147;4;2,9;2;1;1
252857087147;252857087148;1;2,9;2;1;1
252857087148;252857087150;2;2,9;2;1;1
252857087150;252857087156;6;2,9;2;1;1
252857087156;252857087157;1;2,9;2;1;1
252857087157;252857087163;6;2,9;2;1;1
252857087163;252857087167;4;2,9;2;1;1
252857087167;252857087170;3;2,9;2;1;1
252857087170;252857087173;3;2,9;2;1;1
252857087173;252857087179;6;2,9;2;1;1
252857087179;252857087182;3;2,9;2;1;1
252857087182;252857087188;6;2,9;2;1;1
252857087188;252857087190;2;2,9;2;1;1
252857087190;252857087191;1;2,9;2;1;1
252857087191;252857087194;3;2,9;2;1;1
252857087194;252857087195;1;2,9;2;1;1
252857087195;252857087199;4;2,9;2;1;1
252857087199;252857087214;15;2,9;2;1;1
252857087214;252857087222;8;2,9;2;1;1
252857087222;252857087225;3;2,9;2;1;1
252857087225;252857087229;4;2,9;2;1;1
252857087229;252857087250;21;2,9;2;1;1
252857087250;252857087254;4;2,9;2;1;1
252857087254;252857087256;2;2,9;2;1;1
252857087256;252857087259;3;2,9;2;1;1
252857087259;252857087262;3;2,9;2;1;1
252857087262;252857087266;4;2,9;2;1;1
252857087266;252857087287;21;2,9;2;1;1
252857087287;252857087290;3;2,9;2;1;1
252857087290;252857087293;3;2,9;2;1;1
252857087293;252857087303;10;2,9;2;1;1
252857087303;252857087316;13;2,9;2;1;1
252857087316;252857087319;3;2,9;2;1;1
252857087319;252857087320;1;2,9;2;1;1
252857087320;252857087338;18;2,9;2;1;1
252857087338;252857087341;3;2,9;2;1;1
252857087341;252857087344;3;2,9;2;1;1
252857087344;252857087345;1;2,9;2;1;1
252857087345;252857087346;1;2,9;2;1;1
252857087346;252857087348;2;2,9;2;1;1
252857087348;252857087359;11;2,9;2;1;1
252857087359;252857087365;6;2,9;2;1;1
252857087365;252857087374;9;2,9;2;1;1
252857087374;252857087376;2;2,9;2;1;1
252857087376;252857087377;1;2,9;2;1;1
252857087377;252857087383;6;2,9;2;1;1
252857087383;252857087385;2;2,9;2;1;1
252857087385;252857087388;3;2,9;2;1;1
252857087388;252857087392;4;2,9;2;1;1
252857087392;252857087395;3;2,9;2;1;1
252857087395;252857087401;6;2,9;2;1;1
252857087401;252857087404;3;2,9;2;1;1
252857087404;252857087411;7;2,9;2;1;1
252857087411;252857087412;1;2,9;2;1;1
252857087412;252857087416;4;2,9;2;1;1
252857087416;252857087418;2;2,9;2;1;1
252857087418;252857087421;3;2,9;2;1;1
252857087421;252857087430;9;2,9;2;1;1
252857087430;252857087439;9;2,9;2;1;1
252857087439;252857087445;6;2,9;2;1;1
252857087445;252857087446;1;2,9;2;1;1
252857087446;252857087451;5;2,9;2;1;1
252857087451;252857087461;10;2,9;2;1;1
252857087461;252857087463;2;2,9;2;1;1
252857087463;252857087471;8;2,9;2;1;1
252857087471;252857087476;5;2,9;2;1;1
252857087476;252857087477;1;2,9;2;1;1
252857087477;252857087482;5;2,9;2;1;1
252857087482;252857087503;21;2,9;2;1;1
252857087503;252857087505;2;2,9;2;1;1
252857087505;252857087509;4;2,9;2;1;1
252857087509;252857087513;4;2,9;2;1;1
252857087513;252857087520;7;2,9;2;1;1
252857087520;252857087534;14;2,9;2;1;1
252857087534;252857087537;3;2,9;2;1;1
252857087537;252857087547;10;2,9;2;1;1
252857087547;252857087560;13;2,9;2;1;1
252857087560;252857087568;8;2,9;2;1;1
252857087568;252857087574;6;2,9;2;1;1
252857087574;252857087576;2;2,9;2;1;1
252857087576;252857087583;7;2,9;2;1;1
252857087583;252857087588;5;2,9;2;1;1
252857087588;252857087594;6;2,9;2;1;1
252857087594;252857087597;3;2,9;2;1;1
252857087597;252857087617;20;2,9;2;1;1
252857087617;252857087618;1;2,9;2;1;1
252857087618;252857087619;1;2,9;2;1;1
252857087619;252857087626;7;2,9;2;1;1
252857087626;252857087635;9;2,9;2;1;1
252857087635;252857087645;10;2,9;2;1;1
252857087645;252857087659;14;2,9;2;1;1
252857087659;252857087663;4;2,9;2;1;1
252857087663;252857087670;7;2,9;2;1;1
252857087670;252857087684;14;2,9;2;1;1
252857087684;252857087686;2;2,9;2;1;1
252857087686;252857087688;2;2,9;2;1;1
252857087688;252857087689;1;2,9;2;1;1
252857087689;252857087693;4;2,9;2;1;1
252857087693;252857087699;6;2,9;2;1;1
252857087699;252857087700;1;2,9;2;1;1
252857087700;252857087707;7;2,9;2;1;1
252857087707;252857087712;5;2,9;2;1;1
252857087712;252857087715;3;2,9;2;1;1
252857087715;252857087716;1;2,9;2;1;1
252857087716;252857087724;8;2,9;2;1;1
252857087724;252857087727;3;2,9;2;1;1
252857087727;252857087728;1;2,9;2;1;1
252857087728;252857087731;3;2,9;2;1;1
252857087731;252857087734;3;2,9;2;1;1
252857087734;252857087736;2;2,9;2;1;1
252857087736;252857087737;1;2,9;2;1;1
252857087737;252857087740;3;2,9;2;1;1
252857087740;252857087743;3;2,9;2;1;1
252857087743;252857087750;7;2,9;2;1;1
252857087750;252857087758;8;2,9;2;1;1
252857087758;252857087763;5;2,9;2;1;1
252857087763;252857087770;7;2,9;2;1;1
252857087770;252857087783;13;2,9;2;1;1
252857087783;252857087791;8;2,9;2;1;1
252857087791;252857087799;8;2,9;2;1;1
252857087799;252857087802;3;2,9;2;1;1
252857087802;252857087803;1;2,9;2;1;1
252857087803;252857087804;1;2,9;2;1;1
252857087804;252857087806;2;2,9;2;1;1
252857087806;252857087810;4;2,9;2;1;1
252857087810;252857087817;7;2,9;2;1;1
252857087817;252857087819;2;2,9;2;1;1
252857087819;252857087827;8;2,9;2;1;1
252857087827;252857087828;1;2,9;2;1;1
252857087828;252857087832;4;2,9;2;1;1
252857087832;252857087833;1;2,9;2;1;1
252857087833;252857087837;4;2,9;2;1;1
252857087837;252857087842;5;2,9;2;1;1
252857087842;252857087865;23;2,9;2;1;1
252857087865;252857087878;13;2,9;2;1;1
252857087878;252857087894;16;2,9;2;1;1
252857087894;252857087899;5;2,9;2;1;1
252857087899;252857087905;6;2,9;2;1;1
252857087905;252857087910;5;2,9;2;1;1
252857087910;252857087911;1;2,9;2;1;1
252857087911;252857087919;8;2,9;2;1;1
252857087919;252857087924;5;2,9;2;1;1
252857087924;252857087934;10;2,9;2;1;1
252857087934;252857087935;1;2,9;2;1;1
252857087935;252857087947;12;2,9;2;1;1
252857087947;252857087948;1;2,9;2;1;1
252857087948;252857087952;4;2,9;2;1;1
252857087952;252857087957;5;2,9;2;1;1
252857087957;252857087959;2;2,9;2;1;1
252857087959;252857087967;8;2,9;2;1;1
252857087967;252857087971;4;2,9;2;1;1
252857087971;252857087975;4;2,9;2;1;1
252857087975;252857087988;13;2,9;2;1;1
252857087988;252857087989;1;2,9;2;1;1
252857087989;252857088006;17;2,9;2;1;1
252857088006;252857088007;1;2,9;2;1;1
252857088007;252857088034;27;2,9;2;1;1
252857088034;252857088036;2;2,9;2;1;1
252857088036;252857088044;8;2,9;2;1;1
252857088044;252857088046;2;2,9;2;1;1
252857088046;252857088058;12;2,9;2;1;1
252857088058;252857088061;3;2,9;2;1;1
252857088061;252857088068;7;2,9;2;1;1
252857088068;252857088074;6;2,9;2;1;1
252857088074;252857088091;17;2,9;2;1;1
252857088091;252857088100;9;2,9;2;1;1
252857088100;252857088104;4;2,9;2;1;1
252857088104;252857088109;5;2,9;2;1;1
252857088109;252857088116;7;2,9;2;1;1
252857088116;252857088119;3;2,9;2;1;1
252857088119;252857088121;2;2,9;2;1;1
252857088121;252857088138;17;2,9;2;1;1
252857088138;252857088143;5;2,9;2;1;1
252857088143;252857088155;12;2,9;2;1;1
252857088155;252857088165;10;2,9;2;1;1
252857088165;252857088171;6;2,9;2;1;1
252857088171;252857088183;12;2,9;2;1;1
252857088183;252857088187;4;2,9;2;1;1
252857088187;252857088189;2;2,9;2;1;1
252857088189;252857088206;17;2,9;2;1;1
252857088206;252857088212;6;2,9;2;1;1
252857088212;252857088218;6;2,9;2;1;1
252857088218;252857088222;4;2,9;2;1;1
252857088222;252857088231;9;2,9;2;1;1
252857088231;252857088232;1;2,9;2;1;1
252857088232;252857088239;7;2,9;2;1;1
252857088239;252857088244;5;2,9;2;1;1
252857088244;252857088249;5;2,9;2;1;1
252857088249;252857088252;3;2,9;2;1;1
252857088252;252857088259;7;2,9;2;1;1
252857088259;252857088263;4;2,9;2;1;1
252857088263;252857088278;15;2,9;2;1;1
252857088278;252857088282;4;2,9;2;1;1
252857088282;252857088288;6;2,9;2;1;1
252857088288;252857088299;11;2,9;2;1;1
252857088299;252857088303;4;2,9;2;1;1
252857088303;252857088304;1;2,9;2;1;1
252857088304;252857088310;6;2,9;2;1;1
252857088310;252857088314;4;2,9;2;1;1
252857088314;252857088324;10;2,9;2;1;1
252857088324;252857088334;10;2,9;2;1;1
252857088334;252857088337;3;2,9;2;1;1
252857088337;252857088339;2;2,9;2;1;1
252857088339;252857088346;7;2,9;2;1;1
252857088346;252857088361;15;2,9;2;1;1
252857088361;252857088363;2;2,9;2;1;1
252857088363;252857088365;2;2,9;2;1;1
252857088365;252857088370;5;2,9;2;1;1
252857088370;252857088373;3;2,9;2;1;1
252857088373;252857088380;7;2,9;2;1;1
252857088380;252857088385;5;2,9;2;1;1
252857088385;252857088396;11;2,9;2;1;1
252857088396;252857088402;6;2,9;2;1;1
252857088402;252857088410;8;2,9;2;1;1
252857088410;252857088413;3;2,9;2;1;1
252857088413;252857088414;1;2,9;2;1;1
252857088414;252857088440;26;2,9;2;1;1
252857088440;252857088443;3;2,9;2;1;1
252857088443;252857088452;9;2,9;2;1;1
252857088452;252857088467;15;2,9;2;1;1
252857088467;252857088474;7;2,9;2;1;1
252857088474;252857088481;7;2,9;2;1;1
252857088481;252857088497;16;2,9;2;1;1
252857088497;252857088514;17;2,9;2;1;1
252857088514;252857088529;15;2,9;2;1;1
252857088529;252857088541;12;2,9;2;1;1
252857088541;252857088546;5;2,9;2;1;1
252857088546;252857088565;19;2,9;2;1;1
252857088565;252857088566;1;2,9;2;1;1
252857088566;252857088570;4;2,9;2;1;1
252857088570;252857088576;6;2,9;2;1;1
252857088576;252857088584;8;2,9;2;1;1
252857088584;252857088593;9;2,9;2;1;1
252857088593;252857088598;5;2,9;2;1;1
252857088598;252857088603;5;2,9;2;1;1
252857088603;252857088627;24;2,9;2;1;1
252857088627;252857088635;8;2,9;2;1;1
252857088635;252857088639;4;2,9;2;1;1
252857088639;252857088651;12;2,9;2;1;1
252857088651;252857088661;10;2,9;2;1;1
252857088661;252857088666;5;2,9;2;1;1
252857088666;252857088687;21;2,9;2;1;1
252857088687;252857088693;6;2,9;2;1;1
252857088693;252857088699;6;2,9;2;1;1
252857088699;252857088706;7;2,9;2;1;1
252857088706;252857088707;1;2,9;2;1;1
252857088707;252857088721;14;2,9;2;1;1
252857088721;252857088724;3;2,9;2;1;1
252857088724;252857088732;8;2,9;2;1;1
252857088732;252857088746;14;2,9;2;1;1
252857088746;252857088748;2;2,9;2;1;1
252857088748;252857088757;9;2,9;2;1;1
252857088757;252857088764;7;2,9;2;1;1
252857088764;252857088769;5;2,9;2;1;1
252857088769;252857088777;8;2,9;2;1;1
252857088777;252857088778;1;2,9;2;1;1
252857088778;252857088779;1;2,9;2;1;1
252857088779;252857088782;3;2,9;2;1;1
252857088782;252857088798;16;2,9;2;1;1
252857088798;252857088804;6;2,9;2;1;1
252857088804;252857088810;6;2,9;2;1;1
252857088810;252857088821;11;2,9;2;1;1
252857088821;252857088832;11;2,9;2;1;1
252857088832;252857088852;20;2,9;2;1;1
252857088852;252857088857;5;2,9;2;1;1
252857088857;252857088881;24;2,9;2;1;1
252857088881;252857088889;8;2,9;2;1;1
252857088889;252857088901;12;2,9;2;1;1
252857088901;252857088903;2;2,9;2;1;1
252857088903;252857088908;5;2,9;2;1;1
252857088908;252857088912;4;2,9;2;1;1
252857088912;252857088917;5;2,9;2;1;1
252857088917;252857088927;10;2,9;2;1;1
252857088927;252857088934;7;2,9;2;1;1
252857088934;252857088936;2;2,9;2;1;1
252857088936;252857088942;6;2,9;2;1;1
252857088942;252857088956;14;2,9;2;1;1
252857088956;252857088966;10;2,9;2;1;1
252857088966;252857088971;5;2,9;2;1;1
252857088971;252857088983;12;2,9;2;1;1
252857088983;252857088986;3;2,9;2;1;1
252857088986;252857088997;11;2,9;2;1;1
252857088997;252857089005;8;2,9;2;1;1
252857089005;252857089030;25;2,9;2;1;1
252857089030;252857089032;2;2,9;2;1;1
252857089032;252857089033;1;2,9;2;1;1
252857089033;252857089040;7;2,9;2;1;1
252857089040;252857089087;47;2,9;2;1;1
252857089087;252857089091;4;2,9;2;1;1
252857089091;252857089104;13;2,9;2;1;1
252857089104;252857089111;7;2,9;2;1;1
252857089111;252857089112;1;2,9;2;1;1
252857089112;252857089125;13;2,9;2;1;1
252857089125;252857089126;1;2,9;2;1;1
252857089126;252857089130;4;2,9;2;1;1
252857089130;252857089160;30;2,9;2;1;1
252857089160;252857089171;11;2,9;2;1;1
252857089171;252857089180;9;2,9;2;1;1
252857089180;252857089198;18;2,9;2;1;1
252857089198;252857089203;5;2,9;2;1;1
252857089203;252857089210;7;2,9;2;1;1
252857089210;252857089211;1;2,9;2;1;1
252857089211;252857089220;9;2,9;2;1;1
252857089220;252857089235;15;2,9;2;1;1
252857089235;252857089238;3;2,9;2;1;1
252857089238;252857089251;13;2,9;2;1;1
252857089251;252857089278;27;2,9;2;1;1
252857089278;252857089283;5;2,9;2;1;1
252857089283;252857089285;2;2,9;2;1;1
252857089285;252857089291;6;2,9;2;1;1
252857089291;252857089298;7;2,9;2;1;1
252857089298;252857089303;5;2,9;2;1;1
252857089303;252857089307;4;2,9;2;1;1
252857089307;252857089310;3;2,9;2;1;1
252857089310;252857089316;6;2,9;2;1;1
252857089316;252857089324;8;2,9;2;1;1
252857089324;252857089326;2;2,9;2;1;1
252857089326;252857089335;9;2,9;2;1;1
252857089335;252857089345;10;2,9;2;1;1
252857089345;252857089348;3;2,9;2;1;1
252857089348;252857089350;2;2,9;2;1;1
252857089350;252857089353;3;2,9;2;1;1
252857089353;252857089371;18;2,9;2;1;1
252857089371;252857089376;5;2,9;2;1;1
252857089376;252857089377;1;2,9;2;1;1
252857089377;252857089386;9;2,9;2;1;1
252857089386;252857089389;3;2,9;2;1;1
252857089389;252857089394;5;2,9;2;1;1
252857089394;252857089395;1;2,9;2;1;1
252857089395;252857089409;14;2,9;2;1;1
252857089409;252857089412;3;2,9;2;1;1
252857089412;252857089421;9;2,9;2;1;1
252857089421;252857089447;26;2,9;2;1;1
252857089447;252857089451;4;2,9;2;1;1
252857089451;252857089466;15;2,9;2;1;1
252857089466;252857089469;3;2,9;2;1;1
252857089469;252857089470;1;2,9;2;1;1
252857089470;252857089473;3;2,9;2;1;1
252857089473;252857089476;3;2,9;2;1;1
252857089476;252857089483;7;2,9;2;1;1
252857089483;252857089485;2;2,9;2;1;1
252857089485;252857089494;9;2,9;2;1;1
252857089494;252857089495;1;2,9;2;1;1
252857089495;252857089499;4;2,9;2;1;1
252857089499;252857089502;3;2,9;2;1;1
252857089502;252857089503;1;2,9;2;1;1
252857089503;252857089511;8;2,9;2;1;1
252857089511;252857089530;19;2,9;2;1;1
252857089530;252857089531;1;2,9;2;1;1
252857089531;252857089537;6;2,9;2;1;1
252857089537;252857089541;4;2,9;2;1;1
252857089541;252857089544;3;2,9;2;1;1
252857089544;252857089546;2;2,9;2;1;1
252857089546;252857089555;9;2,9;2;1;1
252857089555;252857089571;16;2,9;2;1;1
252857089571;252857089594;23;2,9;2;1;1
252857089594;252857089602;8;2,9;2;1;1
252857089602;252857089604;2;2,9;2;1;1
252857089604;252857089625;21;2,9;2;1;1
252857089625;252857089629;4;2,9;2;1;1
252857089629;252857089632;3;2,9;2;1;1
252857089632;252857089635;3;2,9;2;1;1
252857089635;252857089641;6;2,9;2;1;1
252857089641;252857089649;8;2,9;2;1;1
252857089649;252857089655;6;2,9;2;1;1
252857089655;252857089658;3;2,9;2;1;1
252857089658;252857089671;13;2,9;2;1;1
252857089671;252857089684;13;2,9;2;1;1
252857089684;252857089692;8;2,9;2;1;1
252857089692;252857089700;8;2,9;2;1;1
252857089700;252857089711;11;2,9;2;1;1
252857089711;252857089714;3;2,9;2;1;1
252857089714;252857089715;1;2,9;2;1;1
252857089715;252857089718;3;2,9;2;1;1
252857089718;252857089719;1;2,9;2;1;1
252857089719;252857089722;3;2,9;2;1;1
252857089722;252857089726;4;2,9;2;1;1
252857089726;252857089733;7;2,9;2;1;1
252857089733;252857089740;7;2,9;2;1;1
252857089740;252857089798;58;2,9;2;1;1
252857089798;252857089804;6;2,9;2;1;1
252857089804;252857089823;19;2,9;2;1;1
252857089823;252857089824;1;2,9;2;1;1
252857089824;252857089837;13;2,9;2;1;1
252857089837;252857089847;10;2,9;2;1;1
252857089847;252857089855;8;2,9;2;1;1
252857089855;252857089865;10;2,9;2;1;1
252857089865;252857089884;19;2,9;2;1;1
252857089884;252857089909;25;2,9;2;1;1
252857089909;252857089912;3;2,9;2;1;1
252857089912;252857089922;10;2,9;2;1;1
252857089922;252857089938;16;2,9;2;1;1
252857089938;252857089946;8;2,9;2;1;1
252857089946;252857089959;13;2,9;2;1;1
252857089959;252857089967;8;2,9;2;1;1
252857089967;252857089968;1;2,9;2;1;1
252857089968;252857089974;6;2,9;2;1;1
252857089974;252857089979;5;2,9;2;1;1
252857089979;252857089993;14;2,9;2;1;1
252857089993;252857090003;10;2,9;2;1;1
252857090003;252857090008;5;2,9;2;1;1
252857090008;252857090024;16;2,9;2;1;1
252857090024;252857090033;9;2,9;2;1;1
252857090033;252857090042;9;2,9;2;1;1
252857090042;252857090044;2;2,9;2;1;1
252857090044;252857090051;7;2,9;2;1;1
252857090051;252857090071;20;2,9;2;1;1
252857090071;252857090076;5;2,9;2;1;1
252857090076;252857090078;2;2,9;2;1;1
252857090078;252857090081;3;2,9;2;1;1
252857090081;252857090090;9;2,9;2;1;1
252857090090;252857090096;6;2,9;2;1;1
252857090096;252857090105;9;2,9;2;1;1
252857090105;252857090141;36;2,9;2;1;1
252857090141;252857090144;3;2,9;2;1;1
252857090144;252857090173;29;2,9;2;1;1
252857090173;252857090179;6;2,9;2;1;1
252857090179;252857090192;13;2,9;2;1;1
252857090192;252857090198;6;2,9;2;1;1
252857090198;252857090223;25;2,9;2;1;1
252857090223;252857090246;23;2,9;2;1;1
252857090246;252857090250;4;2,9;2;1;1
252857090250;252857090255;5;2,9;2;1;1
252857090255;252857090256;1;2,9;2;1;1
252857090256;252857090258;2;2,9;2;1;1
252857090258;252857090275;17;2,9;2;1;1
252857090275;252857090287;12;2,9;2;1;1
252857090287;252857090292;5;2,9;2;1;1
252857090292;252857090317;25;2,9;2;1;1
252857090317;252857090330;13;2,9;2;1;1
252857090330;252857090335;5;2,9;2;1;1
252857090335;252857090339;4;2,9;2;1;1
252857090339;252857090340;1;2,9;2;1;1
252857090340;252857090349;9;2,9;2;1;1
252857090349;252857090359;10;2,9;2;1;1
252857090359;252857090361;2;2,9;2;1;1
252857090361;252857090369;8;2,9;2;1;1
252857090369;252857090377;8;2,9;2;1;1
252857090377;252857090393;16;2,9;2;1;1
252857090393;252857090402;9;2,9;2;1;1
252857090402;252857090429;27;2,9;2;1;1
252857090429;252857090434;5;2,9;2;1;1
252857090434;252857090460;26;2,9;2;1;1
252857090460;252857090464;4;2,9;2;1;1
252857090464;252857090484;20;2,9;2;1;1
252857090484;252857090521;37;2,9;2;1;1
252857090521;252857090526;5;2,9;2;1;1
252857090526;252857090534;8;2,9;2;1;1
252857090534;252857090536;2;2,9;2;1;1
252857090536;252857090564;28;2,9;2;1;1
252857090564;252857090569;5;2,9;2;1;1
252857090569;252857090664;95;2,9;2;1;1
252857090664;252857090676;12;2,9;2;1;1
252857090676;252857090690;14;2,9;2;1;1
252857090690;252857090703;13;2,9;2;1;1
252857090703;252857090742;39;2,9;2;1;1
252857090742;252857090768;26;2,9;2;1;1
252857090768;252857090769;1;2,9;2;1;1
252857090769;252857090782;13;2,9;2;1;1
252857090782;252857090785;3;2,9;2;1;1
252857090785;252857090795;10;2,9;2;1;1
252857090795;252857090818;23;2,9;2;1;1
252857090818;252857090840;22;2,9;2;1;1
252857090840;252857090872;32;2,9;2;1;1
252857090872;252857090951;79;2,9;2;1;1
252857090951;252857090969;18;2,9;2;1;1
252857090969;252857090987;18;2,9;2;1;1
252857090987;252857091003;16;2,9;2;1;1
252857091003;252857091005;2;2,9;2;1;1
252857091005;252857091013;8;2,9;2;1;1
252857091013;252857091030;17;2,9;2;1;1
252857091030;252857091063;33;2,9;2;1;1
252857091063;252857091154;91;2,9;2;1;1
252857091154;252857091157;3;2,9;2;1;1
252857091157;252857091231;74;2,9;2;1;1
252857091231;252857091288;57;2,9;2;1;1
252857091288;252857091391;103;2,9;2;1;1
252857091391;252857091419;28;2,9;2;1;1
252857091419;252857091435;16;2,9;2;1;1
252857091435;252857091548;113;2,9;2;1;1
252857091548;252857091559;11;2,9;2;1;1
252857091559;252857091575;16;2,9;2;1;1
252857091575;252857091601;26;2,9;2;1;1
252857091601;252857091691;90;2,9;2;1;1
252857091691;252857091692;1;2,9;2;1;1
252857091692;252857091738;46;2,9;2;1;1
252857091738;252857091744;6;2,9;2;1;1
252857091744;252857091825;81;2,9;2;1;1
252857091825;252857091858;33;2,9;2;1;1
252857091858;252857091932;74;2,9;2;1;1
252857091932;252857091989;57;2,9;2;1;1
252857091989;252857092016;27;2,9;2;1;1
252857092016;252857092088;72;2,9;2;1;1
252857092088;252857092113;25;2,9;2;1;1
252857092113;252857092312;199;2,9;2;1;1
252857092312;252857092947;635;2,9;2;1;1
252857092947;252857093035;88;2,9;2;1;1
252857093035;252857093342;307;2,9;2;1;1
252857093342;252857093678;336;2,9;2;1;1
252857093678;252857093723;45;2,9;2;1;1
252857093723;252857093760;37;2,9;2;1;1
252857093760;252857093825;65;2,9;2;1;1
252857093825;252857093857;32;2,9;2;1;1
252857093857;252857093919;62;2,9;2;1;1
252857093919;252857094116;197;2,9;2;1;1
252857094116;252857101784;7668;2,9;2;1;1
252857101784;252857102591;807;2,9;2;1;1
252857102591;252857102732;141;2,9;2;1;1
252857102732;252857102947;215;2,9;2;1;1
252857102947;252857103037;90;2,9;2;1;1
252857103037;252857103101;64;2,9;2;1;1
252857103101;252857103319;218;2,9;2;1;1
252857103319;252857103396;77;2,9;2;1;1
252857103396;252857103714;318;2,9;2;1;1
252857103714;252857103994;280;2,9;2;1;1
252857103994;252857104079;85;2,9;2;1;1
252857104079;252857104341;262;2,9;2;1;1
252857104341;252857104479;138;2,9;2;1;1
252857104479;252857104530;51;2,9;2;1;1
252857104530;252857125968;21438;2,9;2;1;1
252857125968;252857127032;1064;2,9;2;1;1
252857127032;252857127041;9;2,9;2;1;1
252857127041;252857127083;42;2,9;2;1;1
252857127083;252857127339;256;2,9;2;1;1
252857127339;252857127444;105;2,9;2;1;1
252857127444;252857128893;1449;2,9;2;1;1
252857128893;252857129143;250;2,9;2;1;1
252857129143;252857129293;150;2,9;2;1;1
252857129293;252857129508;215;2,9;2;1;1
252857129508;252857129576;68;2,9;2;1;1
252857129576;252857129872;296;2,9;2;1;1
252857129872;252857129965;93;2,9;2;1;1
252857129965;252857130047;82;2,9;2;1;1
252857130047;252857130126;79;2,9;2;1;1
252857130126;252857130179;53;2,9;2;1;1
252857130179;252857130244;65;2,9;2;1;1
252857130244;252857130385;141;2,9;2;1;1
252857130385;252857130454;69;2,9;2;1;1
252857130454;252857130484;30;2,9;2;1;1
252857130484;252857130521;37;2,9;2;1;1
252857130521;252857130617;96;2,9;2;1;1
252857130617;252857130639;22;2,9;2;1;1
252857130639;252857130710;71;2,9;2;1;1
252857130710;252857130821;111;2,9;2;1;1
252857130821;252857130841;20;2,9;2;1;1
252857130841;252857130895;54;2,9;2;1;1
252857130895;252857131069;174;2,9;2;1;1
252857131069;252857131097;28;2,9;2;1;1
252857131097;252857131128;31;2,9;2;1;1
252857131128;252857131183;55;2,9;2;1;1
252857131183;252857131219;36;2,9;2;1;1
252857131219;252857131243;24;2,9;2;1;1
252857131243;252857131305;62;2,9;2;1;1
252857131305;252857131350;45;2,9;2;1;1
252857131350;252857131434;84;2,9;2;1;1
252857131434;252857131558;124;2,9;2;1;1
252857131558;252857131587;29;2,9;2;1;1
252857131587;252857131609;22;2,9;2;1;1
252857131609;252857131620;11;2,9;2;1;1
252857131620;252857131633;13;2,9;2;1;1
252857131633;252857131659;26;2,9;2;1;1
252857131659;252857131692;33;2,9;2;1;1
252857131692;252857131697;5;2,9;2;1;1
252857131697;252857131741;44;2,9;2;1;1
252857131741;252857131762;21;2,9;2;1;1
252857131762;252857131768;6;2,9;2;1;1
252857131768;252857131774;6;2,9;2;1;1
252857131774;252857131801;27;2,9;2;1;1
252857131801;252857131824;23;2,9;2;1;1
252857131824;252857131842;18;2,9;2;1;1
252857131842;252857131857;15;2,9;2;1;1
252857131857;252857132114;257;2,9;2;1;1
252857132114;252857132152;38;2,9;2;1;1
252857132152;252857132198;46;2,9;2;1;1
252857132198;252857132225;27;2,9;2;1;1
252857132225;252857132226;1;2,9;2;1;1
252857132226;252857132337;111;2,9;2;1;1
252857132337;252857132427;90;2,9;2;1;1
252857132427;252857132438;11;2,9;2;1;1
252857132438;252857132512;74;2,9;2;1;1
252857132512;252857132588;76;2,9;2;1;1
252857132588;252857132650;62;2,9;2;1;1
252857132650;252857132930;280;2,9;2;1;1
252857132930;252857132955;25;2,9;2;1;1
252857132955;252857132974;19;2,9;2;1;1
252857132974;252857133001;27;2,9;2;1;1
252857133001;252857133026;25;2,9;2;1;1
252857133026;252857133039;13;2,9;2;1;1
252857133039;252857133049;10;2,9;2;1;1
252857133049;252857133065;16;2,9;2;1;1
252857133065;252857133093;28;2,9;2;1;1
252857133093;252857133102;9;2,9;2;1;1
252857133102;252857133126;24;2,9;2;1;1
252857133126;252857133152;26;2,9;2;1;1
252857133152;252857133232;80;2,9;2;1;1
252857133232;252857133233;1;2,9;2;1;1
252857133233;252857133255;22;2,9;2;1;1
252857133255;252857133265;10;2,9;2;1;1
252857133265;252857133266;1;2,9;2;1;1
252857133266;252857133290;24;2,9;2;1;1
252857133290;252857133293;3;2,9;2;1;1
252857133293;252857133313;20;2,9;2;1;1
252857133313;252857133347;34;2,9;2;1;1
252857133347;252857133349;2;2,9;2;1;1
252857133349;252857133397;48;2,9;2;1;1
252857133397;252857133402;5;2,9;2;1;1
252857133402;252857133424;22;2,9;2;1;1
252857133424;252857133457;33;2,9;2;1;1
252857133457;252857133489;32;2,9;2;1;1
252857133489;252857133521;32;2,9;2;1;1
252857133521;252857133537;16;2,9;2;1;1
252857133537;252857133611;74;2,9;2;1;1
252857133611;252857133643;32;2,9;2;1;1
252857133643;252857133656;13;2,9;2;1;1
252857133656;252857133738;82;2,9;2;1;1
252857133738;252857133775;37;2,9;2;1;1
252857133775;252857133776;1;2,9;2;1;1
252857133776;252857133823;47;2,9;2;1;1
252857133823;252857133833;10;2,9;2;1;1
252857133833;252857133935;102;2,9;2;1;1
252857133935;252857133969;34;2,9;2;1;1
252857133969;252857134099;130;2,9;2;1;1
252857134099;252857134219;120;2,9;2;1;1
252857134219;252857134260;41;2,9;2;1;1
252857134260;252857134353;93;2,9;2;1;1
252857134353;252857134402;49;2,9;2;1;1
252857134402;252857134431;29;2,9;2;1;1
252857134431;252857134595;164;2,9;2;1;1
252857134595;252857134860;265;2,9;2;1;1
252857134860;252857134886;26;2,9;2;1;1
252857134886;252857134985;99;2,9;2;1;1
252857134985;252857135507;522;2,9;2;1;1
252857135507;252857135666;159;2,9;2;1;1
252857135666;252857135731;65;2,9;2;1;1
252857135731;252857135761;30;2,9;2;1;1
252857135761;252857135780;19;2,9;2;1;1
252857135780;252857135819;39;2,9;2;1;1
252857135819;252857135858;39;2,9;2;1;1
252857135858;252857135931;73;2,9;2;1;1
252857135931;252857135981;50;2,9;2;1;1
252857135981;252857136036;55;2,9;2;1;1
252857136036;252857136091;55;2,9;2;1;1
252857136091;252857136118;27;2,9;2;1;1
252857136118;252857136176;58;2,9;2;1;1
252857136176;252857136202;26;2,9;2;1;1
252857136202;252857136260;58;2,9;2;1;1
252857136260;252857136310;50;2,9;2;1;1
252857136310;252857137128;818;2,9;2;1;1
252857137128;252857137378;250;2,9;2;1;1
252857137378;252857137881;503;2,9;2;1;1
252857137881;252857138019;138;2,9;2;1;1
252857138019;252857138058;39;2,9;2;1;1
252857138058;252857138116;58;2,9;2;1;1
252857138116;252857138133;17;2,9;2;1;1
252857138133;252857138246;113;2,9;2;1;1
252857138246;252857138277;31;2,9;2;1;1
252857138277;252857138350;73;2,9;2;1;1
252857138350;252857138448;98;2,9;2;1;1
252857138448;252857138542;94;2,9;2;1;1
252857138542;252857138640;98;2,9;2;1;1
252857138640;252857139020;380;2,9;2;1;1
252857139020;252857140124;1104;2,9;2;1;1
252857140124;252857140183;59;2,9;2;1;1
252857140183;252857140258;75;2,9;2;1;1
252857140258;252857140389;131;2,9;2;1;1
252857140389;252857140420;31;2,9;2;1;1
252857140420;252857140454;34;2,9;2;1;1
252857140454;252857140515;61;2,9;2;1;1
252857140515;252857140548;33;2,9;2;1;1
252857140548;252857140568;20;2,9;2;1;1
252857140568;252857140673;105;2,9;2;1;1
252857140673;252857140851;178;2,9;2;1;1
252857140851;252857140889;38;2,9;2;1;1
252857140889;252857140925;36;2,9;2;1;1
252857140925;252857141038;113;2,9;2;1;1
252857141038;252857141142;104;2,9;2;1;1
252857141142;252857141418;276;2,9;2;1;1
252857141418;252857157325;15907;2,9;2;1;1
252857157325;252862407591;5250266;2,9;2;1;1
252862407591;252902483281;40075690;2,9;2;1;1
252902483281;252938154745;35671464;2,9;2;1;1
252938154745;252938271279;116534;2,9;2;1;1
252938271279;252938919684;648405;2,9;2;1;1
252938919684;252938981343;61659;2,9;2;1;1
252938981343;252938989639;8296;2,9;2;1;1
252938989639;252939019941;30302;2,9;2;1;1
252939019941;252939024095;4154;2,9;2;1;1
252939024095;252939059298;35203;2,9;2;1;1
252939059298;252939096532;37234;2,9;2;1;1
252939096532;252939103832;7300;2,9;2;1;1
252939103832;252939114832;11000;2,9;2;1;1
252939114832;252939127638;12806;2,9;2;1;1
252939127638;252939133341;5703;2,9;2;1;1
252939133341;252939165362;32021;2,9;2;1;1
252939165362;252939194225;28863;2,9;2;1;1
252939194225;252939210059;15834;2,9;2;1;1
252939210059;252939216225;6166;2,9;2;1;1
252939216225;252939243258;27033;2,9;2;1;1
252939243258;252939302545;59287;2,9;2;1;1
252939302545;252939365848;63303;2,9;2;1;1
252939365848;252939371110;5262;2,9;2;1;1
252939371110;252939435637;64527;2,9;2;1;1
252939435637;252939441760;6123;2,9;2;1;1
252939441760;252939486077;44317;2,9;2;1;1
252939486077;252939528949;42872;2,9;2;1;1
252939528949;252939893700;364751;2,9;2;1;1
252939893700;252940829002;935302;2,9;2;1;1
252940829002;252947020495;6191493;2,9;2;1;1
252947020495;252947606916;586421;2,9;2;1;1
252947606916;252947645349;38433;2,9;2;1;1
252947645349;252947694566;49217;2,9;2;1;1
252947694566;252947808894;114328;2,9;2;1;1
252947808894;252947895158;86264;2,9;2;1;1
252947895158;252947905440;10282;2,9;2;1;1
252947905440;252947926288;20848;2,9;2;1;1
252947926288;252947929234;2946;2,9;2;1;1
252947929234;252947967096;37862;2,9;2;1;1
252947967096;252948073778;106682;2,9;2;1;1
252948073778;252948447486;373708;2,9;2;1;1
252948447486;252952204726;3757240;2,9;2;1;1
252952204726;252956703569;4498843;2,9;2;1;1
252956703569;252956735059;31490;2,9;2;1;1
252956735059;252959744673;3009614;2,9;2;1;1
252959744673;252959847046;102373;2,9;2;1;1
252959847046;252959966792;119746;2,9;2;1;1
252959966792;252959971583;4791;2,9;2;1;1
252959971583;252960027993;56410;2,9;2;1;1
252960027993;252960031712;3719;2,9;2;1;1
252960031712;252960031792;80;2,9;2;1;1
252960031792;252960031844;52;2,9;2;1;1
252960031844;252960031954;110;2,9;2;1;1
252960031954;252960031960;6;2,9;2;1;1
252960031960;252960032058;98;2,9;2;1;1
252960032058;252960032167;109;2,9;2;1;1
252960032167;252960032258;91;2,9;2;1;1
252960032258;252960032300;42;2,9;2;1;1
252960032300;252960032348;48;2,9;2;1;1
252960032348;252960032398;50;2,9;2;1;1
252960032398;252960032402;4;2,9;2;1;1
252960032402;252960032446;44;2,9;2;1;1
252960032446;252960032531;85;2,9;2;1;1
252960032531;252960032545;14;2,9;2;1;1
252960032545;252960032570;25;2,9;2;1;1
252960032570;252960032600;30;2,9;2;1;1
252960032600;252960032656;56;2,9;2;1;1
252960032656;252960032670;14;2,9;2;1;1
252960032670;252960032701;31;2,9;2;1;1
252960032701;252960032704;3;2,9;2;1;1
252960032704;252960032720;16;2,9;2;1;1
252960032720;252960032759;39;2,9;2;1;1
252960032759;252960032775;16;2,9;2;1;1
252960032775;252960032777;2;2,9;2;1;1
252960032777;252960032793;16;2,9;2;1;1
252960032793;252960032814;21;2,9;2;1;1
252960032814;252960032852;38;2,9;2;1;1
252960032852;252960032881;29;2,9;2;1;1
252960032881;252960032902;21;2,9;2;1;1
252960032902;252960032909;7;2,9;2;1;1
252960032909;252960032941;32;2,9;2;1;1
252960032941;252960032961;20;2,9;2;1;1
252960032961;252960032973;12;2,9;2;1;1
252960032973;252960032983;10;2,9;2;1;1
252960032983;252960033027;44;2,9;2;1;1
252960033027;252960033070;43;2,9;2;1;1
252960033070;252960033082;12;2,9;2;1;1
252960033082;252960033121;39;2,9;2;1;1
252960033121;252960033128;7;2,9;2;1;1
252960033128;252960033131;3;2,9;2;1;1
252960033131;252960033141;10;2,9;2;1;1
252960033141;252960033160;19;2,9;2;1;1
252960033160;252960033170;10;2,9;2;1;1
252960033170;252960033177;7;2,9;2;1;1
252960033177;252960033189;12;2,9;2;1;1
252960033189;252960033216;27;2,9;2;1;1
252960033216;252960033219;3;2,9;2;1;1
252960033219;252960033226;7;2,9;2;1;1
252960033226;252960033233;7;2,9;2;1;1
252960033233;252960033250;17;2,9;2;1;1
252960033250;252960033273;23;2,9;2;1;1
252960033273;252960033298;25;2,9;2;1;1
252960033298;252960033300;2;2,9;2;1;1
252960033300;252960033304;4;2,9;2;1;1
252960033304;252960033314;10;2,9;2;1;1
252960033314;252960033315;1;2,9;2;1;1
252960033315;252960033318;3;2,9;2;1;1
252960033318;252960033321;3;2,9;2;1;1
252960033321;252960033325;4;2,9;2;1;1
252960033325;252960033352;27;2,9;2;1;1
252960033352;252960033359;7;2,9;2;1;1
252960033359;252960033381;22;2,9;2;1;1
252960033381;252960033390;9;2,9;2;1;1
252960033390;252960033400;10;2,9;2;1;1
252960033400;252960033405;5;2,9;2;1;1
252960033405;252960033451;46;2,9;2;1;1
252960033451;252960033475;24;2,9;2;1;1
252960033475;252960033495;20;2,9;2;1;1
252960033495;252960033514;19;2,9;2;1;1
252960033514;252960033534;20;2,9;2;1;1
252960033534;252960033560;26;2,9;2;1;1
252960033560;252960033562;2;2,9;2;1;1
252960033562;252960033591;29;2,9;2;1;1
252960033591;252960033612;21;2,9;2;1;1
252960033612;252960033691;79;2,9;2;1;1
252960033691;252960033693;2;2,9;2;1;1
252960033693;252960033740;47;2,9;2;1;1
252960033740;252960033769;29;2,9;2;1;1
252960033769;252960033770;1;2,9;2;1;1
252960033770;252960033783;13;2,9;2;1;1
252960033783;252960033798;15;2,9;2;1;1
252960033798;252960033811;13;2,9;2;1;1
252960033811;252960033830;19;2,9;2;1;1
252960033830;252960033840;10;2,9;2;1;1
252960033840;252960033858;18;2,9;2;1;1
252960033858;252960033872;14;2,9;2;1;1
252960033872;252960033878;6;2,9;2;1;1
252960033878;252960033879;1;2,9;2;1;1
252960033879;252960033884;5;2,9;2;1;1
252960033884;252960033896;12;2,9;2;1;1
252960033896;252960033900;4;2,9;2;1;1
252960033900;252960033903;3;2,9;2;1;1
252960033903;252960033906;3;2,9;2;1;1
252960033906;252960033907;1;2,9;2;1;1
252960033907;252960033910;3;2,9;2;1;1
252960033910;252960033914;4;2,9;2;1;1
252960033914;252960033923;9;2,9;2;1;1
252960033923;252960033926;3;2,9;2;1;1
252960033926;252960033942;16;2,9;2;1;1
252960033942;252960033945;3;2,9;2;1;1
252960033945;252960033956;11;2,9;2;1;1
252960033956;252960033972;16;2,9;2;1;1
252960033972;252960033973;1;2,9;2;1;1
252960033973;252960033974;1;2,9;2;1;1
252960033974;252960034011;37;2,9;2;1;1
252960034011;252960034013;2;2,9;2;1;1
252960034013;252960034016;3;2,9;2;1;1
252960034016;252960034035;19;2,9;2;1;1
252960034035;252960034052;17;2,9;2;1;1
252960034052;252960034063;11;2,9;2;1;1
252960034063;252960034068;5;2,9;2;1;1
252960034068;252960034077;9;2,9;2;1;1
252960034077;252960034082;5;2,9;2;1;1
252960034082;252960034083;1;2,9;2;1;1
252960034083;252960034084;1;2,9;2;1;1
252960034084;252960034093;9;2,9;2;1;1
252960034093;252960034133;40;2,9;2;1;1
252960034133;252960034140;7;2,9;2;1;1
252960034140;252960034147;7;2,9;2;1;1
252960034147;252960034156;9;2,9;2;1;1
252960034156;252960034163;7;2,9;2;1;1
252960034163;252960034164;1;2,9;2;1;1
252960034164;252960034171;7;2,9;2;1;1
252960034171;252960034175;4;2,9;2;1;1
252960034175;252960034176;1;2,9;2;1;1
252960034176;252960034178;2;2,9;2;1;1
252960034178;252960034194;16;2,9;2;1;1
252960034194;252960034199;5;2,9;2;1;1
252960034199;252960034200;1;2,9;2;1;1
252960034200;252960034205;5;2,9;2;1;1
252960034205;252960034215;10;2,9;2;1;1
252960034215;252960034226;11;2,9;2;1;1
252960034226;252960034231;5;2,9;2;1;1
252960034231;252960034239;8;2,9;2;1;1
252960034239;252960034241;2;2,9;2;1;1
252960034241;252960034263;22;2,9;2;1;1
252960034263;252960034268;5;2,9;2;1;1
252960034268;252960034277;9;2,9;2;1;1
252960034277;252960034285;8;2,9;2;1;1
252960034285;252960034290;5;2,9;2;1;1
252960034290;252960034308;18;2,9;2;1;1
252960034308;252960034312;4;2,9;2;1;1
252960034312;252960034314;2;2,9;2;1;1
252960034314;252960034327;13;2,9;2;1;1
252960034327;252960034351;24;2,9;2;1;1
252960034351;252960034363;12;2,9;2;1;1
252960034363;252960034372;9;2,9;2;1;1
252960034372;252960034401;29;2,9;2;1;1
252960034401;252960034413;12;2,9;2;1;1
252960034413;252960034424;11;2,9;2;1;1
252960034424;252960034431;7;2,9;2;1;1
252960034431;252960034484;53;2,9;2;1;1
252960034484;252960034491;7;2,9;2;1;1
252960034491;252960034509;18;2,9;2;1;1
252960034509;252960034542;33;2,9;2;1;1
252960034542;252960034547;5;2,9;2;1;1
252960034547;252960034556;9;2,9;2;1;1
252960034556;252960034581;25;2,9;2;1;1
252960034581;252960034584;3;2,9;2;1;1
252960034584;252960034592;8;2,9;2;1;1
252960034592;252960034624;32;2,9;2;1;1
252960034624;252960034625;1;2,9;2;1;1
252960034625;252960034628;3;2,9;2;1;1
252960034628;252960034631;3;2,9;2;1;1
252960034631;252960034671;40;2,9;2;1;1
252960034671;252960034695;24;2,9;2;1;1
252960034695;252960034697;2;2,9;2;1;1
252960034697;252960034698;1;2,9;2;1;1
252960034698;252960034724;26;2,9;2;1;1
252960034724;252960034742;18;2,9;2;1;1
252960034742;252960034754;12;2,9;2;1;1
252960034754;252960034761;7;2,9;2;1;1
252960034761;252960034767;6;2,9;2;1;1
252960034767;252960034771;4;2,9;2;1;1
252960034771;252960034781;10;2,9;2;1;1
252960034781;252960034782;1;2,9;2;1;1
252960034782;252960034796;14;2,9;2;1;1
252960034796;252960034805;9;2,9;2;1;1
252960034805;252960034808;3;2,9;2;1;1
252960034808;252960034824;16;2,9;2;1;1
252960034824;252960034835;11;2,9;2;1;1
252960034835;252960034860;25;2,9;2;1;1
252960034860;252960034904;44;2,9;2;1;1
252960034904;252960034905;1;2,9;2;1;1
252960034905;252960034937;32;2,9;2;1;1
252960034937;252960034962;25;2,9;2;1;1
252960034962;252960034986;24;2,9;2;1;1
252960034986;252960035004;18;2,9;2;1;1
252960035004;252960035038;34;2,9;2;1;1
252960035038;252960035071;33;2,9;2;1;1
252960035071;252960035084;13;2,9;2;1;1
252960035084;252960035087;3;2,9;2;1;1
252960035087;252960035092;5;2,9;2;1;1
252960035092;252960035114;22;2,9;2;1;1
252960035114;252960035116;2;2,9;2;1;1
252960035116;252960035135;19;2,9;2;1;1
252960035135;252960035145;10;2,9;2;1;1
252960035145;252960035176;31;2,9;2;1;1
252960035176;252960035178;2;2,9;2;1;1
252960035178;252960035184;6;2,9;2;1;1
252960035184;252960035196;12;2,9;2;1;1
252960035196;252960035223;27;2,9;2;1;1
252960035223;252960035230;7;2,9;2;1;1
252960035230;252960035233;3;2,9;2;1;1
252960035233;252960035239;6;2,9;2;1;1
252960035239;252960035248;9;2,9;2;1;1
252960035248;252960035265;17;2,9;2;1;1
252960035265;252960035266;1;2,9;2;1;1
252960035266;252960035269;3;2,9;2;1;1
252960035269;252960035279;10;2,9;2;1;1
252960035279;252960035285;6;2,9;2;1;1
252960035285;252960035291;6;2,9;2;1;1
252960035291;252960035297;6;2,9;2;1;1
252960035297;252960035308;11;2,9;2;1;1
252960035308;252960035310;2;2,9;2;1;1
252960035310;252960035313;3;2,9;2;1;1
252960035313;252960035332;19;2,9;2;1;1
252960035332;252960035339;7;2,9;2;1;1
252960035339;252960035345;6;2,9;2;1;1
252960035345;252960035350;5;2,9;2;1;1
252960035350;252960035351;1;2,9;2;1;1
252960035351;252960035368;17;2,9;2;1;1
252960035368;252960035372;4;2,9;2;1;1
252960035372;252960035374;2;2,9;2;1;1
252960035374;252960035399;25;2,9;2;1;1
252960035399;252960035408;9;2,9;2;1;1
252960035408;252960035425;17;2,9;2;1;1
252960035425;252960035426;1;2,9;2;1;1
252960035426;252960035432;6;2,9;2;1;1
252960035432;252960035463;31;2,9;2;1;1
252960035463;252960035465;2;2,9;2;1;1
252960035465;252960035468;3;2,9;2;1;1
252960035468;252960035472;4;2,9;2;1;1
252960035472;252960035486;14;2,9;2;1;1
252960035486;252960035487;1;2,9;2;1;1
252960035487;252960035512;25;2,9;2;1;1
252960035512;252960035558;46;2,9;2;1;1
252960035558;252960035577;19;2,9;2;1;1
252960035577;252960035587;10;2,9;2;1;1
252960035587;252960035620;33;2,9;2;1;1
252960035620;252960035624;4;2,9;2;1;1
252960035624;252960035636;12;2,9;2;1;1
252960035636;252960035650;14;2,9;2;1;1
252960035650;252960035667;17;2,9;2;1;1
252960035667;252960035673;6;2,9;2;1;1
252960035673;252960035675;2;2,9;2;1;1
252960035675;252960035686;11;2,9;2;1;1
252960035686;252960035688;2;2,9;2;1;1
252960035688;252960035691;3;2,9;2;1;1
252960035691;252960035692;1;2,9;2;1;1
252960035692;252960035698;6;2,9;2;1;1
252960035698;252960035702;4;2,9;2;1;1
252960035702;252960035711;9;2,9;2;1;1
252960035711;252960035714;3;2,9;2;1;1
252960035714;252960035716;2;2,9;2;1;1
252960035716;252960035741;25;2,9;2;1;1
252960035741;252960035743;2;2,9;2;1;1
252960035743;252960035745;2;2,9;2;1;1
252960035745;252960035766;21;2,9;2;1;1
252960035766;252960035772;6;2,9;2;1;1
252960035772;252960035775;3;2,9;2;1;1
252960035775;252960035793;18;2,9;2;1;1
252960035793;252960035831;38;2,9;2;1;1
252960035831;252960035848;17;2,9;2;1;1
252960035848;252960035860;12;2,9;2;1;1
252960035860;252960035864;4;2,9;2;1;1
252960035864;252960035877;13;2,9;2;1;1
252960035877;252960035883;6;2,9;2;1;1
252960035883;252960035889;6;2,9;2;1;1
252960035889;252960035896;7;2,9;2;1;1
252960035896;252960035897;1;2,9;2;1;1
252960035897;252960035902;5;2,9;2;1;1
252960035902;252960035904;2;2,9;2;1;1
252960035904;252960035914;10;2,9;2;1;1
252960035914;252960035916;2;2,9;2;1;1
252960035916;252960035923;7;2,9;2;1;1
252960035923;252960035925;2;2,9;2;1;1
252960035925;252960035927;2;2,9;2;1;1
252960035927;252960035934;7;2,9;2;1;1
252960035934;252960035952;18;2,9;2;1;1
252960035952;252960035967;15;2,9;2;1;1
252960035967;252960035975;8;2,9;2;1;1
252960035975;252960035982;7;2,9;2;1;1
252960035982;252960036016;34;2,9;2;1;1
252960036016;252960036021;5;2,9;2;1;1
252960036021;252960036025;4;2,9;2;1;1
252960036025;252960036026;1;2,9;2;1;1
252960036026;252960036032;6;2,9;2;1;1
252960036032;252960036052;20;2,9;2;1;1
252960036052;252960036054;2;2,9;2;1;1
252960036054;252960036062;8;2,9;2;1;1
252960036062;252960036075;13;2,9;2;1;1
252960036075;252960036082;7;2,9;2;1;1
252960036082;252960036084;2;2,9;2;1;1
252960036084;252960036092;8;2,9;2;1;1
252960036092;252960036103;11;2,9;2;1;1
252960036103;252960036106;3;2,9;2;1;1
252960036106;252960036112;6;2,9;2;1;1
252960036112;252960036121;9;2,9;2;1;1
252960036121;252960036129;8;2,9;2;1;1
252960036129;252960036131;2;2,9;2;1;1
252960036131;252960036132;1;2,9;2;1;1
252960036132;252960036138;6;2,9;2;1;1
252960036138;252960036148;10;2,9;2;1;1
252960036148;252960036171;23;2,9;2;1;1
252960036171;252960036174;3;2,9;2;1;1
252960036174;252960036190;16;2,9;2;1;1
252960036190;252960036195;5;2,9;2;1;1
252960036195;252960036200;5;2,9;2;1;1
252960036200;252960036217;17;2,9;2;1;1
252960036217;252960036234;17;2,9;2;1;1
252960036234;252960036235;1;2,9;2;1;1
252960036235;252960036242;7;2,9;2;1;1
252960036242;252960036243;1;2,9;2;1;1
252960036243;252960036244;1;2,9;2;1;1
252960036244;252960036246;2;2,9;2;1;1
252960036246;252960036248;2;2,9;2;1;1
252960036248;252960036250;2;2,9;2;1;1
252960036250;252960036291;41;2,9;2;1;1
252960036291;252960036304;13;2,9;2;1;1
252960036304;252960036305;1;2,9;2;1;1
252960036305;252960036316;11;2,9;2;1;1
252960036316;252960036352;36;2,9;2;1;1
252960036352;252960036356;4;2,9;2;1;1
252960036356;252960036367;11;2,9;2;1;1
252960036367;252960036396;29;2,9;2;1;1
252960036396;252960036418;22;2,9;2;1;1
252960036418;252960036441;23;2,9;2;1;1
252960036441;252960036500;59;2,9;2;1;1
252960036500;252960036507;7;2,9;2;1;1
252960036507;252960036521;14;2,9;2;1;1
252960036521;252960036523;2;2,9;2;1;1
252960036523;252960036534;11;2,9;2;1;1
252960036534;252960036567;33;2,9;2;1;1
252960036567;252960036611;44;2,9;2;1;1
252960036611;252960036649;38;2,9;2;1;1
252960036649;252960036675;26;2,9;2;1;1
252960036675;252960036690;15;2,9;2;1;1
252960036690;252960036722;32;2,9;2;1;1
252960036722;252960036737;15;2,9;2;1;1
252960036737;252960036771;34;2,9;2;1;1
252960036771;252960036808;37;2,9;2;1;1
252960036808;252960036826;18;2,9;2;1;1
252960036826;252960036835;9;2,9;2;1;1
252960036835;252960036863;28;2,9;2;1;1
252960036863;252960036885;22;2,9;2;1;1
252960036885;252960036927;42;2,9;2;1;1
252960036927;252960036943;16;2,9;2;1;1
252960036943;252960036986;43;2,9;2;1;1
252960036986;252960037012;26;2,9;2;1;1
252960037012;252960037021;9;2,9;2;1;1
252960037021;252960037031;10;2,9;2;1;1
252960037031;252960037066;35;2,9;2;1;1
252960037066;252960037081;15;2,9;2;1;1
252960037081;252960037086;5;2,9;2;1;1
252960037086;252960037089;3;2,9;2;1;1
252960037089;252960037123;34;2,9;2;1;1
252960037123;252960037140;17;2,9;2;1;1
252960037140;252960037144;4;2,9;2;1;1
252960037144;252960037149;5;2,9;2;1;1
252960037149;252960037153;4;2,9;2;1;1
252960037153;252960037192;39;2,9;2;1;1
252960037192;252960037193;1;2,9;2;1;1
252960037193;252960037213;20;2,9;2;1;1
252960037213;252960037232;19;2,9;2;1;1
252960037232;252960037234;2;2,9;2;1;1
252960037234;252960037237;3;2,9;2;1;1
252960037237;252960037249;12;2,9;2;1;1
252960037249;252960037280;31;2,9;2;1;1
252960037280;252960037295;15;2,9;2;1;1
252960037295;252960037296;1;2,9;2;1;1
252960037296;252960037304;8;2,9;2;1;1
252960037304;252960037330;26;2,9;2;1;1
252960037330;252960037334;4;2,9;2;1;1
252960037334;252960037336;2;2,9;2;1;1
252960037336;252960037337;1;2,9;2;1;1
252960037337;252960037344;7;2,9;2;1;1
252960037344;252960037345;1;2,9;2;1;1
252960037345;252960037374;29;2,9;2;1;1
252960037374;252960037384;10;2,9;2;1;1
252960037384;252960037396;12;2,9;2;1;1
252960037396;252960037406;10;2,9;2;1;1
252960037406;252960037413;7;2,9;2;1;1
252960037413;252960037486;73;2,9;2;1;1
252960037486;252960037517;31;2,9;2;1;1
252960037517;252960037535;18;2,9;2;1;1
252960037535;252960037565;30;2,9;2;1;1
252960037565;252960037626;61;2,9;2;1;1
252960037626;252960037670;44;2,9;2;1;1
252960037670;252960037696;26;2,9;2;1;1
252960037696;252960037716;20;2,9;2;1;1
252960037716;252960037750;34;2,9;2;1;1
252960037750;252960037800;50;2,9;2;1;1
252960037800;252960037818;18;2,9;2;1;1
252960037818;252960037860;42;2,9;2;1;1
252960037860;252960037957;97;2,9;2;1;1
252960037957;252960037977;20;2,9;2;1;1
252960037977;252960038068;91;2,9;2;1;1
252960038068;252960038092;24;2,9;2;1;1
252960038092;252960038157;65;2,9;2;1;1
252960038157;252960038174;17;2,9;2;1;1
252960038174;252960038207;33;2,9;2;1;1
252960038207;252960038209;2;2,9;2;1;1
252960038209;252960038213;4;2,9;2;1;1
252960038213;252960038217;4;2,9;2;1;1
252960038217;252960038244;27;2,9;2;1;1
252960038244;252960038247;3;2,9;2;1;1
252960038247;252960038278;31;2,9;2;1;1
252960038278;252960038285;7;2,9;2;1;1
252960038285;252960038311;26;2,9;2;1;1
252960038311;252960038320;9;2,9;2;1;1
252960038320;252960038330;10;2,9;2;1;1
252960038330;252960038358;28;2,9;2;1;1
252960038358;252960038379;21;2,9;2;1;1
252960038379;252960038417;38;2,9;2;1;1
252960038417;252960038450;33;2,9;2;1;1
252960038450;252960038492;42;2,9;2;1;1
252960038492;252960038499;7;2,9;2;1;1
252960038499;252960038555;56;2,9;2;1;1
252960038555;252960038566;11;2,9;2;1;1
252960038566;252960038587;21;2,9;2;1;1
252960038587;252960038625;38;2,9;2;1;1
252960038625;252960038637;12;2,9;2;1;1
252960038637;252960038717;80;2,9;2;1;1
252960038717;252960038721;4;2,9;2;1;1
252960038721;252960038764;43;2,9;2;1;1
252960038764;252960038781;17;2,9;2;1;1
252960038781;252960038815;34;2,9;2;1;1
252960038815;252960038845;30;2,9;2;1;1
252960038845;252960038866;21;2,9;2;1;1
252960038866;252960038878;12;2,9;2;1;1
252960038878;252960038883;5;2,9;2;1;1
252960038883;252960038889;6;2,9;2;1;1
252960038889;252960038905;16;2,9;2;1;1
252960038905;252960038913;8;2,9;2;1;1
252960038913;252960038915;2;2,9;2;1;1
252960038915;252960038926;11;2,9;2;1;1
252960038926;252960038930;4;2,9;2;1;1
252960038930;252960038948;18;2,9;2;1;1
252960038948;252960038960;12;2,9;2;1;1
252960038960;252960038981;21;2,9;2;1;1
252960038981;252960039026;45;2,9;2;1;1
252960039026;252960039035;9;2,9;2;1;1
252960039035;252960039069;34;2,9;2;1;1
252960039069;252960039092;23;2,9;2;1;1
252960039092;252960039097;5;2,9;2;1;1
252960039097;252960039114;17;2,9;2;1;1
252960039114;252960039139;25;2,9;2;1;1
252960039139;252960039195;56;2,9;2;1;1
252960039195;252960039214;19;2,9;2;1;1
252960039214;252960039224;10;2,9;2;1;1
252960039224;252960039249;25;2,9;2;1;1
252960039249;252960039260;11;2,9;2;1;1
252960039260;252960039269;9;2,9;2;1;1
252960039269;252960039296;27;2,9;2;1;1
252960039296;252960039323;27;2,9;2;1;1
252960039323;252960039347;24;2,9;2;1;1
252960039347;252960039423;76;2,9;2;1;1
252960039423;252960039461;38;2,9;2;1;1
252960039461;252960039488;27;2,9;2;1;1
252960039488;252960039551;63;2,9;2;1;1
252960039551;252960039553;2;2,9;2;1;1
252960039553;252960039723;170;2,9;2;1;1
252960039723;252960039793;70;2,9;2;1;1
252960039793;252960039926;133;2,9;2;1;1
252960039926;252960039957;31;2,9;2;1;1
252960039957;252960050754;10797;2,9;2;1;1
252960050754;252960050762;8;2,9;2;1;1
252960050762;252960050769;7;2,9;2;1;1
252960050769;252960050819;50;2,9;2;1;1
252960050819;252960050845;26;2,9;2;1;1
252960050845;252960050894;49;2,9;2;1;1
252960050894;252960050903;9;2,9;2;1;1
252960050903;252960050918;15;2,9;2;1;1
252960050918;252960050989;71;2,9;2;1;1
252960050989;252960051011;22;2,9;2;1;1
252960051011;252960051014;3;2,9;2;1;1
252960051014;252960051056;42;2,9;2;1;1
252960051056;252960051077;21;2,9;2;1;1
252960051077;252960051080;3;2,9;2;1;1
252960051080;252960051082;2;2,9;2;1;1
252960051082;252960051145;63;2,9;2;1;1
252960051145;252960051166;21;2,9;2;1;1
252960051166;252960051175;9;2,9;2;1;1
252960051175;252960051180;5;2,9;2;1;1
252960051180;252960051211;31;2,9;2;1;1
252960051211;252960051254;43;2,9;2;1;1
252960051254;252960051257;3;2,9;2;1;1
252960051257;252960051300;43;2,9;2;1;1
252960051300;252960051302;2;2,9;2;1;1
252960051302;252960051318;16;2,9;2;1;1
252960051318;252960051337;19;2,9;2;1;1
252960051337;252960051448;111;2,9;2;1;1
252960051448;252960051456;8;2,9;2;1;1
252960051456;252960051474;18;2,9;2;1;1
252960051474;252960051495;21;2,9;2;1;1
252960051495;252960051521;26;2,9;2;1;1
252960051521;252960051555;34;2,9;2;1;1
252960051555;252960051564;9;2,9;2;1;1
252960051564;252960051594;30;2,9;2;1;1
252960051594;252960051608;14;2,9;2;1;1
252960051608;252960051658;50;2,9;2;1;1
252960051658;252960051664;6;2,9;2;1;1
252960051664;252960051691;27;2,9;2;1;1
252960051691;252960051702;11;2,9;2;1;1
252960051702;252960051715;13;2,9;2;1;1
252960051715;252960051720;5;2,9;2;1;1
252960051720;252960051729;9;2,9;2;1;1
252960051729;252960051745;16;2,9;2;1;1
252960051745;252960051775;30;2,9;2;1;1
252960051775;252960051776;1;2,9;2;1;1
252960051776;252960051782;6;2,9;2;1;1
252960051782;252960051789;7;2,9;2;1;1
252960051789;252960051792;3;2,9;2;1;1
252960051792;252960051816;24;2,9;2;1;1
252960051816;252960051828;12;2,9;2;1;1
252960051828;252960051831;3;2,9;2;1;1
252960051831;252960051853;22;2,9;2;1;1
252960051853;252960051878;25;2,9;2;1;1
252960051878;252960051890;12;2,9;2;1;1
252960051890;252960051951;61;2,9;2;1;1
252960051951;252960051964;13;2,9;2;1;1
252960051964;252960051984;20;2,9;2;1;1
252960051984;252960052002;18;2,9;2;1;1
252960052002;252960052032;30;2,9;2;1;1
252960052032;252960052050;18;2,9;2;1;1
252960052050;252960052051;1;2,9;2;1;1
252960052051;252960052052;1;2,9;2;1;1
252960052052;252960052053;1;2,9;2;1;1
252960052053;252960052058;5;2,9;2;1;1
252960052058;252960052072;14;2,9;2;1;1
252960052072;252960052089;17;2,9;2;1;1
252960052089;252960052119;30;2,9;2;1;1
252960052119;252960052132;13;2,9;2;1;1
252960052132;252960052134;2;2,9;2;1;1
252960052134;252960052135;1;2,9;2;1;1
252960052135;252960052146;11;2,9;2;1;1
252960052146;252960052180;34;2,9;2;1;1
252960052180;252960052204;24;2,9;2;1;1
252960052204;252960052208;4;2,9;2;1;1
252960052208;252960052227;19;2,9;2;1;1
252960052227;252960052232;5;2,9;2;1;1
252960052232;252960052262;30;2,9;2;1;1
252960052262;252960052270;8;2,9;2;1;1
252960052270;252960052282;12;2,9;2;1;1
252960052282;252960052303;21;2,9;2;1;1
252960052303;252960052338;35;2,9;2;1;1
252960052338;252960052348;10;2,9;2;1;1
252960052348;252960052352;4;2,9;2;1;1
252960052352;252960052441;89;2,9;2;1;1
252960052441;252960052462;21;2,9;2;1;1
252960052462;252960052474;12;2,9;2;1;1
252960052474;252960052496;22;2,9;2;1;1
252960052496;252960052501;5;2,9;2;1;1
252960052501;252960052511;10;2,9;2;1;1
252960052511;252960052513;2;2,9;2;1;1
252960052513;252960052523;10;2,9;2;1;1
252960052523;252960052533;10;2,9;2;1;1
252960052533;252960052543;10;2,9;2;1;1
252960052543;252960052546;3;2,9;2;1;1
252960052546;252960052552;6;2,9;2;1;1
252960052552;252960052559;7;2,9;2;1;1
252960052559;252960052567;8;2,9;2;1;1
252960052567;252960052578;11;2,9;2;1;1
252960052578;252960052589;11;2,9;2;1;1
252960052589;252960052596;7;2,9;2;1;1
252960052596;252960052599;3;2,9;2;1;1
252960052599;252960052607;8;2,9;2;1;1
252960052607;252960052626;19;2,9;2;1;1
252960052626;252960052640;14;2,9;2;1;1
252960052640;252960052642;2;2,9;2;1;1
252960052642;252960052667;25;2,9;2;1;1
252960052667;252960052693;26;2,9;2;1;1
252960052693;252960052752;59;2,9;2;1;1
252960052752;252960052761;9;2,9;2;1;1
252960052761;252960052767;6;2,9;2;1;1
252960052767;252960052769;2;2,9;2;1;1
252960052769;252960052786;17;2,9;2;1;1
252960052786;252960052790;4;2,9;2;1;1
252960052790;252960052848;58;2,9;2;1;1
252960052848;252960052869;21;2,9;2;1;1
252960052869;252960052871;2;2,9;2;1;1
252960052871;252960052881;10;2,9;2;1;1
252960052881;252960052885;4;2,9;2;1;1
252960052885;252960052888;3;2,9;2;1;1
252960052888;252960052889;1;2,9;2;1;1
252960052889;252960052890;1;2,9;2;1;1
252960052890;252960052896;6;2,9;2;1;1
252960052896;252960052935;39;2,9;2;1;1
252960052935;252960052957;22;2,9;2;1;1
252960052957;252960052965;8;2,9;2;1;1
252960052965;252960052966;1;2,9;2;1;1
252960052966;252960052978;12;2,9;2;1;1
252960052978;252960053022;44;2,9;2;1;1
252960053022;252960053025;3;2,9;2;1;1
252960053025;252960053028;3;2,9;2;1;1
252960053028;252960053030;2;2,9;2;1;1
252960053030;252960053050;20;2,9;2;1;1
252960053050;252960053056;6;2,9;2;1;1
252960053056;252960053059;3;2,9;2;1;1
252960053059;252960053063;4;2,9;2;1;1
252960053063;252960053102;39;2,9;2;1;1
252960053102;252960053125;23;2,9;2;1;1
252960053125;252960053144;19;2,9;2;1;1
252960053144;252960053175;31;2,9;2;1;1
252960053175;252960053190;15;2,9;2;1;1
252960053190;252960053193;3;2,9;2;1;1
252960053193;252960053211;18;2,9;2;1;1
252960053211;252960053244;33;2,9;2;1;1
252960053244;252960053262;18;2,9;2;1;1
252960053262;252960053301;39;2,9;2;1;1
252960053301;252960053304;3;2,9;2;1;1
252960053304;252960053311;7;2,9;2;1;1
252960053311;252960053339;28;2,9;2;1;1
252960053339;252960053354;15;2,9;2;1;1
252960053354;252960053369;15;2,9;2;1;1
252960053369;252960053412;43;2,9;2;1;1
252960053412;252960053420;8;2,9;2;1;1
252960053420;252960053425;5;2,9;2;1;1
252960053425;252960053436;11;2,9;2;1;1
252960053436;252960053445;9;2,9;2;1;1
252960053445;252960053449;4;2,9;2;1;1
252960053449;252960053471;22;2,9;2;1;1
252960053471;252960053474;3;2,9;2;1;1
252960053474;252960053486;12;2,9;2;1;1
252960053486;252960053515;29;2,9;2;1;1
252960053515;252960053521;6;2,9;2;1;1
252960053521;252960053529;8;2,9;2;1;1
252960053529;252960053534;5;2,9;2;1;1
252960053534;252960053562;28;2,9;2;1;1
252960053562;252960053584;22;2,9;2;1;1
252960053584;252960053610;26;2,9;2;1;1
252960053610;252960053611;1;2,9;2;1;1
252960053611;252960053623;12;2,9;2;1;1
252960053623;252960053624;1;2,9;2;1;1
252960053624;252960053633;9;2,9;2;1;1
252960053633;252960053649;16;2,9;2;1;1
252960053649;252960053672;23;2,9;2;1;1
252960053672;252960053688;16;2,9;2;1;1
252960053688;252960053702;14;2,9;2;1;1
252960053702;252960053710;8;2,9;2;1;1
252960053710;252960053711;1;2,9;2;1;1
252960053711;252960053742;31;2,9;2;1;1
252960053742;252960053753;11;2,9;2;1;1
252960053753;252960053766;13;2,9;2;1;1
252960053766;252960053785;19;2,9;2;1;1
252960053785;252960053803;18;2,9;2;1;1
252960053803;252960053806;3;2,9;2;1;1
252960053806;252960053808;2;2,9;2;1;1
252960053808;252960053818;10;2,9;2;1;1
252960053818;252960053825;7;2,9;2;1;1
252960053825;252960053844;19;2,9;2;1;1
252960053844;252960053846;2;2,9;2;1;1
252960053846;252960053848;2;2,9;2;1;1
252960053848;252960053883;35;2,9;2;1;1
252960053883;252960053887;4;2,9;2;1;1
252960053887;252960053899;12;2,9;2;1;1
252960053899;252960053900;1;2,9;2;1;1
252960053900;252960053914;14;2,9;2;1;1
252960053914;252960053915;1;2,9;2;1;1
252960053915;252960053919;4;2,9;2;1;1
252960053919;252960053933;14;2,9;2;1;1
252960053933;252960053940;7;2,9;2;1;1
252960053940;252960053941;1;2,9;2;1;1
252960053941;252960053948;7;2,9;2;1;1
252960053948;252960053962;14;2,9;2;1;1
252960053962;252960053967;5;2,9;2;1;1
252960053967;252960053973;6;2,9;2;1;1
252960053973;252960053974;1;2,9;2;1;1
252960053974;252960053977;3;2,9;2;1;1
252960053977;252960053978;1;2,9;2;1;1
252960053978;252960053998;20;2,9;2;1;1
252960053998;252960054006;8;2,9;2;1;1
252960054006;252960054032;26;2,9;2;1;1
252960054032;252960054073;41;2,9;2;1;1
252960054073;252960054079;6;2,9;2;1;1
252960054079;252960054090;11;2,9;2;1;1
252960054090;252960054105;15;2,9;2;1;1
252960054105;252960054113;8;2,9;2;1;1
252960054113;252960054126;13;2,9;2;1;1
252960054126;252960054136;10;2,9;2;1;1
252960054136;252960054160;24;2,9;2;1;1
252960054160;252960054181;21;2,9;2;1;1
252960054181;252960054183;2;2,9;2;1;1
252960054183;252960054201;18;2,9;2;1;1
252960054201;252960054221;20;2,9;2;1;1
252960054221;252960054271;50;2,9;2;1;1
252960054271;252960054276;5;2,9;2;1;1
252960054276;252960054282;6;2,9;2;1;1
252960054282;252960054293;11;2,9;2;1;1
252960054293;252960054319;26;2,9;2;1;1
252960054319;252960054322;3;2,9;2;1;1
252960054322;252960054324;2;2,9;2;1;1
252960054324;252960054330;6;2,9;2;1;1
252960054330;252960054341;11;2,9;2;1;1
252960054341;252960054342;1;2,9;2;1;1
252960054342;252960054350;8;2,9;2;1;1
252960054350;252960054356;6;2,9;2;1;1
252960054356;252960054367;11;2,9;2;1;1
252960054367;252960054373;6;2,9;2;1;1
252960054373;252960054383;10;2,9;2;1;1
252960054383;252960054400;17;2,9;2;1;1
252960054400;252960054412;12;2,9;2;1;1
252960054412;252960054420;8;2,9;2;1;1
252960054420;252960054427;7;2,9;2;1;1
252960054427;252960054428;1;2,9;2;1;1
252960054428;252960054442;14;2,9;2;1;1
252960054442;252960054450;8;2,9;2;1;1
252960054450;252960054488;38;2,9;2;1;1
252960054488;252960054497;9;2,9;2;1;1
252960054497;252960054507;10;2,9;2;1;1
252960054507;252960054515;8;2,9;2;1;1
252960054515;252960054520;5;2,9;2;1;1
252960054520;252960054526;6;2,9;2;1;1
252960054526;252960054530;4;2,9;2;1;1
252960054530;252960054541;11;2,9;2;1;1
252960054541;252960054550;9;2,9;2;1;1
252960054550;252960054556;6;2,9;2;1;1
252960054556;252960054582;26;2,9;2;1;1
252960054582;252960054620;38;2,9;2;1;1
252960054620;252960054624;4;2,9;2;1;1
252960054624;252960054626;2;2,9;2;1;1
252960054626;252960054636;10;2,9;2;1;1
252960054636;252960054639;3;2,9;2;1;1
252960054639;252960054653;14;2,9;2;1;1
252960054653;252960054661;8;2,9;2;1;1
252960054661;252960054667;6;2,9;2;1;1
252960054667;252960054668;1;2,9;2;1;1
252960054668;252960054672;4;2,9;2;1;1
252960054672;252960054682;10;2,9;2;1;1
252960054682;252960054683;1;2,9;2;1;1
252960054683;252960054704;21;2,9;2;1;1
252960054704;252960054709;5;2,9;2;1;1
252960054709;252960054716;7;2,9;2;1;1
252960054716;252960054724;8;2,9;2;1;1
252960054724;252960054747;23;2,9;2;1;1
252960054747;252960054754;7;2,9;2;1;1
252960054754;252960054755;1;2,9;2;1;1
252960054755;252960054766;11;2,9;2;1;1
252960054766;252960054778;12;2,9;2;1;1
252960054778;252960054796;18;2,9;2;1;1
252960054796;252960054802;6;2,9;2;1;1
252960054802;252960054813;11;2,9;2;1;1
252960054813;252960054821;8;2,9;2;1;1
252960054821;252960054822;1;2,9;2;1;1
252960054822;252960054866;44;2,9;2;1;1
252960054866;252960054897;31;2,9;2;1;1
252960054897;252960054923;26;2,9;2;1;1
252960054923;252960054926;3;2,9;2;1;1
252960054926;252960054929;3;2,9;2;1;1
252960054929;252960054941;12;2,9;2;1;1
252960054941;252960054946;5;2,9;2;1;1
252960054946;252960054949;3;2,9;2;1;1
252960054949;252960054955;6;2,9;2;1;1
252960054955;252960054956;1;2,9;2;1;1
252960054956;252960054985;29;2,9;2;1;1
252960054985;252960054997;12;2,9;2;1;1
252960054997;252960054998;1;2,9;2;1;1
252960054998;252960055023;25;2,9;2;1;1
252960055023;252960055034;11;2,9;2;1;1
252960055034;252960055040;6;2,9;2;1;1
252960055040;252960055042;2;2,9;2;1;1
252960055042;252960055051;9;2,9;2;1;1
252960055051;252960055072;21;2,9;2;1;1
252960055072;252960055103;31;2,9;2;1;1
252960055103;252960055105;2;2,9;2;1;1
252960055105;252960055107;2;2,9;2;1;1
252960055107;252960055119;12;2,9;2;1;1
252960055119;252960055128;9;2,9;2;1;1
252960055128;252960055132;4;2,9;2;1;1
252960055132;252960055135;3;2,9;2;1;1
252960055135;252960055159;24;2,9;2;1;1
252960055159;252960055187;28;2,9;2;1;1
252960055187;252960055200;13;2,9;2;1;1
252960055200;252960055221;21;2,9;2;1;1
252960055221;252960055244;23;2,9;2;1;1
252960055244;252960055253;9;2,9;2;1;1
252960055253;252960055257;4;2,9;2;1;1
252960055257;252960055268;11;2,9;2;1;1
252960055268;252960055271;3;2,9;2;1;1
252960055271;252960055277;6;2,9;2;1;1
252960055277;252960055280;3;2,9;2;1;1
252960055280;252960055324;44;2,9;2;1;1
252960055324;252960055331;7;2,9;2;1;1
252960055331;252960055333;2;2,9;2;1;1
252960055333;252960055345;12;2,9;2;1;1
252960055345;252960055363;18;2,9;2;1;1
252960055363;252960055392;29;2,9;2;1;1
252960055392;252960055400;8;2,9;2;1;1
252960055400;252960055412;12;2,9;2;1;1
252960055412;252960055417;5;2,9;2;1;1
252960055417;252960055420;3;2,9;2;1;1
252960055420;252960055438;18;2,9;2;1;1
252960055438;252960055452;14;2,9;2;1;1
252960055452;252960055469;17;2,9;2;1;1
252960055469;252960055479;10;2,9;2;1;1
252960055479;252960055485;6;2,9;2;1;1
252960055485;252960055510;25;2,9;2;1;1
252960055510;252960055516;6;2,9;2;1;1
252960055516;252960055544;28;2,9;2;1;1
252960055544;252960055557;13;2,9;2;1;1
252960055557;252960055578;21;2,9;2;1;1
252960055578;252960055642;64;2,9;2;1;1
252960055642;252960055653;11;2,9;2;1;1
252960055653;252960055661;8;2,9;2;1;1
252960055661;252960055665;4;2,9;2;1;1
252960055665;252960055680;15;2,9;2;1;1
252960055680;252960055681;1;2,9;2;1;1
252960055681;252960055684;3;2,9;2;1;1
252960055684;252960055700;16;2,9;2;1;1
252960055700;252960055705;5;2,9;2;1;1
252960055705;252960055772;67;2,9;2;1;1
252960055772;252960055784;12;2,9;2;1;1
252960055784;252960055790;6;2,9;2;1;1
252960055790;252960055806;16;2,9;2;1;1
252960055806;252960055812;6;2,9;2;1;1
252960055812;252960055828;16;2,9;2;1;1
252960055828;252960055837;9;2,9;2;1;1
252960055837;252960055860;23;2,9;2;1;1
252960055860;252960055875;15;2,9;2;1;1
252960055875;252960055883;8;2,9;2;1;1
252960055883;252960055907;24;2,9;2;1;1
252960055907;252960055911;4;2,9;2;1;1
252960055911;252960055919;8;2,9;2;1;1
252960055919;252960055921;2;2,9;2;1;1
252960055921;252960055932;11;2,9;2;1;1
252960055932;252960055936;4;2,9;2;1;1
252960055936;252960055960;24;2,9;2;1;1
252960055960;252960055967;7;2,9;2;1;1
252960055967;252960055976;9;2,9;2;1;1
252960055976;252960055996;20;2,9;2;1;1
252960055996;252960056015;19;2,9;2;1;1
252960056015;252960056031;16;2,9;2;1;1
252960056031;252960056034;3;2,9;2;1;1
252960056034;252960056049;15;2,9;2;1;1
252960056049;252960056079;30;2,9;2;1;1
252960056079;252960056097;18;2,9;2;1;1
252960056097;252960056104;7;2,9;2;1;1
252960056104;252960056125;21;2,9;2;1;1
252960056125;252960056135;10;2,9;2;1;1
252960056135;252960056146;11;2,9;2;1;1
252960056146;252960056167;21;2,9;2;1;1
252960056167;252960056171;4;2,9;2;1;1
252960056171;252960056175;4;2,9;2;1;1
252960056175;252960056188;13;2,9;2;1;1
252960056188;252960056232;44;2,9;2;1;1
252960056232;252960056249;17;2,9;2;1;1
252960056249;252960056266;17;2,9;2;1;1
252960056266;252960056285;19;2,9;2;1;1
252960056285;252960056299;14;2,9;2;1;1
252960056299;252960056300;1;2,9;2;1;1
252960056300;252960056313;13;2,9;2;1;1
252960056313;252960056315;2;2,9;2;1;1
252960056315;252960056316;1;2,9;2;1;1
252960056316;252960056346;30;2,9;2;1;1
252960056346;252960056347;1;2,9;2;1;1
252960056347;252960056359;12;2,9;2;1;1
252960056359;252960056401;42;2,9;2;1;1
252960056401;252960056413;12;2,9;2;1;1
252960056413;252960056420;7;2,9;2;1;1
252960056420;252960056442;22;2,9;2;1;1
252960056442;252960056443;1;2,9;2;1;1
252960056443;252960056444;1;2,9;2;1;1
252960056444;252960056462;18;2,9;2;1;1
252960056462;252960056480;18;2,9;2;1;1
252960056480;252960056481;1;2,9;2;1;1
252960056481;252960056490;9;2,9;2;1;1
252960056490;252960056493;3;2,9;2;1;1
252960056493;252960056499;6;2,9;2;1;1
252960056499;252960056502;3;2,9;2;1;1
252960056502;252960056505;3;2,9;2;1;1
252960056505;252960056520;15;2,9;2;1;1
252960056520;252960056526;6;2,9;2;1;1
252960056526;252960056528;2;2,9;2;1;1
252960056528;252960056535;7;2,9;2;1;1
252960056535;252960056544;9;2,9;2;1;1
252960056544;252960056559;15;2,9;2;1;1
252960056559;252960056579;20;2,9;2;1;1
252960056579;252960056639;60;2,9;2;1;1
252960056639;252960056687;48;2,9;2;1;1
252960056687;252960056714;27;2,9;2;1;1
252960056714;252960056723;9;2,9;2;1;1
252960056723;252960056727;4;2,9;2;1;1
252960056727;252960056728;1;2,9;2;1;1
252960056728;252960056746;18;2,9;2;1;1
252960056746;252960056752;6;2,9;2;1;1
252960056752;252960056781;29;2,9;2;1;1
252960056781;252960056784;3;2,9;2;1;1
252960056784;252960056796;12;2,9;2;1;1
252960056796;252960056806;10;2,9;2;1;1
252960056806;252960056844;38;2,9;2;1;1
252960056844;252960056872;28;2,9;2;1;1
252960056872;252960056888;16;2,9;2;1;1
252960056888;252960056955;67;2,9;2;1;1
252960056955;252960056973;18;2,9;2;1;1
252960056973;252960056977;4;2,9;2;1;1
252960056977;252960057037;60;2,9;2;1;1
252960057037;252960057063;26;2,9;2;1;1
252960057063;252960057080;17;2,9;2;1;1
252960057080;252960057111;31;2,9;2;1;1
252960057111;252960057145;34;2,9;2;1;1
252960057145;252960057155;10;2,9;2;1;1
252960057155;252960057159;4;2,9;2;1;1
252960057159;252960057167;8;2,9;2;1;1
252960057167;252960057185;18;2,9;2;1;1
252960057185;252960057275;90;2,9;2;1;1
252960057275;252960057280;5;2,9;2;1;1
252960057280;252960057287;7;2,9;2;1;1
252960057287;252960057330;43;2,9;2;1;1
252960057330;252960057354;24;2,9;2;1;1
252960057354;252960057368;14;2,9;2;1;1
252960057368;252960057381;13;2,9;2;1;1
252960057381;252960057386;5;2,9;2;1;1
252960057386;252960057411;25;2,9;2;1;1
252960057411;252960057415;4;2,9;2;1;1
252960057415;252960057434;19;2,9;2;1;1
252960057434;252960057470;36;2,9;2;1;1
252960057470;252960057530;60;2,9;2;1;1
252960057530;252960057540;10;2,9;2;1;1
252960057540;252960057567;27;2,9;2;1;1
252960057567;252960057570;3;2,9;2;1;1
252960057570;252960057612;42;2,9;2;1;1
252960057612;252960057621;9;2,9;2;1;1
252960057621;252960057635;14;2,9;2;1;1
252960057635;252960057660;25;2,9;2;1;1
252960057660;252960057687;27;2,9;2;1;1
252960057687;252960057711;24;2,9;2;1;1
252960057711;252960057762;51;2,9;2;1;1
252960057762;252960058092;330;2,9;2;1;1
252960058092;252960062965;4873;2,9;2;1;1
252960062965;252960222081;159116;2,9;2;1;1
252960222081;252960384198;162117;2,9;2;1;1
252960384198;252980327295;19943097;2,9;2;1;1
252980327295;253017338335;37011040;2,9;2;1;1
253017338335;253017393882;55547;2,9;2;1;1
253017393882;253017438574;44692;2,9;2;1;1
253017438574;253017457496;18922;2,9;2;1;1
253017457496;253017458733;1237;2,9;2;1;1
253017458733;253017634607;175874;2,9;2;1;1
253017634607;253017872458;237851;2,9;2;1;1
253017872458;253023863380;5990922;2,9;2;1;1
253023863380;253024069400;206020;2,9;2;1;1
253024069400;253033493014;9423614;2,9;2;1;1
253033493014;253034010513;517499;2,9;2;1;1
253034010513;253034025705;15192;2,9;2;1;1
253034025705;253034046583;20878;2,9;2;1;1
253034046583;253034394515;347932;2,9;2;1;1
253034394515;253034892786;498271;2,9;2;1;1
253034892786;253035095686;202900;2,9;2;1;1
253035095686;253035437203;341517;2,9;2;1;1
253035437203;253035438237;1034;2,9;2;1;1
253035438237;253035613877;175640;2,9;2;1;1
253035613877;253035630900;17023;2,9;2;1;1
253035630900;253035644233;13333;2,9;2;1;1
253035644233;253301189106;265544873;2,9;2;1;1
253301189106;253301303149;114043;2,9;2;1;1
253301303149;253309317599;8014450;2,9;2;1;1
253309317599;253458777886;149460287;2,9;2;1;1
253458777886;253458778958;1072;2,9,11;3;1;1
253458778958;253458781231;2273;2,9;2;1;1
253458781231;253458784506;3275;2,9,11;3;1;1
253458784506;253459039523;255017;2,9;2;1;1
253459039523;253486943114;27903591;2,9,11;3;1;1
253486943114;253540205449;53262335;2,9;2;1;1
253540205449;253540221409;15960;2,9;2;1;1
253540221409;253540277174;55765;2,9;2;1;1
253540277174;253540283350;6176;2,9;2;1;1
253540283350;253540287628;4278;2,9;2;1;1
253540287628;253540288155;527;2,9;2;1;1
253540288155;253540307003;18848;2,9;2;1;1
253540307003;253540332864;25861;2,9;2;1;1
253540332864;253540400593;67729;2,9;2;1;1
253540400593;253540414132;13539;2,9;2;1;1
253540414132;253540419028;4896;2,9;2;1;1
253540419028;253720333989;179914961;2,9;2;1;1
253720333989;253720431151;97162;2,9;2;1;1
253720431151;253720666955;235804;2,9;2;1;1
253720666955;253720687861;20906;2,9;2;1;1
253720687861;253720696586;8725;2,9;2;1;1
253720696586;253720922459;225873;2,9;2;1;1
253720922459;253721596764;674305;2,9;2;1;1
253721596764;253731733271;10136507;2,9;2;1;1
253731733271;253742906970;11173699;2,9;2;1;1
253742906970;253750254907;7347937;2,9;2;1;1
253750254907;253750272692;17785;2,9;2;1;1
253750272692;253750289184;16492;2,9;2;1;1
253750289184;253898486038;148196854;2,9;2;1;1
253898486038;253898661116;175078;2,9;2;1;1
253898661116;253936336371;37675255;2,9;2;1;1
253936336371;253936422262;85891;2,9;2;1;1
253936422262;253959409359;22987097;2,9;2;1;1
253959409359;253962129631;2720272;2,9;2;1;1
253962129631;253971429367;9299736;2,9;2;1;1
253971429367;253973711321;2281954;2,9;2;1;1
253973711321;253995509538;21798217;2,9;2;1;1
253995509538;253996366667;857129;2,9;2;1;1
253996366667;254021509752;25143085;2,9;2;1;1
254021509752;254024180831;2671079;2,9;2;1;1
254024180831;254047748794;23567963;2,9;2;1;1
254047748794;254056404861;8656067;2,9;2;1;1
254056404861;254056407517;2656;2,9;2;1;1
254056407517;254056542952;135435;2,9;2;1;1
254056542952;254060000943;3457991;2,9;2;1;1
254060000943;254065980962;5980019;2,9;2;1;1
254065980962;254066964447;983485;2,9;2;1;1
254066964447;254069399006;2434559;2,9;2;1;1
254069399006;254069630946;231940;2,9;2;1;1
254069630946;254131044434;61413488;2,9;2;1;1
254131044434;254393577906;262533472;2,9;2;1;1
254393577906;254865064879;471486973;2,9;2;1;1
254865064879;254865206528;141649;2,9;2;1;1
254865206528;255246876184;381669656;2,9;2;1;1
255246876184;255281311487;34435303;2,9,10;3;1;1
255281311487;255310278673;28967186;2,9;2;1;1
255310278673;255336123992;25845319;2,6,9;3;1;1
255336123992;255834324318;498200326;2,9;2;1;1
255834324318;255881567232;47242914;2,3,9;3;1;1
255881567232;256525177991;643610759;2,9;2;1;1
256525177991;256575802083;50624092;2,3,9;3;1;1
256575802083;256801229786;225427703;2,9;2;1;1
256801229786;256849075340;47845554;2,5,9;3;1;1
256849075340;256894325533;45250193;2,9;2;1;1
256894325533;256895124984;799451;2,9;2;1;1
256895124984;256903472680;8347696;2,9;2;1;1
256903472680;256904581879;1109199;2,9;2;1;1
256904581879;256912872429;8290550;2,9;2;1;1
256912872429;256913788923;916494;2,9;2;1;1
256913788923;256920135849;6346926;2,9;2;1;1
256920135849;256921118592;982743;2,9;2;1;1
256921118592;256927721340;6602748;2,9;2;1;1
256927721340;256928741345;1020005;2,9;2;1;1
256928741345;256937064838;8323493;2,9;2;1;1
256937064838;256938035878;971040;2,9;2;1;1
256938035878;256944045589;6009711;2,9;2;1;1
256944045589;256944851800;806211;2,9;2;1;1
256944851800;256950505080;5653280;2,9;2;1;1
256950505080;256951145572;640492;2,9;2;1;1
256951145572;256955931045;4785473;2,9;2;1;1
256955931045;256956055018;123973;2,9;2;1;1
256956055018;257273192588;317137570;2,9;2;1;1
257273192588;257273193642;1054;2,9,11;3;1;1
257273193642;257273195661;2019;2,9;2;1;1
257273195661;257273198932;3271;2,9,11;3;1;1
257273198932;257274149718;950786;2,9;2;1;1
257274149718;257303427819;29278101;2,9,11;3;1;1
257303427819;257316881903;13454084;2,9;2;1;1
257316881903;257359857699;42975796;2,6,9;3;1;1
257359857699;257499111210;139253511;2,9;2;1;1
257499111210;257505519908;6408698;2,5,9;3;1;1
257505519908;257505976844;456936;2,5,9;3;1;1
257505976844;257538720725;32743881;2,5,9;3;1;1
257538720725;257538726317;5592;2,5,9;3;1;1
257538726317;257538735245;8928;2,5,9;3;1;1
257538735245;257538744501;9256;2,5,9;3;1;1
257538744501;257538753578;9077;2,5,9;3;1;1
257538753578;257538757595;4017;2,5,9;3;1;1
257538757595;257549858984;11101389;2,5,9;3;1;1
257549858984;257748469118;198610134;2,9;2;1;1
257748469118;257748640767;171649;2,9;2;1;1
257748640767;257763390768;14750001;2,9;2;1;1
257763390768;257810856778;47466010;0,2,9;3;1;1
257810856778;257849532766;38675988;2,9;2;1;1
257849532766;257849574972;42206;2,9;2;1;1
257849574972;257852087347;2512375;2,9;2;1;1
257852087347;257852101940;14593;2,9;2;1;1
257852101940;257852122857;20917;2,9;2;1;1
257852122857;257852227630;104773;2,9;2;1;1
257852227630;257852505630;278000;2,9;2;1;1
257852505630;258076315092;223809462;2,9;2;1;1
258076315092;258076471280;156188;2,9;2;1;1
258076471280;258076477640;6360;2,9;2;1;1
258076477640;258076478560;920;2,9;2;1;1
258076478560;258076488487;9927;2,9;2;1;1
258076488487;258076489141;654;2,9;2;1;1
258076489141;258076491009;1868;2,9;2;1;1
258076491009;258076496214;5205;2,9;2;1;1
258076496214;258076512102;15888;2,9;2;1;1
258076512102;258076521833;9731;2,9;2;1;1
258076521833;258076521922;89;2,9;2;1;1
258076521922;258076538172;16250;2,9;2;1;1
258076538172;258076543139;4967;2,9;2;1;1
258076543139;258076552291;9152;2,9;2;1;1
258076552291;258076571287;18996;2,9;2;1;1
258076571287;258076623060;51773;2,9;2;1;1
258076623060;258076624678;1618;2,9;2;1;1
258076624678;258076629470;4792;2,9;2;1;1
258076629470;258076635743;6273;2,9;2;1;1
258076635743;258076637221;1478;2,9;2;1;1
258076637221;258076650662;13441;2,9;2;1;1
258076650662;258076652008;1346;2,9;2;1;1
258076652008;258076660761;8753;2,9;2;1;1
258076660761;258076663472;2711;2,9;2;1;1
258076663472;258076664036;564;2,9;2;1;1
258076664036;258076669006;4970;2,9;2;1;1
258076669006;258076669080;74;2,9;2;1;1
258076669080;258076670329;1249;2,9;2;1;1
258076670329;258076670733;404;2,9;2;1;1
258076670733;258076671520;787;2,9;2;1;1
258076671520;258076713430;41910;2,9;2;1;1
258076713430;258076720107;6677;2,9;2;1;1
258076720107;258076720674;567;2,9;2;1;1
258076720674;258076734323;13649;2,9;2;1;1
258076734323;258076734975;652;2,9;2;1;1
258076734975;258076749051;14076;2,9;2;1;1
258076749051;258076767303;18252;2,9;2;1;1
258076767303;258076775950;8647;2,9;2;1;1
258076775950;258076786230;10280;2,9;2;1;1
258076786230;258076801643;15413;2,9;2;1;1
258076801643;258076821542;19899;2,9;2;1;1
258076821542;258076822028;486;2,9;2;1;1
258076822028;258076823620;1592;2,9;2;1;1
258076823620;258076829556;5936;2,9;2;1;1
258076829556;258076830042;486;2,9;2;1;1
258076830042;258076852354;22312;2,9;2;1;1
258076852354;258076855072;2718;2,9;2;1;1
258076855072;258076855561;489;2,9;2;1;1
258076855561;258076889594;34033;2,9;2;1;1
258076889594;258076901113;11519;2,9;2;1;1
258076901113;258076908297;7184;2,9;2;1;1
258076908297;258076908981;684;2,9;2;1;1
258076908981;258076967056;58075;2,9;2;1;1
258076967056;258076997379;30323;2,9;2;1;1
258076997379;258077008032;10653;2,9;2;1;1
258077008032;258077021264;13232;2,9;2;1;1
258077021264;258077053838;32574;2,9;2;1;1
258077053838;258077056427;2589;2,9;2;1;1
258077056427;258077056925;498;2,9;2;1;1
258077056925;258077074302;17377;2,9;2;1;1
258077074302;258077074782;480;2,9;2;1;1
258077074782;258077074913;131;2,9;2;1;1
258077074913;258077086167;11254;2,9;2;1;1
258077086167;258077098836;12669;2,9;2;1;1
258077098836;258077112303;13467;2,9;2;1;1
258077112303;258077113011;708;2,9;2;1;1
258077113011;258077127690;14679;2,9;2;1;1
258077127690;258077128171;481;2,9;2;1;1
258077128171;258077133431;5260;2,9;2;1;1
258077133431;258077138502;5071;2,9;2;1;1
258077138502;258077180794;42292;2,9;2;1;1
258077180794;258077197642;16848;2,9;2;1;1
258077197642;258077198271;629;2,9;2;1;1
258077198271;258077205863;7592;2,9;2;1;1
258077205863;258077225806;19943;2,9;2;1;1
258077225806;258077246518;20712;2,9;2;1;1
258077246518;258077250828;4310;2,9;2;1;1
258077250828;258077260863;10035;2,9;2;1;1
258077260863;258077261344;481;2,9;2;1;1
258077261344;258077273023;11679;2,9;2;1;1
258077273023;258077302833;29810;2,9;2;1;1
258077302833;258077303457;624;2,9;2;1;1
258077303457;258077305933;2476;2,9;2;1;1
258077305933;258077309913;3980;2,9;2;1;1
258077309913;258077310403;490;2,9;2;1;1
258077310403;258077311409;1006;2,9;2;1;1
258077311409;258077321510;10101;2,9;2;1;1
258077321510;258077346217;24707;2,9;2;1;1
258077346217;258077359236;13019;2,9;2;1;1
258077359236;258077388708;29472;2,9;2;1;1
258077388708;258077405121;16413;2,9;2;1;1
258077405121;258077405922;801;2,9;2;1;1
258077405922;258077409207;3285;2,9;2;1;1
258077409207;258077413165;3958;2,9;2;1;1
258077413165;258077413556;391;2,9;2;1;1
258077413556;258077413673;117;2,9;2;1;1
258077413673;258077414034;361;2,9;2;1;1
258077414034;258077430940;16906;2,9;2;1;1
258077430940;258077442555;11615;2,9;2;1;1
258077442555;258077463460;20905;2,9;2;1;1
258077463460;258077463946;486;2,9;2;1;1
258077463946;258077472772;8826;2,9;2;1;1
258077472772;258077485621;12849;2,9;2;1;1
258077485621;258077496314;10693;2,9;2;1;1
258077496314;258077496830;516;2,9;2;1;1
258077496830;258077497711;881;2,9;2;1;1
258077497711;258077498205;494;2,9;2;1;1
258077498205;258077505524;7319;2,9;2;1;1
258077505524;258077527043;21519;2,9;2;1;1
258077527043;258077556947;29904;2,9;2;1;1
258077556947;258077579941;22994;2,9;2;1;1
258077579941;258077582605;2664;2,9;2;1;1
258077582605;258077583093;488;2,9;2;1;1
258077583093;258077614904;31811;2,9;2;1;1
258077614904;258077636317;21413;2,9;2;1;1
258077636317;258077638710;2393;2,9;2;1;1
258077638710;258077639191;481;2,9;2;1;1
258077639191;258077661834;22643;2,9;2;1;1
258077661834;258077689139;27305;2,9;2;1;1
258077689139;258077696472;7333;2,9;2;1;1
258077696472;258077710303;13831;2,9;2;1;1
258077710303;258077711151;848;2,9;2;1;1
258077711151;258077715881;4730;2,9;2;1;1
258077715881;258077744077;28196;2,9;2;1;1
258077744077;258077758516;14439;2,9;2;1;1
258077758516;258077759169;653;2,9;2;1;1
258077759169;258077770138;10969;2,9;2;1;1
258077770138;258077770622;484;2,9;2;1;1
258077770622;258077771917;1295;2,9;2;1;1
258077771917;258077791778;19861;2,9;2;1;1
258077791778;258077815418;23640;2,9;2;1;1
258077815418;258077835982;20564;2,9;2;1;1
258077835982;258077836738;756;2,9;2;1;1
258077836738;258077837389;651;2,9;2;1;1
258077837389;258077846952;9563;2,9;2;1;1
258077846952;258077872917;25965;2,9;2;1;1
258077872917;258077873400;483;2,9;2;1;1
258077873400;258077887071;13671;2,9;2;1;1
258077887071;258077899465;12394;2,9;2;1;1
258077899465;258077904520;5055;2,9;2;1;1
258077904520;258077905171;651;2,9;2;1;1
258077905171;258077910705;5534;2,9;2;1;1
258077910705;258077911188;483;2,9;2;1;1
258077911188;258077928585;17397;2,9;2;1;1
258077928585;258077949767;21182;2,9;2;1;1
258077949767;258077966487;16720;2,9;2;1;1
258077966487;258077977423;10936;2,9;2;1;1
258077977423;258078004745;27322;2,9;2;1;1
258078004745;258078005224;479;2,9;2;1;1
258078005224;258078008214;2990;2,9;2;1;1
258078008214;258078038572;30358;2,9;2;1;1
258078038572;258078039142;570;2,9;2;1;1
258078039142;258078039632;490;2,9;2;1;1
258078039632;258078044648;5016;2,9;2;1;1
258078044648;258078065112;20464;2,9;2;1;1
258078065112;258078085431;20319;2,9;2;1;1
258078085431;258078091748;6317;2,9;2;1;1
258078091748;258078094164;2416;2,9;2;1;1
258078094164;258078094642;478;2,9;2;1;1
258078094642;258078122446;27804;2,9;2;1;1
258078122446;258078122934;488;2,9;2;1;1
258078122934;258078126751;3817;2,9;2;1;1
258078126751;258078140278;13527;2,9;2;1;1
258078140278;258078160567;20289;2,9;2;1;1
258078160567;258078161219;652;2,9;2;1;1
258078161219;258078166393;5174;2,9;2;1;1
258078166393;258078183081;16688;2,9;2;1;1
258078183081;258078198298;15217;2,9;2;1;1
258078198298;258078198948;650;2,9;2;1;1
258078198948;258078199202;254;2,9;2;1;1
258078199202;258078199851;649;2,9;2;1;1
258078199851;258078212444;12593;2,9;2;1;1
258078212444;258078217563;5119;2,9;2;1;1
258078217563;258078252608;35045;2,9;2;1;1
258078252608;258078273068;20460;2,9;2;1;1
258078273068;258078276136;3068;2,9;2;1;1
258078276136;258078276789;653;2,9;2;1;1
258078276789;258078285168;8379;2,9;2;1;1
258078285168;258078296246;11078;2,9;2;1;1
258078296246;258078326312;30066;2,9;2;1;1
258078326312;258078326802;490;2,9;2;1;1
258078326802;258078335179;8377;2,9;2;1;1
258078335179;258078352869;17690;2,9;2;1;1
258078352869;258078353366;497;2,9;2;1;1
258078353366;258078359837;6471;2,9;2;1;1
258078359837;258078384232;24395;2,9;2;1;1
258078384232;258078396091;11859;2,9;2;1;1
258078396091;258078406218;10127;2,9;2;1;1
258078406218;258078406698;480;2,9;2;1;1
258078406698;258078417049;10351;2,9;2;1;1
258078417049;258078417534;485;2,9;2;1;1
258078417534;258078425221;7687;2,9;2;1;1
258078425221;258078446406;21185;2,9;2;1;1
258078446406;258078467678;21272;2,9;2;1;1
258078467678;258078498371;30693;2,9;2;1;1
258078498371;258078508806;10435;2,9;2;1;1
258078508806;258078514209;5403;2,9;2;1;1
258078514209;258078514857;648;2,9;2;1;1
258078514857;258078530364;15507;2,9;2;1;1
258078530364;258078553120;22756;2,9;2;1;1
258078553120;258078566049;12929;2,9;2;1;1
258078566049;258078566702;653;2,9;2;1;1
258078566702;258078571739;5037;2,9;2;1;1
258078571739;258078582382;10643;2,9;2;1;1
258078582382;258078582876;494;2,9;2;1;1
258078582876;258078585201;2325;2,9;2;1;1
258078585201;258078585687;486;2,9;2;1;1
258078585687;258078591619;5932;2,9;2;1;1
258078591619;258078616903;25284;2,9;2;1;1
258078616903;258078628972;12069;2,9;2;1;1
258078628972;258078629478;506;2,9;2;1;1
258078629478;258078630128;650;2,9;2;1;1
258078630128;258078639906;9778;2,9;2;1;1
258078639906;258078670017;30111;2,9;2;1;1
258078670017;258078684301;14284;2,9;2;1;1
258078684301;258078693354;9053;2,9;2;1;1
258078693354;258078693844;490;2,9;2;1;1
258078693844;258078710385;16541;2,9;2;1;1
258078710385;258078735540;25155;2,9;2;1;1
258078735540;258078741559;6019;2,9;2;1;1
258078741559;258078742047;488;2,9;2;1;1
258078742047;258078764098;22051;2,9;2;1;1
258078764098;258078787486;23388;2,9;2;1;1
258078787486;258078790428;2942;2,9;2;1;1
258078790428;258078790913;485;2,9;2;1;1
258078790913;258078800770;9857;2,9;2;1;1
258078800770;258078801505;735;2,9;2;1;1
258078801505;258078805867;4362;2,9;2;1;1
258078805867;258078818332;12465;2,9;2;1;1
258078818332;258078832273;13941;2,9;2;1;1
258078832273;258078832938;665;2,9;2;1;1
258078832938;258078907752;74814;2,9;2;1;1
258078907752;258078934954;27202;2,9;2;1;1
258078934954;258078945517;10563;2,9;2;1;1
258078945517;258078945997;480;2,9;2;1;1
258078945997;258078947081;1084;2,9;2;1;1
258078947081;258078973245;26164;2,9;2;1;1
258078973245;258078989161;15916;2,9;2;1;1
258078989161;258079027815;38654;2,9;2;1;1
258079027815;258079028305;490;2,9;2;1;1
258079028305;258079033523;5218;2,9;2;1;1
258079033523;258079038792;5269;2,9;2;1;1
258079038792;258079074487;35695;2,9;2;1;1
258079074487;258079085072;10585;2,9;2;1;1
258079085072;258079085558;486;2,9;2;1;1
258079085558;258079089639;4081;2,9;2;1;1
258079089639;258079090120;481;2,9;2;1;1
258079090120;258079102041;11921;2,9;2;1;1
258079102041;258079139532;37491;2,9;2;1;1
258079139532;258079152170;12638;2,9;2;1;1
258079152170;258079153855;1685;2,9;2;1;1
258079153855;258079154504;649;2,9;2;1;1
258079154504;258079168035;13531;2,9;2;1;1
258079168035;258079178128;10093;2,9;2;1;1
258079178128;258079178735;607;2,9;2;1;1
258079178735;258079218058;39323;2,9;2;1;1
258079218058;258079240629;22571;2,9;2;1;1
258079240629;258079250779;10150;2,9;2;1;1
258079250779;258079251258;479;2,9;2;1;1
258079251258;258079271110;19852;2,9;2;1;1
258079271110;258079296361;25251;2,9;2;1;1
258079296361;258079306885;10524;2,9;2;1;1
258079306885;258079308034;1149;2,9;2;1;1
258079308034;258079312796;4762;2,9;2;1;1
258079312796;258079333673;20877;2,9;2;1;1
258079333673;258079359377;25704;2,9;2;1;1
258079359377;258079369581;10204;2,9;2;1;1
258079369581;258079392179;22598;2,9;2;1;1
258079392179;258079392831;652;2,9;2;1;1
258079392831;258079421294;28463;2,9;2;1;1
258079421294;258079445877;24583;2,9;2;1;1
258079445877;258079458563;12686;2,9;2;1;1
258079458563;258079459328;765;2,9;2;1;1
258079459328;258079473555;14227;2,9;2;1;1
258079473555;258079491118;17563;2,9;2;1;1
258079491118;258079513958;22840;2,9;2;1;1
258079513958;258079539480;25522;2,9;2;1;1
258079539480;258079545181;5701;2,9;2;1;1
258079545181;258079545664;483;2,9;2;1;1
258079545664;258079550226;4562;2,9;2;1;1
258079550226;258079550709;483;2,9;2;1;1
258079550709;258079559120;8411;2,9;2;1;1
258079559120;258079583025;23905;2,9;2;1;1
258079583025;258079593761;10736;2,9;2;1;1
258079593761;258079594236;475;2,9;2;1;1
258079594236;258079603408;9172;2,9;2;1;1
258079603408;258079628273;24865;2,9;2;1;1
258079628273;258079638430;10157;2,9;2;1;1
258079638430;258079638909;479;2,9;2;1;1
258079638909;258079645844;6935;2,9;2;1;1
258079645844;258079687174;41330;2,9;2;1;1
258079687174;258079714316;27142;2,9;2;1;1
258079714316;258079725987;11671;2,9;2;1;1
258079725987;258079726467;480;2,9;2;1;1
258079726467;258079729702;3235;2,9;2;1;1
258079729702;258079771094;41392;2,9;2;1;1
258079771094;258079773942;2848;2,9;2;1;1
258079773942;258079781065;7123;2,9;2;1;1
258079781065;258079784418;3353;2,9;2;1;1
258079784418;258079784900;482;2,9;2;1;1
258079784900;258079792558;7658;2,9;2;1;1
258079792558;258079793179;621;2,9;2;1;1
258079793179;258079794171;992;2,9;2;1;1
258079794171;258079806783;12612;2,9;2;1;1
258079806783;258079807462;679;2,9;2;1;1
258079807462;258079828780;21318;2,9;2;1;1
258079828780;258079844361;15581;2,9;2;1;1
258079844361;258079903176;58815;2,9;2;1;1
258079903176;258079903945;769;2,9;2;1;1
258079903945;258079906829;2884;2,9;2;1;1
258079906829;258079911548;4719;2,9;2;1;1
258079911548;258079937434;25886;2,9;2;1;1
258079937434;258079973448;36014;2,9;2;1;1
258079973448;258079973935;487;2,9;2;1;1
258079973935;258079976577;2642;2,9;2;1;1
258079976577;258079980674;4097;2,9;2;1;1
258079980674;258079989437;8763;2,9;2;1;1
258079989437;258079990087;650;2,9;2;1;1
258079990087;258080000218;10131;2,9;2;1;1
258080000218;258080011012;10794;2,9;2;1;1
258080011012;258080011490;478;2,9;2;1;1
258080011490;258080021788;10298;2,9;2;1;1
258080021788;258080030841;9053;2,9;2;1;1
258080030841;258080063439;32598;2,9;2;1;1
258080063439;258080067520;4081;2,9;2;1;1
258080067520;258080110459;42939;2,9;2;1;1
258080110459;258080143440;32981;2,9;2;1;1
258080143440;258080153756;10316;2,9;2;1;1
258080153756;258080157170;3414;2,9;2;1;1
258080157170;258080157821;651;2,9;2;1;1
258080157821;258080168847;11026;2,9;2;1;1
258080168847;258080179938;11091;2,9;2;1;1
258080179938;258080180417;479;2,9;2;1;1
258080180417;258080203704;23287;2,9;2;1;1
258080203704;258080219298;15594;2,9;2;1;1
258080219298;258080230785;11487;2,9;2;1;1
258080230785;258080231275;490;2,9;2;1;1
258080231275;258080261301;30026;2,9;2;1;1
258080261301;258080322073;60772;2,9;2;1;1
258080322073;258080363704;41631;2,9;2;1;1
258080363704;258080372151;8447;2,9;2;1;1
258080372151;258080373944;1793;2,9;2;1;1
258080373944;258080374434;490;2,9;2;1;1
258080374434;258080378311;3877;2,9;2;1;1
258080378311;258080391445;13134;2,9;2;1;1
258080391445;258080392097;652;2,9;2;1;1
258080392097;258080393710;1613;2,9;2;1;1
258080393710;258080407153;13443;2,9;2;1;1
258080407153;258080407805;652;2,9;2;1;1
258080407805;258080420106;12301;2,9;2;1;1
258080420106;258080444655;24549;2,9;2;1;1
258080444655;258080455558;10903;2,9;2;1;1
258080455558;258080456038;480;2,9;2;1;1
258080456038;258080462474;6436;2,9;2;1;1
258080462474;258080481485;19011;2,9;2;1;1
258080481485;258080512596;31111;2,9;2;1;1
258080512596;258080533030;20434;2,9;2;1;1
258080533030;258080544176;11146;2,9;2;1;1
258080544176;258080544661;485;2,9;2;1;1
258080544661;258080554166;9505;2,9;2;1;1
258080554166;258080556501;2335;2,9;2;1;1
258080556501;258080585714;29213;2,9;2;1;1
258080585714;258080594813;9099;2,9;2;1;1
258080594813;258080622418;27605;2,9;2;1;1
258080622418;258080630822;8404;2,9;2;1;1
258080630822;258080654961;24139;2,9;2;1;1
258080654961;258080700605;45644;2,9;2;1;1
258080700605;258080721444;20839;2,9;2;1;1
258080721444;258080725467;4023;2,9;2;1;1
258080725467;258080736056;10589;2,9;2;1;1
258080736056;258080736738;682;2,9;2;1;1
258080736738;258080738264;1526;2,9;2;1;1
258080738264;258080738752;488;2,9;2;1;1
258080738752;258080746897;8145;2,9;2;1;1
258080746897;258080755996;9099;2,9;2;1;1
258080755996;258080787299;31303;2,9;2;1;1
258080787299;258080811507;24208;2,9;2;1;1
258080811507;258080823122;11615;2,9;2;1;1
258080823122;258080823603;481;2,9;2;1;1
258080823603;258080831434;7831;2,9;2;1;1
258080831434;258080858735;27301;2,9;2;1;1
258080858735;258080870287;11552;2,9;2;1;1
258080870287;258080870778;491;2,9;2;1;1
258080870778;258080912214;41436;2,9;2;1;1
258080912214;258080924311;12097;2,9;2;1;1
258080924311;258080935163;10852;2,9;2;1;1
258080935163;258080935809;646;2,9;2;1;1
258080935809;258080954229;18420;2,9;2;1;1
258080954229;258080974353;20124;2,9;2;1;1
258080974353;258080987691;13338;2,9;2;1;1
258080987691;258080988341;650;2,9;2;1;1
258080988341;258081034258;45917;2,9;2;1;1
258081034258;258081036655;2397;2,9;2;1;1
258081036655;258081077573;40918;2,9;2;1;1
258081077573;258081098795;21222;2,9;2;1;1
258081098795;258081109788;10993;2,9;2;1;1
258081109788;258081110275;487;2,9;2;1;1
258081110275;258081113611;3336;2,9;2;1;1
258081113611;258081121863;8252;2,9;2;1;1
258081121863;258081155278;33415;2,9;2;1;1
258081155278;258081168717;13439;2,9;2;1;1
258081168717;258081180097;11380;2,9;2;1;1
258081180097;258081180631;534;2,9;2;1;1
258081180631;258081197506;16875;2,9;2;1;1
258081197506;258081199607;2101;2,9;2;1;1
258081199607;258081245296;45689;2,9;2;1;1
258081245296;258081266567;21271;2,9;2;1;1
258081266567;258081279492;12925;2,9;2;1;1
258081279492;258081279978;486;2,9;2;1;1
258081279978;258081304089;24111;2,9;2;1;1
258081304089;258081313326;9237;2,9;2;1;1
258081313326;258081347848;34522;2,9;2;1;1
258081347848;258081368163;20315;2,9;2;1;1
258081368163;258081378968;10805;2,9;2;1;1
258081378968;258081379446;478;2,9;2;1;1
258081379446;258081391708;12262;2,9;2;1;1
258081391708;258081426023;34315;2,9;2;1;1
258081426023;258081434814;8791;2,9;2;1;1
258081434814;258081436632;1818;2,9;2;1;1
258081436632;258081437112;480;2,9;2;1;1
258081437112;258081465746;28634;2,9;2;1;1
258081465746;258081476215;10469;2,9;2;1;1
258081476215;258081476703;488;2,9;2;1;1
258081476703;258081486684;9981;2,9;2;1;1
258081486684;258081495667;8983;2,9;2;1;1
258081495667;258081520241;24574;2,9;2;1;1
258081520241;258081541533;21292;2,9;2;1;1
258081541533;258081552859;11326;2,9;2;1;1
258081552859;258081553348;489;2,9;2;1;1
258081553348;258081567768;14420;2,9;2;1;1
258081567768;258081577002;9234;2,9;2;1;1
258081577002;258081608362;31360;2,9;2;1;1
258081608362;258081640990;32628;2,9;2;1;1
258081640990;258081659537;18547;2,9;2;1;1
258081659537;258081661882;2345;2,9;2;1;1
258081661882;258081697480;35598;2,9;2;1;1
258081697480;258081731154;33674;2,9;2;1;1
258081731154;258081733977;2823;2,9;2;1;1
258081733977;258081745429;11452;2,9;2;1;1
258081745429;258081746079;650;2,9;2;1;1
258081746079;258081754629;8550;2,9;2;1;1
258081754629;258081765298;10669;2,9;2;1;1
258081765298;258081765784;486;2,9;2;1;1
258081765784;258081786674;20890;2,9;2;1;1
258081786674;258081811448;24774;2,9;2;1;1
258081811448;258081835611;24163;2,9;2;1;1
258081835611;258081858184;22573;2,9;2;1;1
258081858184;258081870075;11891;2,9;2;1;1
258081870075;258081870560;485;2,9;2;1;1
258081870560;258081878708;8148;2,9;2;1;1
258081878708;258081892656;13948;2,9;2;1;1
258081892656;258081903926;11270;2,9;2;1;1
258081903926;258081904414;488;2,9;2;1;1
258081904414;258081909947;5533;2,9;2;1;1
258081909947;258081918734;8787;2,9;2;1;1
258081918734;258081953509;34775;2,9;2;1;1
258081953509;258081977329;23820;2,9;2;1;1
258081977329;258081988131;10802;2,9;2;1;1
258081988131;258081988621;490;2,9;2;1;1
258081988621;258081991529;2908;2,9;2;1;1
258081991529;258082002297;10768;2,9;2;1;1
258082002297;258082028421;26124;2,9;2;1;1
258082028421;258082036923;8502;2,9;2;1;1
258082036923;258082070335;33412;2,9;2;1;1
258082070335;258082096475;26140;2,9;2;1;1
258082096475;258082141530;45055;2,9;2;1;1
258082141530;258082161962;20432;2,9;2;1;1
258082161962;258082180314;18352;2,9;2;1;1
258082180314;258082213367;33053;2,9;2;1;1
258082213367;258082216589;3222;2,9;2;1;1
258082216589;258082235935;19346;2,9;2;1;1
258082235935;258082246434;10499;2,9;2;1;1
258082246434;258082246955;521;2,9;2;1;1
258082246955;258082263178;16223;2,9;2;1;1
258082263178;258082290611;27433;2,9;2;1;1
258082290611;258082301127;10516;2,9;2;1;1
258082301127;258082309125;7998;2,9;2;1;1
258082309125;258082342980;33855;2,9;2;1;1
258082342980;258082361939;18959;2,9;2;1;1
258082361939;258082366504;4565;2,9;2;1;1
258082366504;258082369094;2590;2,9;2;1;1
258082369094;258082415812;46718;2,9;2;1;1
258082415812;258082423563;7751;2,9;2;1;1
258082423563;258082457358;33795;2,9;2;1;1
258082457358;258082470515;13157;2,9;2;1;1
258082470515;258082499619;29104;2,9;2;1;1
258082499619;258082520162;20543;2,9;2;1;1
258082520162;258082531496;11334;2,9;2;1;1
258082531496;258082531986;490;2,9;2;1;1
258082531986;258082541600;9614;2,9;2;1;1
258082541600;258082571758;30158;2,9;2;1;1
258082571758;258082585069;13311;2,9;2;1;1
258082585069;258082593187;8118;2,9;2;1;1
258082593187;258082619498;26311;2,9;2;1;1
258082619498;258082627677;8179;2,9;2;1;1
258082627677;258082674852;47175;2,9;2;1;1
258082674852;258082676992;2140;2,9;2;1;1
258082676992;258082714913;37921;2,9;2;1;1
258082714913;258082722869;7956;2,9;2;1;1
258082722869;258082756371;33502;2,9;2;1;1
258082756371;258082778692;22321;2,9;2;1;1
258082778692;258082830337;51645;2,9;2;1;1
258082830337;258082834543;4206;2,9;2;1;1
258082834543;258082863155;28612;2,9;2;1;1
258082863155;258082865223;2068;2,9;2;1;1
258082865223;258082899477;34254;2,9;2;1;1
258082899477;258082920306;20829;2,9;2;1;1
258082920306;258082932687;12381;2,9;2;1;1
258082932687;258082951700;19013;2,9;2;1;1
258082951700;258082973868;22168;2,9;2;1;1
258082973868;258082998655;24787;2,9;2;1;1
258082998655;258083007126;8471;2,9;2;1;1
258083007126;258083007555;429;2,9;2;1;1
258083007555;258083038737;31182;2,9;2;1;1
258083038737;258083040816;2079;2,9;2;1;1
258083040816;258083070842;30026;2,9;2;1;1
258083070842;258083078938;8096;2,9;2;1;1
258083078938;258083102805;23867;2,9;2;1;1
258083102805;258083110755;7950;2,9;2;1;1
258083110755;258083148373;37618;2,9;2;1;1
258083148373;258083160920;12547;2,9;2;1;1
258083160920;258083172446;11526;2,9;2;1;1
258083172446;258083175080;2634;2,9;2;1;1
258083175080;258083197518;22438;2,9;2;1;1
258083197518;258083205695;8177;2,9;2;1;1
258083205695;258083214274;8579;2,9;2;1;1
258083214274;258083216338;2064;2,9;2;1;1
258083216338;258083255358;39020;2,9;2;1;1
258083255358;258083263292;7934;2,9;2;1;1
258083263292;258083297919;34627;2,9;2;1;1
258083297919;258083305598;7679;2,9;2;1;1
258083305598;258083331881;26283;2,9;2;1;1
258083331881;258083353136;21255;2,9;2;1;1
258083353136;258083371459;18323;2,9;2;1;1
258083371459;258083380809;9350;2,9;2;1;1
258083380809;258083430746;49937;2,9;2;1;1
258083430746;258083433420;2674;2,9;2;1;1
258083433420;258083434346;926;2,9;2;1;1
258083434346;258083441471;7125;2,9;2;1;1
258083441471;258083445438;3967;2,9;2;1;1
258083445438;258083445729;291;2,9;2;1;1
258083445729;258083449810;4081;2,9;2;1;1
258083449810;258083451682;1872;2,9;2;1;1
258083451682;258083463363;11681;2,9;2;1;1
258083463363;258083464018;655;2,9;2;1;1
258083464018;258083492581;28563;2,9;2;1;1
258083492581;258083496768;4187;2,9;2;1;1
258083496768;258083614374;117606;2,9;2;1;1
258083614374;258083658761;44387;2,9;2;1;1
258083658761;258083670619;11858;2,9;2;1;1
258083670619;258083682961;12342;2,9;2;1;1
258083682961;258083690009;7048;2,9;2;1;1
258083690009;258083690660;651;2,9;2;1;1
258083690660;258083701571;10911;2,9;2;1;1
258083701571;258083739932;38361;2,9;2;1;1
258083739932;258083751643;11711;2,9;2;1;1
258083751643;258083768641;16998;2,9;2;1;1
258083768641;258083769126;485;2,9;2;1;1
258083769126;258083788695;19569;2,9;2;1;1
258083788695;258083801255;12560;2,9;2;1;1
258083801255;258083820303;19048;2,9;2;1;1
258083820303;258083820953;650;2,9;2;1;1
258083820953;258083829564;8611;2,9;2;1;1
258083829564;258083845269;15705;2,9;2;1;1
258083845269;258083845749;480;2,9;2;1;1
258083845749;258083846802;1053;2,9;2;1;1
258083846802;258083870526;23724;2,9;2;1;1
258083870526;258083890687;20161;2,9;2;1;1
258083890687;258083891336;649;2,9;2;1;1
258083891336;258083891488;152;2,9;2;1;1
258083891488;258083908765;17277;2,9;2;1;1
258083908765;258083924749;15984;2,9;2;1;1
258083924749;258083925228;479;2,9;2;1;1
258083925228;258083932530;7302;2,9;2;1;1
258083932530;258083942335;9805;2,9;2;1;1
258083942335;258083960088;17753;2,9;2;1;1
258083960088;258083960584;496;2,9;2;1;1
258083960584;258083979208;18624;2,9;2;1;1
258083979208;258083988774;9566;2,9;2;1;1
258083988774;258084004756;15982;2,9;2;1;1
258084004756;258084005238;482;2,9;2;1;1
258084005238;258084033373;28135;2,9;2;1;1
258084033373;258084037178;3805;2,9;2;1;1
258084037178;258084055020;17842;2,9;2;1;1
258084055020;258084055503;483;2,9;2;1;1
258084055503;258084078262;22759;2,9;2;1;1
258084078262;258084083391;5129;2,9;2;1;1
258084083391;258084101286;17895;2,9;2;1;1
258084101286;258084101911;625;2,9;2;1;1
258084101911;258084120967;19056;2,9;2;1;1
258084120967;258084125120;4153;2,9;2;1;1
258084125120;258084144611;19491;2,9;2;1;1
258084144611;258084145088;477;2,9;2;1;1
258084145088;258084162844;17756;2,9;2;1;1
258084162844;258084172935;10091;2,9;2;1;1
258084172935;258084193193;20258;2,9;2;1;1
258084193193;258084193840;647;2,9;2;1;1
258084193840;258084213178;19338;2,9;2;1;1
258084213178;258084222953;9775;2,9;2;1;1
258084222953;258084238952;15999;2,9;2;1;1
258084238952;258084239431;479;2,9;2;1;1
258084239431;258084260023;20592;2,9;2;1;1
258084260023;258084280673;20650;2,9;2;1;1
258084280673;258084287551;6878;2,9;2;1;1
258084287551;258084298147;10596;2,9;2;1;1
258084298147;258084298625;478;2,9;2;1;1
258084298625;258084326411;27786;2,9;2;1;1
258084326411;258084345612;19201;2,9;2;1;1
258084345612;258084346774;1162;2,9;2;1;1
258084346774;258084347423;649;2,9;2;1;1
258084347423;258084376447;29024;2,9;2;1;1
258084376447;258084394644;18197;2,9;2;1;1
258084394644;258084395295;651;2,9;2;1;1
258084395295;258084423395;28100;2,9;2;1;1
258084423395;258084428139;4744;2,9;2;1;1
258084428139;258084444582;16443;2,9;2;1;1
258084444582;258084445062;480;2,9;2;1;1
258084445062;258084482360;37298;2,9;2;1;1
258084482360;258084486184;3824;2,9;2;1;1
258084486184;258084502836;16652;2,9;2;1;1
258084502836;258084503319;483;2,9;2;1;1
258084503319;258084531471;28152;2,9;2;1;1
258084531471;258084536347;4876;2,9;2;1;1
258084536347;258084552104;15757;2,9;2;1;1
258084552104;258084552602;498;2,9;2;1;1
258084552602;258084581609;29007;2,9;2;1;1
258084581609;258084591502;9893;2,9;2;1;1
258084591502;258084607689;16187;2,9;2;1;1
258084607689;258084608239;550;2,9;2;1;1
258084608239;258084623695;15456;2,9;2;1;1
258084623695;258084634044;10349;2,9;2;1;1
258084634044;258084652478;18434;2,9;2;1;1
258084652478;258084653055;577;2,9;2;1;1
258084653055;258084665513;12458;2,9;2;1;1
258084665513;258084676223;10710;2,9;2;1;1
258084676223;258084693406;17183;2,9;2;1;1
258084693406;258084694147;741;2,9;2;1;1
258084694147;258084706356;12209;2,9;2;1;1
258084706356;258084725723;19367;2,9;2;1;1
258084725723;258084743737;18014;2,9;2;1;1
258084743737;258084744342;605;2,9;2;1;1
258084744342;258084744991;649;2,9;2;1;1
258084744991;258084771844;26853;2,9;2;1;1
258084771844;258084785024;13180;2,9;2;1;1
258084785024;258084788695;3671;2,9;2;1;1
258084788695;258084788929;234;2,9;2;1;1
258084788929;258084789180;251;2,9;2;1;1
258084789180;258084808977;19797;2,9;2;1;1
258084808977;258084809942;965;2,9;2;1;1
258084809942;258084826784;16842;2,9;2;1;1
258084826784;258084831711;4927;2,9;2;1;1
258084831711;258084847966;16255;2,9;2;1;1
258084847966;258084848553;587;2,9;2;1;1
258084848553;258084870147;21594;2,9;2;1;1
258084870147;258084880582;10435;2,9;2;1;1
258084880582;258084896313;15731;2,9;2;1;1
258084896313;258084896791;478;2,9;2;1;1
258084896791;258084917120;20329;2,9;2;1;1
258084917120;258084922110;4990;2,9;2;1;1
258084922110;258084937901;15791;2,9;2;1;1
258084937901;258084938450;549;2,9;2;1;1
258084938450;258084958634;20184;2,9;2;1;1
258084958634;258084969007;10373;2,9;2;1;1
258084969007;258084985308;16301;2,9;2;1;1
258084985308;258084985794;486;2,9;2;1;1
258084985794;258084989059;3265;2,9;2;1;1
258084989059;258084999452;10393;2,9;2;1;1
258084999452;258085021367;21915;2,9;2;1;1
258085021367;258085022588;1221;2,9;2;1;1
258085022588;258085024772;2184;2,9;2;1;1
258085024772;258085035604;10832;2,9;2;1;1
258085035604;258085058063;22459;2,9;2;1;1
258085058063;258085058715;652;2,9;2;1;1
258085058715;258085061752;3037;2,9;2;1;1
258085061752;258085071788;10036;2,9;2;1;1
258085071788;258085091197;19409;2,9;2;1;1
258085091197;258085091843;646;2,9;2;1;1
258085091843;258085102676;10833;2,9;2;1;1
258085102676;258085107824;5148;2,9;2;1;1
258085107824;258085126630;18806;2,9;2;1;1
258085126630;258085127282;652;2,9;2;1;1
258085127282;258085155371;28089;2,9;2;1;1
258085155371;258085165991;10620;2,9;2;1;1
258085165991;258085182342;16351;2,9;2;1;1
258085182342;258085182834;492;2,9;2;1;1
258085182834;258085205445;22611;2,9;2;1;1
258085205445;258085210304;4859;2,9;2;1;1
258085210304;258085225683;15379;2,9;2;1;1
258085225683;258085226252;569;2,9;2;1;1
258085226252;258085255492;29240;2,9;2;1;1
258085255492;258085295068;39576;2,9;2;1;1
258085295068;258085314172;19104;2,9;2;1;1
258085314172;258085314802;630;2,9;2;1;1
258085314802;258085315455;653;2,9;2;1;1
258085315455;258085322943;7488;2,9;2;1;1
258085322943;258085358105;35162;2,9;2;1;1
258085358105;258085386575;28470;2,9;2;1;1
258085386575;258085403246;16671;2,9;2;1;1
258085403246;258085403727;481;2,9;2;1;1
258085403727;258085404941;1214;2,9;2;1;1
258085404941;258085429489;24548;2,9;2;1;1
258085429489;258085437178;7689;2,9;2;1;1
258085437178;258085448297;11119;2,9;2;1;1
258085448297;258085448948;651;2,9;2;1;1
258085448948;258085478845;29897;2,9;2;1;1
258085478845;258085485422;6577;2,9;2;1;1
258085485422;258085495490;10068;2,9;2;1;1
258085495490;258085495979;489;2,9;2;1;1
258085495979;258085496146;167;2,9;2;1;1
258085496146;258085515345;19199;2,9;2;1;1
258085515345;258085515996;651;2,9;2;1;1
258085515996;258085531128;15132;2,9;2;1;1
258085531128;258085534754;3626;2,9;2;1;1
258085534754;258085572385;37631;2,9;2;1;1
258085572385;258085577549;5164;2,9;2;1;1
258085577549;258085595045;17496;2,9;2;1;1
258085595045;258085595695;650;2,9;2;1;1
258085595695;258085623483;27788;2,9;2;1;1
258085623483;258085632229;8746;2,9;2;1;1
258085632229;258085665402;33173;2,9;2;1;1
258085665402;258085675526;10124;2,9;2;1;1
258085675526;258085695018;19492;2,9;2;1;1
258085695018;258085695669;651;2,9;2;1;1
258085695669;258085712608;16939;2,9;2;1;1
258085712608;258085722779;10171;2,9;2;1;1
258085722779;258085742295;19516;2,9;2;1;1
258085742295;258085742954;659;2,9;2;1;1
258085742954;258085752952;9998;2,9;2;1;1
258085752952;258085792753;39801;2,9;2;1;1
258085792753;258085804252;11499;2,9;2;1;1
258085804252;258085804806;554;2,9;2;1;1
258085804806;258085823916;19110;2,9;2;1;1
258085823916;258085824566;650;2,9;2;1;1
258085824566;258085830789;6223;2,9;2;1;1
258085830789;258085831312;523;2,9;2;1;1
258085831312;258085855792;24480;2,9;2;1;1
258085855792;258085859771;3979;2,9;2;1;1
258085859771;258085875161;15390;2,9;2;1;1
258085875161;258085875648;487;2,9;2;1;1
258085875648;258085896307;20659;2,9;2;1;1
258085896307;258085898893;2586;2,9;2;1;1
258085898893;258085939200;40307;2,9;2;1;1
258085939200;258085948215;9015;2,9;2;1;1
258085948215;258085969958;21743;2,9;2;1;1
258085969958;258085980376;10418;2,9;2;1;1
258085980376;258085996108;15732;2,9;2;1;1
258085996108;258085996647;539;2,9;2;1;1
258085996647;258086027477;30830;2,9;2;1;1
258086027477;258086052868;25391;2,9;2;1;1
258086052868;258086070388;17520;2,9;2;1;1
258086070388;258086070877;489;2,9;2;1;1
258086070877;258086101446;30569;2,9;2;1;1
258086101446;258086107061;5615;2,9;2;1;1
258086107061;258086123287;16226;2,9;2;1;1
258086123287;258086128120;4833;2,9;2;1;1
258086128120;258086128959;839;2,9;2;1;1
258086128959;258086129330;371;2,9;2;1;1
258086129330;258086150091;20761;2,9;2;1;1
258086150091;258086150328;237;2,9;2;1;1
258086150328;258086150978;650;2,9;2;1;1
258086150978;258086160087;9109;2,9;2;1;1
258086160087;258086177686;17599;2,9;2;1;1
258086177686;258086178347;661;2,9;2;1;1
258086178347;258086188482;10135;2,9;2;1;1
258086188482;258086191078;2596;2,9;2;1;1
258086191078;258086220614;29536;2,9;2;1;1
258086220614;258086235771;15157;2,9;2;1;1
258086235771;258086261700;25929;2,9;2;1;1
258086261700;258086271045;9345;2,9;2;1;1
258086271045;258086303701;32656;2,9;2;1;1
258086303701;258086313728;10027;2,9;2;1;1
258086313728;258086333109;19381;2,9;2;1;1
258086333109;258086333761;652;2,9;2;1;1
258086333761;258086354139;20378;2,9;2;1;1
258086354139;258086379436;25297;2,9;2;1;1
258086379436;258086400092;20656;2,9;2;1;1
258086400092;258086400856;764;2,9;2;1;1
258086400856;258086407960;7104;2,9;2;1;1
258086407960;258086419214;11254;2,9;2;1;1
258086419214;258086449815;30601;2,9;2;1;1
258086449815;258086453879;4064;2,9;2;1;1
258086453879;258086474240;20361;2,9;2;1;1
258086474240;258086474896;656;2,9;2;1;1
258086474896;258086481063;6167;2,9;2;1;1
258086481063;258086489727;8664;2,9;2;1;1
258086489727;258086554609;64882;2,9;2;1;1
258086554609;258086564137;9528;2,9;2;1;1
258086564137;258086596519;32382;2,9;2;1;1
258086596519;258086598928;2409;2,9;2;1;1
258086598928;258086645939;47011;2,9;2;1;1
258086645939;258086658069;12130;2,9;2;1;1
258086658069;258086689806;31737;2,9;2;1;1
258086689806;258086698782;8976;2,9;2;1;1
258086698782;258086731820;33038;2,9;2;1;1
258086731820;258086751899;20079;2,9;2;1;1
258086751899;258086767724;15825;2,9;2;1;1
258086767724;258086770035;2311;2,9;2;1;1
258086770035;258086808015;37980;2,9;2;1;1
258086808015;258086816280;8265;2,9;2;1;1
258086816280;258086855825;39545;2,9;2;1;1
258086855825;258086864028;8203;2,9;2;1;1
258086864028;258086899708;35680;2,9;2;1;1
258086899708;258086902082;2374;2,9;2;1;1
258086902082;258086939493;37411;2,9;2;1;1
258086939493;258086942119;2626;2,9;2;1;1
258086942119;258086994782;52663;2,9;2;1;1
258086994782;258087034146;39364;2,9;2;1;1
258087034146;258087040626;6480;2,9;2;1;1
258087040626;258087042957;2331;2,9;2;1;1
258087042957;258087057426;14469;2,9;2;1;1
258087057426;258087057919;493;2,9;2;1;1
258087057919;258087084627;26708;2,9;2;1;1
258087084627;258087094147;9520;2,9;2;1;1
258087094147;258087125190;31043;2,9;2;1;1
258087125190;258087134484;9294;2,9;2;1;1
258087134484;258087165448;30964;2,9;2;1;1
258087165448;258087191472;26024;2,9;2;1;1
258087191472;258087205764;14292;2,9;2;1;1
258087205764;258087207979;2215;2,9;2;1;1
258087207979;258087210798;2819;2,9;2;1;1
258087210798;258087211448;650;2,9;2;1;1
258087211448;258087266803;55355;2,9;2;1;1
258087266803;258087291108;24305;2,9;2;1;1
258087291108;258087320075;28967;2,9;2;1;1
258087320075;258087322541;2466;2,9;2;1;1
258087322541;258087352442;29901;2,9;2;1;1
258087352442;258087393056;40614;2,9;2;1;1
258087393056;258087394657;1601;2,9;2;1;1
258087394657;258087402642;7985;2,9;2;1;1
258087402642;258087411290;8648;2,9;2;1;1
258087411290;258087411940;650;2,9;2;1;1
258087411940;258087451087;39147;2,9;2;1;1
258087451087;258087475567;24480;2,9;2;1;1
258087475567;258087484391;8824;2,9;2;1;1
258087484391;258087485557;1166;2,9;2;1;1
258087485557;258087512917;27360;2,9;2;1;1
258087512917;258087537475;24558;2,9;2;1;1
258087537475;258087555593;18118;2,9;2;1;1
258087555593;258087556074;481;2,9;2;1;1
258087556074;258087556209;135;2,9;2;1;1
258087556209;258087565136;8927;2,9;2;1;1
258087565136;258087611545;46409;2,9;2;1;1
258087611545;258087620143;8598;2,9;2;1;1
258087620143;258087653982;33839;2,9;2;1;1
258087653982;258087662128;8146;2,9;2;1;1
258087662128;258087716109;53981;2,9;2;1;1
258087716109;258087718770;2661;2,9;2;1;1
258087718770;258087748754;29984;2,9;2;1;1
258087748754;258087750971;2217;2,9;2;1;1
258087750971;258087789099;38128;2,9;2;1;1
258087789099;258087800489;11390;2,9;2;1;1
258087800489;258087819757;19268;2,9;2;1;1
258087819757;258087820573;816;2,9;2;1;1
258087820573;258087841920;21347;2,9;2;1;1
258087841920;258087850520;8600;2,9;2;1;1
258087850520;258087883697;33177;2,9;2;1;1
258087883697;258087892329;8632;2,9;2;1;1
258087892329;258087924874;32545;2,9;2;1;1
258087924874;258087934102;9228;2,9;2;1;1
258087934102;258087965836;31734;2,9;2;1;1
258087965836;258087974226;8390;2,9;2;1;1
258087974226;258087997593;23367;2,9;2;1;1
258087997593;258088005748;8155;2,9;2;1;1
258088005748;258088040776;35028;2,9;2;1;1
258088040776;258088062860;22084;2,9;2;1;1
258088062860;258088079494;16634;2,9;2;1;1
258088079494;258088079982;488;2,9;2;1;1
258088079982;258088081396;1414;2,9;2;1;1
258088081396;258088089488;8092;2,9;2;1;1
258088089488;258088104675;15187;2,9;2;1;1
258088104675;258088105156;481;2,9;2;1;1
258088105156;258088122986;17830;2,9;2;1;1
258088122986;258088131337;8351;2,9;2;1;1
258088131337;258088251742;120405;2,9;2;1;1
258088251742;258088254127;2385;2,9;2;1;1
258088254127;258088295743;41616;2,9;2;1;1
258088295743;258088298205;2462;2,9;2;1;1
258088298205;258088341785;43580;2,9;2;1;1
258088341785;258088344285;2500;2,9;2;1;1
258088344285;258088372617;28332;2,9;2;1;1
258088372617;258088377925;5308;2,9;2;1;1
258088377925;258088392981;15056;2,9;2;1;1
258088392981;258088393471;490;2,9;2;1;1
258088393471;258088418252;24781;2,9;2;1;1
258088418252;258088448164;29912;2,9;2;1;1
258088448164;258088458502;10338;2,9;2;1;1
258088458502;258088466589;8087;2,9;2;1;1
258088466589;258088466921;332;2,9;2;1;1
258088466921;258088467571;650;2,9;2;1;1
258088467571;258088497674;30103;2,9;2;1;1
258088497674;258088505958;8284;2,9;2;1;1
258088505958;258088546710;40752;2,9;2;1;1
258088546710;258088549913;3203;2,9;2;1;1
258088549913;258088589556;39643;2,9;2;1;1
258088589556;258088597913;8357;2,9;2;1;1
258088597913;258088629588;31675;2,9;2;1;1
258088629588;258088638526;8938;2,9;2;1;1
258088638526;258088670817;32291;2,9;2;1;1
258088670817;258088674334;3517;2,9;2;1;1
258088674334;258088690176;15842;2,9;2;1;1
258088690176;258088690655;479;2,9;2;1;1
258088690655;258088728321;37666;2,9;2;1;1
258088728321;258088737331;9010;2,9;2;1;1
258088737331;258088756527;19196;2,9;2;1;1
258088756527;258088757286;759;2,9;2;1;1
258088757286;258088766327;9041;2,9;2;1;1
258088766327;258088791210;24883;2,9;2;1;1
258088791210;258088806151;14941;2,9;2;1;1
258088806151;258088814387;8236;2,9;2;1;1
258088814387;258088849376;34989;2,9;2;1;1
258088849376;258088851571;2195;2,9;2;1;1
258088851571;258088880633;29062;2,9;2;1;1
258088880633;258088891474;10841;2,9;2;1;1
258088891474;258088908609;17135;2,9;2;1;1
258088908609;258088909094;485;2,9;2;1;1
258088909094;258088927846;18752;2,9;2;1;1
258088927846;258088940072;12226;2,9;2;1;1
258088940072;258088958321;18249;2,9;2;1;1
258088958321;258088958972;651;2,9;2;1;1
258088958972;258088961846;2874;2,9;2;1;1
258088961846;258088971665;9819;2,9;2;1;1
258088971665;258088991149;19484;2,9;2;1;1
258088991149;258088991914;765;2,9;2;1;1
258088991914;258088996198;4284;2,9;2;1;1
258088996198;258089018713;22515;2,9;2;1;1
258089018713;258089033838;15125;2,9;2;1;1
258089033838;258089034317;479;2,9;2;1;1
258089034317;258089035378;1061;2,9;2;1;1
258089035378;258089059040;23662;2,9;2;1;1
258089059040;258089070671;11631;2,9;2;1;1
258089070671;258089079570;8899;2,9;2;1;1
258089079570;258089108762;29192;2,9;2;1;1
258089108762;258089111401;2639;2,9;2;1;1
258089111401;258089147442;36041;2,9;2;1;1
258089147442;258089149888;2446;2,9;2;1;1
258089149888;258089197165;47277;2,9;2;1;1
258089197165;258089210961;13796;2,9;2;1;1
258089210961;258089226703;15742;2,9;2;1;1
258089226703;258089227183;480;2,9;2;1;1
258089227183;258089245285;18102;2,9;2;1;1
258089245285;258089256614;11329;2,9;2;1;1
258089256614;258089271979;15365;2,9;2;1;1
258089271979;258089272462;483;2,9;2;1;1
258089272462;258089283633;11171;2,9;2;1;1
258089283633;258089311053;27420;2,9;2;1;1
258089311053;258089329379;18326;2,9;2;1;1
258089329379;258089330380;1001;2,9;2;1;1
258089330380;258089331027;647;2,9;2;1;1
258089331027;258089341164;10137;2,9;2;1;1
258089341164;258089356729;15565;2,9;2;1;1
258089356729;258089357205;476;2,9;2;1;1
258089357205;258089370895;13690;2,9;2;1;1
258089370895;258089392082;21187;2,9;2;1;1
258089392082;258089406667;14585;2,9;2;1;1
258089406667;258089407149;482;2,9;2;1;1
258089407149;258089431442;24293;2,9;2;1;1
258089431442;258089437713;6271;2,9;2;1;1
258089437713;258089455706;17993;2,9;2;1;1
258089455706;258089456357;651;2,9;2;1;1
258089456357;258089485081;28724;2,9;2;1;1
258089485081;258089494702;9621;2,9;2;1;1
258089494702;258089519114;24412;2,9;2;1;1
258089519114;258089544594;25480;2,9;2;1;1
258089544594;258089563293;18699;2,9;2;1;1
258089563293;258089563895;602;2,9;2;1;1
258089563895;258089563940;45;2,9;2;1;1
258089563940;258089589591;25651;2,9;2;1;1
258089589591;258089607688;18097;2,9;2;1;1
258089607688;258089608173;485;2,9;2;1;1
258089608173;258089615393;7220;2,9;2;1;1
258089615393;258089646962;31569;2,9;2;1;1
258089646962;258089648499;1537;2,9;2;1;1
258089648499;258089660676;12177;2,9;2;1;1
258089660676;258089664695;4019;2,9;2;1;1
258089664695;258089665345;650;2,9;2;1;1
258089665345;258089679903;14558;2,9;2;1;1
258089679903;258089680553;650;2,9;2;1;1
258089680553;258089689632;9079;2,9;2;1;1
258089689632;258089692165;2533;2,9;2;1;1
258089692165;258090039834;347669;2,9;2;1;1
258090039834;258090042061;2227;2,9;2;1;1
258090042061;258090087165;45104;2,9;2;1;1
258090087165;258090095667;8502;2,9;2;1;1
258090095667;258090142044;46377;2,9;2;1;1
258090142044;258090147579;5535;2,9;2;1;1
258090147579;258090163211;15632;2,9;2;1;1
258090163211;258090163704;493;2,9;2;1;1
258090163704;258090178472;14768;2,9;2;1;1
258090178472;258090199276;20804;2,9;2;1;1
258090199276;258090215388;16112;2,9;2;1;1
258090215388;258090215893;505;2,9;2;1;1
258090215893;258090217134;1241;2,9;2;1;1
258090217134;258090219740;2606;2,9;2;1;1
258090219740;258090284358;64618;2,9;2;1;1
258090284358;258090296303;11945;2,9;2;1;1
258090296303;258090314760;18457;2,9;2;1;1
258090314760;258090315574;814;2,9;2;1;1
258090315574;258090320525;4951;2,9;2;1;1
258090320525;258090357673;37148;2,9;2;1;1
258090357673;258090379934;22261;2,9;2;1;1
258090379934;258090382067;2133;2,9;2;1;1
258090382067;258090394578;12511;2,9;2;1;1
258090394578;258090395058;480;2,9;2;1;1
258090395058;258090397715;2657;2,9;2;1;1
258090397715;258090398201;486;2,9;2;1;1
258090398201;258090407999;9798;2,9;2;1;1
258090407999;258090410731;2732;2,9;2;1;1
258090410731;258090439323;28592;2,9;2;1;1
258090439323;258090448112;8789;2,9;2;1;1
258090448112;258090477105;28993;2,9;2;1;1
258090477105;258090479309;2204;2,9;2;1;1
258090479309;258090509803;30494;2,9;2;1;1
258090509803;258090514096;4293;2,9;2;1;1
258090514096;258090533447;19351;2,9;2;1;1
258090533447;258090534098;651;2,9;2;1;1
258090534098;258090551076;16978;2,9;2;1;1
258090551076;258090577086;26010;2,9;2;1;1
258090577086;258090592379;15293;2,9;2;1;1
258090592379;258090593055;676;2,9;2;1;1
258090593055;258090597944;4889;2,9;2;1;1
258090597944;258090600814;2870;2,9;2;1;1
258090600814;258090639810;38996;2,9;2;1;1
258090639810;258090642476;2666;2,9;2;1;1
258090642476;258090672145;29669;2,9;2;1;1
258090672145;258090699999;27854;2,9;2;1;1
258090699999;258090718742;18743;2,9;2;1;1
258090718742;258090719001;259;2,9;2;1;1
258090719001;258090719650;649;2,9;2;1;1
258090719650;258090754830;35180;2,9;2;1;1
258090754830;258090757194;2364;2,9;2;1;1
258090757194;258090775202;18008;2,9;2;1;1
258090775202;258090775689;487;2,9;2;1;1
258090775689;258090784051;8362;2,9;2;1;1
258090784051;258090791717;7666;2,9;2;1;1
258090791717;258090806693;14976;2,9;2;1;1
258090806693;258090807172;479;2,9;2;1;1
258090807172;258090814390;7218;2,9;2;1;1
258090814390;258090824790;10400;2,9;2;1;1
258090824790;258090830328;5538;2,9;2;1;1
258090830328;258090830816;488;2,9;2;1;1
258090830816;258090867496;36680;2,9;2;1;1
258090867496;258090879661;12165;2,9;2;1;1
258090879661;258090882196;2535;2,9;2;1;1
258090882196;258090882676;480;2,9;2;1;1
258090882676;258090907830;25154;2,9;2;1;1
258090907830;258090919166;11336;2,9;2;1;1
258090919166;258090924950;5784;2,9;2;1;1
258090924950;258090925427;477;2,9;2;1;1
258090925427;258090958824;33397;2,9;2;1;1
258090958824;258090960865;2041;2,9;2;1;1
258090960865;258090961344;479;2,9;2;1;1
258090961344;258090975762;14418;2,9;2;1;1
258090975762;258090976247;485;2,9;2;1;1
258090976247;258090999018;22771;2,9;2;1;1
258090999018;258091045088;46070;2,9;2;1;1
258091045088;258091046463;1375;2,9;2;1;1
258091046463;258091064880;18417;2,9;2;1;1
258091064880;258091065532;652;2,9;2;1;1
258091065532;258091079011;13479;2,9;2;1;1
258091079011;258091094340;15329;2,9;2;1;1
258091094340;258091094825;485;2,9;2;1;1
258091094825;258091096621;1796;2,9;2;1;1
258091096621;258091119358;22737;2,9;2;1;1
258091119358;258091135118;15760;2,9;2;1;1
258091135118;258091135603;485;2,9;2;1;1
258091135603;258091140193;4590;2,9;2;1;1
258091140193;258091165599;25406;2,9;2;1;1
258091165599;258091186708;21109;2,9;2;1;1
258091186708;258091247094;60386;2,9;2;1;1
258091247094;258091253664;6570;2,9;2;1;1
258091253664;258091271943;18279;2,9;2;1;1
258091271943;258091272753;810;2,9;2;1;1
258091272753;258091287442;14689;2,9;2;1;1
258091287442;258091301392;13950;2,9;2;1;1
258091301392;258091319968;18576;2,9;2;1;1
258091319968;258091320618;650;2,9;2;1;1
258091320618;258091329900;9282;2,9;2;1;1
258091329900;258091330299;399;2,9;2;1;1
258091330299;258091345574;15275;2,9;2;1;1
258091345574;258091346057;483;2,9;2;1;1
258091346057;258091374403;28346;2,9;2;1;1
258091374403;258091386412;12009;2,9;2;1;1
258091386412;258091401887;15475;2,9;2;1;1
258091401887;258091405229;3342;2,9;2;1;1
258091405229;258091405879;650;2,9;2;1;1
258091405879;258091414971;9092;2,9;2;1;1
258091414971;258091416783;1812;2,9;2;1;1
258091416783;258091417270;487;2,9;2;1;1
258091417270;258091425562;8292;2,9;2;1;1
258091425562;258091448060;22498;2,9;2;1;1
258091448060;258091456873;8813;2,9;2;1;1
258091456873;258091488333;31460;2,9;2;1;1
258091488333;258091537369;49036;2,9;2;1;1
258091537369;258091540162;2793;2,9;2;1;1
258091540162;258091547796;7634;2,9;2;1;1
258091547796;258091563994;16198;2,9;2;1;1
258091563994;258091564477;483;2,9;2;1;1
258091564477;258091578049;13572;2,9;2;1;1
258091578049;258091604665;26616;2,9;2;1;1
258091604665;258091623737;19072;2,9;2;1;1
258091623737;258091624559;822;2,9;2;1;1
258091624559;258091632829;8270;2,9;2;1;1
258091632829;258091641289;8460;2,9;2;1;1
258091641289;258091674553;33264;2,9;2;1;1
258091674553;258091677472;2919;2,9;2;1;1
258091677472;258091715547;38075;2,9;2;1;1
258091715547;258091725209;9662;2,9;2;1;1
258091725209;258091759439;34230;2,9;2;1;1
258091759439;258091768025;8586;2,9;2;1;1
258091768025;258091821248;53223;2,9;2;1;1
258091821248;258091845637;24389;2,9;2;1;1
258091845637;258091861055;15418;2,9;2;1;1
258091861055;258091861647;592;2,9;2;1;1
258091861647;258091863309;1662;2,9;2;1;1
258091863309;258091872095;8786;2,9;2;1;1
258091872095;258091903906;31811;2,9;2;1;1
258091903906;258091913775;9869;2,9;2;1;1
258091913775;258091945156;31381;2,9;2;1;1
258091945156;258091962840;17684;2,9;2;1;1
258091962840;258091986373;23533;2,9;2;1;1
258091986373;258091995186;8813;2,9;2;1;1
258091995186;258092027298;32112;2,9;2;1;1
258092027298;258092030374;3076;2,9;2;1;1
258092030374;258092072128;41754;2,9;2;1;1
258092072128;258092080732;8604;2,9;2;1;1
258092080732;258092121367;40635;2,9;2;1;1
258092121367;258092154594;33227;2,9;2;1;1
258092154594;258092170005;15411;2,9;2;1;1
258092170005;258092170690;685;2,9;2;1;1
258092170690;258092171302;612;2,9;2;1;1
258092171302;258092180510;9208;2,9;2;1;1
258092180510;258092229358;48848;2,9;2;1;1
258092229358;258092231912;2554;2,9;2;1;1
258092231912;258092266854;34942;2,9;2;1;1
258092266854;258092286537;19683;2,9;2;1;1
258092286537;258092309852;23315;2,9;2;1;1
258092309852;258092319274;9422;2,9;2;1;1
258092319274;258092344250;24976;2,9;2;1;1
258092344250;258092352770;8520;2,9;2;1;1
258092352770;258092405914;53144;2,9;2;1;1
258092405914;258092424142;18228;2,9;2;1;1
258092424142;258092447516;23374;2,9;2;1;1
258092447516;258092483308;35792;2,9;2;1;1
258092483308;258092489885;6577;2,9;2;1;1
258092489885;258092498338;8453;2,9;2;1;1
258092498338;258092498819;481;2,9;2;1;1
258092498819;258092499123;304;2,9;2;1;1
258092499123;258092576048;76925;2,9;2;1;1
258092576048;258092584208;8160;2,9;2;1;1
258092584208;258092683784;99576;2,9;2;1;1
258092683784;258092686611;2827;2,9;2;1;1
258092686611;258092724776;38165;2,9;2;1;1
258092724776;258092733056;8280;2,9;2;1;1
258092733056;258092773409;40353;2,9;2;1;1
258092773409;258092776985;3576;2,9;2;1;1
258092776985;258092792973;15988;2,9;2;1;1
258092792973;258092793460;487;2,9;2;1;1
258092793460;258092814232;20772;2,9;2;1;1
258092814232;258092823615;9383;2,9;2;1;1
258092823615;258092846858;23243;2,9;2;1;1
258092846858;258092855346;8488;2,9;2;1;1
258092855346;258092891265;35919;2,9;2;1;1
258092891265;258092900036;8771;2,9;2;1;1
258092900036;258092936027;35991;2,9;2;1;1
258092936027;258092944770;8743;2,9;2;1;1
258092944770;258092974129;29359;2,9;2;1;1
258092974129;258092983453;9324;2,9;2;1;1
258092983453;258093014085;30632;2,9;2;1;1
258093014085;258093017996;3911;2,9;2;1;1
258093017996;258093036079;18083;2,9;2;1;1
258093036079;258093036569;490;2,9;2;1;1
258093036569;258093047047;10478;2,9;2;1;1
258093047047;258093049788;2741;2,9;2;1;1
258093049788;258093087160;37372;2,9;2;1;1
258093087160;258093095870;8710;2,9;2;1;1
258093095870;258093128425;32555;2,9;2;1;1
258093128425;258093137802;9377;2,9;2;1;1
258093137802;258093172638;34836;2,9;2;1;1
258093172638;258093172674;36;2,9;2;1;1
258093172674;258093183577;10903;2,9;2;1;1
258093183577;258093183756;179;2,9;2;1;1
258093183756;258093183783;27;2,9;2;1;1
258093183783;258093184344;561;2,9;2;1;1
258093184344;258093184405;61;2,9;2;1;1
258093184405;258093184697;292;2,9;2;1;1
258093184697;258093185540;843;2,9;2;1;1
258093185540;258093185976;436;2,9;2;1;1
258093185976;258093187138;1162;2,9;2;1;1
258093187138;258093192227;5089;2,9;2;1;1
258093192227;258093193624;1397;2,9;2;1;1
258093193624;258093198703;5079;2,9;2;1;1
258093198703;258093201068;2365;2,9;2;1;1
258093201068;258093201533;465;2,9;2;1;1
258093201533;258093253858;52325;2,9;2;1;1
258093253858;258093262661;8803;2,9;2;1;1
258093262661;258093286787;24126;2,9;2;1;1
258093286787;258093295339;8552;2,9;2;1;1
258093295339;258093326143;30804;2,9;2;1;1
258093326143;258093328652;2509;2,9;2;1;1
258093328652;258093344888;16236;2,9;2;1;1
258093344888;258093384304;39416;2,9;2;1;1
258093384304;258093423282;38978;2,9;2;1;1
258093423282;258093469510;46228;2,9;2;1;1
258093469510;258093518417;48907;2,9;2;1;1
258093518417;258093561730;43313;2,9;2;1;1
258093561730;258093602502;40772;2,9;2;1;1
258093602502;258093633536;31034;2,9;2;1;1
258093633536;258093666929;33393;2,9;2;1;1
258093666929;258093707520;40591;2,9;2;1;1
258093707520;258093752066;44546;2,9;2;1;1
258093752066;258093795546;43480;2,9;2;1;1
258093795546;258093836371;40825;2,9;2;1;1
258093836371;258093873819;37448;2,9;2;1;1
258093873819;258093914976;41157;2,9;2;1;1
258093914976;258093939197;24221;2,9;2;1;1
258093939197;258093980434;41237;2,9;2;1;1
258093980434;258094023119;42685;2,9;2;1;1
258094023119;258094058572;35453;2,9;2;1;1
258094058572;258094107228;48656;2,9;2;1;1
258094107228;258094148398;41170;2,9;2;1;1
258094148398;258094202711;54313;2,9;2;1;1
258094202711;258094249246;46535;2,9;2;1;1
258094249246;258094296623;47377;2,9;2;1;1
258094296623;258094343208;46585;2,9;2;1;1
258094343208;258094375501;32293;2,9;2;1;1
258094375501;258094438432;62931;2,9;2;1;1
258094438432;258094494185;55753;2,9;2;1;1
258094494185;258094532697;38512;2,9;2;1;1
258094532697;258094590669;57972;2,9;2;1;1
258094590669;258094638913;48244;2,9;2;1;1
258094638913;258094679442;40529;2,9;2;1;1
258094679442;258094728252;48810;2,9;2;1;1
258094728252;258094760853;32601;2,9;2;1;1
258094760853;258094846510;85657;2,9;2;1;1
258094846510;258094887233;40723;2,9;2;1;1
258094887233;258094932210;44977;2,9;2;1;1
258094932210;258094975576;43366;2,9;2;1;1
258094975576;258095012916;37340;2,9;2;1;1
258095012916;258095044207;31291;2,9;2;1;1
258095044207;258095085155;40948;2,9;2;1;1
258095085155;258095126567;41412;2,9;2;1;1
258095126567;258095161913;35346;2,9;2;1;1
258095161913;258095208858;46945;2,9;2;1;1
258095208858;258095442959;234101;2,9;2;1;1
258095442959;258095489366;46407;2,9;2;1;1
258095489366;258095536551;47185;2,9;2;1;1
258095536551;258095569995;33444;2,9;2;1;1
258095569995;258095612267;42272;2,9;2;1;1
258095612267;258095648141;35874;2,9;2;1;1
258095648141;258095690398;42257;2,9;2;1;1
258095690398;258095729742;39344;2,9;2;1;1
258095729742;258095753912;24170;2,9;2;1;1
258095753912;258095794023;40111;2,9;2;1;1
258095794023;258095809130;15107;2,9;2;1;1
258095809130;258095809209;79;2,9;2;1;1
258095809209;258095809275;66;2,9;2;1;1
258095809275;258095809328;53;2,9;2;1;1
258095809328;258095809458;130;2,9;2;1;1
258095809458;258095809549;91;2,9;2;1;1
258095809549;258095809695;146;2,9;2;1;1
258095809695;258095809730;35;2,9;2;1;1
258095809730;258095809779;49;2,9;2;1;1
258095809779;258095809784;5;2,9;2;1;1
258095809784;258095809792;8;2,9;2;1;1
258095809792;258095809809;17;2,9;2;1;1
258095809809;258095809847;38;2,9;2;1;1
258095809847;258095809851;4;2,9;2;1;1
258095809851;258095809867;16;2,9;2;1;1
258095809867;258095809887;20;2,9;2;1;1
258095809887;258095809892;5;2,9;2;1;1
258095809892;258095809966;74;2,9;2;1;1
258095809966;258095809985;19;2,9;2;1;1
258095809985;258095810011;26;2,9;2;1;1
258095810011;258095810110;99;2,9;2;1;1
258095810110;258095810136;26;2,9;2;1;1
258095810136;258095810180;44;2,9;2;1;1
258095810180;258095810230;50;2,9;2;1;1
258095810230;258095810267;37;2,9;2;1;1
258095810267;258095810304;37;2,9;2;1;1
258095810304;258095810314;10;2,9;2;1;1
258095810314;258095810337;23;2,9;2;1;1
258095810337;258095810340;3;2,9;2;1;1
258095810340;258095810377;37;2,9;2;1;1
258095810377;258095810414;37;2,9;2;1;1
258095810414;258095810415;1;2,9;2;1;1
258095810415;258095810450;35;2,9;2;1;1
258095810450;258095810451;1;2,9;2;1;1
258095810451;258095810487;36;2,9;2;1;1
258095810487;258095810519;32;2,9;2;1;1
258095810519;258095810547;28;2,9;2;1;1
258095810547;258095810565;18;2,9;2;1;1
258095810565;258095810589;24;2,9;2;1;1
258095810589;258095810658;69;2,9;2;1;1
258095810658;258095810692;34;2,9;2;1;1
258095810692;258095810762;70;2,9;2;1;1
258095810762;258095810773;11;2,9;2;1;1
258095810773;258095810776;3;2,9;2;1;1
258095810776;258095810777;1;2,9;2;1;1
258095810777;258095810785;8;2,9;2;1;1
258095810785;258095810821;36;2,9;2;1;1
258095810821;258095810840;19;2,9;2;1;1
258095810840;258095810877;37;2,9;2;1;1
258095810877;258095810891;14;2,9;2;1;1
258095810891;258095810892;1;2,9;2;1;1
258095810892;258095810944;52;2,9;2;1;1
258095810944;258095810945;1;2,9;2;1;1
258095810945;258095810975;30;2,9;2;1;1
258095810975;258095810997;22;2,9;2;1;1
258095810997;258095810998;1;2,9;2;1;1
258095810998;258095811011;13;2,9;2;1;1
258095811011;258095811034;23;2,9;2;1;1
258095811034;258095811039;5;2,9;2;1;1
258095811039;258095811048;9;2,9;2;1;1
258095811048;258095811049;1;2,9;2;1;1
258095811049;258095811058;9;2,9;2;1;1
258095811058;258095811061;3;2,9;2;1;1
258095811061;258095811068;7;2,9;2;1;1
258095811068;258095811079;11;2,9;2;1;1
258095811079;258095811085;6;2,9;2;1;1
258095811085;258095811092;7;2,9;2;1;1
258095811092;258095811099;7;2,9;2;1;1
258095811099;258095811109;10;2,9;2;1;1
258095811109;258095811110;1;2,9;2;1;1
258095811110;258095811111;1;2,9;2;1;1
258095811111;258095811120;9;2,9;2;1;1
258095811120;258095811122;2;2,9;2;1;1
258095811122;258095811127;5;2,9;2;1;1
258095811127;258095811128;1;2,9;2;1;1
258095811128;258095811133;5;2,9;2;1;1
258095811133;258095811155;22;2,9;2;1;1
258095811155;258095811157;2;2,9;2;1;1
258095811157;258095811169;12;2,9;2;1;1
258095811169;258095811172;3;2,9;2;1;1
258095811172;258095811178;6;2,9;2;1;1
258095811178;258095811180;2;2,9;2;1;1
258095811180;258095811205;25;2,9;2;1;1
258095811205;258095811206;1;2,9;2;1;1
258095811206;258095811211;5;2,9;2;1;1
258095811211;258095811215;4;2,9;2;1;1
258095811215;258095811231;16;2,9;2;1;1
258095811231;258095811238;7;2,9;2;1;1
258095811238;258095811243;5;2,9;2;1;1
258095811243;258095811254;11;2,9;2;1;1
258095811254;258095811256;2;2,9;2;1;1
258095811256;258095811280;24;2,9;2;1;1
258095811280;258095811284;4;2,9;2;1;1
258095811284;258095811296;12;2,9;2;1;1
258095811296;258095811299;3;2,9;2;1;1
258095811299;258095811304;5;2,9;2;1;1
258095811304;258095811306;2;2,9;2;1;1
258095811306;258095811317;11;2,9;2;1;1
258095811317;258095811322;5;2,9;2;1;1
258095811322;258095811332;10;2,9;2;1;1
258095811332;258095811334;2;2,9;2;1;1
258095811334;258095811351;17;2,9;2;1;1
258095811351;258095811356;5;2,9;2;1;1
258095811356;258095811359;3;2,9;2;1;1
258095811359;258095811360;1;2,9;2;1;1
258095811360;258095811365;5;2,9;2;1;1
258095811365;258095811373;8;2,9;2;1;1
258095811373;258095811384;11;2,9;2;1;1
258095811384;258095811387;3;2,9;2;1;1
258095811387;258095811388;1;2,9;2;1;1
258095811388;258095811390;2;2,9;2;1;1
258095811390;258095811400;10;2,9;2;1;1
258095811400;258095811401;1;2,9;2;1;1
258095811401;258095811418;17;2,9;2;1;1
258095811418;258095811419;1;2,9;2;1;1
258095811419;258095811421;2;2,9;2;1;1
258095811421;258095811427;6;2,9;2;1;1
258095811427;258095811445;18;2,9;2;1;1
258095811445;258095811458;13;2,9;2;1;1
258095811458;258095811461;3;2,9;2;1;1
258095811461;258095811470;9;2,9;2;1;1
258095811470;258095811474;4;2,9;2;1;1
258095811474;258095811480;6;2,9;2;1;1
258095811480;258095811491;11;2,9;2;1;1
258095811491;258095811494;3;2,9;2;1;1
258095811494;258095811507;13;2,9;2;1;1
258095811507;258095811510;3;2,9;2;1;1
258095811510;258095811523;13;2,9;2;1;1
258095811523;258095811529;6;2,9;2;1;1
258095811529;258095811534;5;2,9;2;1;1
258095811534;258095811541;7;2,9;2;1;1
258095811541;258095811555;14;2,9;2;1;1
258095811555;258095811563;8;2,9;2;1;1
258095811563;258095811575;12;2,9;2;1;1
258095811575;258095811583;8;2,9;2;1;1
258095811583;258095811594;11;2,9;2;1;1
258095811594;258095811605;11;2,9;2;1;1
258095811605;258095811609;4;2,9;2;1;1
258095811609;258095811614;5;2,9;2;1;1
258095811614;258095811625;11;2,9;2;1;1
258095811625;258095811633;8;2,9;2;1;1
258095811633;258095811635;2;2,9;2;1;1
258095811635;258095811638;3;2,9;2;1;1
258095811638;258095811665;27;2,9;2;1;1
258095811665;258095811667;2;2,9;2;1;1
258095811667;258095811686;19;2,9;2;1;1
258095811686;258095811710;24;2,9;2;1;1
258095811710;258095811711;1;2,9;2;1;1
258095811711;258095811716;5;2,9;2;1;1
258095811716;258095811758;42;2,9;2;1;1
258095811758;258095811759;1;2,9;2;1;1
258095811759;258095811765;6;2,9;2;1;1
258095811765;258095811793;28;2,9;2;1;1
258095811793;258095811812;19;2,9;2;1;1
258095811812;258095811813;1;2,9;2;1;1
258095811813;258095811850;37;2,9;2;1;1
258095811850;258095811880;30;2,9;2;1;1
258095811880;258095811886;6;2,9;2;1;1
258095811886;258095811903;17;2,9;2;1;1
258095811903;258095811919;16;2,9;2;1;1
258095811919;258095811921;2;2,9;2;1;1
258095811921;258095811933;12;2,9;2;1;1
258095811933;258095811935;2;2,9;2;1;1
258095811935;258095811949;14;2,9;2;1;1
258095811949;258095811978;29;2,9;2;1;1
258095811978;258095811983;5;2,9;2;1;1
258095811983;258095811992;9;2,9;2;1;1
258095811992;258095812016;24;2,9;2;1;1
258095812016;258095812043;27;2,9;2;1;1
258095812043;258095812054;11;2,9;2;1;1
258095812054;258095812063;9;2,9;2;1;1
258095812063;258095812071;8;2,9;2;1;1
258095812071;258095812072;1;2,9;2;1;1
258095812072;258095812107;35;2,9;2;1;1
258095812107;258095812110;3;2,9;2;1;1
258095812110;258095812141;31;2,9;2;1;1
258095812141;258095812142;1;2,9;2;1;1
258095812142;258095812181;39;2,9;2;1;1
258095812181;258095812203;22;2,9;2;1;1
258095812203;258095812225;22;2,9;2;1;1
258095812225;258095812240;15;2,9;2;1;1
258095812240;258095812242;2;2,9;2;1;1
258095812242;258095812245;3;2,9;2;1;1
258095812245;258095812264;19;2,9;2;1;1
258095812264;258095812275;11;2,9;2;1;1
258095812275;258095812317;42;2,9;2;1;1
258095812317;258095812335;18;2,9;2;1;1
258095812335;258095812348;13;2,9;2;1;1
258095812348;258095812377;29;2,9;2;1;1
258095812377;258095812381;4;2,9;2;1;1
258095812381;258095812382;1;2,9;2;1;1
258095812382;258095812394;12;2,9;2;1;1
258095812394;258095812410;16;2,9;2;1;1
258095812410;258095812423;13;2,9;2;1;1
258095812423;258095812439;16;2,9;2;1;1
258095812439;258095812443;4;2,9;2;1;1
258095812443;258095812446;3;2,9;2;1;1
258095812446;258095812453;7;2,9;2;1;1
258095812453;258095812455;2;2,9;2;1;1
258095812455;258095812480;25;2,9;2;1;1
258095812480;258095812543;63;2,9;2;1;1
258095812543;258095812580;37;2,9;2;1;1
258095812580;258095812595;15;2,9;2;1;1
258095812595;258095812598;3;2,9;2;1;1
258095812598;258095812599;1;2,9;2;1;1
258095812599;258095812642;43;2,9;2;1;1
258095812642;258095812659;17;2,9;2;1;1
258095812659;258095812687;28;2,9;2;1;1
258095812687;258095812718;31;2,9;2;1;1
258095812718;258095812722;4;2,9;2;1;1
258095812722;258095812758;36;2,9;2;1;1
258095812758;258095812783;25;2,9;2;1;1
258095812783;258095812814;31;2,9;2;1;1
258095812814;258095812827;13;2,9;2;1;1
258095812827;258095812854;27;2,9;2;1;1
258095812854;258095812867;13;2,9;2;1;1
258095812867;258095812869;2;2,9;2;1;1
258095812869;258095812904;35;2,9;2;1;1
258095812904;258095812909;5;2,9;2;1;1
258095812909;258095812946;37;2,9;2;1;1
258095812946;258095812948;2;2,9;2;1;1
258095812948;258095812984;36;2,9;2;1;1
258095812984;258095812987;3;2,9;2;1;1
258095812987;258095813007;20;2,9;2;1;1
258095813007;258095813022;15;2,9;2;1;1
258095813022;258095813025;3;2,9;2;1;1
258095813025;258095813042;17;2,9;2;1;1
258095813042;258095813056;14;2,9;2;1;1
258095813056;258095813061;5;2,9;2;1;1
258095813061;258095813062;1;2,9;2;1;1
258095813062;258095813074;12;2,9;2;1;1
258095813074;258095813083;9;2,9;2;1;1
258095813083;258095813092;9;2,9;2;1;1
258095813092;258095813103;11;2,9;2;1;1
258095813103;258095813117;14;2,9;2;1;1
258095813117;258095813121;4;2,9;2;1;1
258095813121;258095813138;17;2,9;2;1;1
258095813138;258095813152;14;2,9;2;1;1
258095813152;258095813182;30;2,9;2;1;1
258095813182;258095813187;5;2,9;2;1;1
258095813187;258095813189;2;2,9;2;1;1
258095813189;258095813205;16;2,9;2;1;1
258095813205;258095813224;19;2,9;2;1;1
258095813224;258095813229;5;2,9;2;1;1
258095813229;258095813268;39;2,9;2;1;1
258095813268;258095813279;11;2,9;2;1;1
258095813279;258095813302;23;2,9;2;1;1
258095813302;258095813332;30;2,9;2;1;1
258095813332;258095813337;5;2,9;2;1;1
258095813337;258095813338;1;2,9;2;1;1
258095813338;258095813363;25;2,9;2;1;1
258095813363;258095813373;10;2,9;2;1;1
258095813373;258095813374;1;2,9;2;1;1
258095813374;258095813408;34;2,9;2;1;1
258095813408;258095813429;21;2,9;2;1;1
258095813429;258095813458;29;2,9;2;1;1
258095813458;258095813475;17;2,9;2;1;1
258095813475;258095813507;32;2,9;2;1;1
258095813507;258095813541;34;2,9;2;1;1
258095813541;258095813582;41;2,9;2;1;1
258095813582;258095813587;5;2,9;2;1;1
258095813587;258095813633;46;2,9;2;1;1
258095813633;258095813676;43;2,9;2;1;1
258095813676;258095813703;27;2,9;2;1;1
258095813703;258095813720;17;2,9;2;1;1
258095813720;258095813764;44;2,9;2;1;1
258095813764;258095813808;44;2,9;2;1;1
258095813808;258095813826;18;2,9;2;1;1
258095813826;258095813853;27;2,9;2;1;1
258095813853;258095813864;11;2,9;2;1;1
258095813864;258095813902;38;2,9;2;1;1
258095813902;258095813939;37;2,9;2;1;1
258095813939;258095814070;131;2,9;2;1;1
258095814070;258095814193;123;2,9;2;1;1
258095814193;258095814313;120;2,9;2;1;1
258095814313;258095830897;16584;2,9;2;1;1
258095830897;258095852415;21518;2,9;2;1;1
258095852415;258095856097;3682;2,9;2;1;1
258095856097;258095856973;876;2,9;2;1;1
258095856973;258095857597;624;2,9;2;1;1
258095857597;258095859703;2106;2,9;2;1;1
258095859703;258095872652;12949;2,9;2;1;1
258095872652;258095873009;357;2,9;2;1;1
258095873009;258095873603;594;2,9;2;1;1
258095873603;258095873822;219;2,9;2;1;1
258095873822;258095878997;5175;2,9;2;1;1
258095878997;258095880726;1729;2,9;2;1;1
258095880726;258095880760;34;2,9;2;1;1
258095880760;258095883177;2417;2,9;2;1;1
258095883177;258095883465;288;2,9;2;1;1
258095883465;258095893408;9943;2,9;2;1;1
258095893408;258095893547;139;2,9;2;1;1
258095893547;258095893669;122;2,9;2;1;1
258095893669;258095896656;2987;2,9;2;1;1
258095896656;258095904262;7606;2,9;2;1;1
258095904262;258095904792;530;2,9;2;1;1
258095904792;258095904814;22;2,9;2;1;1
258095904814;258095905409;595;2,9;2;1;1
258095905409;258095907902;2493;2,9;2;1;1
258095907902;258095908030;128;2,9;2;1;1
258095908030;258095911099;3069;2,9;2;1;1
258095911099;258095911790;691;2,9;2;1;1
258095911790;258095913795;2005;2,9;2;1;1
258095913795;258095914763;968;2,9;2;1;1
258095914763;258095923573;8810;2,9;2;1;1
258095923573;258095934236;10663;2,9;2;1;1
258095934236;258095934753;517;2,9;2;1;1
258095934753;258095935594;841;2,9;2;1;1
258095935594;258095936038;444;2,9;2;1;1
258095936038;258095936515;477;2,9;2;1;1
258095936515;258095936945;430;2,9;2;1;1
258095936945;258095938465;1520;2,9;2;1;1
258095938465;258095940295;1830;2,9;2;1;1
258095940295;258095941204;909;2,9;2;1;1
258095941204;258095944925;3721;2,9;2;1;1
258095944925;258095948919;3994;2,9;2;1;1
258095948919;258095949727;808;2,9;2;1;1
258095949727;258095950004;277;2,9;2;1;1
258095950004;258095951838;1834;2,9;2;1;1
258095951838;258095952128;290;2,9;2;1;1
258095952128;258095952882;754;2,9;2;1;1
258095952882;258095955728;2846;2,9;2;1;1
258095955728;258095956513;785;2,9;2;1;1
258095956513;258095956592;79;2,9;2;1;1
258095956592;258095957288;696;2,9;2;1;1
258095957288;258095963840;6552;2,9;2;1;1
258095963840;258095966079;2239;2,9;2;1;1
258095966079;258095967073;994;2,9;2;1;1
258095967073;258095967077;4;2,9;2;1;1
258095967077;258095967105;28;2,9;2;1;1
258095967105;258095967470;365;2,9;2;1;1
258095967470;258095968018;548;2,9;2;1;1
258095968018;258095968111;93;2,9;2;1;1
258095968111;258095968147;36;2,9;2;1;1
258095968147;258095968253;106;2,9;2;1;1
258095968253;258095968447;194;2,9;2;1;1
258095968447;258095969210;763;2,9;2;1;1
258095969210;258095969323;113;2,9;2;1;1
258095969323;258095969481;158;2,9;2;1;1
258095969481;258095970062;581;2,9;2;1;1
258095970062;258095970317;255;2,9;2;1;1
258095970317;258095973230;2913;2,9;2;1;1
258095973230;258095973507;277;2,9;2;1;1
258095973507;258095973523;16;2,9;2;1;1
258095973523;258095973545;22;2,9;2;1;1
258095973545;258095973730;185;2,9;2;1;1
258095973730;258095973894;164;2,9;2;1;1
258095973894;258095974007;113;2,9;2;1;1
258095974007;258095974089;82;2,9;2;1;1
258095974089;258095974119;30;2,9;2;1;1
258095974119;258095974146;27;2,9;2;1;1
258095974146;258095974172;26;2,9;2;1;1
258095974172;258095974199;27;2,9;2;1;1
258095974199;258095974671;472;2,9;2;1;1
258095974671;258095974902;231;2,9;2;1;1
258095974902;258095974985;83;2,9;2;1;1
258095974985;258095975126;141;2,9;2;1;1
258095975126;258095977577;2451;2,9;2;1;1
258095977577;258095978244;667;2,9;2;1;1
258095978244;258095978669;425;2,9;2;1;1
258095978669;258095985289;6620;2,9;2;1;1
258095985289;258095985393;104;2,9;2;1;1
258095985393;258095986355;962;2,9;2;1;1
258095986355;258095986579;224;2,9;2;1;1
258095986579;258095988676;2097;2,9;2;1;1
258095988676;258095989065;389;2,9;2;1;1
258095989065;258095989920;855;2,9;2;1;1
258095989920;258095992719;2799;2,9;2;1;1
258095992719;258095992725;6;2,9;2;1;1
258095992725;258095992760;35;2,9;2;1;1
258095992760;258095992953;193;2,9;2;1;1
258095992953;258095993101;148;2,9;2;1;1
258095993101;258095993285;184;2,9;2;1;1
258095993285;258095993747;462;2,9;2;1;1
258095993747;258095994711;964;2,9;2;1;1
258095994711;258095997277;2566;2,9;2;1;1
258095997277;258095997453;176;2,9;2;1;1
258095997453;258095998223;770;2,9;2;1;1
258095998223;258095998368;145;2,9;2;1;1
258095998368;258095998516;148;2,9;2;1;1
258095998516;258095998691;175;2,9;2;1;1
258095998691;258095998752;61;2,9;2;1;1
258095998752;258095998837;85;2,9;2;1;1
258095998837;258095999832;995;2,9;2;1;1
258095999832;258096010143;10311;2,9;2;1;1
258096010143;258096012669;2526;2,9;2;1;1
258096012669;258096014527;1858;2,9;2;1;1
258096014527;258096016909;2382;2,9;2;1;1
258096016909;258096017043;134;2,9;2;1;1
258096017043;258096017187;144;2,9;2;1;1
258096017187;258096017354;167;2,9;2;1;1
258096017354;258096017555;201;2,9;2;1;1
258096017555;258096019184;1629;2,9;2;1;1
258096019184;258096019654;470;2,9;2;1;1
258096019654;258096021833;2179;2,9;2;1;1
258096021833;258096021968;135;2,9;2;1;1
258096021968;258096022215;247;2,9;2;1;1
258096022215;258096022259;44;2,9;2;1;1
258096022259;258096022266;7;2,9;2;1;1
258096022266;258096022395;129;2,9;2;1;1
258096022395;258096022481;86;2,9;2;1;1
258096022481;258096022529;48;2,9;2;1;1
258096022529;258096022578;49;2,9;2;1;1
258096022578;258096022688;110;2,9;2;1;1
258096022688;258096022720;32;2,9;2;1;1
258096022720;258096024009;1289;2,9;2;1;1
258096024009;258096024325;316;2,9;2;1;1
258096024325;258096026100;1775;2,9;2;1;1
258096026100;258096027379;1279;2,9;2;1;1
258096027379;258096027866;487;2,9;2;1;1
258096027866;258096027894;28;2,9;2;1;1
258096027894;258096028159;265;2,9;2;1;1
258096028159;258096028294;135;2,9;2;1;1
258096028294;258096028964;670;2,9;2;1;1
258096028964;258096032755;3791;2,9;2;1;1
258096032755;258096033412;657;2,9;2;1;1
258096033412;258096034019;607;2,9;2;1;1
258096034019;258096034289;270;2,9;2;1;1
258096034289;258096034750;461;2,9;2;1;1
258096034750;258096035497;747;2,9;2;1;1
258096035497;258096035500;3;2,9;2;1;1
258096035500;258096035545;45;2,9;2;1;1
258096035545;258096035595;50;2,9;2;1;1
258096035595;258096035729;134;2,9;2;1;1
258096035729;258096035824;95;2,9;2;1;1
258096035824;258096037639;1815;2,9;2;1;1
258096037639;258096037670;31;2,9;2;1;1
258096037670;258096038713;1043;2,9;2;1;1
258096038713;258096039893;1180;2,9;2;1;1
258096039893;258096039960;67;2,9;2;1;1
258096039960;258096040703;743;2,9;2;1;1
258096040703;258096040987;284;2,9;2;1;1
258096040987;258096041596;609;2,9;2;1;1
258096041596;258096041683;87;2,9;2;1;1
258096041683;258096041697;14;2,9;2;1;1
258096041697;258096041767;70;2,9;2;1;1
258096041767;258096041983;216;2,9;2;1;1
258096041983;258096042406;423;2,9;2;1;1
258096042406;258096042782;376;2,9;2;1;1
258096042782;258096043016;234;2,9;2;1;1
258096043016;258096043417;401;2,9;2;1;1
258096043417;258096046804;3387;2,9;2;1;1
258096046804;258096046869;65;2,9;2;1;1
258096046869;258096047068;199;2,9;2;1;1
258096047068;258096047132;64;2,9;2;1;1
258096047132;258096047162;30;2,9;2;1;1
258096047162;258096047314;152;2,9;2;1;1
258096047314;258096047497;183;2,9;2;1;1
258096047497;258096047536;39;2,9;2;1;1
258096047536;258096047575;39;2,9;2;1;1
258096047575;258096047753;178;2,9;2;1;1
258096047753;258096047811;58;2,9;2;1;1
258096047811;258096047873;62;2,9;2;1;1
258096047873;258096047907;34;2,9;2;1;1
258096047907;258096049088;1181;2,9;2;1;1
258096049088;258096051072;1984;2,9;2;1;1
258096051072;258096051492;420;2,9;2;1;1
258096051492;258096051539;47;2,9;2;1;1
258096051539;258096051577;38;2,9;2;1;1
258096051577;258096051760;183;2,9;2;1;1
258096051760;258096051901;141;2,9;2;1;1
258096051901;258096052091;190;2,9;2;1;1
258096052091;258096052132;41;2,9;2;1;1
258096052132;258096052198;66;2,9;2;1;1
258096052198;258096052830;632;2,9;2;1;1
258096052830;258096053054;224;2,9;2;1;1
258096053054;258096053120;66;2,9;2;1;1
258096053120;258096053192;72;2,9;2;1;1
258096053192;258096053463;271;2,9;2;1;1
258096053463;258096053524;61;2,9;2;1;1
258096053524;258096053717;193;2,9;2;1;1
258096053717;258096054387;670;2,9;2;1;1
258096054387;258096055035;648;2,9;2;1;1
258096055035;258096055058;23;2,9;2;1;1
258096055058;258096055158;100;2,9;2;1;1
258096055158;258096055426;268;2,9;2;1;1
258096055426;258096056477;1051;2,9;2;1;1
258096056477;258096057045;568;2,9;2;1;1
258096057045;258096057203;158;2,9;2;1;1
258096057203;258096057670;467;2,9;2;1;1
258096057670;258096057803;133;2,9;2;1;1
258096057803;258096057854;51;2,9;2;1;1
258096057854;258096057865;11;2,9;2;1;1
258096057865;258096058174;309;2,9;2;1;1
258096058174;258096058215;41;2,9;2;1;1
258096058215;258096058277;62;2,9;2;1;1
258096058277;258096058467;190;2,9;2;1;1
258096058467;258096058554;87;2,9;2;1;1
258096058554;258096058866;312;2,9;2;1;1
258096058866;258096059398;532;2,9;2;1;1
258096059398;258096059641;243;2,9;2;1;1
258096059641;258096060174;533;2,9;2;1;1
258096060174;258096060671;497;2,9;2;1;1
258096060671;258096060756;85;2,9;2;1;1
258096060756;258096061315;559;2,9;2;1;1
258096061315;258096061619;304;2,9;2;1;1
258096061619;258096061822;203;2,9;2;1;1
258096061822;258096061947;125;2,9;2;1;1
258096061947;258096062518;571;2,9;2;1;1
258096062518;258096062658;140;2,9;2;1;1
258096062658;258096062745;87;2,9;2;1;1
258096062745;258096062830;85;2,9;2;1;1
258096062830;258096062847;17;2,9;2;1;1
258096062847;258096063016;169;2,9;2;1;1
258096063016;258096063144;128;2,9;2;1;1
258096063144;258096063188;44;2,9;2;1;1
258096063188;258096063397;209;2,9;2;1;1
258096063397;258096063468;71;2,9;2;1;1
258096063468;258096063480;12;2,9;2;1;1
258096063480;258096063642;162;2,9;2;1;1
258096063642;258096063697;55;2,9;2;1;1
258096063697;258096063726;29;2,9;2;1;1
258096063726;258096063853;127;2,9;2;1;1
258096063853;258096064169;316;2,9;2;1;1
258096064169;258096064257;88;2,9;2;1;1
258096064257;258096064267;10;2,9;2;1;1
258096064267;258096064368;101;2,9;2;1;1
258096064368;258096064380;12;2,9;2;1;1
258096064380;258096064399;19;2,9;2;1;1
258096064399;258096064406;7;2,9;2;1;1
258096064406;258096064511;105;2,9;2;1;1
258096064511;258096064786;275;2,9;2;1;1
258096064786;258096065027;241;2,9;2;1;1
258096065027;258096065196;169;2,9;2;1;1
258096065196;258096065237;41;2,9;2;1;1
258096065237;258096065257;20;2,9;2;1;1
258096065257;258096066375;1118;2,9;2;1;1
258096066375;258096066612;237;2,9;2;1;1
258096066612;258096066733;121;2,9;2;1;1
258096066733;258096067179;446;2,9;2;1;1
258096067179;258096067279;100;2,9;2;1;1
258096067279;258096067657;378;2,9;2;1;1
258096067657;258096067991;334;2,9;2;1;1
258096067991;258096068855;864;2,9;2;1;1
258096068855;258096068926;71;2,9;2;1;1
258096068926;258096069009;83;2,9;2;1;1
258096069009;258096069047;38;2,9;2;1;1
258096069047;258096069060;13;2,9;2;1;1
258096069060;258096069071;11;2,9;2;1;1
258096069071;258096069097;26;2,9;2;1;1
258096069097;258096069115;18;2,9;2;1;1
258096069115;258096069147;32;2,9;2;1;1
258096069147;258096069198;51;2,9;2;1;1
258096069198;258096069203;5;2,9;2;1;1
258096069203;258096069310;107;2,9;2;1;1
258096069310;258096069414;104;2,9;2;1;1
258096069414;258096069426;12;2,9;2;1;1
258096069426;258096069627;201;2,9;2;1;1
258096069627;258096070072;445;2,9;2;1;1
258096070072;258096070132;60;2,9;2;1;1
258096070132;258096070391;259;2,9;2;1;1
258096070391;258096070604;213;2,9;2;1;1
258096070604;258096072371;1767;2,9;2;1;1
258096072371;258096072652;281;2,9;2;1;1
258096072652;258096072702;50;2,9;2;1;1
258096072702;258096072802;100;2,9;2;1;1
258096072802;258096073076;274;2,9;2;1;1
258096073076;258096073270;194;2,9;2;1;1
258096073270;258096073927;657;2,9;2;1;1
258096073927;258096074929;1002;2,9;2;1;1
258096074929;258096075750;821;2,9;2;1;1
258096075750;258096076560;810;2,9;2;1;1
258096076560;258096076639;79;2,9;2;1;1
258096076639;258096076863;224;2,9;2;1;1
258096076863;258096076956;93;2,9;2;1;1
258096076956;258096077031;75;2,9;2;1;1
258096077031;258096077401;370;2,9;2;1;1
258096077401;258096078308;907;2,9;2;1;1
258096078308;258096078549;241;2,9;2;1;1
258096078549;258096078655;106;2,9;2;1;1
258096078655;258096078683;28;2,9;2;1;1
258096078683;258096078724;41;2,9;2;1;1
258096078724;258096078927;203;2,9;2;1;1
258096078927;258096079059;132;2,9;2;1;1
258096079059;258096079244;185;2,9;2;1;1
258096079244;258096079308;64;2,9;2;1;1
258096079308;258096079549;241;2,9;2;1;1
258096079549;258096079676;127;2,9;2;1;1
258096079676;258096079753;77;2,9;2;1;1
258096079753;258096079823;70;2,9;2;1;1
258096079823;258096080483;660;2,9;2;1;1
258096080483;258096080534;51;2,9;2;1;1
258096080534;258096080634;100;2,9;2;1;1
258096080634;258096080920;286;2,9;2;1;1
258096080920;258096081100;180;2,9;2;1;1
258096081100;258096081258;158;2,9;2;1;1
258096081258;258096081357;99;2,9;2;1;1
258096081357;258096082358;1001;2,9;2;1;1
258096082358;258096082461;103;2,9;2;1;1
258096082461;258096083123;662;2,9;2;1;1
258096083123;258096083264;141;2,9;2;1;1
258096083264;258096083529;265;2,9;2;1;1
258096083529;258096083573;44;2,9;2;1;1
258096083573;258096083674;101;2,9;2;1;1
258096083674;258096083827;153;2,9;2;1;1
258096083827;258096084031;204;2,9;2;1;1
258096084031;258096084182;151;2,9;2;1;1
258096084182;258096084209;27;2,9;2;1;1
258096084209;258096084232;23;2,9;2;1;1
258096084232;258096084356;124;2,9;2;1;1
258096084356;258096084407;51;2,9;2;1;1
258096084407;258096084704;297;2,9;2;1;1
258096084704;258096084768;64;2,9;2;1;1
258096084768;258096084957;189;2,9;2;1;1
258096084957;258096085127;170;2,9;2;1;1
258096085127;258096085201;74;2,9;2;1;1
258096085201;258096085245;44;2,9;2;1;1
258096085245;258096085270;25;2,9;2;1;1
258096085270;258096085318;48;2,9;2;1;1
258096085318;258096085343;25;2,9;2;1;1
258096085343;258096085466;123;2,9;2;1;1
258096085466;258096085483;17;2,9;2;1;1
258096085483;258096085811;328;2,9;2;1;1
258096085811;258096085955;144;2,9;2;1;1
258096085955;258096086018;63;2,9;2;1;1
258096086018;258096086164;146;2,9;2;1;1
258096086164;258096086175;11;2,9;2;1;1
258096086175;258096086404;229;2,9;2;1;1
258096086404;258096086483;79;2,9;2;1;1
258096086483;258096086779;296;2,9;2;1;1
258096086779;258096086991;212;2,9;2;1;1
258096086991;258096087039;48;2,9;2;1;1
258096087039;258096087645;606;2,9;2;1;1
258096087645;258096087748;103;2,9;2;1;1
258096087748;258096089495;1747;2,9;2;1;1
258096089495;258096089828;333;2,9;2;1;1
258096089828;258096090121;293;2,9;2;1;1
258096090121;258096090230;109;2,9;2;1;1
258096090230;258096090385;155;2,9;2;1;1
258096090385;258096090409;24;2,9;2;1;1
258096090409;258096090531;122;2,9;2;1;1
258096090531;258096090629;98;2,9;2;1;1
258096090629;258096090834;205;2,9;2;1;1
258096090834;258096090871;37;2,9;2;1;1
258096090871;258096090938;67;2,9;2;1;1
258096090938;258096091065;127;2,9;2;1;1
258096091065;258096091069;4;2,9;2;1;1
258096091069;258096091112;43;2,9;2;1;1
258096091112;258096091225;113;2,9;2;1;1
258096091225;258096091315;90;2,9;2;1;1
258096091315;258096091399;84;2,9;2;1;1
258096091399;258096091430;31;2,9;2;1;1
258096091430;258096091523;93;2,9;2;1;1
258096091523;258096091571;48;2,9;2;1;1
258096091571;258096091585;14;2,9;2;1;1
258096091585;258096091673;88;2,9;2;1;1
258096091673;258096091906;233;2,9;2;1;1
258096091906;258096092029;123;2,9;2;1;1
258096092029;258096092063;34;2,9;2;1;1
258096092063;258096092087;24;2,9;2;1;1
258096092087;258096092144;57;2,9;2;1;1
258096092144;258096092635;491;2,9;2;1;1
258096092635;258096092704;69;2,9;2;1;1
258096092704;258096092732;28;2,9;2;1;1
258096092732;258096092904;172;2,9;2;1;1
258096092904;258096094016;1112;2,9;2;1;1
258096094016;258096094307;291;2,9;2;1;1
258096094307;258096094683;376;2,9;2;1;1
258096094683;258096095000;317;2,9;2;1;1
258096095000;258096095490;490;2,9;2;1;1
258096095490;258096095940;450;2,9;2;1;1
258096095940;258096096058;118;2,9;2;1;1
258096096058;258096096398;340;2,9;2;1;1
258096096398;258096096400;2;2,9;2;1;1
258096096400;258096096663;263;2,9;2;1;1
258096096663;258096097106;443;2,9;2;1;1
258096097106;258096097172;66;2,9;2;1;1
258096097172;258096097877;705;2,9;2;1;1
258096097877;258096097960;83;2,9;2;1;1
258096097960;258096098388;428;2,9;2;1;1
258096098388;258096098944;556;2,9;2;1;1
258096098944;258096099382;438;2,9;2;1;1
258096099382;258096099417;35;2,9;2;1;1
258096099417;258096099477;60;2,9;2;1;1
258096099477;258096099525;48;2,9;2;1;1
258096099525;258096099529;4;2,9;2;1;1
258096099529;258096099542;13;2,9;2;1;1
258096099542;258096099566;24;2,9;2;1;1
258096099566;258096099595;29;2,9;2;1;1
258096099595;258096099646;51;2,9;2;1;1
258096099646;258096099880;234;2,9;2;1;1
258096099880;258096099899;19;2,9;2;1;1
258096099899;258096100040;141;2,9;2;1;1
258096100040;258096100202;162;2,9;2;1;1
258096100202;258096100234;32;2,9;2;1;1
258096100234;258096100401;167;2,9;2;1;1
258096100401;258096100463;62;2,9;2;1;1
258096100463;258096100490;27;2,9;2;1;1
258096100490;258096100584;94;2,9;2;1;1
258096100584;258096101183;599;2,9;2;1;1
258096101183;258096103014;1831;2,9;2;1;1
258096103014;258096103387;373;2,9;2;1;1
258096103387;258096103955;568;2,9;2;1;1
258096103955;258096104283;328;2,9;2;1;1
258096104283;258096104416;133;2,9;2;1;1
258096104416;258096105990;1574;2,9;2;1;1
258096105990;258096106094;104;2,9;2;1;1
258096106094;258096106664;570;2,9;2;1;1
258096106664;258096107009;345;2,9;2;1;1
258096107009;258096107619;610;2,9;2;1;1
258096107619;258096108012;393;2,9;2;1;1
258096108012;258096108172;160;2,9;2;1;1
258096108172;258096108648;476;2,9;2;1;1
258096108648;258096109058;410;2,9;2;1;1
258096109058;258096109207;149;2,9;2;1;1
258096109207;258096109481;274;2,9;2;1;1
258096109481;258096110214;733;2,9;2;1;1
258096110214;258096110515;301;2,9;2;1;1
258096110515;258096110864;349;2,9;2;1;1
258096110864;258096110868;4;2,9;2;1;1
258096110868;258096111404;536;2,9;2;1;1
258096111404;258096112282;878;2,9;2;1;1
258096112282;258096112305;23;2,9;2;1;1
258096112305;258096113180;875;2,9;2;1;1
258096113180;258096114107;927;2,9;2;1;1
258096114107;258096114314;207;2,9;2;1;1
258096114314;258096114523;209;2,9;2;1;1
258096114523;258096114758;235;2,9;2;1;1
258096114758;258096115382;624;2,9;2;1;1
258096115382;258096116029;647;2,9;2;1;1
258096116029;258096120377;4348;2,9;2;1;1
258096120377;258096120726;349;2,9;2;1;1
258096120726;258096121867;1141;2,9;2;1;1
258096121867;258096121893;26;2,9;2;1;1
258096121893;258096122138;245;2,9;2;1;1
258096122138;258096122490;352;2,9;2;1;1
258096122490;258096122528;38;2,9;2;1;1
258096122528;258096122630;102;2,9;2;1;1
258096122630;258096123064;434;2,9;2;1;1
258096123064;258096123356;292;2,9;2;1;1
258096123356;258096123737;381;2,9;2;1;1
258096123737;258096124050;313;2,9;2;1;1
258096124050;258096124309;259;2,9;2;1;1
258096124309;258096124646;337;2,9;2;1;1
258096124646;258096124861;215;2,9;2;1;1
258096124861;258096127115;2254;2,9;2;1;1
258096127115;258096127348;233;2,9;2;1;1
258096127348;258096127659;311;2,9;2;1;1
258096127659;258096127663;4;2,9;2;1;1
258096127663;258096128025;362;2,9;2;1;1
258096128025;258096128461;436;2,9;2;1;1
258096128461;258096128806;345;2,9;2;1;1
258096128806;258096129214;408;2,9;2;1;1
258096129214;258096129642;428;2,9;2;1;1
258096129642;258096130317;675;2,9;2;1;1
258096130317;258096131875;1558;2,9;2;1;1
258096131875;258096132008;133;2,9;2;1;1
258096132008;258096133999;1991;2,9;2;1;1
258096133999;258096134375;376;2,9;2;1;1
258096134375;258096135015;640;2,9;2;1;1
258096135015;258096135199;184;2,9;2;1;1
258096135199;258096135575;376;2,9;2;1;1
258096135575;258096135943;368;2,9;2;1;1
258096135943;258096136109;166;2,9;2;1;1
258096136109;258096136171;62;2,9;2;1;1
258096136171;258096136383;212;2,9;2;1;1
258096136383;258096136494;111;2,9;2;1;1
258096136494;258096136996;502;2,9;2;1;1
258096136996;258096137404;408;2,9;2;1;1
258096137404;258096137503;99;2,9;2;1;1
258096137503;258096140138;2635;2,9;2;1;1
258096140138;258096140275;137;2,9;2;1;1
258096140275;258096140596;321;2,9;2;1;1
258096140596;258096140618;22;2,9;2;1;1
258096140618;258096140685;67;2,9;2;1;1
258096140685;258096141982;1297;2,9;2;1;1
258096141982;258096142553;571;2,9;2;1;1
258096142553;258096149639;7086;2,9;2;1;1
258096149639;258096151010;1371;2,9;2;1;1
258096151010;258096154426;3416;2,9;2;1;1
258096154426;258096157742;3316;2,9;2;1;1
258096157742;258096159908;2166;2,9;2;1;1
258096159908;258096162434;2526;2,9;2;1;1
258096162434;258096164224;1790;2,9;2;1;1
258096164224;258096166849;2625;2,9;2;1;1
258096166849;258096168989;2140;2,9;2;1;1
258096168989;258096169432;443;2,9;2;1;1
258096169432;258096169918;486;2,9;2;1;1
258096169918;258096171278;1360;2,9;2;1;1
258096171278;258096172834;1556;2,9;2;1;1
258096172834;258096172877;43;2,9;2;1;1
258096172877;258096172930;53;2,9;2;1;1
258096172930;258096173162;232;2,9;2;1;1
258096173162;258096173211;49;2,9;2;1;1
258096173211;258096173356;145;2,9;2;1;1
258096173356;258096175672;2316;2,9;2;1;1
258096175672;258096176810;1138;2,9;2;1;1
258096176810;258096178947;2137;2,9;2;1;1
258096178947;258096184737;5790;2,9;2;1;1
258096184737;258096186634;1897;2,9;2;1;1
258096186634;258096188262;1628;2,9;2;1;1
258096188262;258096188347;85;2,9;2;1;1
258096188347;258096188708;361;2,9;2;1;1
258096188708;258096189054;346;2,9;2;1;1
258096189054;258096192692;3638;2,9;2;1;1
258096192692;258096192705;13;2,9;2;1;1
258096192705;258096192716;11;2,9;2;1;1
258096192716;258096193069;353;2,9;2;1;1
258096193069;258096193098;29;2,9;2;1;1
258096193098;258096193967;869;2,9;2;1;1
258096193967;258096194104;137;2,9;2;1;1
258096194104;258096198642;4538;2,9;2;1;1
258096198642;258096200253;1611;2,9;2;1;1
258096200253;258096208545;8292;2,9;2;1;1
258096208545;258096211420;2875;2,9;2;1;1
258096211420;258096211817;397;2,9;2;1;1
258096211817;258096211855;38;2,9;2;1;1
258096211855;258096211994;139;2,9;2;1;1
258096211994;258096212107;113;2,9;2;1;1
258096212107;258096212394;287;2,9;2;1;1
258096212394;258096212625;231;2,9;2;1;1
258096212625;258096213727;1102;2,9;2;1;1
258096213727;258096215370;1643;2,9;2;1;1
258096215370;258096215435;65;2,9;2;1;1
258096215435;258096218309;2874;2,9;2;1;1
258096218309;258096219847;1538;2,9;2;1;1
258096219847;258096220915;1068;2,9;2;1;1
258096220915;258096227064;6149;2,9;2;1;1
258096227064;258096227121;57;2,9;2;1;1
258096227121;258096227270;149;2,9;2;1;1
258096227270;258096227298;28;2,9;2;1;1
258096227298;258096227317;19;2,9;2;1;1
258096227317;258096229718;2401;2,9;2;1;1
258096229718;258096233153;3435;2,9;2;1;1
258096233153;258096238280;5127;2,9;2;1;1
258096238280;258096238333;53;2,9;2;1;1
258096238333;258096240201;1868;2,9;2;1;1
258096240201;258096243297;3096;2,9;2;1;1
258096243297;258096246056;2759;2,9;2;1;1
258096246056;258096246405;349;2,9;2;1;1
258096246405;258096246557;152;2,9;2;1;1
258096246557;258096246715;158;2,9;2;1;1
258096246715;258096246883;168;2,9;2;1;1
258096246883;258096252172;5289;2,9;2;1;1
258096252172;258096252632;460;2,9;2;1;1
258096252632;258096257702;5070;2,9;2;1;1
258096257702;258096257891;189;2,9;2;1;1
258096257891;258096266625;8734;2,9;2;1;1
258096266625;258096266798;173;2,9;2;1;1
258096266798;258096267258;460;2,9;2;1;1
258096267258;258096298604;31346;2,9;2;1;1
258096298604;258096303120;4516;2,9;2;1;1
258096303120;258096321406;18286;2,9;2;1;1
258096321406;258096324346;2940;2,9;2;1;1
258096324346;258096324720;374;2,9;2;1;1
258096324720;258096328350;3630;2,9;2;1;1
258096328350;258096328565;215;2,9;2;1;1
258096328565;258096328803;238;2,9;2;1;1
258096328803;258096328807;4;2,9;2;1;1
258096328807;258096328859;52;2,9;2;1;1
258096328859;258096328978;119;2,9;2;1;1
258096328978;258096329179;201;2,9;2;1;1
258096329179;258096329859;680;2,9;2;1;1
258096329859;258096329909;50;2,9;2;1;1
258096329909;258096330003;94;2,9;2;1;1
258096330003;258096333506;3503;2,9;2;1;1
258096333506;258096333635;129;2,9;2;1;1
258096333635;258096333971;336;2,9;2;1;1
258096333971;258096339365;5394;2,9;2;1;1
258096339365;258096339837;472;2,9;2;1;1
258096339837;258096340083;246;2,9;2;1;1
258096340083;258096342928;2845;2,9;2;1;1
258096342928;258096343560;632;2,9;2;1;1
258096343560;258096343624;64;2,9;2;1;1
258096343624;258096343919;295;2,9;2;1;1
258096343919;258096344001;82;2,9;2;1;1
258096344001;258096344185;184;2,9;2;1;1
258096344185;258096344316;131;2,9;2;1;1
258096344316;258096344372;56;2,9;2;1;1
258096344372;258096431739;87367;2,9;2;1;1
258096431739;258096462638;30899;2,9;2;1;1
258096462638;258096473577;10939;2,9;2;1;1
258096473577;258096482500;8923;2,9;2;1;1
258096482500;258096482758;258;2,9;2;1;1
258096482758;258096519370;36612;2,9;2;1;1
258096519370;258096530184;10814;2,9;2;1;1
258096530184;258096530235;51;2,9;2;1;1
258096530235;258096530261;26;2,9;2;1;1
258096530261;258096530317;56;2,9;2;1;1
258096530317;258096530331;14;2,9;2;1;1
258096530331;258096530352;21;2,9;2;1;1
258096530352;258096531165;813;2,9;2;1;1
258096531165;258096561944;30779;2,9;2;1;1
258096561944;258096565328;3384;2,9;2;1;1
258096565328;258096565762;434;2,9;2;1;1
258096565762;258096565998;236;2,9;2;1;1
258096565998;258096566076;78;2,9;2;1;1
258096566076;258096566521;445;2,9;2;1;1
258096566521;258096597440;30919;2,9;2;1;1
258096597440;258096636865;39425;2,9;2;1;1
258096636865;258096637921;1056;2,9;2;1;1
258096637921;258096689834;51913;2,9;2;1;1
258096689834;258096698978;9144;2,9;2;1;1
258096698978;258096699232;254;2,9;2;1;1
258096699232;258096731147;31915;2,9;2;1;1
258096731147;258096734854;3707;2,9;2;1;1
258096734854;258096734962;108;2,9;2;1;1
258096734962;258096735276;314;2,9;2;1;1
258096735276;258096735464;188;2,9;2;1;1
258096735464;258096762048;26584;2,9;2;1;1
258096762048;258096762089;41;2,9;2;1;1
258096762089;258096762140;51;2,9;2;1;1
258096762140;258096762356;216;2,9;2;1;1
258096762356;258096762506;150;2,9;2;1;1
258096762506;258096762652;146;2,9;2;1;1
258096762652;258096762707;55;2,9;2;1;1
258096762707;258096762799;92;2,9;2;1;1
258096762799;258096762926;127;2,9;2;1;1
258096762926;258096763082;156;2,9;2;1;1
258096763082;258096763237;155;2,9;2;1;1
258096763237;258096766491;3254;2,9;2;1;1
258096766491;258096774140;7649;2,9;2;1;1
258096774140;258096775434;1294;2,9;2;1;1
258096775434;258096779182;3748;2,9;2;1;1
258096779182;258096781575;2393;2,9;2;1;1
258096781575;258096784147;2572;2,9;2;1;1
258096784147;258096784559;412;2,9;2;1;1
258096784559;258096797006;12447;2,9;2;1;1
258096797006;258096802819;5813;2,9;2;1;1
258096802819;258096803081;262;2,9;2;1;1
258096803081;258096803135;54;2,9;2;1;1
258096803135;258096803147;12;2,9;2;1;1
258096803147;258096803168;21;2,9;2;1;1
258096803168;258096803362;194;2,9;2;1;1
258096803362;258096803400;38;2,9;2;1;1
258096803400;258096803493;93;2,9;2;1;1
258096803493;258096814645;11152;2,9;2;1;1
258096814645;258096818701;4056;2,9;2;1;1
258096818701;258096820482;1781;2,9;2;1;1
258096820482;258096832932;12450;2,9;2;1;1
258096832932;258096836338;3406;2,9;2;1;1
258096836338;258096836870;532;2,9;2;1;1
258096836870;258096847909;11039;2,9;2;1;1
258096847909;258096871220;23311;2,9;2;1;1
258096871220;258096882526;11306;2,9;2;1;1
258096882526;258096882577;51;2,9;2;1;1
258096882577;258096891105;8528;2,9;2;1;1
258096891105;258096891356;251;2,9;2;1;1
258096891356;258096891565;209;2,9;2;1;1
258096891565;258096891664;99;2,9;2;1;1
258096891664;258096891744;80;2,9;2;1;1
258096891744;258096902759;11015;2,9;2;1;1
258096902759;258096905413;2654;2,9;2;1;1
258096905413;258096906245;832;2,9;2;1;1
258096906245;258096906768;523;2,9;2;1;1
258096906768;258096906813;45;2,9;2;1;1
258096906813;258096916174;9361;2,9;2;1;1
258096916174;258096917260;1086;2,9;2;1;1
258096917260;258096945258;27998;2,9;2;1;1
258096945258;258096945784;526;2,9;2;1;1
258096945784;258096945854;70;2,9;2;1;1
258096945854;258096948738;2884;2,9;2;1;1
258096948738;258096948810;72;2,9;2;1;1
258096948810;258096948852;42;2,9;2;1;1
258096948852;258096948876;24;2,9;2;1;1
258096948876;258096948885;9;2,9;2;1;1
258096948885;258096948926;41;2,9;2;1;1
258096948926;258096949047;121;2,9;2;1;1
258096949047;258096949114;67;2,9;2;1;1
258096949114;258096949130;16;2,9;2;1;1
258096949130;258096949153;23;2,9;2;1;1
258096949153;258096956710;7557;2,9;2;1;1
258096956710;258096961297;4587;2,9;2;1;1
258096961297;258096966421;5124;2,9;2;1;1
258096966421;258096966457;36;2,9;2;1;1
258096966457;258097000191;33734;2,9;2;1;1
258097000191;258097000459;268;2,9;2;1;1
258097000459;258097000508;49;2,9;2;1;1
258097000508;258097000598;90;2,9;2;1;1
258097000598;258097000675;77;2,9;2;1;1
258097000675;258097000684;9;2,9;2;1;1
258097000684;258097000892;208;2,9;2;1;1
258097000892;258097001200;308;2,9;2;1;1
258097001200;258097001349;149;2,9;2;1;1
258097001349;258097001371;22;2,9;2;1;1
258097001371;258097007502;6131;2,9;2;1;1
258097007502;258097007520;18;2,9;2;1;1
258097007520;258097007546;26;2,9;2;1;1
258097007546;258097007636;90;2,9;2;1;1
258097007636;258097007697;61;2,9;2;1;1
258097007697;258097007753;56;2,9;2;1;1
258097007753;258097007777;24;2,9;2;1;1
258097007777;258097007883;106;2,9;2;1;1
258097007883;258097007964;81;2,9;2;1;1
258097007964;258097008027;63;2,9;2;1;1
258097008027;258097012037;4010;2,9;2;1;1
258097012037;258097012707;670;2,9;2;1;1
258097012707;258097019306;6599;2,9;2;1;1
258097019306;258097046508;27202;2,9;2;1;1
258097046508;258097056673;10165;2,9;2;1;1
258097056673;258097056825;152;2,9;2;1;1
258097056825;258097056987;162;2,9;2;1;1
258097056987;258097057013;26;2,9;2;1;1
258097057013;258097057249;236;2,9;2;1;1
258097057249;258097059365;2116;2,9;2;1;1
258097059365;258097060670;1305;2,9;2;1;1
258097060670;258097061021;351;2,9;2;1;1
258097061021;258097061391;370;2,9;2;1;1
258097061391;258097061426;35;2,9;2;1;1
258097061426;258097061537;111;2,9;2;1;1
258097061537;258097061623;86;2,9;2;1;1
258097061623;258097061663;40;2,9;2;1;1
258097061663;258097061746;83;2,9;2;1;1
258097061746;258097061816;70;2,9;2;1;1
258097061816;258097061986;170;2,9;2;1;1
258097061986;258097062151;165;2,9;2;1;1
258097062151;258097071890;9739;2,9;2;1;1
258097071890;258097081798;9908;2,9;2;1;1
258097081798;258097081829;31;2,9;2;1;1
258097081829;258097081870;41;2,9;2;1;1
258097081870;258097081919;49;2,9;2;1;1
258097081919;258097082105;186;2,9;2;1;1
258097082105;258097082132;27;2,9;2;1;1
258097082132;258097082242;110;2,9;2;1;1
258097082242;258097082391;149;2,9;2;1;1
258097082391;258097082401;10;2,9;2;1;1
258097082401;258097082468;67;2,9;2;1;1
258097082468;258097082526;58;2,9;2;1;1
258097082526;258097082645;119;2,9;2;1;1
258097082645;258097083600;955;2,9;2;1;1
258097083600;258097083779;179;2,9;2;1;1
258097083779;258097084118;339;2,9;2;1;1
258097084118;258097084204;86;2,9;2;1;1
258097084204;258097084272;68;2,9;2;1;1
258097084272;258097086272;2000;2,9;2;1;1
258097086272;258097087023;751;2,9;2;1;1
258097087023;258097094215;7192;2,9;2;1;1
258097094215;258097094436;221;2,9;2;1;1
258097094436;258097095003;567;2,9;2;1;1
258097095003;258097095746;743;2,9;2;1;1
258097095746;258097096758;1012;2,9;2;1;1
258097096758;258097102038;5280;2,9;2;1;1
258097102038;258097109189;7151;2,9;2;1;1
258097109189;258097111166;1977;2,9;2;1;1
258097111166;258097111498;332;2,9;2;1;1
258097111498;258097111913;415;2,9;2;1;1
258097111913;258097139495;27582;2,9;2;1;1
258097139495;258097149872;10377;2,9;2;1;1
258097149872;258097150000;128;2,9;2;1;1
258097150000;258097150035;35;2,9;2;1;1
258097150035;258097150071;36;2,9;2;1;1
258097150071;258097150612;541;2,9;2;1;1
258097150612;258097180424;29812;2,9;2;1;1
258097180424;258097189622;9198;2,9;2;1;1
258097189622;258097189858;236;2,9;2;1;1
258097189858;258097189882;24;2,9;2;1;1
258097189882;258097189954;72;2,9;2;1;1
258097189954;258097189981;27;2,9;2;1;1
258097189981;258097190000;19;2,9;2;1;1
258097190000;258097190649;649;2,9;2;1;1
258097190649;258097259035;68386;2,9;2;1;1
258097259035;258097259145;110;2,9;2;1;1
258097259145;258097259294;149;2,9;2;1;1
258097259294;258097270133;10839;2,9;2;1;1
258097270133;258097274015;3882;2,9;2;1;1
258097274015;258097274188;173;2,9;2;1;1
258097274188;258097274221;33;2,9;2;1;1
258097274221;258097274244;23;2,9;2;1;1
258097274244;258097348744;74500;2,9;2;1;1
258097348744;258097349787;1043;2,9;2;1;1
258097349787;258097349842;55;2,9;2;1;1
258097349842;258097349864;22;2,9;2;1;1
258097349864;258097350324;460;2,9;2;1;1
258097350324;258097350550;226;2,9;2;1;1
258097350550;258097350618;68;2,9;2;1;1
258097350618;258097350657;39;2,9;2;1;1
258097350657;258097354536;3879;2,9;2;1;1
258097354536;258097354540;4;2,9;2;1;1
258097354540;258097354568;28;2,9;2;1;1
258097354568;258097389236;34668;2,9;2;1;1
258097389236;258097393778;4542;2,9;2;1;1
258097393778;258097394142;364;2,9;2;1;1
258097394142;258097398578;4436;2,9;2;1;1
258097398578;258097398634;56;2,9;2;1;1
258097398634;258097398752;118;2,9;2;1;1
258097398752;258097402440;3688;2,9;2;1;1
258097402440;258097402588;148;2,9;2;1;1
258097402588;258097402638;50;2,9;2;1;1
258097402638;258097402748;110;2,9;2;1;1
258097402748;258097402817;69;2,9;2;1;1
258097402817;258097402863;46;2,9;2;1;1
258097402863;258097402909;46;2,9;2;1;1
258097402909;258097402965;56;2,9;2;1;1
258097402965;258097403314;349;2,9;2;1;1
258097403314;258097403757;443;2,9;2;1;1
258097403757;258097403829;72;2,9;2;1;1
258097403829;258097403872;43;2,9;2;1;1
258097403872;258097404102;230;2,9;2;1;1
258097404102;258097404247;145;2,9;2;1;1
258097404247;258097404289;42;2,9;2;1;1
258097404289;258097415996;11707;2,9;2;1;1
258097415996;258097416081;85;2,9;2;1;1
258097416081;258097416200;119;2,9;2;1;1
258097416200;258097416282;82;2,9;2;1;1
258097416282;258097416386;104;2,9;2;1;1
258097416386;258097416402;16;2,9;2;1;1
258097416402;258097416422;20;2,9;2;1;1
258097416422;258097416520;98;2,9;2;1;1
258097416520;258097416672;152;2,9;2;1;1
258097416672;258097416695;23;2,9;2;1;1
258097416695;258097416793;98;2,9;2;1;1
258097416793;258097420220;3427;2,9;2;1;1
258097420220;258097422643;2423;2,9;2;1;1
258097422643;258097440272;17629;2,9;2;1;1
258097440272;258097440471;199;2,9;2;1;1
258097440471;258097440759;288;2,9;2;1;1
258097440759;258097440954;195;2,9;2;1;1
258097440954;258097441157;203;2,9;2;1;1
258097441157;258097441310;153;2,9;2;1;1
258097441310;258097441351;41;2,9;2;1;1
258097441351;258097441559;208;2,9;2;1;1
258097441559;258097441597;38;2,9;2;1;1
258097441597;258097441835;238;2,9;2;1;1
258097441835;258097442466;631;2,9;2;1;1
258097442466;258097450830;8364;2,9;2;1;1
258097450830;258097461779;10949;2,9;2;1;1
258097461779;258097465488;3709;2,9;2;1;1
258097465488;258097465549;61;2,9;2;1;1
258097465549;258097465735;186;2,9;2;1;1
258097465735;258097466014;279;2,9;2;1;1
258097466014;258097466299;285;2,9;2;1;1
258097466299;258097483648;17349;2,9;2;1;1
258097483648;258097483817;169;2,9;2;1;1
258097483817;258097484043;226;2,9;2;1;1
258097484043;258097484067;24;2,9;2;1;1
258097484067;258097484082;15;2,9;2;1;1
258097484082;258097484128;46;2,9;2;1;1
258097484128;258097484155;27;2,9;2;1;1
258097484155;258097484851;696;2,9;2;1;1
258097484851;258097485915;1064;2,9;2;1;1
258097485915;258097489351;3436;2,9;2;1;1
258097489351;258097489368;17;2,9;2;1;1
258097489368;258097500773;11405;2,9;2;1;1
258097500773;258097500920;147;2,9;2;1;1
258097500920;258097501311;391;2,9;2;1;1
258097501311;258097501389;78;2,9;2;1;1
258097501389;258097501637;248;2,9;2;1;1
258097501637;258097501716;79;2,9;2;1;1
258097501716;258097501750;34;2,9;2;1;1
258097501750;258097501791;41;2,9;2;1;1
258097501791;258097501825;34;2,9;2;1;1
258097501825;258097501860;35;2,9;2;1;1
258097501860;258097501893;33;2,9;2;1;1
258097501893;258097512006;10113;2,9;2;1;1
258097512006;258097512118;112;2,9;2;1;1
258097512118;258097533529;21411;2,9;2;1;1
258097533529;258097540383;6854;2,9;2;1;1
258097540383;258097540407;24;2,9;2;1;1
258097540407;258097540465;58;2,9;2;1;1
258097540465;258097540520;55;2,9;2;1;1
258097540520;258097540570;50;2,9;2;1;1
258097540570;258097540624;54;2,9;2;1;1
258097540624;258097541113;489;2,9;2;1;1
258097541113;258097542016;903;2,9;2;1;1
258097542016;258097542164;148;2,9;2;1;1
258097542164;258097542388;224;2,9;2;1;1
258097542388;258097542461;73;2,9;2;1;1
258097542461;258097542695;234;2,9;2;1;1
258097542695;258097542932;237;2,9;2;1;1
258097542932;258097545967;3035;2,9;2;1;1
258097545967;258097548146;2179;2,9;2;1;1
258097548146;258097548376;230;2,9;2;1;1
258097548376;258097548461;85;2,9;2;1;1
258097548461;258097548746;285;2,9;2;1;1
258097548746;258097548998;252;2,9;2;1;1
258097548998;258097564160;15162;2,9;2;1;1
258097564160;258097564737;577;2,9;2;1;1
258097564737;258097564873;136;2,9;2;1;1
258097564873;258097564960;87;2,9;2;1;1
258097564960;258097565121;161;2,9;2;1;1
258097565121;258097565336;215;2,9;2;1;1
258097565336;258097565743;407;2,9;2;1;1
258097565743;258097565795;52;2,9;2;1;1
258097565795;258097569328;3533;2,9;2;1;1
258097569328;258097569524;196;2,9;2;1;1
258097569524;258097569868;344;2,9;2;1;1
258097569868;258097570056;188;2,9;2;1;1
258097570056;258097570103;47;2,9;2;1;1
258097570103;258097570213;110;2,9;2;1;1
258097570213;258097570281;68;2,9;2;1;1
258097570281;258097570368;87;2,9;2;1;1
258097570368;258097570513;145;2,9;2;1;1
258097570513;258097570659;146;2,9;2;1;1
258097570659;258097575443;4784;2,9;2;1;1
258097575443;258097579540;4097;2,9;2;1;1
258097579540;258097585052;5512;2,9;2;1;1
258097585052;258097585061;9;2,9;2;1;1
258097585061;258097585111;50;2,9;2;1;1
258097585111;258097585122;11;2,9;2;1;1
258097585122;258097585146;24;2,9;2;1;1
258097585146;258097585174;28;2,9;2;1;1
258097585174;258097585798;624;2,9;2;1;1
258097585798;258097623166;37368;2,9;2;1;1
258097623166;258097634667;11501;2,9;2;1;1
258097634667;258097635086;419;2,9;2;1;1
258097635086;258097638499;3413;2,9;2;1;1
258097638499;258097638665;166;2,9;2;1;1
258097638665;258097638932;267;2,9;2;1;1
258097638932;258097639150;218;2,9;2;1;1
258097639150;258097639381;231;2,9;2;1;1
258097639381;258097639526;145;2,9;2;1;1
258097639526;258097639672;146;2,9;2;1;1
258097639672;258097639816;144;2,9;2;1;1
258097639816;258097639962;146;2,9;2;1;1
258097639962;258097640105;143;2,9;2;1;1
258097640105;258097644888;4783;2,9;2;1;1
258097644888;258097645105;217;2,9;2;1;1
258097645105;258097645140;35;2,9;2;1;1
258097645140;258097645274;134;2,9;2;1;1
258097645274;258097645628;354;2,9;2;1;1
258097645628;258097645955;327;2,9;2;1;1
258097645955;258097646044;89;2,9;2;1;1
258097646044;258097646149;105;2,9;2;1;1
258097646149;258097646373;224;2,9;2;1;1
258097646373;258097646687;314;2,9;2;1;1
258097646687;258097650306;3619;2,9;2;1;1
258097650306;258097657099;6793;2,9;2;1;1
258097657099;258097658261;1162;2,9;2;1;1
258097658261;258097660779;2518;2,9;2;1;1
258097660779;258097660991;212;2,9;2;1;1
258097660991;258097661027;36;2,9;2;1;1
258097661027;258097661111;84;2,9;2;1;1
258097661111;258097661230;119;2,9;2;1;1
258097661230;258097661288;58;2,9;2;1;1
258097661288;258097661457;169;2,9;2;1;1
258097661457;258097661632;175;2,9;2;1;1
258097661632;258097661671;39;2,9;2;1;1
258097661671;258097661793;122;2,9;2;1;1
258097661793;258097669481;7688;2,9;2;1;1
258097669481;258097671420;1939;2,9;2;1;1
258097671420;258097672319;899;2,9;2;1;1
258097672319;258097685325;13006;2,9;2;1;1
258097685325;258097685375;50;2,9;2;1;1
258097685375;258097685737;362;2,9;2;1;1
258097685737;258097698029;12292;2,9;2;1;1
258097698029;258097701613;3584;2,9;2;1;1
258097701613;258097701689;76;2,9;2;1;1
258097701689;258097701983;294;2,9;2;1;1
258097701983;258097702084;101;2,9;2;1;1
258097702084;258097702179;95;2,9;2;1;1
258097702179;258097726856;24677;2,9;2;1;1
258097726856;258097741194;14338;2,9;2;1;1
258097741194;258097745840;4646;2,9;2;1;1
258097745840;258097745861;21;2,9;2;1;1
258097745861;258097745876;15;2,9;2;1;1
258097745876;258097745917;41;2,9;2;1;1
258097745917;258097745968;51;2,9;2;1;1
258097745968;258097746021;53;2,9;2;1;1
258097746021;258097746045;24;2,9;2;1;1
258097746045;258097774596;28551;2,9;2;1;1
258097774596;258097784410;9814;2,9;2;1;1
258097784410;258097816693;32283;2,9;2;1;1
258097816693;258097826002;9309;2,9;2;1;1
258097826002;258097826256;254;2,9;2;1;1
258097826256;258097845406;19150;2,9;2;1;1
258097845406;258097845516;110;2,9;2;1;1
258097845516;258097845550;34;2,9;2;1;1
258097845550;258097858092;12542;2,9;2;1;1
258097858092;258097868453;10361;2,9;2;1;1
258097868453;258097868498;45;2,9;2;1;1
258097868498;258097868506;8;2,9;2;1;1
258097868506;258097868520;14;2,9;2;1;1
258097868520;258097868540;20;2,9;2;1;1
258097868540;258097878440;9900;2,9;2;1;1
258097878440;258097878462;22;2,9;2;1;1
258097878462;258097878674;212;2,9;2;1;1
258097878674;258097899707;21033;2,9;2;1;1
258097899707;258097953139;53432;2,9;2;1;1
258097953139;258097963538;10399;2,9;2;1;1
258097963538;258097963573;35;2,9;2;1;1
258097963573;258097986466;22893;2,9;2;1;1
258097986466;258098038347;51881;2,9;2;1;1
258098038347;258098038589;242;2,9;2;1;1
258098038589;258098038996;407;2,9;2;1;1
258098038996;258098039310;314;2,9;2;1;1
258098039310;258098040430;1120;2,9;2;1;1
258098040430;258098040455;25;2,9;2;1;1
258098040455;258098040518;63;2,9;2;1;1
258098040518;258098041914;1396;2,9;2;1;1
258098041914;258098041988;74;2,9;2;1;1
258098041988;258098050385;8397;2,9;2;1;1
258098050385;258098053259;2874;2,9;2;1;1
258098053259;258098163001;109742;2,9;2;1;1
258098163001;258098213589;50588;2,9;2;1;1
258098213589;258098222442;8853;2,9;2;1;1
258098222442;258098254654;32212;2,9;2;1;1
258098254654;258098257815;3161;2,9;2;1;1
258098257815;258098257872;57;2,9;2;1;1
258098257872;258098269104;11232;2,9;2;1;1
258098269104;258098269140;36;2,9;2;1;1
258098269140;258098269171;31;2,9;2;1;1
258098269171;258098300512;31341;2,9;2;1;1
258098300512;258098341330;40818;2,9;2;1;1
258098341330;258098341971;641;2,9;2;1;1
258098341971;258098350693;8722;2,9;2;1;1
258098350693;258098350842;149;2,9;2;1;1
258098350842;258098350869;27;2,9;2;1;1
258098350869;258098350956;87;2,9;2;1;1
258098350956;258098352888;1932;2,9;2;1;1
258098352888;258098353317;429;2,9;2;1;1
258098353317;258098353371;54;2,9;2;1;1
258098353371;258098353379;8;2,9;2;1;1
258098353379;258098353429;50;2,9;2;1;1
258098353429;258098372549;19120;2,9;2;1;1
258098372549;258098373006;457;2,9;2;1;1
258098373006;258098373054;48;2,9;2;1;1
258098373054;258098373073;19;2,9;2;1;1
258098373073;258098373107;34;2,9;2;1;1
258098373107;258098373645;538;2,9;2;1;1
258098373645;258098376493;2848;2,9;2;1;1
258098376493;258098376903;410;2,9;2;1;1
258098376903;258098389310;12407;2,9;2;1;1
258098389310;258098389384;74;2,9;2;1;1
258098389384;258098389510;126;2,9;2;1;1
258098389510;258098389604;94;2,9;2;1;1
258098389604;258098389628;24;2,9;2;1;1
258098389628;258098389937;309;2,9;2;1;1
258098389937;258098389972;35;2,9;2;1;1
258098389972;258098390092;120;2,9;2;1;1
258098390092;258098390211;119;2,9;2;1;1
258098390211;258098390306;95;2,9;2;1;1
258098390306;258098398624;8318;2,9;2;1;1
258098398624;258098399089;465;2,9;2;1;1
258098399089;258098399279;190;2,9;2;1;1
258098399279;258098399381;102;2,9;2;1;1
258098399381;258098399435;54;2,9;2;1;1
258098399435;258098399616;181;2,9;2;1;1
258098399616;258098399690;74;2,9;2;1;1
258098399690;258098399954;264;2,9;2;1;1
258098399954;258098400081;127;2,9;2;1;1
258098400081;258098400117;36;2,9;2;1;1
258098400117;258098400139;22;2,9;2;1;1
258098400139;258098400173;34;2,9;2;1;1
258098400173;258098400285;112;2,9;2;1;1
258098400285;258098400290;5;2,9;2;1;1
258098400290;258098400346;56;2,9;2;1;1
258098400346;258098400409;63;2,9;2;1;1
258098400409;258098400518;109;2,9;2;1;1
258098400518;258098400631;113;2,9;2;1;1
258098400631;258098400750;119;2,9;2;1;1
258098400750;258098400860;110;2,9;2;1;1
258098400860;258098401334;474;2,9;2;1;1
258098401334;258098401396;62;2,9;2;1;1
258098401396;258098407904;6508;2,9;2;1;1
258098407904;258098407992;88;2,9;2;1;1
258098407992;258098408644;652;2,9;2;1;1
258098408644;258098409569;925;2,9;2;1;1
258098409569;258098409617;48;2,9;2;1;1
258098409617;258098409991;374;2,9;2;1;1
258098409991;258098410597;606;2,9;2;1;1
258098410597;258098410672;75;2,9;2;1;1
258098410672;258098410698;26;2,9;2;1;1
258098410698;258098411184;486;2,9;2;1;1
258098411184;258098411496;312;2,9;2;1;1
258098411496;258098411682;186;2,9;2;1;1
258098411682;258098411859;177;2,9;2;1;1
258098411859;258098411883;24;2,9;2;1;1
258098411883;258098411896;13;2,9;2;1;1
258098411896;258098412608;712;2,9;2;1;1
258098412608;258098413350;742;2,9;2;1;1
258098413350;258098415267;1917;2,9;2;1;1
258098415267;258098415965;698;2,9;2;1;1
258098415965;258098416003;38;2,9;2;1;1
258098416003;258098416082;79;2,9;2;1;1
258098416082;258098416142;60;2,9;2;1;1
258098416142;258098416153;11;2,9;2;1;1
258098416153;258098416210;57;2,9;2;1;1
258098416210;258098416357;147;2,9;2;1;1
258098416357;258098416418;61;2,9;2;1;1
258098416418;258098416530;112;2,9;2;1;1
258098416530;258098416778;248;2,9;2;1;1
258098416778;258098420606;3828;2,9;2;1;1
258098420606;258098427192;6586;2,9;2;1;1
258098427192;258098428303;1111;2,9;2;1;1
258098428303;258098428403;100;2,9;2;1;1
258098428403;258098428672;269;2,9;2;1;1
258098428672;258098428707;35;2,9;2;1;1
258098428707;258098428795;88;2,9;2;1;1
258098428795;258098428912;117;2,9;2;1;1
258098428912;258098429028;116;2,9;2;1;1
258098429028;258098429361;333;2,9;2;1;1
258098429361;258098429763;402;2,9;2;1;1
258098429763;258098430662;899;2,9;2;1;1
258098430662;258098430805;143;2,9;2;1;1
258098430805;258098431057;252;2,9;2;1;1
258098431057;258098432935;1878;2,9;2;1;1
258098432935;258098439996;7061;2,9;2;1;1
258098439996;258098440201;205;2,9;2;1;1
258098440201;258098440283;82;2,9;2;1;1
258098440283;258098440391;108;2,9;2;1;1
258098440391;258098440417;26;2,9;2;1;1
258098440417;258098440640;223;2,9;2;1;1
258098440640;258098440648;8;2,9;2;1;1
258098440648;258098440688;40;2,9;2;1;1
258098440688;258098440760;72;2,9;2;1;1
258098440760;258098441141;381;2,9;2;1;1
258098441141;258098442416;1275;2,9;2;1;1
258098442416;258098444240;1824;2,9;2;1;1
258098444240;258098448660;4420;2,9;2;1;1
258098448660;258098451894;3234;2,9;2;1;1
258098451894;258098458793;6899;2,9;2;1;1
258098458793;258098459121;328;2,9;2;1;1
258098459121;258098462347;3226;2,9;2;1;1
258098462347;258098462463;116;2,9;2;1;1
258098462463;258098462516;53;2,9;2;1;1
258098462516;258098462720;204;2,9;2;1;1
258098462720;258098462885;165;2,9;2;1;1
258098462885;258098463068;183;2,9;2;1;1
258098463068;258098463254;186;2,9;2;1;1
258098463254;258098463289;35;2,9;2;1;1
258098463289;258098463425;136;2,9;2;1;1
258098463425;258098463514;89;2,9;2;1;1
258098463514;258098463675;161;2,9;2;1;1
258098463675;258098463824;149;2,9;2;1;1
258098463824;258098463970;146;2,9;2;1;1
258098463970;258098465930;1960;2,9;2;1;1
258098465930;258098466065;135;2,9;2;1;1
258098466065;258098466147;82;2,9;2;1;1
258098466147;258098466292;145;2,9;2;1;1
258098466292;258098466297;5;2,9;2;1;1
258098466297;258098466352;55;2,9;2;1;1
258098466352;258098466357;5;2,9;2;1;1
258098466357;258098466432;75;2,9;2;1;1
258098466432;258098466478;46;2,9;2;1;1
258098466478;258098466515;37;2,9;2;1;1
258098466515;258098470920;4405;2,9;2;1;1
258098470920;258098475210;4290;2,9;2;1;1
258098475210;258098477062;1852;2,9;2;1;1
258098477062;258098480611;3549;2,9;2;1;1
258098480611;258098480777;166;2,9;2;1;1
258098480777;258098481192;415;2,9;2;1;1
258098481192;258098481228;36;2,9;2;1;1
258098481228;258098481758;530;2,9;2;1;1
258098481758;258098482371;613;2,9;2;1;1
258098482371;258098490299;7928;2,9;2;1;1
258098490299;258098490311;12;2,9;2;1;1
258098490311;258098491758;1447;2,9;2;1;1
258098491758;258098491848;90;2,9;2;1;1
258098491848;258098491902;54;2,9;2;1;1
258098491902;258098492170;268;2,9;2;1;1
258098492170;258098492731;561;2,9;2;1;1
258098492731;258098510695;17964;2,9;2;1;1
258098510695;258098510915;220;2,9;2;1;1
258098510915;258098510957;42;2,9;2;1;1
258098510957;258098510988;31;2,9;2;1;1
258098510988;258098511036;48;2,9;2;1;1
258098511036;258098511108;72;2,9;2;1;1
258098511108;258098511141;33;2,9;2;1;1
258098511141;258098511360;219;2,9;2;1;1
258098511360;258098511507;147;2,9;2;1;1
258098511507;258098511653;146;2,9;2;1;1
258098511653;258098520474;8821;2,9;2;1;1
258098520474;258098531457;10983;2,9;2;1;1
258098531457;258098576261;44804;2,9;2;1;1
258098576261;258098587634;11373;2,9;2;1;1
258098587634;258098608024;20390;2,9;2;1;1
258098608024;258098611427;3403;2,9;2;1;1
258098611427;258098611748;321;2,9;2;1;1
258098611748;258098614993;3245;2,9;2;1;1
258098614993;258098615067;74;2,9;2;1;1
258098615067;258098616334;1267;2,9;2;1;1
258098616334;258098616580;246;2,9;2;1;1
258098616580;258098616777;197;2,9;2;1;1
258098616777;258098616920;143;2,9;2;1;1
258098616920;258098617066;146;2,9;2;1;1
258098617066;258098617330;264;2,9;2;1;1
258098617330;258098617378;48;2,9;2;1;1
258098617378;258098617526;148;2,9;2;1;1
258098617526;258098617748;222;2,9;2;1;1
258098617748;258098617774;26;2,9;2;1;1
258098617774;258098617933;159;2,9;2;1;1
258098617933;258098618394;461;2,9;2;1;1
258098618394;258098620351;1957;2,9;2;1;1
258098620351;258098620454;103;2,9;2;1;1
258098620454;258098620477;23;2,9;2;1;1
258098620477;258098620589;112;2,9;2;1;1
258098620589;258098620666;77;2,9;2;1;1
258098620666;258098620797;131;2,9;2;1;1
258098620797;258098620850;53;2,9;2;1;1
258098620850;258098620900;50;2,9;2;1;1
258098620900;258098620962;62;2,9;2;1;1
258098620962;258098621051;89;2,9;2;1;1
258098621051;258098627518;6467;2,9;2;1;1
258098627518;258098628863;1345;2,9;2;1;1
258098628863;258098632363;3500;2,9;2;1;1
258098632363;258098636304;3941;2,9;2;1;1
258098636304;258098636673;369;2,9;2;1;1
258098636673;258098670579;33906;2,9;2;1;1
258098670579;258098672236;1657;2,9;2;1;1
258098672236;258098672499;263;2,9;2;1;1
258098672499;258098672855;356;2,9;2;1;1
258098672855;258098672975;120;2,9;2;1;1
258098672975;258098673022;47;2,9;2;1;1
258098673022;258098673056;34;2,9;2;1;1
258098673056;258098673097;41;2,9;2;1;1
258098673097;258098673147;50;2,9;2;1;1
258098673147;258098673175;28;2,9;2;1;1
258098673175;258098673323;148;2,9;2;1;1
258098673323;258098679958;6635;2,9;2;1;1
258098679958;258098680103;145;2,9;2;1;1
258098680103;258098694267;14164;2,9;2;1;1
258098694267;258098711508;17241;2,9;2;1;1
258098711508;258098720109;8601;2,9;2;1;1
258098720109;258098720739;630;2,9;2;1;1
258098720739;258098741018;20279;2,9;2;1;1
258098741018;258098741153;135;2,9;2;1;1
258098741153;258098741195;42;2,9;2;1;1
258098741195;258098741302;107;2,9;2;1;1
258098741302;258098742004;702;2,9;2;1;1
258098742004;258098742149;145;2,9;2;1;1
258098742149;258098742188;39;2,9;2;1;1
258098742188;258098742280;92;2,9;2;1;1
258098742280;258098742351;71;2,9;2;1;1
258098742351;258098743077;726;2,9;2;1;1
258098743077;258098746167;3090;2,9;2;1;1
258098746167;258098746241;74;2,9;2;1;1
258098746241;258098746370;129;2,9;2;1;1
258098746370;258098746372;2;2,9;2;1;1
258098746372;258098746522;150;2,9;2;1;1
258098746522;258098746556;34;2,9;2;1;1
258098746556;258098746864;308;2,9;2;1;1
258098746864;258098746902;38;2,9;2;1;1
258098746902;258098747073;171;2,9;2;1;1
258098747073;258098747114;41;2,9;2;1;1
258098747114;258098761426;14312;2,9;2;1;1
258098761426;258098761461;35;2,9;2;1;1
258098761461;258098761484;23;2,9;2;1;1
258098761484;258098761541;57;2,9;2;1;1
258098761541;258098761971;430;2,9;2;1;1
258098761971;258098763772;1801;2,9;2;1;1
258098763772;258098764678;906;2,9;2;1;1
258098764678;258098764776;98;2,9;2;1;1
258098764776;258098765076;300;2,9;2;1;1
258098765076;258098765226;150;2,9;2;1;1
258098765226;258098767162;1936;2,9;2;1;1
258098767162;258098774601;7439;2,9;2;1;1
258098774601;258098774634;33;2,9;2;1;1
258098774634;258098774668;34;2,9;2;1;1
258098774668;258098775054;386;2,9;2;1;1
258098775054;258098775155;101;2,9;2;1;1
258098775155;258098775269;114;2,9;2;1;1
258098775269;258098775657;388;2,9;2;1;1
258098775657;258098775696;39;2,9;2;1;1
258098775696;258098775798;102;2,9;2;1;1
258098775798;258098776473;675;2,9;2;1;1
258098776473;258098776511;38;2,9;2;1;1
258098776511;258098776566;55;2,9;2;1;1
258098776566;258098776615;49;2,9;2;1;1
258098776615;258098777057;442;2,9;2;1;1
258098777057;258098780675;3618;2,9;2;1;1
258098780675;258098780760;85;2,9;2;1;1
258098780760;258098780939;179;2,9;2;1;1
258098780939;258098781154;215;2,9;2;1;1
258098781154;258098781227;73;2,9;2;1;1
258098781227;258098781387;160;2,9;2;1;1
258098781387;258098781402;15;2,9;2;1;1
258098781402;258098781560;158;2,9;2;1;1
258098781560;258098781607;47;2,9;2;1;1
258098781607;258098781615;8;2,9;2;1;1
258098781615;258098781681;66;2,9;2;1;1
258098781681;258098781731;50;2,9;2;1;1
258098781731;258098781764;33;2,9;2;1;1
258098781764;258098781774;10;2,9;2;1;1
258098781774;258098781817;43;2,9;2;1;1
258098781817;258098781885;68;2,9;2;1;1
258098781885;258098781942;57;2,9;2;1;1
258098781942;258098782078;136;2,9;2;1;1
258098782078;258098782215;137;2,9;2;1;1
258098782215;258098786078;3863;2,9;2;1;1
258098786078;258098787673;1595;2,9;2;1;1
258098787673;258098792647;4974;2,9;2;1;1
258098792647;258098794567;1920;2,9;2;1;1
258098794567;258098794774;207;2,9;2;1;1
258098794774;258098795078;304;2,9;2;1;1
258098795078;258098796784;1706;2,9;2;1;1
258098796784;258098796792;8;2,9;2;1;1
258098796792;258098796843;51;2,9;2;1;1
258098796843;258098796851;8;2,9;2;1;1
258098796851;258098796902;51;2,9;2;1;1
258098796902;258098796952;50;2,9;2;1;1
258098796952;258098797720;768;2,9;2;1;1
258098797720;258098809405;11685;2,9;2;1;1
258098809405;258098817150;7745;2,9;2;1;1
258098817150;258098820894;3744;2,9;2;1;1
258098820894;258098827161;6267;2,9;2;1;1
258098827161;258098829170;2009;2,9;2;1;1
258098829170;258098829196;26;2,9;2;1;1
258098829196;258098830523;1327;2,9;2;1;1
258098830523;258098830677;154;2,9;2;1;1
258098830677;258098832457;1780;2,9;2;1;1
258098832457;258098832572;115;2,9;2;1;1
258098832572;258098832621;49;2,9;2;1;1
258098832621;258098832874;253;2,9;2;1;1
258098832874;258098832898;24;2,9;2;1;1
258098832898;258098833090;192;2,9;2;1;1
258098833090;258098833116;26;2,9;2;1;1
258098833116;258098833175;59;2,9;2;1;1
258098833175;258098833185;10;2,9;2;1;1
258098833185;258098833242;57;2,9;2;1;1
258098833242;258098833253;11;2,9;2;1;1
258098833253;258098833451;198;2,9;2;1;1
258098833451;258098833507;56;2,9;2;1;1
258098833507;258098833788;281;2,9;2;1;1
258098833788;258098833981;193;2,9;2;1;1
258098833981;258098834604;623;2,9;2;1;1
258098834604;258098834643;39;2,9;2;1;1
258098834643;258098834826;183;2,9;2;1;1
258098834826;258098834865;39;2,9;2;1;1
258098834865;258098834989;124;2,9;2;1;1
258098834989;258098835045;56;2,9;2;1;1
258098835045;258098835260;215;2,9;2;1;1
258098835260;258098835518;258;2,9;2;1;1
258098835518;258098838359;2841;2,9;2;1;1
258098838359;258098838544;185;2,9;2;1;1
258098838544;258098838561;17;2,9;2;1;1
258098838561;258098838647;86;2,9;2;1;1
258098838647;258098838695;48;2,9;2;1;1
258098838695;258098838751;56;2,9;2;1;1
258098838751;258098838811;60;2,9;2;1;1
258098838811;258098838843;32;2,9;2;1;1
258098838843;258098839009;166;2,9;2;1;1
258098839009;258098849505;10496;2,9;2;1;1
258098849505;258098850722;1217;2,9;2;1;1
258098850722;258098851873;1151;2,9;2;1;1
258098851873;258098856015;4142;2,9;2;1;1
258098856015;258098856144;129;2,9;2;1;1
258098856144;258098856168;24;2,9;2;1;1
258098856168;258098856331;163;2,9;2;1;1
258098856331;258098856348;17;2,9;2;1;1
258098856348;258098856494;146;2,9;2;1;1
258098856494;258098856522;28;2,9;2;1;1
258098856522;258098856622;100;2,9;2;1;1
258098856622;258098856649;27;2,9;2;1;1
258098856649;258098856734;85;2,9;2;1;1
258098856734;258098857141;407;2,9;2;1;1
258098857141;258098857169;28;2,9;2;1;1
258098857169;258098857306;137;2,9;2;1;1
258098857306;258098857645;339;2,9;2;1;1
258098857645;258098857704;59;2,9;2;1;1
258098857704;258098857759;55;2,9;2;1;1
258098857759;258098857792;33;2,9;2;1;1
258098857792;258098857814;22;2,9;2;1;1
258098857814;258098857864;50;2,9;2;1;1
258098857864;258098858245;381;2,9;2;1;1
258098858245;258098859104;859;2,9;2;1;1
258098859104;258098859281;177;2,9;2;1;1
258098859281;258098859918;637;2,9;2;1;1
258098859918;258098863320;3402;2,9;2;1;1
258098863320;258098863612;292;2,9;2;1;1
258098863612;258098863638;26;2,9;2;1;1
258098863638;258098863723;85;2,9;2;1;1
258098863723;258098863944;221;2,9;2;1;1
258098863944;258098863967;23;2,9;2;1;1
258098863967;258098864017;50;2,9;2;1;1
258098864017;258098864061;44;2,9;2;1;1
258098864061;258098864170;109;2,9;2;1;1
258098864170;258098864244;74;2,9;2;1;1
258098864244;258098864281;37;2,9;2;1;1
258098864281;258098864462;181;2,9;2;1;1
258098864462;258098864507;45;2,9;2;1;1
258098864507;258098864615;108;2,9;2;1;1
258098864615;258098864627;12;2,9;2;1;1
258098864627;258098864717;90;2,9;2;1;1
258098864717;258098864719;2;2,9;2;1;1
258098864719;258098864888;169;2,9;2;1;1
258098864888;258098865074;186;2,9;2;1;1
258098865074;258098865119;45;2,9;2;1;1
258098865119;258098865228;109;2,9;2;1;1
258098865228;258098871480;6252;2,9;2;1;1
258098871480;258098873028;1548;2,9;2;1;1
258098873028;258098873036;8;2,9;2;1;1
258098873036;258098873126;90;2,9;2;1;1
258098873126;258098873369;243;2,9;2;1;1
258098873369;258098873412;43;2,9;2;1;1
258098873412;258098873896;484;2,9;2;1;1
258098873896;258098874274;378;2,9;2;1;1
258098874274;258098878233;3959;2,9;2;1;1
258098878233;258098879324;1091;2,9;2;1;1
258098879324;258098886791;7467;2,9;2;1;1
258098886791;258098886811;20;2,9;2;1;1
258098886811;258098887175;364;2,9;2;1;1
258098887175;258098888765;1590;2,9;2;1;1
258098888765;258098888889;124;2,9;2;1;1
258098888889;258098889151;262;2,9;2;1;1
258098889151;258098889714;563;2,9;2;1;1
258098889714;258098889951;237;2,9;2;1;1
258098889951;258098889989;38;2,9;2;1;1
258098889989;258098893097;3108;2,9;2;1;1
258098893097;258098893110;13;2,9;2;1;1
258098893110;258098893235;125;2,9;2;1;1
258098893235;258098893307;72;2,9;2;1;1
258098893307;258098893614;307;2,9;2;1;1
258098893614;258098893659;45;2,9;2;1;1
258098893659;258098893809;150;2,9;2;1;1
258098893809;258098893861;52;2,9;2;1;1
258098893861;258098894094;233;2,9;2;1;1
258098894094;258098897923;3829;2,9;2;1;1
258098897923;258098903266;5343;2,9;2;1;1
258098903266;258098903382;116;2,9;2;1;1
258098903382;258098903425;43;2,9;2;1;1
258098903425;258098903659;234;2,9;2;1;1
258098903659;258098903877;218;2,9;2;1;1
258098903877;258098903923;46;2,9;2;1;1
258098903923;258098904467;544;2,9;2;1;1
258098904467;258098904533;66;2,9;2;1;1
258098904533;258098915232;10699;2,9;2;1;1
258098915232;258098919120;3888;2,9;2;1;1
258098919120;258098919171;51;2,9;2;1;1
258098919171;258098919240;69;2,9;2;1;1
258098919240;258098919447;207;2,9;2;1;1
258098919447;258098919483;36;2,9;2;1;1
258098919483;258098919572;89;2,9;2;1;1
258098919572;258098919691;119;2,9;2;1;1
258098919691;258098919888;197;2,9;2;1;1
258098919888;258098919904;16;2,9;2;1;1
258098919904;258098919927;23;2,9;2;1;1
258098919927;258098920045;118;2,9;2;1;1
258098920045;258098920116;71;2,9;2;1;1
258098920116;258098920163;47;2,9;2;1;1
258098920163;258098920228;65;2,9;2;1;1
258098920228;258098920252;24;2,9;2;1;1
258098920252;258098920333;81;2,9;2;1;1
258098920333;258098929058;8725;2,9;2;1;1
258098929058;258098944862;15804;2,9;2;1;1
258098944862;258098945258;396;2,9;2;1;1
258098945258;258098945293;35;2,9;2;1;1
258098945293;258098945310;17;2,9;2;1;1
258098945310;258098945389;79;2,9;2;1;1
258098945389;258098945427;38;2,9;2;1;1
258098945427;258098945787;360;2,9;2;1;1
258098945787;258098945795;8;2,9;2;1;1
258098945795;258098945854;59;2,9;2;1;1
258098945854;258098945869;15;2,9;2;1;1
258098945869;258098945939;70;2,9;2;1;1
258098945939;258098951018;5079;2,9;2;1;1
258098951018;258098951103;85;2,9;2;1;1
258098951103;258098951112;9;2,9;2;1;1
258098951112;258098951412;300;2,9;2;1;1
258098951412;258098951432;20;2,9;2;1;1
258098951432;258098951492;60;2,9;2;1;1
258098951492;258098951542;50;2,9;2;1;1
258098951542;258098951589;47;2,9;2;1;1
258098951589;258098951624;35;2,9;2;1;1
258098951624;258098951636;12;2,9;2;1;1
258098951636;258098951755;119;2,9;2;1;1
258098951755;258098951770;15;2,9;2;1;1
258098951770;258098951783;13;2,9;2;1;1
258098951783;258098951903;120;2,9;2;1;1
258098951903;258098951918;15;2,9;2;1;1
258098951918;258098952065;147;2,9;2;1;1
258098952065;258098952088;23;2,9;2;1;1
258098952088;258098952190;102;2,9;2;1;1
258098952190;258098952233;43;2,9;2;1;1
258098952233;258098952378;145;2,9;2;1;1
258098952378;258098957636;5258;2,9;2;1;1
258098957636;258098957827;191;2,9;2;1;1
258098957827;258098957833;6;2,9;2;1;1
258098957833;258098958112;279;2,9;2;1;1
258098958112;258098958943;831;2,9;2;1;1
258098958943;258098959089;146;2,9;2;1;1
258098959089;258098959368;279;2,9;2;1;1
258098959368;258098959557;189;2,9;2;1;1
258098959557;258098959798;241;2,9;2;1;1
258098959798;258098959820;22;2,9;2;1;1
258098959820;258098959965;145;2,9;2;1;1
258098959965;258098961993;2028;2,9;2;1;1
258098961993;258098962343;350;2,9;2;1;1
258098962343;258098962847;504;2,9;2;1;1
258098962847;258098970033;7186;2,9;2;1;1
258098970033;258098970477;444;2,9;2;1;1
258098970477;258099006904;36427;2,9;2;1;1
258099006904;258099007099;195;2,9;2;1;1
258099007099;258099007386;287;2,9;2;1;1
258099007386;258099007481;95;2,9;2;1;1
258099007481;258099007668;187;2,9;2;1;1
258099007668;258099007863;195;2,9;2;1;1
258099007863;258099007907;44;2,9;2;1;1
258099007907;258099008107;200;2,9;2;1;1
258099008107;258099008253;146;2,9;2;1;1
258099008253;258099008398;145;2,9;2;1;1
258099008398;258099010021;1623;2,9;2;1;1
258099010021;258099013207;3186;2,9;2;1;1
258099013207;258099017072;3865;2,9;2;1;1
258099017072;258099017221;149;2,9;2;1;1
258099017221;258099017301;80;2,9;2;1;1
258099017301;258099017338;37;2,9;2;1;1
258099017338;258099017500;162;2,9;2;1;1
258099017500;258099017525;25;2,9;2;1;1
258099017525;258099017652;127;2,9;2;1;1
258099017652;258099017798;146;2,9;2;1;1
258099017798;258099017884;86;2,9;2;1;1
258099017884;258099017914;30;2,9;2;1;1
258099017914;258099017941;27;2,9;2;1;1
258099017941;258099019203;1262;2,9;2;1;1
258099019203;258099022525;3322;2,9;2;1;1
258099022525;258099022605;80;2,9;2;1;1
258099022605;258099024134;1529;2,9;2;1;1
258099024134;258099024167;33;2,9;2;1;1
258099024167;258099024217;50;2,9;2;1;1
258099024217;258099024278;61;2,9;2;1;1
258099024278;258099024300;22;2,9;2;1;1
258099024300;258099024420;120;2,9;2;1;1
258099024420;258099024448;28;2,9;2;1;1
258099024448;258099024482;34;2,9;2;1;1
258099024482;258099024613;131;2,9;2;1;1
258099024613;258099024775;162;2,9;2;1;1
258099024775;258099027482;2707;2,9;2;1;1
258099027482;258099029950;2468;2,9;2;1;1
258099029950;258099030135;185;2,9;2;1;1
258099030135;258099030172;37;2,9;2;1;1
258099030172;258099030303;131;2,9;2;1;1
258099030303;258099030458;155;2,9;2;1;1
258099030458;258099030860;402;2,9;2;1;1
258099030860;258099030999;139;2,9;2;1;1
258099030999;258099031092;93;2,9;2;1;1
258099031092;258099031159;67;2,9;2;1;1
258099031159;258099031194;35;2,9;2;1;1
258099031194;258099031793;599;2,9;2;1;1
258099031793;258099031988;195;2,9;2;1;1
258099031988;258099032322;334;2,9;2;1;1
258099032322;258099032418;96;2,9;2;1;1
258099032418;258099032623;205;2,9;2;1;1
258099032623;258099032665;42;2,9;2;1;1
258099032665;258099032780;115;2,9;2;1;1
258099032780;258099032821;41;2,9;2;1;1
258099032821;258099032915;94;2,9;2;1;1
258099032915;258099033061;146;2,9;2;1;1
258099033061;258099037797;4736;2,9;2;1;1
258099037797;258099041132;3335;2,9;2;1;1
258099041132;258099043055;1923;2,9;2;1;1
258099043055;258099046358;3303;2,9;2;1;1
258099046358;258099055978;9620;2,9;2;1;1
258099055978;258099056022;44;2,9;2;1;1
258099056022;258099068186;12164;2,9;2;1;1
258099068186;258099068373;187;2,9;2;1;1
258099068373;258099068405;32;2,9;2;1;1
258099068405;258099068455;50;2,9;2;1;1
258099068455;258099068515;60;2,9;2;1;1
258099068515;258099068884;369;2,9;2;1;1
258099068884;258099083030;14146;2,9;2;1;1
258099083030;258099083039;9;2,9;2;1;1
258099083039;258099083055;16;2,9;2;1;1
258099083055;258099083070;15;2,9;2;1;1
258099083070;258099083164;94;2,9;2;1;1
258099083164;258099083340;176;2,9;2;1;1
258099083340;258099085231;1891;2,9;2;1;1
258099085231;258099098118;12887;2,9;2;1;1
258099098118;258099098288;170;2,9;2;1;1
258099098288;258099146983;48695;2,9;2;1;1
258099146983;258099147080;97;2,9;2;1;1
258099147080;258099147215;135;2,9;2;1;1
258099147215;258099147261;46;2,9;2;1;1
258099147261;258099147282;21;2,9;2;1;1
258099147282;258099147393;111;2,9;2;1;1
258099147393;258099147420;27;2,9;2;1;1
258099147420;258099147428;8;2,9;2;1;1
258099147428;258099147492;64;2,9;2;1;1
258099147492;258099147642;150;2,9;2;1;1
258099147642;258099147759;117;2,9;2;1;1
258099147759;258099151040;3281;2,9;2;1;1
258099151040;258099151048;8;2,9;2;1;1
258099151048;258099151099;51;2,9;2;1;1
258099151099;258099151116;17;2,9;2;1;1
258099151116;258099151134;18;2,9;2;1;1
258099151134;258099151169;35;2,9;2;1;1
258099151169;258099151193;24;2,9;2;1;1
258099151193;258099157909;6716;2,9;2;1;1
258099157909;258099170727;12818;2,9;2;1;1
258099170727;258099170881;154;2,9;2;1;1
258099170881;258099171037;156;2,9;2;1;1
258099171037;258099171132;95;2,9;2;1;1
258099171132;258099171159;27;2,9;2;1;1
258099171159;258099171168;9;2,9;2;1;1
258099171168;258099171336;168;2,9;2;1;1
258099171336;258099171378;42;2,9;2;1;1
258099171378;258099171407;29;2,9;2;1;1
258099171407;258099171437;30;2,9;2;1;1
258099171437;258099179856;8419;2,9;2;1;1
258099179856;258099186890;7034;2,9;2;1;1
258099186890;258099196703;9813;2,9;2;1;1
258099196703;258099196901;198;2,9;2;1;1
258099196901;258099197160;259;2,9;2;1;1
258099197160;258099197234;74;2,9;2;1;1
258099197234;258099197603;369;2,9;2;1;1
258099197603;258099226090;28487;2,9;2;1;1
258099226090;258099233362;7272;2,9;2;1;1
258099233362;258099237947;4585;2,9;2;1;1
258099237947;258099237998;51;2,9;2;1;1
258099237998;258099238049;51;2,9;2;1;1
258099238049;258099238100;51;2,9;2;1;1
258099238100;258099238150;50;2,9;2;1;1
258099238150;258099238200;50;2,9;2;1;1
258099238200;258099239169;969;2,9;2;1;1
258099239169;258099258597;19428;2,9;2;1;1
258099258597;258099258970;373;2,9;2;1;1
258099258970;258099259288;318;2,9;2;1;1
258099259288;258099261867;2579;2,9;2;1;1
258099261867;258099261916;49;2,9;2;1;1
258099261916;258099261968;52;2,9;2;1;1
258099261968;258099262038;70;2,9;2;1;1
258099262038;258099262820;782;2,9;2;1;1
258099262820;258099262856;36;2,9;2;1;1
258099262856;258099266113;3257;2,9;2;1;1
258099266113;258099266275;162;2,9;2;1;1
258099266275;258099266330;55;2,9;2;1;1
258099266330;258099266451;121;2,9;2;1;1
258099266451;258099266789;338;2,9;2;1;1
258099266789;258099266957;168;2,9;2;1;1
258099266957;258099267121;164;2,9;2;1;1
258099267121;258099267412;291;2,9;2;1;1
258099267412;258099267434;22;2,9;2;1;1
258099267434;258099267532;98;2,9;2;1;1
258099267532;258099276225;8693;2,9;2;1;1
258099276225;258099278773;2548;2,9;2;1;1
258099278773;258099278795;22;2,9;2;1;1
258099278795;258099278933;138;2,9;2;1;1
258099278933;258099278984;51;2,9;2;1;1
258099278984;258099279298;314;2,9;2;1;1
258099279298;258099280157;859;2,9;2;1;1
258099280157;258099281164;1007;2,9;2;1;1
258099281164;258099281621;457;2,9;2;1;1
258099281621;258099286308;4687;2,9;2;1;1
258099286308;258099286357;49;2,9;2;1;1
258099286357;258099286398;41;2,9;2;1;1
258099286398;258099286513;115;2,9;2;1;1
258099286513;258099286580;67;2,9;2;1;1
258099286580;258099286748;168;2,9;2;1;1
258099286748;258099286877;129;2,9;2;1;1
258099286877;258099286893;16;2,9;2;1;1
258099286893;258099287059;166;2,9;2;1;1
258099287059;258099287368;309;2,9;2;1;1
258099287368;258099290510;3142;2,9;2;1;1
258099290510;258099290511;1;2,9;2;1;1
258099290511;258099290548;37;2,9;2;1;1
258099290548;258099290570;22;2,9;2;1;1
258099290570;258099290759;189;2,9;2;1;1
258099290759;258099296908;6149;2,9;2;1;1
258099296908;258099296941;33;2,9;2;1;1
258099296941;258099297039;98;2,9;2;1;1
258099297039;258099297075;36;2,9;2;1;1
258099297075;258099297114;39;2,9;2;1;1
258099297114;258099297146;32;2,9;2;1;1
258099297146;258099307183;10037;2,9;2;1;1
258099307183;258099310246;3063;2,9;2;1;1
258099310246;258099311110;864;2,9;2;1;1
258099311110;258099311647;537;2,9;2;1;1
258099311647;258099311691;44;2,9;2;1;1
258099311691;258099312034;343;2,9;2;1;1
258099312034;258099312086;52;2,9;2;1;1
258099312086;258099312646;560;2,9;2;1;1
258099312646;258099349298;36652;2,9;2;1;1
258099349298;258099349391;93;2,9;2;1;1
258099349391;258099349399;8;2,9;2;1;1
258099349399;258099349444;45;2,9;2;1;1
258099349444;258099349591;147;2,9;2;1;1
258099349591;258099349600;9;2,9;2;1;1
258099349600;258099349640;40;2,9;2;1;1
258099349640;258099349779;139;2,9;2;1;1
258099349779;258099349962;183;2,9;2;1;1
258099349962;258099349996;34;2,9;2;1;1
258099349996;258099362048;12052;2,9;2;1;1
258099362048;258099371350;9302;2,9;2;1;1
258099371350;258099371389;39;2,9;2;1;1
258099371389;258099371437;48;2,9;2;1;1
258099371437;258099371447;10;2,9;2;1;1
258099371447;258099371674;227;2,9;2;1;1
258099371674;258099371755;81;2,9;2;1;1
258099371755;258099371758;3;2,9;2;1;1
258099371758;258099371784;26;2,9;2;1;1
258099371784;258099371976;192;2,9;2;1;1
258099371976;258099372237;261;2,9;2;1;1
258099372237;258099372504;267;2,9;2;1;1
258099372504;258099381623;9119;2,9;2;1;1
258099381623;258099381894;271;2,9;2;1;1
258099381894;258099384130;2236;2,9;2;1;1
258099384130;258099392846;8716;2,9;2;1;1
258099392846;258099392972;126;2,9;2;1;1
258099392972;258099403409;10437;2,9;2;1;1
258099403409;258099404622;1213;2,9;2;1;1
258099404622;258099406936;2314;2,9;2;1;1
258099406936;258099406967;31;2,9;2;1;1
258099406967;258099407013;46;2,9;2;1;1
258099407013;258099407074;61;2,9;2;1;1
258099407074;258099407220;146;2,9;2;1;1
258099407220;258099407253;33;2,9;2;1;1
258099407253;258099407411;158;2,9;2;1;1
258099407411;258099407452;41;2,9;2;1;1
258099407452;258099407556;104;2,9;2;1;1
258099407556;258099407805;249;2,9;2;1;1
258099407805;258099418408;10603;2,9;2;1;1
258099418408;258099418687;279;2,9;2;1;1
258099418687;258099429705;11018;2,9;2;1;1
258099429705;258099429732;27;2,9;2;1;1
258099429732;258099429810;78;2,9;2;1;1
258099429810;258099430754;944;2,9;2;1;1
258099430754;258099430794;40;2,9;2;1;1
258099430794;258099451201;20407;2,9;2;1;1
258099451201;258099460763;9562;2,9;2;1;1
258099460763;258099461006;243;2,9;2;1;1
258099461006;258099461027;21;2,9;2;1;1
258099461027;258099461098;71;2,9;2;1;1
258099461098;258099461124;26;2,9;2;1;1
258099461124;258099461144;20;2,9;2;1;1
258099461144;258099461788;644;2,9;2;1;1
258099461788;258099482500;20712;2,9;2;1;1
258099482500;258099510159;27659;2,9;2;1;1
258099510159;258099513394;3235;2,9;2;1;1
258099513394;258099513410;16;2,9;2;1;1
258099513410;258099548402;34992;2,9;2;1;1
258099548402;258099558364;9962;2,9;2;1;1
258099558364;258099559071;707;2,9;2;1;1
258099559071;258099559126;55;2,9;2;1;1
258099559126;258099559174;48;2,9;2;1;1
258099559174;258099559256;82;2,9;2;1;1
258099559256;258099562721;3465;2,9;2;1;1
258099562721;258099562949;228;2,9;2;1;1
258099562949;258099563095;146;2,9;2;1;1
258099563095;258099563352;257;2,9;2;1;1
258099563352;258099563384;32;2,9;2;1;1
258099563384;258099563838;454;2,9;2;1;1
258099563838;258099587446;23608;2,9;2;1;1
258099587446;258099587743;297;2,9;2;1;1
258099587743;258099588002;259;2,9;2;1;1
258099588002;258099588116;114;2,9;2;1;1
258099588116;258099588182;66;2,9;2;1;1
258099588182;258099588229;47;2,9;2;1;1
258099588229;258099588292;63;2,9;2;1;1
258099588292;258099588471;179;2,9;2;1;1
258099588471;258099588509;38;2,9;2;1;1
258099588509;258099608046;19537;2,9;2;1;1
258099608046;258099608393;347;2,9;2;1;1
258099608393;258099608614;221;2,9;2;1;1
258099608614;258099611884;3270;2,9;2;1;1
258099611884;258099612297;413;2,9;2;1;1
258099612297;258099612564;267;2,9;2;1;1
258099612564;258099612816;252;2,9;2;1;1
258099612816;258099612946;130;2,9;2;1;1
258099612946;258099612988;42;2,9;2;1;1
258099612988;258099613020;32;2,9;2;1;1
258099613020;258099613199;179;2,9;2;1;1
258099613199;258099613296;97;2,9;2;1;1
258099613296;258099613354;58;2,9;2;1;1
258099613354;258099631466;18112;2,9;2;1;1
258099631466;258099631590;124;2,9;2;1;1
258099631590;258099631715;125;2,9;2;1;1
258099631715;258099633638;1923;2,9;2;1;1
258099633638;258099634117;479;2,9;2;1;1
258099634117;258099635008;891;2,9;2;1;1
258099635008;258099635179;171;2,9;2;1;1
258099635179;258099635282;103;2,9;2;1;1
258099635282;258099635298;16;2,9;2;1;1
258099635298;258099635367;69;2,9;2;1;1
258099635367;258099635402;35;2,9;2;1;1
258099635402;258099635419;17;2,9;2;1;1
258099635419;258099635501;82;2,9;2;1;1
258099635501;258099635530;29;2,9;2;1;1
258099635530;258099635705;175;2,9;2;1;1
258099635705;258099645678;9973;2,9;2;1;1
258099645678;258099645752;74;2,9;2;1;1
258099645752;258099645807;55;2,9;2;1;1
258099645807;258099645888;81;2,9;2;1;1
258099645888;258099645903;15;2,9;2;1;1
258099645903;258099646197;294;2,9;2;1;1
258099646197;258099647388;1191;2,9;2;1;1
258099647388;258099648177;789;2,9;2;1;1
258099648177;258099648483;306;2,9;2;1;1
258099648483;258099649197;714;2,9;2;1;1
258099649197;258099649267;70;2,9;2;1;1
258099649267;258099649304;37;2,9;2;1;1
258099649304;258099649367;63;2,9;2;1;1
258099649367;258099649485;118;2,9;2;1;1
258099649485;258099670019;20534;2,9;2;1;1
258099670019;258099680322;10303;2,9;2;1;1
258099680322;258099680487;165;2,9;2;1;1
258099680487;258099680750;263;2,9;2;1;1
258099680750;258099681000;250;2,9;2;1;1
258099681000;258099681192;192;2,9;2;1;1
258099681192;258099681336;144;2,9;2;1;1
258099681336;258099681481;145;2,9;2;1;1
258099681481;258099681625;144;2,9;2;1;1
258099681625;258099681771;146;2,9;2;1;1
258099681771;258099681913;142;2,9;2;1;1
258099681913;258099690399;8486;2,9;2;1;1
258099690399;258099691147;748;2,9;2;1;1
258099691147;258099694714;3567;2,9;2;1;1
258099694714;258099694973;259;2,9;2;1;1
258099694973;258099736037;41064;2,9;2;1;1
258099736037;258099744369;8332;2,9;2;1;1
258099744369;258099744501;132;2,9;2;1;1
258099744501;258099744619;118;2,9;2;1;1
258099744619;258099744739;120;2,9;2;1;1
258099744739;258099744857;118;2,9;2;1;1
258099744857;258099744986;129;2,9;2;1;1
258099744986;258099745259;273;2,9;2;1;1
258099745259;258099745402;143;2,9;2;1;1
258099745402;258099745549;147;2,9;2;1;1
258099745549;258099745781;232;2,9;2;1;1
258099745781;258099745808;27;2,9;2;1;1
258099745808;258099746202;394;2,9;2;1;1
258099746202;258099746337;135;2,9;2;1;1
258099746337;258099746379;42;2,9;2;1;1
258099746379;258099746744;365;2,9;2;1;1
258099746744;258099755057;8313;2,9;2;1;1
258099755057;258099781692;26635;2,9;2;1;1
258099781692;258099781759;67;2,9;2;1;1
258099781759;258099781760;1;2,9;2;1;1
258099781760;258099781768;8;2,9;2;1;1
258099781768;258099781786;18;2,9;2;1;1
258099781786;258099781818;32;2,9;2;1;1
258099781818;258099781868;50;2,9;2;1;1
258099781868;258099781879;11;2,9;2;1;1
258099781879;258099781894;15;2,9;2;1;1
258099781894;258099781979;85;2,9;2;1;1
258099781979;258099795124;13145;2,9;2;1;1
258099795124;258099801334;6210;2,9;2;1;1
258099801334;258099801380;46;2,9;2;1;1
258099801380;258099801620;240;2,9;2;1;1
258099801620;258099801659;39;2,9;2;1;1
258099801659;258099801727;68;2,9;2;1;1
258099801727;258099802561;834;2,9;2;1;1
258099802561;258099802605;44;2,9;2;1;1
258099802605;258099802936;331;2,9;2;1;1
258099802936;258099814752;11816;2,9;2;1;1
258099814752;258099819584;4832;2,9;2;1;1
258099819584;258099819744;160;2,9;2;1;1
258099819744;258099820086;342;2,9;2;1;1
258099820086;258099820552;466;2,9;2;1;1
258099820552;258099820665;113;2,9;2;1;1
258099820665;258099820804;139;2,9;2;1;1
258099820804;258099820943;139;2,9;2;1;1
258099820943;258099821090;147;2,9;2;1;1
258099821090;258099821123;33;2,9;2;1;1
258099821123;258099821150;27;2,9;2;1;1
258099821150;258099822987;1837;2,9;2;1;1
258099822987;258099823942;955;2,9;2;1;1
258099823942;258099829642;5700;2,9;2;1;1
258099829642;258099835498;5856;2,9;2;1;1
258099835498;258099881797;46299;2,9;2;1;1
258099881797;258099882240;443;2,9;2;1;1
258099882240;258099882694;454;2,9;2;1;1
258099882694;258099882762;68;2,9;2;1;1
258099882762;258099882856;94;2,9;2;1;1
258099882856;258099882982;126;2,9;2;1;1
258099882982;258099883024;42;2,9;2;1;1
258099883024;258099883053;29;2,9;2;1;1
258099883053;258099883089;36;2,9;2;1;1
258099883089;258099883162;73;2,9;2;1;1
258099883162;258099883219;57;2,9;2;1;1
258099883219;258099883283;64;2,9;2;1;1
258099883283;258099883588;305;2,9;2;1;1
258099883588;258099883621;33;2,9;2;1;1
258099883621;258099883635;14;2,9;2;1;1
258099883635;258099883728;93;2,9;2;1;1
258099883728;258099883787;59;2,9;2;1;1
258099883787;258099883922;135;2,9;2;1;1
258099883922;258099884067;145;2,9;2;1;1
258099884067;258099884103;36;2,9;2;1;1
258099884103;258099884347;244;2,9;2;1;1
258099884347;258099893603;9256;2,9;2;1;1
258099893603;258099893734;131;2,9;2;1;1
258099893734;258099894282;548;2,9;2;1;1
258099894282;258099894321;39;2,9;2;1;1
258099894321;258099894535;214;2,9;2;1;1
258099894535;258099895884;1349;2,9;2;1;1
258099895884;258099895920;36;2,9;2;1;1
258099895920;258099899299;3379;2,9;2;1;1
258099899299;258099899463;164;2,9;2;1;1
258099899463;258099899603;140;2,9;2;1;1
258099899603;258099899723;120;2,9;2;1;1
258099899723;258099899749;26;2,9;2;1;1
258099899749;258099899896;147;2,9;2;1;1
258099899896;258099899952;56;2,9;2;1;1
258099899952;258099900097;145;2,9;2;1;1
258099900097;258099900242;145;2,9;2;1;1
258099900242;258099900386;144;2,9;2;1;1
258099900386;258099902744;2358;2,9;2;1;1
258099902744;258099907915;5171;2,9;2;1;1
258099907915;258099912559;4644;2,9;2;1;1
258099912559;258099923530;10971;2,9;2;1;1
258099923530;258099926940;3410;2,9;2;1;1
258099926940;258099927001;61;2,9;2;1;1
258099927001;258099927052;51;2,9;2;1;1
258099927052;258099927062;10;2,9;2;1;1
258099927062;258099927652;590;2,9;2;1;1
258099927652;258099952367;24715;2,9;2;1;1
258099952367;258099956279;3912;2,9;2;1;1
258099956279;258099956509;230;2,9;2;1;1
258099956509;258099956737;228;2,9;2;1;1
258099956737;258099957169;432;2,9;2;1;1
258099957169;258099981764;24595;2,9;2;1;1
258099981764;258099984147;2383;2,9;2;1;1
258099984147;258099984235;88;2,9;2;1;1
258099984235;258099984455;220;2,9;2;1;1
258099984455;258099990835;6380;2,9;2;1;1
258099990835;258099991101;266;2,9;2;1;1
258099991101;258099991832;731;2,9;2;1;1
258099991832;258099991975;143;2,9;2;1;1
258099991975;258099992116;141;2,9;2;1;1
258099992116;258099992163;47;2,9;2;1;1
258099992163;258099992257;94;2,9;2;1;1
258099992257;258099992335;78;2,9;2;1;1
258099992335;258099992470;135;2,9;2;1;1
258099992470;258099992500;30;2,9;2;1;1
258099992500;258099992677;177;2,9;2;1;1
258099992677;258099992908;231;2,9;2;1;1
258099992908;258099994155;1247;2,9;2;1;1
258099994155;258099994167;12;2,9;2;1;1
258099994167;258099994190;23;2,9;2;1;1
258099994190;258099994586;396;2,9;2;1;1
258099994586;258100026895;32309;2,9;2;1;1
258100026895;258100026929;34;2,9;2;1;1
258100026929;258100027284;355;2,9;2;1;1
258100027284;258100027341;57;2,9;2;1;1
258100027341;258100027690;349;2,9;2;1;1
258100027690;258100049236;21546;2,9;2;1;1
258100049236;258100053020;3784;2,9;2;1;1
258100053020;258100053128;108;2,9;2;1;1
258100053128;258100053442;314;2,9;2;1;1
258100053442;258100053630;188;2,9;2;1;1
258100053630;258100079746;26116;2,9;2;1;1
258100079746;258100083372;3626;2,9;2;1;1
258100083372;258100085776;2404;2,9;2;1;1
258100085776;258100087241;1465;2,9;2;1;1
258100087241;258100088773;1532;2,9;2;1;1
258100088773;258100089924;1151;2,9;2;1;1
258100089924;258100089984;60;2,9;2;1;1
258100089984;258100090169;185;2,9;2;1;1
258100090169;258100090477;308;2,9;2;1;1
258100090477;258100090946;469;2,9;2;1;1
258100090946;258100099695;8749;2,9;2;1;1
258100099695;258100099744;49;2,9;2;1;1
258100099744;258100099794;50;2,9;2;1;1
258100099794;258100099872;78;2,9;2;1;1
258100099872;258100100287;415;2,9;2;1;1
258100100287;258100100533;246;2,9;2;1;1
258100100533;258100105321;4788;2,9;2;1;1
258100105321;258100105643;322;2,9;2;1;1
258100105643;258100105731;88;2,9;2;1;1
258100105731;258100109900;4169;2,9;2;1;1
258100109900;258100109956;56;2,9;2;1;1
258100109956;258100110175;219;2,9;2;1;1
258100110175;258100113197;3022;2,9;2;1;1
258100113197;258100113460;263;2,9;2;1;1
258100113460;258100113543;83;2,9;2;1;1
258100113543;258100113732;189;2,9;2;1;1
258100113732;258100114778;1046;2,9;2;1;1
258100114778;258100120471;5693;2,9;2;1;1
258100120471;258100120520;49;2,9;2;1;1
258100120520;258100120557;37;2,9;2;1;1
258100120557;258100126445;5888;2,9;2;1;1
258100126445;258100129600;3155;2,9;2;1;1
258100129600;258100129627;27;2,9;2;1;1
258100129627;258100130391;764;2,9;2;1;1
258100130391;258100130483;92;2,9;2;1;1
258100130483;258100135087;4604;2,9;2;1;1
258100135087;258100140685;5598;2,9;2;1;1
258100140685;258100140852;167;2,9;2;1;1
258100140852;258100140905;53;2,9;2;1;1
258100140905;258100159268;18363;2,9;2;1;1
258100159268;258100162788;3520;2,9;2;1;1
258100162788;258100171897;9109;2,9;2;1;1
258100171897;258100171931;34;2,9;2;1;1
258100171931;258100172012;81;2,9;2;1;1
258100172012;258100174206;2194;2,9;2;1;1
258100174206;258100174432;226;2,9;2;1;1
258100174432;258100174545;113;2,9;2;1;1
258100174545;258100174629;84;2,9;2;1;1
258100174629;258100174671;42;2,9;2;1;1
258100174671;258100174786;115;2,9;2;1;1
258100174786;258100174814;28;2,9;2;1;1
258100174814;258100174932;118;2,9;2;1;1
258100174932;258100175152;220;2,9;2;1;1
258100175152;258100175268;116;2,9;2;1;1
258100175268;258100176007;739;2,9;2;1;1
258100176007;258100186483;10476;2,9;2;1;1
258100186483;258100186723;240;2,9;2;1;1
258100186723;258100187990;1267;2,9;2;1;1
258100187990;258100188169;179;2,9;2;1;1
258100188169;258100188264;95;2,9;2;1;1
258100188264;258100188404;140;2,9;2;1;1
258100188404;258100188428;24;2,9;2;1;1
258100188428;258100188822;394;2,9;2;1;1
258100188822;258100189023;201;2,9;2;1;1
258100189023;258100189061;38;2,9;2;1;1
258100189061;258100199192;10131;2,9;2;1;1
258100199192;258100199680;488;2,9;2;1;1
258100199680;258100201792;2112;2,9;2;1;1
258100201792;258100201859;67;2,9;2;1;1
258100201859;258100201942;83;2,9;2;1;1
258100201942;258100201985;43;2,9;2;1;1
258100201985;258100202092;107;2,9;2;1;1
258100202092;258100202132;40;2,9;2;1;1
258100202132;258100202275;143;2,9;2;1;1
258100202275;258100202308;33;2,9;2;1;1
258100202308;258100202327;19;2,9;2;1;1
258100202327;258100202531;204;2,9;2;1;1
258100202531;258100212085;9554;2,9;2;1;1
258100212085;258100212117;32;2,9;2;1;1
258100212117;258100212221;104;2,9;2;1;1
258100212221;258100212250;29;2,9;2;1;1
258100212250;258100212379;129;2,9;2;1;1
258100212379;258100212512;133;2,9;2;1;1
258100212512;258100212692;180;2,9;2;1;1
258100212692;258100212729;37;2,9;2;1;1
258100212729;258100212817;88;2,9;2;1;1
258100212817;258100212824;7;2,9;2;1;1
258100212824;258100218367;5543;2,9;2;1;1
258100218367;258100218434;67;2,9;2;1;1
258100218434;258100218476;42;2,9;2;1;1
258100218476;258100218603;127;2,9;2;1;1
258100218603;258100218659;56;2,9;2;1;1
258100218659;258100218671;12;2,9;2;1;1
258100218671;258100218748;77;2,9;2;1;1
258100218748;258100218823;75;2,9;2;1;1
258100218823;258100218888;65;2,9;2;1;1
258100218888;258100219096;208;2,9;2;1;1
258100219096;258100222778;3682;2,9;2;1;1
258100222778;258100229925;7147;2,9;2;1;1
258100229925;258100238601;8676;2,9;2;1;1
258100238601;258100240748;2147;2,9;2;1;1
258100240748;258100260437;19689;2,9;2;1;1
258100260437;258100260639;202;2,9;2;1;1
258100260639;258100263502;2863;2,9;2;1;1
258100263502;258100263558;56;2,9;2;1;1
258100263558;258100264014;456;2,9;2;1;1
258100264014;258100273942;9928;2,9;2;1;1
258100273942;258100274089;147;2,9;2;1;1
258100274089;258100274209;120;2,9;2;1;1
258100274209;258100274341;132;2,9;2;1;1
258100274341;258100274357;16;2,9;2;1;1
258100274357;258100274533;176;2,9;2;1;1
258100274533;258100274592;59;2,9;2;1;1
258100274592;258100274742;150;2,9;2;1;1
258100274742;258100274914;172;2,9;2;1;1
258100274914;258100275131;217;2,9;2;1;1
258100275131;258100279904;4773;2,9;2;1;1
258100279904;258100280283;379;2,9;2;1;1
258100280283;258100290989;10706;2,9;2;1;1
258100290989;258100293272;2283;2,9;2;1;1
258100293272;258100293306;34;2,9;2;1;1
258100293306;258100293575;269;2,9;2;1;1
258100293575;258100294116;541;2,9;2;1;1
258100294116;258100294370;254;2,9;2;1;1
258100294370;258100294609;239;2,9;2;1;1
258100294609;258100294637;28;2,9;2;1;1
258100294637;258100297869;3232;2,9;2;1;1
258100297869;258100297942;73;2,9;2;1;1
258100297942;258100298015;73;2,9;2;1;1
258100298015;258100298136;121;2,9;2;1;1
258100298136;258100298164;28;2,9;2;1;1
258100298164;258100298205;41;2,9;2;1;1
258100298205;258100298281;76;2,9;2;1;1
258100298281;258100298576;295;2,9;2;1;1
258100298576;258100298903;327;2,9;2;1;1
258100298903;258100299111;208;2,9;2;1;1
258100299111;258100303771;4660;2,9;2;1;1
258100303771;258100303814;43;2,9;2;1;1
258100303814;258100304006;192;2,9;2;1;1
258100304006;258100304105;99;2,9;2;1;1
258100304105;258100304456;351;2,9;2;1;1
258100304456;258100304834;378;2,9;2;1;1
258100304834;258100308346;3512;2,9;2;1;1
258100308346;258100308354;8;2,9;2;1;1
258100308354;258100308407;53;2,9;2;1;1
258100308407;258100308415;8;2,9;2;1;1
258100308415;258100308467;52;2,9;2;1;1
258100308467;258100308520;53;2,9;2;1;1
258100308520;258100308613;93;2,9;2;1;1
258100308613;258100310753;2140;2,9;2;1;1
258100310753;258100319268;8515;2,9;2;1;1
258100319268;258100323517;4249;2,9;2;1;1
258100323517;258100323894;377;2,9;2;1;1
258100323894;258100340794;16900;2,9;2;1;1
258100340794;258100369766;28972;2,9;2;1;1
258100369766;258100369874;108;2,9;2;1;1
258100369874;258100369898;24;2,9;2;1;1
258100369898;258100370041;143;2,9;2;1;1
258100370041;258100370255;214;2,9;2;1;1
258100370255;258100372515;2260;2,9;2;1;1
258100372515;258100372577;62;2,9;2;1;1
258100372577;258100375109;2532;2,9;2;1;1
258100375109;258100375895;786;2,9;2;1;1
258100375895;258100376065;170;2,9;2;1;1
258100376065;258100376507;442;2,9;2;1;1
258100376507;258100376521;14;2,9;2;1;1
258100376521;258100376569;48;2,9;2;1;1
258100376569;258100376706;137;2,9;2;1;1
258100376706;258100376872;166;2,9;2;1;1
258100376872;258100376993;121;2,9;2;1;1
258100376993;258100377023;30;2,9;2;1;1
258100377023;258100377368;345;2,9;2;1;1
258100377368;258100379091;1723;2,9;2;1;1
258100379091;258100379538;447;2,9;2;1;1
258100379538;258100379580;42;2,9;2;1;1
258100379580;258100379955;375;2,9;2;1;1
258100379955;258100380218;263;2,9;2;1;1
258100380218;258100380434;216;2,9;2;1;1
258100380434;258100380462;28;2,9;2;1;1
258100380462;258100387718;7256;2,9;2;1;1
258100387718;258100388217;499;2,9;2;1;1
258100388217;258100388275;58;2,9;2;1;1
258100388275;258100388469;194;2,9;2;1;1
258100388469;258100389151;682;2,9;2;1;1
258100389151;258100393603;4452;2,9;2;1;1
258100393603;258100393624;21;2,9;2;1;1
258100393624;258100393638;14;2,9;2;1;1
258100393638;258100393679;41;2,9;2;1;1
258100393679;258100393731;52;2,9;2;1;1
258100393731;258100393781;50;2,9;2;1;1
258100393781;258100393808;27;2,9;2;1;1
258100393808;258100402240;8432;2,9;2;1;1
258100402240;258100402279;39;2,9;2;1;1
258100402279;258100402337;58;2,9;2;1;1
258100402337;258100402510;173;2,9;2;1;1
258100402510;258100402555;45;2,9;2;1;1
258100402555;258100402637;82;2,9;2;1;1
258100402637;258100402792;155;2,9;2;1;1
258100402792;258100402825;33;2,9;2;1;1
258100402825;258100403013;188;2,9;2;1;1
258100403013;258100403178;165;2,9;2;1;1
258100403178;258100410909;7731;2,9;2;1;1
258100410909;258100411866;957;2,9;2;1;1
258100411866;258100412209;343;2,9;2;1;1
258100412209;258100412582;373;2,9;2;1;1
258100412582;258100412642;60;2,9;2;1;1
258100412642;258100412749;107;2,9;2;1;1
258100412749;258100413289;540;2,9;2;1;1
258100413289;258100413485;196;2,9;2;1;1
258100413485;258100416436;2951;2,9;2;1;1
258100416436;258100417141;705;2,9;2;1;1
258100417141;258100421502;4361;2,9;2;1;1
258100421502;258100421556;54;2,9;2;1;1
258100421556;258100421719;163;2,9;2;1;1
258100421719;258100421829;110;2,9;2;1;1
258100421829;258100421835;6;2,9;2;1;1
258100421835;258100422129;294;2,9;2;1;1
258100422129;258100422304;175;2,9;2;1;1
258100422304;258100422549;245;2,9;2;1;1
258100422549;258100422587;38;2,9;2;1;1
258100422587;258100422682;95;2,9;2;1;1
258100422682;258100422752;70;2,9;2;1;1
258100422752;258100422818;66;2,9;2;1;1
258100422818;258100422828;10;2,9;2;1;1
258100422828;258100422996;168;2,9;2;1;1
258100422996;258100423633;637;2,9;2;1;1
258100423633;258100430828;7195;2,9;2;1;1
258100430828;258100430918;90;2,9;2;1;1
258100430918;258100430945;27;2,9;2;1;1
258100430945;258100430961;16;2,9;2;1;1
258100430961;258100430985;24;2,9;2;1;1
258100430985;258100431001;16;2,9;2;1;1
258100431001;258100431113;112;2,9;2;1;1
258100431113;258100431133;20;2,9;2;1;1
258100431133;258100431148;15;2,9;2;1;1
258100431148;258100431284;136;2,9;2;1;1
258100431284;258100438119;6835;2,9;2;1;1
258100438119;258100438430;311;2,9;2;1;1
258100438430;258100441422;2992;2,9;2;1;1
258100441422;258100441787;365;2,9;2;1;1
258100441787;258100454361;12574;2,9;2;1;1
258100454361;258100456656;2295;2,9;2;1;1
258100456656;258100459473;2817;2,9;2;1;1
258100459473;258100459948;475;2,9;2;1;1
258100459948;258100460162;214;2,9;2;1;1
258100460162;258100460375;213;2,9;2;1;1
258100460375;258100460685;310;2,9;2;1;1
258100460685;258100461242;557;2,9;2;1;1
258100461242;258100461352;110;2,9;2;1;1
258100461352;258100461584;232;2,9;2;1;1
258100461584;258100461773;189;2,9;2;1;1
258100461773;258100462217;444;2,9;2;1;1
258100462217;258100462779;562;2,9;2;1;1
258100462779;258100463502;723;2,9;2;1;1
258100463502;258100471811;8309;2,9;2;1;1
258100471811;258100473826;2015;2,9;2;1;1
258100473826;258100474400;574;2,9;2;1;1
258100474400;258100474526;126;2,9;2;1;1
258100474526;258100474599;73;2,9;2;1;1
258100474599;258100474726;127;2,9;2;1;1
258100474726;258100475324;598;2,9;2;1;1
258100475324;258100475720;396;2,9;2;1;1
258100475720;258100475883;163;2,9;2;1;1
258100475883;258100475974;91;2,9;2;1;1
258100475974;258100476152;178;2,9;2;1;1
258100476152;258100476224;72;2,9;2;1;1
258100476224;258100491133;14909;2,9;2;1;1
258100491133;258100506249;15116;2,9;2;1;1
258100506249;258100506393;144;2,9;2;1;1
258100506393;258100506430;37;2,9;2;1;1
258100506430;258100506434;4;2,9;2;1;1
258100506434;258100506562;128;2,9;2;1;1
258100506562;258100506838;276;2,9;2;1;1
258100506838;258100507081;243;2,9;2;1;1
258100507081;258100507122;41;2,9;2;1;1
258100507122;258100507275;153;2,9;2;1;1
258100507275;258100507443;168;2,9;2;1;1
258100507443;258100510966;3523;2,9;2;1;1
258100510966;258100511117;151;2,9;2;1;1
258100511117;258100511280;163;2,9;2;1;1
258100511280;258100511481;201;2,9;2;1;1
258100511481;258100515279;3798;2,9;2;1;1
258100515279;258100515316;37;2,9;2;1;1
258100515316;258100515502;186;2,9;2;1;1
258100515502;258100518175;2673;2,9;2;1;1
258100518175;258100518374;199;2,9;2;1;1
258100518374;258100518472;98;2,9;2;1;1
258100518472;258100518535;63;2,9;2;1;1
258100518535;258100518637;102;2,9;2;1;1
258100518637;258100518800;163;2,9;2;1;1
258100518800;258100518846;46;2,9;2;1;1
258100518846;258100518885;39;2,9;2;1;1
258100518885;258100519026;141;2,9;2;1;1
258100519026;258100519161;135;2,9;2;1;1
258100519161;258100520224;1063;2,9;2;1;1
258100520224;258100520326;102;2,9;2;1;1
258100520326;258100520373;47;2,9;2;1;1
258100520373;258100520381;8;2,9;2;1;1
258100520381;258100520432;51;2,9;2;1;1
258100520432;258100520443;11;2,9;2;1;1
258100520443;258100520467;24;2,9;2;1;1
258100520467;258100520495;28;2,9;2;1;1
258100520495;258100521291;796;2,9;2;1;1
258100521291;258100530002;8711;2,9;2;1;1
258100530002;258100534393;4391;2,9;2;1;1
258100534393;258100534401;8;2,9;2;1;1
258100534401;258100534493;92;2,9;2;1;1
258100534493;258100534687;194;2,9;2;1;1
258100534687;258100534749;62;2,9;2;1;1
258100534749;258100534759;10;2,9;2;1;1
258100534759;258100534812;53;2,9;2;1;1
258100534812;258100535187;375;2,9;2;1;1
258100535187;258100535724;537;2,9;2;1;1
258100535724;258100535855;131;2,9;2;1;1
258100535855;258100535910;55;2,9;2;1;1
258100535910;258100535956;46;2,9;2;1;1
258100535956;258100535982;26;2,9;2;1;1
258100535982;258100536047;65;2,9;2;1;1
258100536047;258100536121;74;2,9;2;1;1
258100536121;258100536122;1;2,9;2;1;1
258100536122;258100536303;181;2,9;2;1;1
258100536303;258100536337;34;2,9;2;1;1
258100536337;258100536368;31;2,9;2;1;1
258100536368;258100539185;2817;2,9;2;1;1
258100539185;258100539305;120;2,9;2;1;1
258100539305;258100539332;27;2,9;2;1;1
258100539332;258100539713;381;2,9;2;1;1
258100539713;258100539751;38;2,9;2;1;1
258100539751;258100539770;19;2,9;2;1;1
258100539770;258100539898;128;2,9;2;1;1
258100539898;258100540046;148;2,9;2;1;1
258100540046;258100540240;194;2,9;2;1;1
258100540240;258100540371;131;2,9;2;1;1
258100540371;258100546457;6086;2,9;2;1;1
258100546457;258100547084;627;2,9;2;1;1
258100547084;258100557321;10237;2,9;2;1;1
258100557321;258100557344;23;2,9;2;1;1
258100557344;258100561221;3877;2,9;2;1;1
258100561221;258100564806;3585;2,9;2;1;1
258100564806;258100571717;6911;2,9;2;1;1
258100571717;258100571751;34;2,9;2;1;1
258100571751;258100607304;35553;2,9;2;1;1
258100607304;258100664229;56925;2,9;2;1;1
258100664229;258100664833;604;2,9;2;1;1
258100664833;258100664899;66;2,9;2;1;1
258100664899;258100672611;7712;2,9;2;1;1
258100672611;258100673467;856;2,9;2;1;1
258100673467;258100673621;154;2,9;2;1;1
258100673621;258100673666;45;2,9;2;1;1
258100673666;258100673850;184;2,9;2;1;1
258100673850;258100674025;175;2,9;2;1;1
258100674025;258100674217;192;2,9;2;1;1
258100674217;258100674258;41;2,9;2;1;1
258100674258;258100674389;131;2,9;2;1;1
258100674389;258100674891;502;2,9;2;1;1
258100674891;258100684004;9113;2,9;2;1;1
258100684004;258100684012;8;2,9;2;1;1
258100684012;258100684064;52;2,9;2;1;1
258100684064;258100684106;42;2,9;2;1;1
258100684106;258100684165;59;2,9;2;1;1
258100684165;258100684192;27;2,9;2;1;1
258100684192;258100684249;57;2,9;2;1;1
258100684249;258100684302;53;2,9;2;1;1
258100684302;258100684669;367;2,9;2;1;1
258100684669;258100685057;388;2,9;2;1;1
258100685057;258100706469;21412;2,9;2;1;1
258100706469;258100709722;3253;2,9;2;1;1
258100709722;258100709893;171;2,9;2;1;1
258100709893;258100709972;79;2,9;2;1;1
258100709972;258100710109;137;2,9;2;1;1
258100710109;258100710209;100;2,9;2;1;1
258100710209;258100710234;25;2,9;2;1;1
258100710234;258100710239;5;2,9;2;1;1
258100710239;258100710289;50;2,9;2;1;1
258100710289;258100710465;176;2,9;2;1;1
258100710465;258100710503;38;2,9;2;1;1
258100710503;258100712965;2462;2,9;2;1;1
258100712965;258100714174;1209;2,9;2;1;1
258100714174;258100721519;7345;2,9;2;1;1
258100721519;258100722225;706;2,9;2;1;1
258100722225;258100726366;4141;2,9;2;1;1
258100726366;258100726416;50;2,9;2;1;1
258100726416;258100753914;27498;2,9;2;1;1
258100753914;258100753959;45;2,9;2;1;1
258100753959;258100762610;8651;2,9;2;1;1
258100762610;258100763164;554;2,9;2;1;1
258100763164;258100763325;161;2,9;2;1;1
258100763325;258100763532;207;2,9;2;1;1
258100763532;258100763711;179;2,9;2;1;1
258100763711;258100763870;159;2,9;2;1;1
258100763870;258100763941;71;2,9;2;1;1
258100763941;258100764587;646;2,9;2;1;1
258100764587;258100764694;107;2,9;2;1;1
258100764694;258100764816;122;2,9;2;1;1
258100764816;258100764992;176;2,9;2;1;1
258100764992;258100765329;337;2,9;2;1;1
258100765329;258100768947;3618;2,9;2;1;1
258100768947;258100769119;172;2,9;2;1;1
258100769119;258100769146;27;2,9;2;1;1
258100769146;258100769414;268;2,9;2;1;1
258100769414;258100769465;51;2,9;2;1;1
258100769465;258100773778;4313;2,9;2;1;1
258100773778;258100774200;422;2,9;2;1;1
258100774200;258100774412;212;2,9;2;1;1
258100774412;258100774523;111;2,9;2;1;1
258100774523;258100774853;330;2,9;2;1;1
258100774853;258100775029;176;2,9;2;1;1
258100775029;258100775049;20;2,9;2;1;1
258100775049;258100775116;67;2,9;2;1;1
258100775116;258100775217;101;2,9;2;1;1
258100775217;258100775388;171;2,9;2;1;1
258100775388;258100775606;218;2,9;2;1;1
258100775606;258100775778;172;2,9;2;1;1
258100775778;258100783565;7787;2,9;2;1;1
258100783565;258100785767;2202;2,9;2;1;1
258100785767;258100785789;22;2,9;2;1;1
258100785789;258100786005;216;2,9;2;1;1
258100786005;258100787140;1135;2,9;2;1;1
258100787140;258100787194;54;2,9;2;1;1
258100787194;258100787203;9;2,9;2;1;1
258100787203;258100787234;31;2,9;2;1;1
258100787234;258100787278;44;2,9;2;1;1
258100787278;258100787344;66;2,9;2;1;1
258100787344;258100787404;60;2,9;2;1;1
258100787404;258100787530;126;2,9;2;1;1
258100787530;258100787607;77;2,9;2;1;1
258100787607;258100787820;213;2,9;2;1;1
258100787820;258100798780;10960;2,9;2;1;1
258100798780;258100807612;8832;2,9;2;1;1
258100807612;258100807677;65;2,9;2;1;1
258100807677;258100808273;596;2,9;2;1;1
258100808273;258100812464;4191;2,9;2;1;1
258100812464;258100812488;24;2,9;2;1;1
258100812488;258100812567;79;2,9;2;1;1
258100812567;258100812576;9;2,9;2;1;1
258100812576;258100812676;100;2,9;2;1;1
258100812676;258100812705;29;2,9;2;1;1
258100812705;258100812715;10;2,9;2;1;1
258100812715;258100812773;58;2,9;2;1;1
258100812773;258100812921;148;2,9;2;1;1
258100812921;258100812951;30;2,9;2;1;1
258100812951;258100825055;12104;2,9;2;1;1
258100825055;258100847237;22182;2,9;2;1;1
258100847237;258100849261;2024;2,9;2;1;1
258100849261;258100850175;914;2,9;2;1;1
258100850175;258100850182;7;2,9;2;1;1
258100850182;258100850313;131;2,9;2;1;1
258100850313;258100850315;2;2,9;2;1;1
258100850315;258100850350;35;2,9;2;1;1
258100850350;258100850422;72;2,9;2;1;1
258100850422;258100850448;26;2,9;2;1;1
258100850448;258100850563;115;2,9;2;1;1
258100850563;258100850603;40;2,9;2;1;1
258100850603;258100850635;32;2,9;2;1;1
258100850635;258100859973;9338;2,9;2;1;1
258100859973;258100859981;8;2,9;2;1;1
258100859981;258100860040;59;2,9;2;1;1
258100860040;258100860095;55;2,9;2;1;1
258100860095;258100860131;36;2,9;2;1;1
258100860131;258100860617;486;2,9;2;1;1
258100860617;258100860950;333;2,9;2;1;1
258100860950;258100870845;9895;2,9;2;1;1
258100870845;258100870898;53;2,9;2;1;1
258100870898;258100920531;49633;2,9;2;1;1
258100920531;258100955791;35260;2,9;2;1;1
258100955791;258100960096;4305;2,9;2;1;1
258100960096;258100960148;52;2,9;2;1;1
258100960148;258100960174;26;2,9;2;1;1
258100960174;258100960233;59;2,9;2;1;1
258100960233;258100960284;51;2,9;2;1;1
258100960284;258100961209;925;2,9;2;1;1
258100961209;258100961247;38;2,9;2;1;1
258100961247;258100973669;12422;2,9;2;1;1
258100973669;258100973753;84;2,9;2;1;1
258100973753;258100973961;208;2,9;2;1;1
258100973961;258101019443;45482;2,9;2;1;1
258101019443;258101032497;13054;2,9;2;1;1
258101032497;258101033024;527;2,9;2;1;1
258101033024;258101033066;42;2,9;2;1;1
258101033066;258101054806;21740;2,9;2;1;1
258101054806;258101062952;8146;2,9;2;1;1
258101062952;258101066297;3345;2,9;2;1;1
258101066297;258101066852;555;2,9;2;1;1
258101066852;258101070500;3648;2,9;2;1;1
258101070500;258101070599;99;2,9;2;1;1
258101070599;258101070758;159;2,9;2;1;1
258101070758;258101070778;20;2,9;2;1;1
258101070778;258101070888;110;2,9;2;1;1
258101070888;258101071014;126;2,9;2;1;1
258101071014;258101071075;61;2,9;2;1;1
258101071075;258101071176;101;2,9;2;1;1
258101071176;258101071178;2;2,9;2;1;1
258101071178;258101071312;134;2,9;2;1;1
258101071312;258101071376;64;2,9;2;1;1
258101071376;258101071939;563;2,9;2;1;1
258101071939;258101072163;224;2,9;2;1;1
258101072163;258101072503;340;2,9;2;1;1
258101072503;258101073234;731;2,9;2;1;1
258101073234;258101073305;71;2,9;2;1;1
258101073305;258101076223;2918;2,9;2;1;1
258101076223;258101076392;169;2,9;2;1;1
258101076392;258101076477;85;2,9;2;1;1
258101076477;258101076513;36;2,9;2;1;1
258101076513;258101076874;361;2,9;2;1;1
258101076874;258101077069;195;2,9;2;1;1
258101077069;258101077210;141;2,9;2;1;1
258101077210;258101077760;550;2,9;2;1;1
258101077760;258101079799;2039;2,9;2;1;1
258101079799;258101079843;44;2,9;2;1;1
258101079843;258101079898;55;2,9;2;1;1
258101079898;258101079943;45;2,9;2;1;1
258101079943;258101080004;61;2,9;2;1;1
258101080004;258101080081;77;2,9;2;1;1
258101080081;258101080104;23;2,9;2;1;1
258101080104;258101080135;31;2,9;2;1;1
258101080135;258101080164;29;2,9;2;1;1
258101080164;258101080336;172;2,9;2;1;1
258101080336;258101080347;11;2,9;2;1;1
258101080347;258101080534;187;2,9;2;1;1
258101080534;258101080710;176;2,9;2;1;1
258101080710;258101080914;204;2,9;2;1;1
258101080914;258101081077;163;2,9;2;1;1
258101081077;258101081256;179;2,9;2;1;1
258101081256;258101081304;48;2,9;2;1;1
258101081304;258101081560;256;2,9;2;1;1
258101081560;258101081704;144;2,9;2;1;1
258101081704;258101087518;5814;2,9;2;1;1
258101087518;258101092321;4803;2,9;2;1;1
258101092321;258101096907;4586;2,9;2;1;1
258101096907;258101096933;26;2,9;2;1;1
258101096933;258101097037;104;2,9;2;1;1
258101097037;258101097405;368;2,9;2;1;1
258101097405;258101097764;359;2,9;2;1;1
258101097764;258101101045;3281;2,9;2;1;1
258101101045;258101101190;145;2,9;2;1;1
258101101190;258101101302;112;2,9;2;1;1
258101101302;258101101337;35;2,9;2;1;1
258101101337;258101101451;114;2,9;2;1;1
258101101451;258101101606;155;2,9;2;1;1
258101101606;258101101632;26;2,9;2;1;1
258101101632;258101101671;39;2,9;2;1;1
258101101671;258101101834;163;2,9;2;1;1
258101101834;258101101950;116;2,9;2;1;1
258101101950;258101108861;6911;2,9;2;1;1
258101108861;258101109098;237;2,9;2;1;1
258101109098;258101110394;1296;2,9;2;1;1
258101110394;258101122552;12158;2,9;2;1;1
258101122552;258101128200;5648;2,9;2;1;1
258101128200;258101129335;1135;2,9;2;1;1
258101129335;258101131009;1674;2,9;2;1;1
258101131009;258101131533;524;2,9;2;1;1
258101131533;258101131999;466;2,9;2;1;1
258101131999;258101133365;1366;2,9;2;1;1
258101133365;258101133741;376;2,9;2;1;1
258101133741;258101133918;177;2,9;2;1;1
258101133918;258101134071;153;2,9;2;1;1
258101134071;258101134220;149;2,9;2;1;1
258101134220;258101134356;136;2,9;2;1;1
258101134356;258101134494;138;2,9;2;1;1
258101134494;258101134632;138;2,9;2;1;1
258101134632;258101134766;134;2,9;2;1;1
258101134766;258101134899;133;2,9;2;1;1
258101134899;258101141515;6616;2,9;2;1;1
258101141515;258101141596;81;2,9;2;1;1
258101141596;258101143062;1466;2,9;2;1;1
258101143062;258101152165;9103;2,9;2;1;1
258101152165;258101152557;392;2,9;2;1;1
258101152557;258101155352;2795;2,9;2;1;1
258101155352;258101156594;1242;2,9;2;1;1
258101156594;258101156700;106;2,9;2;1;1
258101156700;258101156738;38;2,9;2;1;1
258101156738;258101157263;525;2,9;2;1;1
258101157263;258101157432;169;2,9;2;1;1
258101157432;258101157476;44;2,9;2;1;1
258101157476;258101157519;43;2,9;2;1;1
258101157519;258101157563;44;2,9;2;1;1
258101157563;258101173804;16241;2,9;2;1;1
258101173804;258101173855;51;2,9;2;1;1
258101173855;258101173995;140;2,9;2;1;1
258101173995;258101177418;3423;2,9;2;1;1
258101177418;258101177601;183;2,9;2;1;1
258101177601;258101177614;13;2,9;2;1;1
258101177614;258101177644;30;2,9;2;1;1
258101177644;258101177649;5;2,9;2;1;1
258101177649;258101177718;69;2,9;2;1;1
258101177718;258101177752;34;2,9;2;1;1
258101177752;258101177845;93;2,9;2;1;1
258101177845;258101177994;149;2,9;2;1;1
258101177994;258101178141;147;2,9;2;1;1
258101178141;258101178320;179;2,9;2;1;1
258101178320;258101182458;4138;2,9;2;1;1
258101182458;258101184842;2384;2,9;2;1;1
258101184842;258101188411;3569;2,9;2;1;1
258101188411;258101190708;2297;2,9;2;1;1
258101190708;258101201611;10903;2,9;2;1;1
258101201611;258101201839;228;2,9;2;1;1
258101201839;258101202085;246;2,9;2;1;1
258101202085;258101210535;8450;2,9;2;1;1
258101210535;258101210849;314;2,9;2;1;1
258101210849;258101221004;10155;2,9;2;1;1
258101221004;258101221152;148;2,9;2;1;1
258101221152;258101241261;20109;2,9;2;1;1
258101241261;258101241272;11;2,9;2;1;1
258101241272;258101241608;336;2,9;2;1;1
258101241608;258101241648;40;2,9;2;1;1
258101241648;258101241743;95;2,9;2;1;1
258101241743;258101241785;42;2,9;2;1;1
258101241785;258101241926;141;2,9;2;1;1
258101241926;258101242076;150;2,9;2;1;1
258101242076;258101242113;37;2,9;2;1;1
258101242113;258101260003;17890;2,9;2;1;1
258101260003;258101260671;668;2,9;2;1;1
258101260671;258101261145;474;2,9;2;1;1
258101261145;258101262028;883;2,9;2;1;1
258101262028;258101262114;86;2,9;2;1;1
258101262114;258101265315;3201;2,9;2;1;1
258101265315;258101265595;280;2,9;2;1;1
258101265595;258101265801;206;2,9;2;1;1
258101265801;258101265884;83;2,9;2;1;1
258101265884;258101266058;174;2,9;2;1;1
258101266058;258101266315;257;2,9;2;1;1
258101266315;258101266349;34;2,9;2;1;1
258101266349;258101266442;93;2,9;2;1;1
258101266442;258101266496;54;2,9;2;1;1
258101266496;258101266658;162;2,9;2;1;1
258101266658;258101269616;2958;2,9;2;1;1
258101269616;258101269881;265;2,9;2;1;1
258101269881;258101270247;366;2,9;2;1;1
258101270247;258101270272;25;2,9;2;1;1
258101270272;258101270356;84;2,9;2;1;1
258101270356;258101270400;44;2,9;2;1;1
258101270400;258101270465;65;2,9;2;1;1
258101270465;258101270603;138;2,9;2;1;1
258101270603;258101270679;76;2,9;2;1;1
258101270679;258101270704;25;2,9;2;1;1
258101270704;258101270744;40;2,9;2;1;1
258101270744;258101270921;177;2,9;2;1;1
258101270921;258101279359;8438;2,9;2;1;1
258101279359;258101279385;26;2,9;2;1;1
258101279385;258101279449;64;2,9;2;1;1
258101279449;258101279475;26;2,9;2;1;1
258101279475;258101279687;212;2,9;2;1;1
258101279687;258101286544;6857;2,9;2;1;1
258101286544;258101287554;1010;2,9;2;1;1
258101287554;258101287582;28;2,9;2;1;1
258101287582;258101287631;49;2,9;2;1;1
258101287631;258101287632;1;2,9;2;1;1
258101287632;258101287642;10;2,9;2;1;1
258101287642;258101287666;24;2,9;2;1;1
258101287666;258101287736;70;2,9;2;1;1
258101287736;258101288505;769;2,9;2;1;1
258101288505;258101289204;699;2,9;2;1;1
258101289204;258101291659;2455;2,9;2;1;1
258101291659;258101292151;492;2,9;2;1;1
258101292151;258101292441;290;2,9;2;1;1
258101292441;258101292447;6;2,9;2;1;1
258101292447;258101292536;89;2,9;2;1;1
258101292536;258101292625;89;2,9;2;1;1
258101292625;258101292636;11;2,9;2;1;1
258101292636;258101292750;114;2,9;2;1;1
258101292750;258101292976;226;2,9;2;1;1
258101292976;258101292993;17;2,9;2;1;1
258101292993;258101294254;1261;2,9;2;1;1
258101294254;258101294415;161;2,9;2;1;1
258101294415;258101294582;167;2,9;2;1;1
258101294582;258101294766;184;2,9;2;1;1
258101294766;258101294908;142;2,9;2;1;1
258101294908;258101294950;42;2,9;2;1;1
258101294950;258101296667;1717;2,9;2;1;1
258101296667;258101296729;62;2,9;2;1;1
258101296729;258101296814;85;2,9;2;1;1
258101296814;258101296957;143;2,9;2;1;1
258101296957;258101297349;392;2,9;2;1;1
258101297349;258101297581;232;2,9;2;1;1
258101297581;258101297586;5;2,9;2;1;1
258101297586;258101297749;163;2,9;2;1;1
258101297749;258101297926;177;2,9;2;1;1
258101297926;258101297962;36;2,9;2;1;1
258101297962;258101298140;178;2,9;2;1;1
258101298140;258101299412;1272;2,9;2;1;1
258101299412;258101299728;316;2,9;2;1;1
258101299728;258101302968;3240;2,9;2;1;1
258101302968;258101303076;108;2,9;2;1;1
258101303076;258101303391;315;2,9;2;1;1
258101303391;258101303580;189;2,9;2;1;1
258101303580;258101307003;3423;2,9;2;1;1
258101307003;258101309454;2451;2,9;2;1;1
258101309454;258101339571;30117;2,9;2;1;1
258101339571;258101342582;3011;2,9;2;1;1
258101342582;258101342608;26;2,9;2;1;1
258101342608;258101349124;6516;2,9;2;1;1
258101349124;258101349692;568;2,9;2;1;1
258101349692;258101350144;452;2,9;2;1;1
258101350144;258101350336;192;2,9;2;1;1
258101350336;258101350534;198;2,9;2;1;1
258101350534;258101350670;136;2,9;2;1;1
258101350670;258101350804;134;2,9;2;1;1
258101350804;258101350942;138;2,9;2;1;1
258101350942;258101350979;37;2,9;2;1;1
258101350979;258101351120;141;2,9;2;1;1
258101351120;258101352464;1344;2,9;2;1;1
258101352464;258101352578;114;2,9;2;1;1
258101352578;258101352812;234;2,9;2;1;1
258101352812;258101384900;32088;2,9;2;1;1
258101384900;258101388401;3501;2,9;2;1;1
258101388401;258101388419;18;2,9;2;1;1
258101388419;258101388462;43;2,9;2;1;1
258101388462;258101388645;183;2,9;2;1;1
258101388645;258101388927;282;2,9;2;1;1
258101388927;258101389213;286;2,9;2;1;1
258101389213;258101427940;38727;2,9;2;1;1
258101427940;258101434221;6281;2,9;2;1;1
258101434221;258101434256;35;2,9;2;1;1
258101434256;258101434324;68;2,9;2;1;1
258101434324;258101434384;60;2,9;2;1;1
258101434384;258101434549;165;2,9;2;1;1
258101434549;258101434569;20;2,9;2;1;1
258101434569;258101434604;35;2,9;2;1;1
258101434604;258101434753;149;2,9;2;1;1
258101434753;258101434790;37;2,9;2;1;1
258101434790;258101434884;94;2,9;2;1;1
258101434884;258101445252;10368;2,9;2;1;1
258101445252;258101459911;14659;2,9;2;1;1
258101459911;258101459981;70;2,9;2;1;1
258101459981;258101460008;27;2,9;2;1;1
258101460008;258101462957;2949;2,9;2;1;1
258101462957;258101463312;355;2,9;2;1;1
258101463312;258101463424;112;2,9;2;1;1
258101463424;258101463452;28;2,9;2;1;1
258101463452;258101463460;8;2,9;2;1;1
258101463460;258101463583;123;2,9;2;1;1
258101463583;258101463637;54;2,9;2;1;1
258101463637;258101463676;39;2,9;2;1;1
258101463676;258101463808;132;2,9;2;1;1
258101463808;258101471384;7576;2,9;2;1;1
258101471384;258101473666;2282;2,9;2;1;1
258101473666;258101473795;129;2,9;2;1;1
258101473795;258101476555;2760;2,9;2;1;1
258101476555;258101476758;203;2,9;2;1;1
258101476758;258101477041;283;2,9;2;1;1
258101477041;258101477322;281;2,9;2;1;1
258101477322;258101477368;46;2,9;2;1;1
258101477368;258101482573;5205;2,9;2;1;1
258101482573;258101504310;21737;2,9;2;1;1
258101504310;258101519850;15540;2,9;2;1;1
258101519850;258101530979;11129;2,9;2;1;1
258101530979;258101530987;8;2,9;2;1;1
258101530987;258101531037;50;2,9;2;1;1
258101531037;258101531087;50;2,9;2;1;1
258101531087;258101531114;27;2,9;2;1;1
258101531114;258101531168;54;2,9;2;1;1
258101531168;258101532105;937;2,9;2;1;1
258101532105;258101556992;24887;2,9;2;1;1
258101556992;258101597566;40574;2,9;2;1;1
258101597566;258101600706;3140;2,9;2;1;1
258101600706;258101600759;53;2,9;2;1;1
258101600759;258101600793;34;2,9;2;1;1
258101600793;258101604600;3807;2,9;2;1;1
258101604600;258101604794;194;2,9;2;1;1
258101604794;258101604862;68;2,9;2;1;1
258101604862;258101604940;78;2,9;2;1;1
258101604940;258101605035;95;2,9;2;1;1
258101605035;258101605108;73;2,9;2;1;1
258101605108;258101605202;94;2,9;2;1;1
258101605202;258101605356;154;2,9;2;1;1
258101605356;258101605450;94;2,9;2;1;1
258101605450;258101605595;145;2,9;2;1;1
258101605595;258101616550;10955;2,9;2;1;1
258101616550;258101655704;39154;2,9;2;1;1
258101655704;258101656629;925;2,9;2;1;1
258101656629;258101656659;30;2,9;2;1;1
258101656659;258101657338;679;2,9;2;1;1
258101657338;258101657383;45;2,9;2;1;1
258101657383;258101657436;53;2,9;2;1;1
258101657436;258101658724;1288;2,9;2;1;1
258101658724;258101661995;3271;2,9;2;1;1
258101661995;258101662024;29;2,9;2;1;1
258101662024;258101662048;24;2,9;2;1;1
258101662048;258101662147;99;2,9;2;1;1
258101662147;258101662198;51;2,9;2;1;1
258101662198;258101662358;160;2,9;2;1;1
258101662358;258101662362;4;2,9;2;1;1
258101662362;258101662447;85;2,9;2;1;1
258101662447;258101662480;33;2,9;2;1;1
258101662480;258101662666;186;2,9;2;1;1
258101662666;258101669881;7215;2,9;2;1;1
258101669881;258101670625;744;2,9;2;1;1
258101670625;258101675120;4495;2,9;2;1;1
258101675120;258101675245;125;2,9;2;1;1
258101675245;258101675397;152;2,9;2;1;1
258101675397;258101677768;2371;2,9;2;1;1
258101677768;258101680098;2330;2,9;2;1;1
258101680098;258101680211;113;2,9;2;1;1
258101680211;258101680236;25;2,9;2;1;1
258101680236;258101680254;18;2,9;2;1;1
258101680254;258101680291;37;2,9;2;1;1
258101680291;258101680302;11;2,9;2;1;1
258101680302;258101680422;120;2,9;2;1;1
258101680422;258101680437;15;2,9;2;1;1
258101680437;258101680837;400;2,9;2;1;1
258101680837;258101680983;146;2,9;2;1;1
258101680983;258101682840;1857;2,9;2;1;1
258101682840;258101682993;153;2,9;2;1;1
258101682993;258101683106;113;2,9;2;1;1
258101683106;258101683366;260;2,9;2;1;1
258101683366;258101683498;132;2,9;2;1;1
258101683498;258101683958;460;2,9;2;1;1
258101683958;258101686844;2886;2,9;2;1;1
258101686844;258101689754;2910;2,9;2;1;1
258101689754;258101689827;73;2,9;2;1;1
258101689827;258101689863;36;2,9;2;1;1
258101689863;258101689993;130;2,9;2;1;1
258101689993;258101690331;338;2,9;2;1;1
258101690331;258101691047;716;2,9;2;1;1
258101691047;258101725584;34537;2,9;2;1;1
258101725584;258101731821;6237;2,9;2;1;1
258101731821;258101731866;45;2,9;2;1;1
258101731866;258101731909;43;2,9;2;1;1
258101731909;258101731971;62;2,9;2;1;1
258101731971;258101732093;122;2,9;2;1;1
258101732093;258101732243;150;2,9;2;1;1
258101732243;258101732341;98;2,9;2;1;1
258101732341;258101732555;214;2,9;2;1;1
258101732555;258101732716;161;2,9;2;1;1
258101732716;258101751723;19007;2,9;2;1;1
258101751723;258101754922;3199;2,9;2;1;1
258101754922;258101754974;52;2,9;2;1;1
258101754974;258101755024;50;2,9;2;1;1
258101755024;258101755075;51;2,9;2;1;1
258101755075;258101755126;51;2,9;2;1;1
258101755126;258101765190;10064;2,9;2;1;1
258101765190;258101765241;51;2,9;2;1;1
258101765241;258101765398;157;2,9;2;1;1
258101765398;258101765600;202;2,9;2;1;1
258101765600;258101765608;8;2,9;2;1;1
258101765608;258101765614;6;2,9;2;1;1
258101765614;258101765659;45;2,9;2;1;1
258101765659;258101765692;33;2,9;2;1;1
258101765692;258101765861;169;2,9;2;1;1
258101765861;258101766064;203;2,9;2;1;1
258101766064;258101766920;856;2,9;2;1;1
258101766920;258101767083;163;2,9;2;1;1
258101767083;258101767248;165;2,9;2;1;1
258101767248;258101767412;164;2,9;2;1;1
258101767412;258101767577;165;2,9;2;1;1
258101767577;258101774896;7319;2,9;2;1;1
258101774896;258101777283;2387;2,9;2;1;1
258101777283;258101777510;227;2,9;2;1;1
258101777510;258101777520;10;2,9;2;1;1
258101777520;258101777651;131;2,9;2;1;1
258101777651;258101777723;72;2,9;2;1;1
258101777723;258101777810;87;2,9;2;1;1
258101777810;258101777991;181;2,9;2;1;1
258101777991;258101778210;219;2,9;2;1;1
258101778210;258101778311;101;2,9;2;1;1
258101778311;258101778471;160;2,9;2;1;1
258101778471;258101778584;113;2,9;2;1;1
258101778584;258101778869;285;2,9;2;1;1
258101778869;258101779206;337;2,9;2;1;1
258101779206;258101783184;3978;2,9;2;1;1
258101783184;258101783306;122;2,9;2;1;1
258101783306;258101783373;67;2,9;2;1;1
258101783373;258101783717;344;2,9;2;1;1
258101783717;258101786015;2298;2,9;2;1;1
258101786015;258101795721;9706;2,9;2;1;1
258101795721;258101796427;706;2,9;2;1;1
258101796427;258101796500;73;2,9;2;1;1
258101796500;258101796517;17;2,9;2;1;1
258101796517;258101796636;119;2,9;2;1;1
258101796636;258101796637;1;2,9;2;1;1
258101796637;258101796729;92;2,9;2;1;1
258101796729;258101796810;81;2,9;2;1;1
258101796810;258101796847;37;2,9;2;1;1
258101796847;258101797019;172;2,9;2;1;1
258101797019;258101797184;165;2,9;2;1;1
258101797184;258101797805;621;2,9;2;1;1
258101797805;258101807634;9829;2,9;2;1;1
258101807634;258101832982;25348;2,9;2;1;1
258101832982;258101833159;177;2,9;2;1;1
258101833159;258101833269;110;2,9;2;1;1
258101833269;258101833455;186;2,9;2;1;1
258101833455;258101833512;57;2,9;2;1;1
258101833512;258101834368;856;2,9;2;1;1
258101834368;258101834452;84;2,9;2;1;1
258101834452;258101834877;425;2,9;2;1;1
258101834877;258101835194;317;2,9;2;1;1
258101835194;258101835228;34;2,9;2;1;1
258101835228;258101835363;135;2,9;2;1;1
258101835363;258101835405;42;2,9;2;1;1
258101835405;258101835441;36;2,9;2;1;1
258101835441;258101835493;52;2,9;2;1;1
258101835493;258101835517;24;2,9;2;1;1
258101835517;258101835793;276;2,9;2;1;1
258101835793;258101835921;128;2,9;2;1;1
258101835921;258101836096;175;2,9;2;1;1
258101836096;258101836640;544;2,9;2;1;1
258101836640;258101840197;3557;2,9;2;1;1
258101840197;258101840278;81;2,9;2;1;1
258101840278;258101840304;26;2,9;2;1;1
258101840304;258101840444;140;2,9;2;1;1
258101840444;258101840536;92;2,9;2;1;1
258101840536;258101840616;80;2,9;2;1;1
258101840616;258101840639;23;2,9;2;1;1
258101840639;258101840676;37;2,9;2;1;1
258101840676;258101840807;131;2,9;2;1;1
258101840807;258101840914;107;2,9;2;1;1
258101840914;258101841041;127;2,9;2;1;1
258101841041;258101841125;84;2,9;2;1;1
258101841125;258101841195;70;2,9;2;1;1
258101841195;258101841228;33;2,9;2;1;1
258101841228;258101841272;44;2,9;2;1;1
258101841272;258101841519;247;2,9;2;1;1
258101841519;258101841573;54;2,9;2;1;1
258101841573;258101841738;165;2,9;2;1;1
258101841738;258101841924;186;2,9;2;1;1
258101841924;258101842069;145;2,9;2;1;1
258101842069;258101842218;149;2,9;2;1;1
258101842218;258101847550;5332;2,9;2;1;1
258101847550;258101848992;1442;2,9;2;1;1
258101848992;258101849136;144;2,9;2;1;1
258101849136;258101849292;156;2,9;2;1;1
258101849292;258101854714;5422;2,9;2;1;1
258101854714;258101856534;1820;2,9;2;1;1
258101856534;258101856609;75;2,9;2;1;1
258101856609;258101856695;86;2,9;2;1;1
258101856695;258101858963;2268;2,9;2;1;1
258101858963;258101859110;147;2,9;2;1;1
258101859110;258101859144;34;2,9;2;1;1
258101859144;258101859180;36;2,9;2;1;1
258101859180;258101859719;539;2,9;2;1;1
258101859719;258101861750;2031;2,9;2;1;1
258101861750;258101861842;92;2,9;2;1;1
258101861842;258101861907;65;2,9;2;1;1
258101861907;258101861916;9;2,9;2;1;1
258101861916;258101862057;141;2,9;2;1;1
258101862057;258101862122;65;2,9;2;1;1
258101862122;258101862177;55;2,9;2;1;1
258101862177;258101862201;24;2,9;2;1;1
258101862201;258101862438;237;2,9;2;1;1
258101862438;258101862471;33;2,9;2;1;1
258101862471;258101873362;10891;2,9;2;1;1
258101873362;258101873418;56;2,9;2;1;1
258101873418;258101873538;120;2,9;2;1;1
258101873538;258101873650;112;2,9;2;1;1
258101873650;258101873826;176;2,9;2;1;1
258101873826;258101873911;85;2,9;2;1;1
258101873911;258101874043;132;2,9;2;1;1
258101874043;258101874275;232;2,9;2;1;1
258101874275;258101874467;192;2,9;2;1;1
258101874467;258101874999;532;2,9;2;1;1
258101874999;258101878696;3697;2,9;2;1;1
258101878696;258101878783;87;2,9;2;1;1
258101878783;258101878842;59;2,9;2;1;1
258101878842;258101878894;52;2,9;2;1;1
258101878894;258101879844;950;2,9;2;1;1
258101879844;258101881523;1679;2,9;2;1;1
258101881523;258101881939;416;2,9;2;1;1
258101881939;258101881979;40;2,9;2;1;1
258101881979;258101882256;277;2,9;2;1;1
258101882256;258101882330;74;2,9;2;1;1
258101882330;258101882442;112;2,9;2;1;1
258101882442;258101883002;560;2,9;2;1;1
258101883002;258101883047;45;2,9;2;1;1
258101883047;258101883253;206;2,9;2;1;1
258101883253;258101883355;102;2,9;2;1;1
258101883355;258101883533;178;2,9;2;1;1
258101883533;258101883703;170;2,9;2;1;1
258101883703;258101883891;188;2,9;2;1;1
258101883891;258101884268;377;2,9;2;1;1
258101884268;258101885031;763;2,9;2;1;1
258101885031;258101885177;146;2,9;2;1;1
258101885177;258101885316;139;2,9;2;1;1
258101885316;258101885454;138;2,9;2;1;1
258101885454;258101885666;212;2,9;2;1;1
258101885666;258101885948;282;2,9;2;1;1
258101885948;258101885965;17;2,9;2;1;1
258101885965;258101886147;182;2,9;2;1;1
258101886147;258101886198;51;2,9;2;1;1
258101886198;258101886295;97;2,9;2;1;1
258101886295;258101886335;40;2,9;2;1;1
258101886335;258101886370;35;2,9;2;1;1
258101886370;258101886425;55;2,9;2;1;1
258101886425;258101886513;88;2,9;2;1;1
258101886513;258101886636;123;2,9;2;1;1
258101886636;258101886813;177;2,9;2;1;1
258101886813;258101886960;147;2,9;2;1;1
258101886960;258101887298;338;2,9;2;1;1
258101887298;258101887561;263;2,9;2;1;1
258101887561;258101887796;235;2,9;2;1;1
258101887796;258101889515;1719;2,9;2;1;1
258101889515;258101896217;6702;2,9;2;1;1
258101896217;258101897248;1031;2,9;2;1;1
258101897248;258101900058;2810;2,9;2;1;1
258101900058;258101900469;411;2,9;2;1;1
258101900469;258101900605;136;2,9;2;1;1
258101900605;258101900921;316;2,9;2;1;1
258101900921;258101901097;176;2,9;2;1;1
258101901097;258101901478;381;2,9;2;1;1
258101901478;258101922174;20696;2,9;2;1;1
258101922174;258101924664;2490;2,9;2;1;1
258101924664;258101935459;10795;2,9;2;1;1
258101935459;258101935648;189;2,9;2;1;1
258101935648;258101935712;64;2,9;2;1;1
258101935712;258101935804;92;2,9;2;1;1
258101935804;258101936574;770;2,9;2;1;1
258101936574;258101936632;58;2,9;2;1;1
258101936632;258101936677;45;2,9;2;1;1
258101936677;258101936721;44;2,9;2;1;1
258101936721;258101936782;61;2,9;2;1;1
258101936782;258101937046;264;2,9;2;1;1
258101937046;258101938575;1529;2,9;2;1;1
258101938575;258101948994;10419;2,9;2;1;1
258101948994;258101960588;11594;2,9;2;1;1
258101960588;258101960654;66;2,9;2;1;1
258101960654;258101960674;20;2,9;2;1;1
258101960674;258101960792;118;2,9;2;1;1
258101960792;258101960797;5;2,9;2;1;1
258101960797;258101960935;138;2,9;2;1;1
258101960935;258101961087;152;2,9;2;1;1
258101961087;258101961143;56;2,9;2;1;1
258101961143;258101961260;117;2,9;2;1;1
258101961260;258101961497;237;2,9;2;1;1
258101961497;258101969251;7754;2,9;2;1;1
258101969251;258101969594;343;2,9;2;1;1
258101969594;258101969811;217;2,9;2;1;1
258101969811;258101970019;208;2,9;2;1;1
258101970019;258101970043;24;2,9;2;1;1
258101970043;258101970146;103;2,9;2;1;1
258101970146;258101970189;43;2,9;2;1;1
258101970189;258101970336;147;2,9;2;1;1
258101970336;258101970457;121;2,9;2;1;1
258101970457;258101970499;42;2,9;2;1;1
258101970499;258101971370;871;2,9;2;1;1
258101971370;258101999393;28023;2,9;2;1;1
258101999393;258102263960;264567;2,9;2;1;1
258102263960;258102273716;9756;2,9;2;1;1
258102273716;258102273768;52;2,9;2;1;1
258102273768;258102301517;27749;2,9;2;1;1
258102301517;258102302484;967;2,9;2;1;1
258102302484;258102302546;62;2,9;2;1;1
258102302546;258102302571;25;2,9;2;1;1
258102302571;258102302811;240;2,9;2;1;1
258102302811;258102302860;49;2,9;2;1;1
258102302860;258102302888;28;2,9;2;1;1
258102302888;258102303225;337;2,9;2;1;1
258102303225;258102303399;174;2,9;2;1;1
258102303399;258102303546;147;2,9;2;1;1
258102303546;258102303730;184;2,9;2;1;1
258102303730;258102350631;46901;2,9;2;1;1
258102350631;258102350870;239;2,9;2;1;1
258102350870;258102352515;1645;2,9;2;1;1
258102352515;258102353012;497;2,9;2;1;1
258102353012;258102353315;303;2,9;2;1;1
258102353315;258102353571;256;2,9;2;1;1
258102353571;258102355480;1909;2,9;2;1;1
258102355480;258102359470;3990;2,9;2;1;1
258102359470;258102359696;226;2,9;2;1;1
258102359696;258102370476;10780;2,9;2;1;1
258102370476;258102370808;332;2,9;2;1;1
258102370808;258102370977;169;2,9;2;1;1
258102370977;258102371014;37;2,9;2;1;1
258102371014;258102371032;18;2,9;2;1;1
258102371032;258102373237;2205;2,9;2;1;1
258102373237;258102373378;141;2,9;2;1;1
258102373378;258102383602;10224;2,9;2;1;1
258102383602;258102383674;72;2,9;2;1;1
258102383674;258102384024;350;2,9;2;1;1
258102384024;258102384578;554;2,9;2;1;1
258102384578;258102385003;425;2,9;2;1;1
258102385003;258102385040;37;2,9;2;1;1
258102385040;258102404196;19156;2,9;2;1;1
258102404196;258102405567;1371;2,9;2;1;1
258102405567;258102417357;11790;2,9;2;1;1
258102417357;258102417413;56;2,9;2;1;1
258102417413;258102417517;104;2,9;2;1;1
258102417517;258102417529;12;2,9;2;1;1
258102417529;258102417551;22;2,9;2;1;1
258102417551;258102417910;359;2,9;2;1;1
258102417910;258102417937;27;2,9;2;1;1
258102417937;258102418249;312;2,9;2;1;1
258102418249;258102418548;299;2,9;2;1;1
258102418548;258102418636;88;2,9;2;1;1
258102418636;258102419329;693;2,9;2;1;1
258102419329;258102421096;1767;2,9;2;1;1
258102421096;258102421147;51;2,9;2;1;1
258102421147;258102421198;51;2,9;2;1;1
258102421198;258102421249;51;2,9;2;1;1
258102421249;258102421299;50;2,9;2;1;1
258102421299;258102421349;50;2,9;2;1;1
258102421349;258102422299;950;2,9;2;1;1
258102422299;258102445423;23124;2,9;2;1;1
258102445423;258102448280;2857;2,9;2;1;1
258102448280;258102448386;106;2,9;2;1;1
258102448386;258102448416;30;2,9;2;1;1
258102448416;258102448564;148;2,9;2;1;1
258102448564;258102448586;22;2,9;2;1;1
258102448586;258102448667;81;2,9;2;1;1
258102448667;258102448795;128;2,9;2;1;1
258102448795;258102448839;44;2,9;2;1;1
258102448839;258102448871;32;2,9;2;1;1
258102448871;258102448921;50;2,9;2;1;1
258102448921;258102449024;103;2,9;2;1;1
258102449024;258102449048;24;2,9;2;1;1
258102449048;258102449163;115;2,9;2;1;1
258102449163;258102449182;19;2,9;2;1;1
258102449182;258102449406;224;2,9;2;1;1
258102449406;258102449446;40;2,9;2;1;1
258102449446;258102449592;146;2,9;2;1;1
258102449592;258102449742;150;2,9;2;1;1
258102449742;258102449781;39;2,9;2;1;1
258102449781;258102449878;97;2,9;2;1;1
258102449878;258102457634;7756;2,9;2;1;1
258102457634;258102457719;85;2,9;2;1;1
258102457719;258102457926;207;2,9;2;1;1
258102457926;258102457957;31;2,9;2;1;1
258102457957;258102458048;91;2,9;2;1;1
258102458048;258102458198;150;2,9;2;1;1
258102458198;258102460063;1865;2,9;2;1;1
258102460063;258102460137;74;2,9;2;1;1
258102460137;258102460163;26;2,9;2;1;1
258102460163;258102460223;60;2,9;2;1;1
258102460223;258102460249;26;2,9;2;1;1
258102460249;258102460739;490;2,9;2;1;1
258102460739;258102461051;312;2,9;2;1;1
258102461051;258102479292;18241;2,9;2;1;1
258102479292;258102479318;26;2,9;2;1;1
258102479318;258102479374;56;2,9;2;1;1
258102479374;258102479387;13;2,9;2;1;1
258102479387;258102479410;23;2,9;2;1;1
258102479410;258102479424;14;2,9;2;1;1
258102479424;258102479447;23;2,9;2;1;1
258102479447;258102479971;524;2,9;2;1;1
258102479971;258102484547;4576;2,9;2;1;1
258102484547;258102494912;10365;2,9;2;1;1
258102494912;258102505484;10572;2,9;2;1;1
258102505484;258102505486;2;2,9;2;1;1
258102505486;258102505565;79;2,9;2;1;1
258102505565;258102505576;11;2,9;2;1;1
258102505576;258102505641;65;2,9;2;1;1
258102505641;258102505725;84;2,9;2;1;1
258102505725;258102505774;49;2,9;2;1;1
258102505774;258102505781;7;2,9;2;1;1
258102505781;258102506094;313;2,9;2;1;1
258102506094;258102506339;245;2,9;2;1;1
258102506339;258102507194;855;2,9;2;1;1
258102507194;258102507207;13;2,9;2;1;1
258102507207;258102507458;251;2,9;2;1;1
258102507458;258102507526;68;2,9;2;1;1
258102507526;258102510285;2759;2,9;2;1;1
258102510285;258102513790;3505;2,9;2;1;1
258102513790;258102513839;49;2,9;2;1;1
258102513839;258102517021;3182;2,9;2;1;1
258102517021;258102526010;8989;2,9;2;1;1
258102526010;258102540038;14028;2,9;2;1;1
258102540038;258102557412;17374;2,9;2;1;1
258102557412;258102563145;5733;2,9;2;1;1
258102563145;258102563166;21;2,9;2;1;1
258102563166;258102563215;49;2,9;2;1;1
258102563215;258102563266;51;2,9;2;1;1
258102563266;258102563292;26;2,9;2;1;1
258102563292;258102563347;55;2,9;2;1;1
258102563347;258102570178;6831;2,9;2;1;1
258102570178;258102570960;782;2,9;2;1;1
258102570960;258102571252;292;2,9;2;1;1
258102571252;258102571654;402;2,9;2;1;1
258102571654;258102571813;159;2,9;2;1;1
258102571813;258102571956;143;2,9;2;1;1
258102571956;258102572068;112;2,9;2;1;1
258102572068;258102572099;31;2,9;2;1;1
258102572099;258102581250;9151;2,9;2;1;1
258102581250;258102585585;4335;2,9;2;1;1
258102585585;258102588687;3102;2,9;2;1;1
258102588687;258102588953;266;2,9;2;1;1
258102588953;258102589244;291;2,9;2;1;1
258102589244;258102589488;244;2,9;2;1;1
258102589488;258102589609;121;2,9;2;1;1
258102589609;258102589667;58;2,9;2;1;1
258102589667;258102589670;3;2,9;2;1;1
258102589670;258102589678;8;2,9;2;1;1
258102589678;258102589729;51;2,9;2;1;1
258102589729;258102589760;31;2,9;2;1;1
258102589760;258102589780;20;2,9;2;1;1
258102589780;258102589832;52;2,9;2;1;1
258102589832;258102589881;49;2,9;2;1;1
258102589881;258102590050;169;2,9;2;1;1
258102590050;258102590313;263;2,9;2;1;1
258102590313;258102590372;59;2,9;2;1;1
258102590372;258102590493;121;2,9;2;1;1
258102590493;258102590538;45;2,9;2;1;1
258102590538;258102593134;2596;2,9;2;1;1
258102593134;258102593196;62;2,9;2;1;1
258102593196;258102593359;163;2,9;2;1;1
258102593359;258102593478;119;2,9;2;1;1
258102593478;258102593844;366;2,9;2;1;1
258102593844;258102593961;117;2,9;2;1;1
258102593961;258102593992;31;2,9;2;1;1
258102593992;258102594202;210;2,9;2;1;1
258102594202;258102594243;41;2,9;2;1;1
258102594243;258102594306;63;2,9;2;1;1
258102594306;258102603220;8914;2,9;2;1;1
258102603220;258102605253;2033;2,9;2;1;1
258102605253;258102624949;19696;2,9;2;1;1
258102624949;258102648527;23578;2,9;2;1;1
258102648527;258102648935;408;2,9;2;1;1
258102648935;258102649132;197;2,9;2;1;1
258102649132;258102649363;231;2,9;2;1;1
258102649363;258102649406;43;2,9;2;1;1
258102649406;258102649506;100;2,9;2;1;1
258102649506;258102649549;43;2,9;2;1;1
258102649549;258102649696;147;2,9;2;1;1
258102649696;258102649844;148;2,9;2;1;1
258102649844;258102649970;126;2,9;2;1;1
258102649970;258102650042;72;2,9;2;1;1
258102650042;258102653798;3756;2,9;2;1;1
258102653798;258102653960;162;2,9;2;1;1
258102653960;258102654108;148;2,9;2;1;1
258102654108;258102654143;35;2,9;2;1;1
258102654143;258102654244;101;2,9;2;1;1
258102654244;258102654655;411;2,9;2;1;1
258102654655;258102654819;164;2,9;2;1;1
258102654819;258102655145;326;2,9;2;1;1
258102655145;258102655227;82;2,9;2;1;1
258102655227;258102655278;51;2,9;2;1;1
258102655278;258102663040;7762;2,9;2;1;1
258102663040;258102664684;1644;2,9;2;1;1
258102664684;258102666103;1419;2,9;2;1;1
258102666103;258102668057;1954;2,9;2;1;1
258102668057;258102668147;90;2,9;2;1;1
258102668147;258102668412;265;2,9;2;1;1
258102668412;258102668535;123;2,9;2;1;1
258102668535;258102668589;54;2,9;2;1;1
258102668589;258102668743;154;2,9;2;1;1
258102668743;258102668950;207;2,9;2;1;1
258102668950;258102668972;22;2,9;2;1;1
258102668972;258102669007;35;2,9;2;1;1
258102669007;258102669100;93;2,9;2;1;1
258102669100;258102669135;35;2,9;2;1;1
258102669135;258102669137;2;2,9;2;1;1
258102669137;258102669158;21;2,9;2;1;1
258102669158;258102669292;134;2,9;2;1;1
258102669292;258102669302;10;2,9;2;1;1
258102669302;258102670557;1255;2,9;2;1;1
258102670557;258102671515;958;2,9;2;1;1
258102671515;258102677602;6087;2,9;2;1;1
258102677602;258102689766;12164;2,9;2;1;1
258102689766;258102698194;8428;2,9;2;1;1
258102698194;258102711550;13356;2,9;2;1;1
258102711550;258102720325;8775;2,9;2;1;1
258102720325;258102721832;1507;2,9;2;1;1
258102721832;258102724860;3028;2,9;2;1;1
258102724860;258102724877;17;2,9;2;1;1
258102724877;258102725482;605;2,9;2;1;1
258102725482;258102727383;1901;2,9;2;1;1
258102727383;258102765241;37858;2,9;2;1;1
258102765241;258102765351;110;2,9;2;1;1
258102765351;258102765390;39;2,9;2;1;1
258102765390;258102765416;26;2,9;2;1;1
258102765416;258102765436;20;2,9;2;1;1
258102765436;258102765584;148;2,9;2;1;1
258102765584;258102765591;7;2,9;2;1;1
258102765591;258102765793;202;2,9;2;1;1
258102765793;258102765833;40;2,9;2;1;1
258102765833;258102767906;2073;2,9;2;1;1
258102767906;258102777990;10084;2,9;2;1;1
258102777990;258102778013;23;2,9;2;1;1
258102778013;258102792315;14302;2,9;2;1;1
258102792315;258102792352;37;2,9;2;1;1
258102792352;258102792384;32;2,9;2;1;1
258102792384;258102792448;64;2,9;2;1;1
258102792448;258102792552;104;2,9;2;1;1
258102792552;258102792673;121;2,9;2;1;1
258102792673;258102792701;28;2,9;2;1;1
258102792701;258102792733;32;2,9;2;1;1
258102792733;258102792792;59;2,9;2;1;1
258102792792;258102798376;5584;2,9;2;1;1
258102798376;258102800081;1705;2,9;2;1;1
258102800081;258102808752;8671;2,9;2;1;1
258102808752;258102808929;177;2,9;2;1;1
258102808929;258102811175;2246;2,9;2;1;1
258102811175;258102830384;19209;2,9;2;1;1
258102830384;258102838711;8327;2,9;2;1;1
258102838711;258102849231;10520;2,9;2;1;1
258102849231;258102849264;33;2,9;2;1;1
258102849264;258102864459;15195;2,9;2;1;1
258102864459;258102864472;13;2,9;2;1;1
258102864472;258102864495;23;2,9;2;1;1
258102864495;258102864524;29;2,9;2;1;1
258102864524;258102865125;601;2,9;2;1;1
258102865125;258102865183;58;2,9;2;1;1
258102865183;258102865474;291;2,9;2;1;1
258102865474;258102869342;3868;2,9;2;1;1
258102869342;258102869469;127;2,9;2;1;1
258102869469;258102869522;53;2,9;2;1;1
258102869522;258102869556;34;2,9;2;1;1
258102869556;258102869578;22;2,9;2;1;1
258102869578;258102869607;29;2,9;2;1;1
258102869607;258102869656;49;2,9;2;1;1
258102869656;258102869767;111;2,9;2;1;1
258102869767;258102869787;20;2,9;2;1;1
258102869787;258102869824;37;2,9;2;1;1
258102869824;258102869828;4;2,9;2;1;1
258102869828;258102869867;39;2,9;2;1;1
258102869867;258102869902;35;2,9;2;1;1
258102869902;258102869942;40;2,9;2;1;1
258102869942;258102869947;5;2,9;2;1;1
258102869947;258102869961;14;2,9;2;1;1
258102869961;258102870219;258;2,9;2;1;1
258102870219;258102870379;160;2,9;2;1;1
258102870379;258102870537;158;2,9;2;1;1
258102870537;258102870824;287;2,9;2;1;1
258102870824;258102871133;309;2,9;2;1;1
258102871133;258102875527;4394;2,9;2;1;1
258102875527;258102875651;124;2,9;2;1;1
258102875651;258102875731;80;2,9;2;1;1
258102875731;258102875980;249;2,9;2;1;1
258102875980;258102876023;43;2,9;2;1;1
258102876023;258102876277;254;2,9;2;1;1
258102876277;258102876566;289;2,9;2;1;1
258102876566;258102876617;51;2,9;2;1;1
258102876617;258102876750;133;2,9;2;1;1
258102876750;258102878378;1628;2,9;2;1;1
258102878378;258102878466;88;2,9;2;1;1
258102878466;258102878549;83;2,9;2;1;1
258102878549;258102878604;55;2,9;2;1;1
258102878604;258102878655;51;2,9;2;1;1
258102878655;258102878823;168;2,9;2;1;1
258102878823;258102878931;108;2,9;2;1;1
258102878931;258102879004;73;2,9;2;1;1
258102879004;258102880914;1910;2,9;2;1;1
258102880914;258102884152;3238;2,9;2;1;1
258102884152;258102884377;225;2,9;2;1;1
258102884377;258102884601;224;2,9;2;1;1
258102884601;258102887290;2689;2,9;2;1;1
258102887290;258102887651;361;2,9;2;1;1
258102887651;258102887723;72;2,9;2;1;1
258102887723;258102888014;291;2,9;2;1;1
258102888014;258102888337;323;2,9;2;1;1
258102888337;258102888582;245;2,9;2;1;1
258102888582;258102888793;211;2,9;2;1;1
258102888793;258102889079;286;2,9;2;1;1
258102889079;258102901011;11932;2,9;2;1;1
258102901011;258102901031;20;2,9;2;1;1
258102901031;258102901601;570;2,9;2;1;1
258102901601;258102901654;53;2,9;2;1;1
258102901654;258102901841;187;2,9;2;1;1
258102901841;258102901884;43;2,9;2;1;1
258102901884;258102902234;350;2,9;2;1;1
258102902234;258102902247;13;2,9;2;1;1
258102902247;258102902303;56;2,9;2;1;1
258102902303;258102902534;231;2,9;2;1;1
258102902534;258102902819;285;2,9;2;1;1
258102902819;258102903152;333;2,9;2;1;1
258102903152;258102903316;164;2,9;2;1;1
258102903316;258102903580;264;2,9;2;1;1
258102903580;258102903945;365;2,9;2;1;1
258102903945;258102903988;43;2,9;2;1;1
258102903988;258102904076;88;2,9;2;1;1
258102904076;258102904110;34;2,9;2;1;1
258102904110;258102904272;162;2,9;2;1;1
258102904272;258102904447;175;2,9;2;1;1
258102904447;258102904617;170;2,9;2;1;1
258102904617;258102907121;2504;2,9;2;1;1
258102907121;258102907257;136;2,9;2;1;1
258102907257;258102907299;42;2,9;2;1;1
258102907299;258102907379;80;2,9;2;1;1
258102907379;258102907513;134;2,9;2;1;1
258102907513;258102907673;160;2,9;2;1;1
258102907673;258102907862;189;2,9;2;1;1
258102907862;258102907901;39;2,9;2;1;1
258102907901;258102908206;305;2,9;2;1;1
258102908206;258102909938;1732;2,9;2;1;1
258102909938;258102913945;4007;2,9;2;1;1
258102913945;258102918686;4741;2,9;2;1;1
258102918686;258102918835;149;2,9;2;1;1
258102918835;258102918873;38;2,9;2;1;1
258102918873;258102920562;1689;2,9;2;1;1
258102920562;258102921061;499;2,9;2;1;1
258102921061;258102921107;46;2,9;2;1;1
258102921107;258102921158;51;2,9;2;1;1
258102921158;258102921453;295;2,9;2;1;1
258102921453;258102921485;32;2,9;2;1;1
258102921485;258102921628;143;2,9;2;1;1
258102921628;258102921675;47;2,9;2;1;1
258102921675;258102922938;1263;2,9;2;1;1
258102922938;258102926465;3527;2,9;2;1;1
258102926465;258102926865;400;2,9;2;1;1
258102926865;258102929084;2219;2,9;2;1;1
258102929084;258102931181;2097;2,9;2;1;1
258102931181;258102941471;10290;2,9;2;1;1
258102941471;258102963973;22502;2,9;2;1;1
258102963973;258102966795;2822;2,9;2;1;1
258102966795;258102970513;3718;2,9;2;1;1
258102970513;258102970714;201;2,9;2;1;1
258102970714;258102970975;261;2,9;2;1;1
258102970975;258102971408;433;2,9;2;1;1
258102971408;258102971450;42;2,9;2;1;1
258102971450;258102971570;120;2,9;2;1;1
258102971570;258102971629;59;2,9;2;1;1
258102971629;258102971840;211;2,9;2;1;1
258102971840;258102971877;37;2,9;2;1;1
258102971877;258102971916;39;2,9;2;1;1
258102971916;258102975250;3334;2,9;2;1;1
258102975250;258102978728;3478;2,9;2;1;1
258102978728;258102979817;1089;2,9;2;1;1
258102979817;258102987935;8118;2,9;2;1;1
258102987935;258102997252;9317;2,9;2;1;1
258102997252;258103006108;8856;2,9;2;1;1
258103006108;258103006121;13;2,9;2;1;1
258103006121;258103006143;22;2,9;2;1;1
258103006143;258103006247;104;2,9;2;1;1
258103006247;258103034415;28168;2,9;2;1;1
258103034415;258103045245;10830;2,9;2;1;1
258103045245;258103045757;512;2,9;2;1;1
258103045757;258103047669;1912;2,9;2;1;1
258103047669;258103047723;54;2,9;2;1;1
258103047723;258103047738;15;2,9;2;1;1
258103047738;258103047854;116;2,9;2;1;1
258103047854;258103048088;234;2,9;2;1;1
258103048088;258103064532;16444;2,9;2;1;1
258103064532;258103065557;1025;2,9;2;1;1
258103065557;258103065989;432;2,9;2;1;1
258103065989;258103068030;2041;2,9;2;1;1
258103068030;258103068063;33;2,9;2;1;1
258103068063;258103068133;70;2,9;2;1;1
258103068133;258103071378;3245;2,9;2;1;1
258103071378;258103071541;163;2,9;2;1;1
258103071541;258103071756;215;2,9;2;1;1
258103071756;258103071786;30;2,9;2;1;1
258103071786;258103071844;58;2,9;2;1;1
258103071844;258103071902;58;2,9;2;1;1
258103071902;258103071946;44;2,9;2;1;1
258103071946;258103071986;40;2,9;2;1;1
258103071986;258103072023;37;2,9;2;1;1
258103072023;258103072131;108;2,9;2;1;1
258103072131;258103076205;4074;2,9;2;1;1
258103076205;258103076377;172;2,9;2;1;1
258103076377;258103076618;241;2,9;2;1;1
258103076618;258103076776;158;2,9;2;1;1
258103076776;258103076998;222;2,9;2;1;1
258103076998;258103077201;203;2,9;2;1;1
258103077201;258103077403;202;2,9;2;1;1
258103077403;258103077615;212;2,9;2;1;1
258103077615;258103077755;140;2,9;2;1;1
258103077755;258103081661;3906;2,9;2;1;1
258103081661;258103081845;184;2,9;2;1;1
258103081845;258103082087;242;2,9;2;1;1
258103082087;258103082158;71;2,9;2;1;1
258103082158;258103082301;143;2,9;2;1;1
258103082301;258103082443;142;2,9;2;1;1
258103082443;258103082472;29;2,9;2;1;1
258103082472;258103082636;164;2,9;2;1;1
258103082636;258103082672;36;2,9;2;1;1
258103082672;258103082704;32;2,9;2;1;1
258103082704;258103082898;194;2,9;2;1;1
258103082898;258103083386;488;2,9;2;1;1
258103083386;258103083965;579;2,9;2;1;1
258103083965;258103086823;2858;2,9;2;1;1
258103086823;258103086930;107;2,9;2;1;1
258103086930;258103087243;313;2,9;2;1;1
258103087243;258103087432;189;2,9;2;1;1
258103087432;258103088347;915;2,9;2;1;1
258103088347;258103088356;9;2,9;2;1;1
258103088356;258103088371;15;2,9;2;1;1
258103088371;258103088425;54;2,9;2;1;1
258103088425;258103093157;4732;2,9;2;1;1
258103093157;258103097724;4567;2,9;2;1;1
258103097724;258103114259;16535;2,9;2;1;1
258103114259;258103119175;4916;2,9;2;1;1
258103119175;258103124160;4985;2,9;2;1;1
258103124160;258103134122;9962;2,9;2;1;1
258103134122;258103134209;87;2,9;2;1;1
258103134209;258103137032;2823;2,9;2;1;1
258103137032;258103166703;29671;2,9;2;1;1
258103166703;258103169465;2762;2,9;2;1;1
258103169465;258103169674;209;2,9;2;1;1
258103169674;258103179644;9970;2,9;2;1;1
258103179644;258103179861;217;2,9;2;1;1
258103179861;258103179911;50;2,9;2;1;1
258103179911;258103194147;14236;2,9;2;1;1
258103194147;258103194153;6;2,9;2;1;1
258103194153;258103195112;959;2,9;2;1;1
258103195112;258103196144;1032;2,9;2;1;1
258103196144;258103198893;2749;2,9;2;1;1
258103198893;258103199100;207;2,9;2;1;1
258103199100;258103199113;13;2,9;2;1;1
258103199113;258103199274;161;2,9;2;1;1
258103199274;258103199310;36;2,9;2;1;1
258103199310;258103218888;19578;2,9;2;1;1
258103218888;258103220199;1311;2,9;2;1;1
258103220199;258103220706;507;2,9;2;1;1
258103220706;258103220904;198;2,9;2;1;1
258103220904;258103220985;81;2,9;2;1;1
258103220985;258103221069;84;2,9;2;1;1
258103221069;258103230529;9460;2,9;2;1;1
258103230529;258103231386;857;2,9;2;1;1
258103231386;258103233766;2380;2,9;2;1;1
258103233766;258103233781;15;2,9;2;1;1
258103233781;258103233856;75;2,9;2;1;1
258103233856;258103237119;3263;2,9;2;1;1
258103237119;258103237177;58;2,9;2;1;1
258103237177;258103237576;399;2,9;2;1;1
258103237576;258103237666;90;2,9;2;1;1
258103237666;258103237695;29;2,9;2;1;1
258103237695;258103237708;13;2,9;2;1;1
258103237708;258103237821;113;2,9;2;1;1
258103237821;258103237841;20;2,9;2;1;1
258103237841;258103238190;349;2,9;2;1;1
258103238190;258103238339;149;2,9;2;1;1
258103238339;258103238404;65;2,9;2;1;1
258103238404;258103238869;465;2,9;2;1;1
258103238869;258103239158;289;2,9;2;1;1
258103239158;258103256868;17710;2,9;2;1;1
258103256868;258103258882;2014;2,9;2;1;1
258103258882;258103259075;193;2,9;2;1;1
258103259075;258103259118;43;2,9;2;1;1
258103259118;258103259186;68;2,9;2;1;1
258103259186;258103259221;35;2,9;2;1;1
258103259221;258103259414;193;2,9;2;1;1
258103259414;258103259451;37;2,9;2;1;1
258103259451;258103259599;148;2,9;2;1;1
258103259599;258103259636;37;2,9;2;1;1
258103259636;258103259731;95;2,9;2;1;1
258103259731;258103266890;7159;2,9;2;1;1
258103266890;258103267637;747;2,9;2;1;1
258103267637;258103282639;15002;2,9;2;1;1
258103282639;258103298424;15785;2,9;2;1;1
258103298424;258103298466;42;2,9;2;1;1
258103298466;258103298508;42;2,9;2;1;1
258103298508;258103302851;4343;2,9;2;1;1
258103302851;258103303046;195;2,9;2;1;1
258103303046;258103303313;267;2,9;2;1;1
258103303313;258103303491;178;2,9;2;1;1
258103303491;258103303511;20;2,9;2;1;1
258103303511;258103303662;151;2,9;2;1;1
258103303662;258103303731;69;2,9;2;1;1
258103303731;258103303895;164;2,9;2;1;1
258103303895;258103304061;166;2,9;2;1;1
258103304061;258103304225;164;2,9;2;1;1
258103304225;258103309286;5061;2,9;2;1;1
258103309286;258103309338;52;2,9;2;1;1
258103309338;258103309465;127;2,9;2;1;1
258103309465;258103310739;1274;2,9;2;1;1
258103310739;258103310809;70;2,9;2;1;1
258103310809;258103310834;25;2,9;2;1;1
258103310834;258103310908;74;2,9;2;1;1
258103310908;258103310982;74;2,9;2;1;1
258103310982;258103311067;85;2,9;2;1;1
258103311067;258103311145;78;2,9;2;1;1
258103311145;258103311238;93;2,9;2;1;1
258103311238;258103311354;116;2,9;2;1;1
258103311354;258103311448;94;2,9;2;1;1
258103311448;258103312548;1100;2,9;2;1;1
258103312548;258103312895;347;2,9;2;1;1
258103312895;258103313250;355;2,9;2;1;1
258103313250;258103313330;80;2,9;2;1;1
258103313330;258103314632;1302;2,9;2;1;1
258103314632;258103317487;2855;2,9;2;1;1
258103317487;258103317635;148;2,9;2;1;1
258103317635;258103317741;106;2,9;2;1;1
258103317741;258103317781;40;2,9;2;1;1
258103317781;258103317824;43;2,9;2;1;1
258103317824;258103317905;81;2,9;2;1;1
258103317905;258103318081;176;2,9;2;1;1
258103318081;258103318110;29;2,9;2;1;1
258103318110;258103318175;65;2,9;2;1;1
258103318175;258103318270;95;2,9;2;1;1
258103318270;258103318333;63;2,9;2;1;1
258103318333;258103318365;32;2,9;2;1;1
258103318365;258103318440;75;2,9;2;1;1
258103318440;258103318498;58;2,9;2;1;1
258103318498;258103318637;139;2,9;2;1;1
258103318637;258103318827;190;2,9;2;1;1
258103318827;258103318847;20;2,9;2;1;1
258103318847;258103318889;42;2,9;2;1;1
258103318889;258103319139;250;2,9;2;1;1
258103319139;258103319176;37;2,9;2;1;1
258103319176;258103319427;251;2,9;2;1;1
258103319427;258103319572;145;2,9;2;1;1
258103319572;258103325126;5554;2,9;2;1;1
258103325126;258103325669;543;2,9;2;1;1
258103325669;258103325844;175;2,9;2;1;1
258103325844;258103325875;31;2,9;2;1;1
258103325875;258103326396;521;2,9;2;1;1
258103326396;258103331764;5368;2,9;2;1;1
258103331764;258103332137;373;2,9;2;1;1
258103332137;258103332212;75;2,9;2;1;1
258103332212;258103332275;63;2,9;2;1;1
258103332275;258103333584;1309;2,9;2;1;1
258103333584;258103333597;13;2,9;2;1;1
258103333597;258103333782;185;2,9;2;1;1
258103333782;258103334388;606;2,9;2;1;1
258103334388;258103363655;29267;2,9;2;1;1
258103363655;258103367819;4164;2,9;2;1;1
258103367819;258103367840;21;2,9;2;1;1
258103367840;258103367854;14;2,9;2;1;1
258103367854;258103367895;41;2,9;2;1;1
258103367895;258103367947;52;2,9;2;1;1
258103367947;258103367997;50;2,9;2;1;1
258103367997;258103368024;27;2,9;2;1;1
258103368024;258103372852;4828;2,9;2;1;1
258103372852;258103383618;10766;2,9;2;1;1
258103383618;258103383671;53;2,9;2;1;1
258103383671;258103383707;36;2,9;2;1;1
258103383707;258103383737;30;2,9;2;1;1
258103383737;258103383756;19;2,9;2;1;1
258103383756;258103383787;31;2,9;2;1;1
258103383787;258103384446;659;2,9;2;1;1
258103384446;258103401750;17304;2,9;2;1;1
258103401750;258103402038;288;2,9;2;1;1
258103402038;258103405819;3781;2,9;2;1;1
258103405819;258103405866;47;2,9;2;1;1
258103405866;258103405906;40;2,9;2;1;1
258103405906;258103405960;54;2,9;2;1;1
258103405960;258103405972;12;2,9;2;1;1
258103405972;258103406003;31;2,9;2;1;1
258103406003;258103406086;83;2,9;2;1;1
258103406086;258103406230;144;2,9;2;1;1
258103406230;258103406299;69;2,9;2;1;1
258103406299;258103406430;131;2,9;2;1;1
258103406430;258103408509;2079;2,9;2;1;1
258103408509;258103408712;203;2,9;2;1;1
258103408712;258103409397;685;2,9;2;1;1
258103409397;258103409585;188;2,9;2;1;1
258103409585;258103409626;41;2,9;2;1;1
258103409626;258103409782;156;2,9;2;1;1
258103409782;258103409950;168;2,9;2;1;1
258103409950;258103410118;168;2,9;2;1;1
258103410118;258103410287;169;2,9;2;1;1
258103410287;258103410453;166;2,9;2;1;1
258103410453;258103413755;3302;2,9;2;1;1
258103413755;258103413869;114;2,9;2;1;1
258103413869;258103413900;31;2,9;2;1;1
258103413900;258103414082;182;2,9;2;1;1
258103414082;258103414269;187;2,9;2;1;1
258103414269;258103414308;39;2,9;2;1;1
258103414308;258103414438;130;2,9;2;1;1
258103414438;258103414581;143;2,9;2;1;1
258103414581;258103414802;221;2,9;2;1;1
258103414802;258103414926;124;2,9;2;1;1
258103414926;258103416563;1637;2,9;2;1;1
258103416563;258103420517;3954;2,9;2;1;1
258103420517;258103424413;3896;2,9;2;1;1
258103424413;258103429691;5278;2,9;2;1;1
258103429691;258103429724;33;2,9;2;1;1
258103429724;258103429804;80;2,9;2;1;1
258103429804;258103440846;11042;2,9;2;1;1
258103440846;258103442688;1842;2,9;2;1;1
258103442688;258103442738;50;2,9;2;1;1
258103442738;258103442788;50;2,9;2;1;1
258103442788;258103442823;35;2,9;2;1;1
258103442823;258103442845;22;2,9;2;1;1
258103442845;258103444104;1259;2,9;2;1;1
258103444104;258103445086;982;2,9;2;1;1
258103445086;258103445391;305;2,9;2;1;1
258103445391;258103450588;5197;2,9;2;1;1
258103450588;258103450731;143;2,9;2;1;1
258103450731;258103450803;72;2,9;2;1;1
258103450803;258103450871;68;2,9;2;1;1
258103450871;258103450947;76;2,9;2;1;1
258103450947;258103450968;21;2,9;2;1;1
258103450968;258103451134;166;2,9;2;1;1
258103451134;258103451317;183;2,9;2;1;1
258103451317;258103451356;39;2,9;2;1;1
258103451356;258103451578;222;2,9;2;1;1
258103451578;258103451600;22;2,9;2;1;1
258103451600;258103455082;3482;2,9;2;1;1
258103455082;258103455290;208;2,9;2;1;1
258103455290;258103455780;490;2,9;2;1;1
258103455780;258103455913;133;2,9;2;1;1
258103455913;258103455970;57;2,9;2;1;1
258103455970;258103455989;19;2,9;2;1;1
258103455989;258103456067;78;2,9;2;1;1
258103456067;258103456198;131;2,9;2;1;1
258103456198;258103456245;47;2,9;2;1;1
258103456245;258103456303;58;2,9;2;1;1
258103456303;258103456353;50;2,9;2;1;1
258103456353;258103456407;54;2,9;2;1;1
258103456407;258103456467;60;2,9;2;1;1
258103456467;258103456606;139;2,9;2;1;1
258103456606;258103456806;200;2,9;2;1;1
258103456806;258103457242;436;2,9;2;1;1
258103457242;258103457277;35;2,9;2;1;1
258103457277;258103471257;13980;2,9;2;1;1
258103471257;258103493025;21768;2,9;2;1;1
258103493025;258103495550;2525;2,9;2;1;1
258103495550;258103497023;1473;2,9;2;1;1
258103497023;258103509583;12560;2,9;2;1;1
258103509583;258103513367;3784;2,9;2;1;1
258103513367;258103513555;188;2,9;2;1;1
258103513555;258103514069;514;2,9;2;1;1
258103514069;258103514766;697;2,9;2;1;1
258103514766;258103516672;1906;2,9;2;1;1
258103516672;258103516680;8;2,9;2;1;1
258103516680;258103516736;56;2,9;2;1;1
258103516736;258103516789;53;2,9;2;1;1
258103516789;258103517888;1099;2,9;2;1;1
258103517888;258103518248;360;2,9;2;1;1
258103518248;258103518415;167;2,9;2;1;1
258103518415;258103518689;274;2,9;2;1;1
258103518689;258103520043;1354;2,9;2;1;1
258103520043;258103520217;174;2,9;2;1;1
258103520217;258103520575;358;2,9;2;1;1
258103520575;258103520620;45;2,9;2;1;1
258103520620;258103520736;116;2,9;2;1;1
258103520736;258103520743;7;2,9;2;1;1
258103520743;258103520810;67;2,9;2;1;1
258103520810;258103520910;100;2,9;2;1;1
258103520910;258103520961;51;2,9;2;1;1
258103520961;258103521217;256;2,9;2;1;1
258103521217;258103522265;1048;2,9;2;1;1
258103522265;258103522474;209;2,9;2;1;1
258103522474;258103522496;22;2,9;2;1;1
258103522496;258103522532;36;2,9;2;1;1
258103522532;258103522652;120;2,9;2;1;1
258103522652;258103522999;347;2,9;2;1;1
258103522999;258103523238;239;2,9;2;1;1
258103523238;258103523402;164;2,9;2;1;1
258103523402;258103523570;168;2,9;2;1;1
258103523570;258103523735;165;2,9;2;1;1
258103523735;258103530213;6478;2,9;2;1;1
258103530213;258103533563;3350;2,9;2;1;1
258103533563;258103538065;4502;2,9;2;1;1
258103538065;258103540683;2618;2,9;2;1;1
258103540683;258103540795;112;2,9;2;1;1
258103540795;258103541019;224;2,9;2;1;1
258103541019;258103541062;43;2,9;2;1;1
258103541062;258103541097;35;2,9;2;1;1
258103541097;258103541164;67;2,9;2;1;1
258103541164;258103541223;59;2,9;2;1;1
258103541223;258103541302;79;2,9;2;1;1
258103541302;258103541307;5;2,9;2;1;1
258103541307;258103541482;175;2,9;2;1;1
258103541482;258103546441;4959;2,9;2;1;1
258103546441;258103546501;60;2,9;2;1;1
258103546501;258103546545;44;2,9;2;1;1
258103546545;258103547125;580;2,9;2;1;1
258103547125;258103548849;1724;2,9;2;1;1
258103548849;258103548887;38;2,9;2;1;1
258103548887;258103549749;862;2,9;2;1;1
258103549749;258103550221;472;2,9;2;1;1
258103550221;258103550258;37;2,9;2;1;1
258103550258;258103554984;4726;2,9;2;1;1
258103554984;258103587332;32348;2,9;2;1;1
258103587332;258103597511;10179;2,9;2;1;1
258103597511;258103597534;23;2,9;2;1;1
258103597534;258103611259;13725;2,9;2;1;1
258103611259;258103611502;243;2,9;2;1;1
258103611502;258103625324;13822;2,9;2;1;1
258103625324;258103625608;284;2,9;2;1;1
258103625608;258103632456;6848;2,9;2;1;1
258103632456;258103637701;5245;2,9;2;1;1
258103637701;258103638054;353;2,9;2;1;1
258103638054;258103638430;376;2,9;2;1;1
258103638430;258103638577;147;2,9;2;1;1
258103638577;258103638715;138;2,9;2;1;1
258103638715;258103638849;134;2,9;2;1;1
258103638849;258103638984;135;2,9;2;1;1
258103638984;258103639120;136;2,9;2;1;1
258103639120;258103639156;36;2,9;2;1;1
258103639156;258103639297;141;2,9;2;1;1
258103639297;258103642239;2942;2,9;2;1;1
258103642239;258103642309;70;2,9;2;1;1
258103642309;258103661524;19215;2,9;2;1;1
258103661524;258103673124;11600;2,9;2;1;1
258103673124;258103686695;13571;2,9;2;1;1
258103686695;258103686715;20;2,9;2;1;1
258103686715;258103686731;16;2,9;2;1;1
258103686731;258103686989;258;2,9;2;1;1
258103686989;258103687251;262;2,9;2;1;1
258103687251;258103687755;504;2,9;2;1;1
258103687755;258103694623;6868;2,9;2;1;1
258103694623;258103696102;1479;2,9;2;1;1
258103696102;258103696152;50;2,9;2;1;1
258103696152;258103696201;49;2,9;2;1;1
258103696201;258103696210;9;2,9;2;1;1
258103696210;258103696261;51;2,9;2;1;1
258103696261;258103696287;26;2,9;2;1;1
258103696287;258103700483;4196;2,9;2;1;1
258103700483;258103700498;15;2,9;2;1;1
258103700498;258103700635;137;2,9;2;1;1
258103700635;258103700777;142;2,9;2;1;1
258103700777;258103700810;33;2,9;2;1;1
258103700810;258103700915;105;2,9;2;1;1
258103700915;258103700938;23;2,9;2;1;1
258103700938;258103701119;181;2,9;2;1;1
258103701119;258103701159;40;2,9;2;1;1
258103701159;258103701314;155;2,9;2;1;1
258103701314;258103703643;2329;2,9;2;1;1
258103703643;258103704278;635;2,9;2;1;1
258103704278;258103704716;438;2,9;2;1;1
258103704716;258103705441;725;2,9;2;1;1
258103705441;258103705460;19;2,9;2;1;1
258103705460;258103705517;57;2,9;2;1;1
258103705517;258103705606;89;2,9;2;1;1
258103705606;258103705759;153;2,9;2;1;1
258103705759;258103706126;367;2,9;2;1;1
258103706126;258103706246;120;2,9;2;1;1
258103706246;258103706294;48;2,9;2;1;1
258103706294;258103706574;280;2,9;2;1;1
258103706574;258103708475;1901;2,9;2;1;1
258103708475;258103708587;112;2,9;2;1;1
258103708587;258103708622;35;2,9;2;1;1
258103708622;258103717170;8548;2,9;2;1;1
258103717170;258103717481;311;2,9;2;1;1
258103717481;258103717762;281;2,9;2;1;1
258103717762;258103718827;1065;2,9;2;1;1
258103718827;258103719520;693;2,9;2;1;1
258103719520;258103720668;1148;2,9;2;1;1
258103720668;258103727357;6689;2,9;2;1;1
258103727357;258103727793;436;2,9;2;1;1
258103727793;258103728531;738;2,9;2;1;1
258103728531;258103728603;72;2,9;2;1;1
258103728603;258103728797;194;2,9;2;1;1
258103728797;258103728884;87;2,9;2;1;1
258103728884;258103728898;14;2,9;2;1;1
258103728898;258103728940;42;2,9;2;1;1
258103728940;258103728943;3;2,9;2;1;1
258103728943;258103729111;168;2,9;2;1;1
258103729111;258103729145;34;2,9;2;1;1
258103729145;258103729243;98;2,9;2;1;1
258103729243;258103729305;62;2,9;2;1;1
258103729305;258103729461;156;2,9;2;1;1
258103729461;258103732875;3414;2,9;2;1;1
258103732875;258103732929;54;2,9;2;1;1
258103732929;258103732992;63;2,9;2;1;1
258103732992;258103733139;147;2,9;2;1;1
258103733139;258103733246;107;2,9;2;1;1
258103733246;258103733283;37;2,9;2;1;1
258103733283;258103733285;2;2,9;2;1;1
258103733285;258103733426;141;2,9;2;1;1
258103733426;258103733562;136;2,9;2;1;1
258103733562;258103733600;38;2,9;2;1;1
258103733600;258103733700;100;2,9;2;1;1
258103733700;258103740763;7063;2,9;2;1;1
258103740763;258103743203;2440;2,9;2;1;1
258103743203;258103764462;21259;2,9;2;1;1
258103764462;258103775814;11352;2,9;2;1;1
258103775814;258103776008;194;2,9;2;1;1
258103776008;258103776066;58;2,9;2;1;1
258103776066;258103776158;92;2,9;2;1;1
258103776158;258103776749;591;2,9;2;1;1
258103776749;258103776783;34;2,9;2;1;1
258103776783;258103776786;3;2,9;2;1;1
258103776786;258103776823;37;2,9;2;1;1
258103776823;258103776848;25;2,9;2;1;1
258103776848;258103776963;115;2,9;2;1;1
258103776963;258103777053;90;2,9;2;1;1
258103777053;258103777411;358;2,9;2;1;1
258103777411;258103777558;147;2,9;2;1;1
258103777558;258103777706;148;2,9;2;1;1
258103777706;258103777897;191;2,9;2;1;1
258103777897;258103778043;146;2,9;2;1;1
258103778043;258103790466;12423;2,9;2;1;1
258103790466;258103800024;9558;2,9;2;1;1
258103800024;258103808749;8725;2,9;2;1;1
258103808749;258103808886;137;2,9;2;1;1
258103808886;258103809023;137;2,9;2;1;1
258103809023;258103809150;127;2,9;2;1;1
258103809150;258103809273;123;2,9;2;1;1
258103809273;258103809773;500;2,9;2;1;1
258103809773;258103810313;540;2,9;2;1;1
258103810313;258103810609;296;2,9;2;1;1
258103810609;258103811293;684;9;1;1;1
258103811293;258103811319;26;9;1;1;1
258103811319;258103811373;54;9;1;1;1
258103811373;258103814846;3473;9;1;1;1
258103814846;258103814862;16;9;1;1;1
258103814862;258103814899;37;9;1;1;1
258103814899;258103814928;29;9;1;1;1
258103814928;258103814944;16;9;1;1;1
258103814944;258103814970;26;9;1;1;1
258103814970;258103815018;48;9;1;1;1
258103815018;258103815063;45;9;1;1;1
258103815063;258103815182;119;9;1;1;1
258103815182;258103815195;13;9;1;1;1
258103815195;258103815773;578;9;1;1;1
258103815773;258103815942;169;9;1;1;1
258103815942;258103816152;210;9;1;1;1
258103816152;258103816299;147;9;1;1;1
258103816299;258103816318;19;9;1;1;1
258103816318;258103816336;18;9;1;1;1
258103816336;258103816442;106;9;1;1;1
258103816442;258103816477;35;9;1;1;1
258103816477;258103816649;172;9;1;1;1
258103816649;258103816864;215;9;1;1;1
258103816864;258103824779;7915;9;1;1;1
258103824779;258103836768;11989;9;1;1;1
258103836768;258103881318;44550;9;1;1;1
258103881318;258103881535;217;9;1;1;1
258103881535;258103883038;1503;9;1;1;1
258103883038;258103884108;1070;9;1;1;1
258103884108;258103884544;436;9;1;1;1
258103884544;258103884915;371;9;1;1;1
258103884915;258103884943;28;9;1;1;1
258103884943;258103885081;138;9;1;1;1
258103885081;258103890442;5361;9;1;1;1
258103890442;258103892474;2032;9;1;1;1
258103892474;258103892920;446;9;1;1;1
258103892920;258103906770;13850;9;1;1;1
258103906770;258103940298;33528;9;1;1;1
258103940298;258103940443;145;9;1;1;1
258103940443;258103940460;17;9;1;1;1
258103940460;258103940468;8;9;1;1;1
258103940468;258103940573;105;9;1;1;1
258103940573;258103940783;210;9;1;1;1
258103940783;258103940930;147;9;1;1;1
258103940930;258103941089;159;9;1;1;1
258103941089;258103968722;27633;9;1;1;1
258103968722;258103978080;9358;9;1;1;1
258103978080;258103979811;1731;9;1;1;1
258103979811;258103979861;50;9;1;1;1
258103979861;258103979911;50;9;1;1;1
258103979911;258103980667;756;9;1;1;1
258103980667;258103982928;2261;9;1;1;1
258103982928;258103983000;72;9;1;1;1
258103983000;258103983042;42;9;1;1;1
258103983042;258103987989;4947;9;1;1;1
258103987989;258103988039;50;9;1;1;1
258103988039;258103988101;62;9;1;1;1
258103988101;258103988112;11;9;1;1;1
258103988112;258103988136;24;9;1;1;1
258103988136;258103992080;3944;9;1;1;1
258103992080;258104026958;34878;9;1;1;1
258104026958;258104030497;3539;9;1;1;1
258104030497;258104030556;59;9;1;1;1
258104030556;258104030704;148;9;1;1;1
258104030704;258104030951;247;9;1;1;1
258104030951;258104030989;38;9;1;1;1
258104030989;258104031007;18;9;1;1;1
258104031007;258104031124;117;9;1;1;1
258104031124;258104031259;135;9;1;1;1
258104031259;258104031408;149;9;1;1;1
258104031408;258104031527;119;9;1;1;1
258104031527;258104039563;8036;9;1;1;1
258104039563;258104042181;2618;9;1;1;1
258104042181;258104042285;104;9;1;1;1
258104042285;258104042504;219;9;1;1;1
258104042504;258104042530;26;9;1;1;1
258104042530;258104044232;1702;9;1;1;1
258104044232;258104044543;311;9;1;1;1
258104044543;258104044579;36;9;1;1;1
258104044579;258104044803;224;9;1;1;1
258104044803;258104072206;27403;9;1;1;1
258104072206;258104081651;9445;9;1;1;1
258104081651;258104081809;158;9;1;1;1
258104081809;258104081860;51;9;1;1;1
258104081860;258104081869;9;9;1;1;1
258104081869;258104119302;37433;9;1;1;1
258104119302;258104129988;10686;9;1;1;1
258104129988;258104130075;87;9;1;1;1
258104130075;258104130143;68;9;1;1;1
258104130143;258104130216;73;9;1;1;1
258104130216;258104130284;68;9;1;1;1
258104130284;258104130335;51;9;1;1;1
258104130335;258104131697;1362;9;1;1;1
258104131697;258104134363;2666;9;1;1;1
258104134363;258104134465;102;9;1;1;1
258104134465;258104134601;136;9;1;1;1
258104134601;258104134779;178;9;1;1;1
258104134779;258104134858;79;9;1;1;1
258104134858;258104134953;95;9;1;1;1
258104134953;258104149948;14995;9;1;1;1
258104149948;258104150056;108;9;1;1;1
258104150056;258104172257;22201;9;1;1;1
258104172257;258104212361;40104;9;1;1;1
258104212361;258104226089;13728;9;1;1;1
258104226089;258104234798;8709;9;1;1;1
258104234798;258104235021;223;9;1;1;1
258104235021;258104235063;42;9;1;1;1
258104235063;258104235097;34;9;1;1;1
258104235097;258104235379;282;9;1;1;1
258104235379;258104273039;37660;9;1;1;1
258104273039;258104304863;31824;9;1;1;1
258104304863;258104338397;33534;9;1;1;1
258104338397;258104339030;633;9;1;1;1
258104339030;258104340000;970;9;1;1;1
258104340000;258104364388;24388;9;1;1;1
258104364388;258104364417;29;9;1;1;1
258104364417;258104364462;45;9;1;1;1
258104364462;258104364561;99;9;1;1;1
258104364561;258104364591;30;9;1;1;1
258104364591;258104364603;12;9;1;1;1
258104364603;258104364621;18;9;1;1;1
258104364621;258104364748;127;9;1;1;1
258104364748;258104364782;34;9;1;1;1
258104364782;258104373828;9046;9;1;1;1
258104373828;258104377034;3206;9;1;1;1
258104377034;258104377049;15;9;1;1;1
258104377049;258104377065;16;9;1;1;1
258104377065;258104377188;123;9;1;1;1
258104377188;258104377256;68;9;1;1;1
258104377256;258104377330;74;9;1;1;1
258104377330;258104377496;166;9;1;1;1
258104377496;258104377572;76;9;1;1;1
258104377572;258104377602;30;9;1;1;1
258104377602;258104377632;30;9;1;1;1
258104377632;258104377634;2;9;1;1;1
258104377634;258104377731;97;9;1;1;1
258104377731;258104377813;82;9;1;1;1
258104377813;258104377845;32;9;1;1;1
258104377845;258104377985;140;9;1;1;1
258104377985;258104378022;37;9;1;1;1
258104378022;258104381008;2986;9;1;1;1
258104381008;258104381012;4;9;1;1;1
258104381012;258104381107;95;9;1;1;1
258104381107;258104381151;44;9;1;1;1
258104381151;258104381289;138;9;1;1;1
258104381289;258104381316;27;9;1;1;1
258104381316;258104381354;38;9;1;1;1
258104381354;258104381421;67;9;1;1;1
258104381421;258104381905;484;9;1;1;1
258104381905;258104381943;38;9;1;1;1
258104381943;258104384309;2366;9;1;1;1
258104384309;258104384348;39;9;1;1;1
258104384348;258104384485;137;9;1;1;1
258104384485;258104384548;63;9;1;1;1
258104384548;258104384647;99;9;1;1;1
258104384647;258104384745;98;9;1;1;1
258104384745;258104384890;145;9;1;1;1
258104384890;258104384983;93;9;1;1;1
258104384983;258104385019;36;9;1;1;1
258104385019;258104385055;36;9;1;1;1
258104385055;258104385839;784;9;1;1;1
258104385839;258104395229;9390;9;1;1;1
258104395229;258104396401;1172;9;1;1;1
258104396401;258104396500;99;9;1;1;1
258104396500;258104399890;3390;9;1;1;1
258104399890;258104400247;357;9;1;1;1
258104400247;258104401527;1280;9;1;1;1
258104401527;258104401578;51;9;1;1;1
258104401578;258104401670;92;9;1;1;1
258104401670;258104403026;1356;9;1;1;1
258104403026;258104406612;3586;9;1;1;1
258104406612;258104406808;196;9;1;1;1
258104406808;258104406816;8;9;1;1;1
258104406816;258104406868;52;9;1;1;1
258104406868;258104406918;50;9;1;1;1
258104406918;258104406970;52;9;1;1;1
258104406970;258104407021;51;9;1;1;1
258104407021;258104407332;311;9;1;1;1
258104407332;258104408430;1098;9;1;1;1
258104408430;258104411162;2732;9;1;1;1
258104411162;258104439286;28124;9;1;1;1
258104439286;258104449703;10417;9;1;1;1
258104449703;258104450010;307;9;1;1;1
258104450010;258104500468;50458;9;1;1;1
258104500468;258104500606;138;9;1;1;1
258104500606;258104500627;21;9;1;1;1
258104500627;258104500816;189;9;1;1;1
258104500816;258104500844;28;9;1;1;1
258104500844;258104500962;118;9;1;1;1
258104500962;258104501008;46;9;1;1;1
258104501008;258104501164;156;9;1;1;1
258104501164;258104501238;74;9;1;1;1
258104501238;258104501290;52;9;1;1;1
258104501290;258104501377;87;9;1;1;1
258104501377;258104501678;301;9;1;1;1
258104501678;258104502419;741;9;1;1;1
258104502419;258104502896;477;9;1;1;1
258104502896;258104503076;180;9;1;1;1
258104503076;258104504156;1080;9;1;1;1
258104504156;258104504214;58;9;1;1;1
258104504214;258104508589;4375;9;1;1;1
258104508589;258104508664;75;9;1;1;1
258104508664;258104508760;96;9;1;1;1
258104508760;258104508797;37;9;1;1;1
258104508797;258104508802;5;9;1;1;1
258104508802;258104509007;205;9;1;1;1
258104509007;258104509043;36;9;1;1;1
258104509043;258104509073;30;9;1;1;1
258104509073;258104509372;299;9;1;1;1
258104509372;258104509899;527;9;1;1;1
258104509899;258104511405;1506;9;1;1;1
258104511405;258104511514;109;9;1;1;1
258104511514;258104512016;502;9;1;1;1
258104512016;258104514622;2606;9;1;1;1
258104514622;258104514707;85;9;1;1;1
258104514707;258104515784;1077;9;1;1;1
258104515784;258104515953;169;9;1;1;1
258104515953;258104515996;43;9;1;1;1
258104515996;258104516064;68;9;1;1;1
258104516064;258104516092;28;9;1;1;1
258104516092;258104516142;50;9;1;1;1
258104516142;258104516149;7;9;1;1;1
258104516149;258104516174;25;9;1;1;1
258104516174;258104516273;99;9;1;1;1
258104516273;258104516346;73;9;1;1;1
258104516346;258104516394;48;9;1;1;1
258104516394;258104516405;11;9;1;1;1
258104516405;258104516430;25;9;1;1;1
258104516430;258104516475;45;9;1;1;1
258104516475;258104516758;283;9;1;1;1
258104516758;258104516803;45;9;1;1;1
258104516803;258104517051;248;9;1;1;1
258104517051;258104517485;434;9;1;1;1
258104517485;258104517542;57;9;1;1;1
258104517542;258104518453;911;9;1;1;1
258104518453;258104518470;17;9;1;1;1
258104518470;258104518675;205;9;1;1;1
258104518675;258104518859;184;9;1;1;1
258104518859;258104518905;46;9;1;1;1
258104518905;258104519001;96;9;1;1;1
258104519001;258104519129;128;9;1;1;1
258104519129;258104519350;221;9;1;1;1
258104519350;258104519520;170;9;1;1;1
258104519520;258104519698;178;9;1;1;1
258104519698;258104530259;10561;9;1;1;1
258104530259;258104533504;3245;9;1;1;1
258104533504;258104538500;4996;9;1;1;1
258104538500;258104546407;7907;9;1;1;1
258104546407;258104551025;4618;9;1;1;1
258104551025;258104557281;6256;9;1;1;1
258104557281;258104558753;1472;9;1;1;1
258104558753;258104558804;51;9;1;1;1
258104558804;258104558829;25;9;1;1;1
258104558829;258104558885;56;9;1;1;1
258104558885;258104558897;12;9;1;1;1
258104558897;258104558920;23;9;1;1;1
258104558920;258104559643;723;9;1;1;1
258104559643;258104561886;2243;9;1;1;1
258104561886;258104561937;51;9;1;1;1
258104561937;258104578847;16910;9;1;1;1
258104578847;258104578873;26;9;1;1;1
258104578873;258104579242;369;9;1;1;1
258104579242;258104579508;266;9;1;1;1
258104579508;258104579524;16;9;1;1;1
258104579524;258104579683;159;9;1;1;1
258104579683;258104579752;69;9;1;1;1
258104579752;258104579791;39;9;1;1;1
258104579791;258104607053;27262;9;1;1;1
258104607053;258104607438;385;9;1;1;1
258104607438;258104607696;258;9;1;1;1
258104607696;258104607822;126;9;1;1;1
258104607822;258104607870;48;9;1;1;1
258104607870;258104607899;29;9;1;1;1
258104607899;258104607934;35;9;1;1;1
258104607934;258104608013;79;9;1;1;1
258104608013;258104608059;46;9;1;1;1
258104608059;258104610635;2576;9;1;1;1
258104610635;258104610791;156;9;1;1;1
258104610791;258104611327;536;9;1;1;1
258104611327;258104612483;1156;9;1;1;1
258104612483;258104613298;815;9;1;1;1
258104613298;258104613497;199;9;1;1;1
258104613497;258104613538;41;9;1;1;1
258104613538;258104613583;45;9;1;1;1
258104613583;258104613727;144;9;1;1;1
258104613727;258104613787;60;9;1;1;1
258104613787;258104613817;30;9;1;1;1
258104613817;258104613982;165;9;1;1;1
258104613982;258104614008;26;9;1;1;1
258104614008;258104614089;81;9;1;1;1
258104614089;258104614106;17;9;1;1;1
258104614106;258104624056;9950;9;1;1;1
258104624056;258104633099;9043;9;1;1;1
258104633099;258104653714;20615;9;1;1;1
258104653714;258104655433;1719;9;1;1;1
258104655433;258104666137;10704;9;1;1;1
258104666137;258104666151;14;9;1;1;1
258104666151;258104666202;51;9;1;1;1
258104666202;258104666210;8;9;1;1;1
258104666210;258104666238;28;9;1;1;1
258104666238;258104672558;6320;9;1;1;1
258104672558;258104672849;291;9;1;1;1
258104672849;258104673011;162;2,9;2;1;1
258104673011;258104673208;197;2,9;2;1;1
258104673208;258104673225;17;2,9;2;1;1
258104673225;258104673238;13;2,9;2;1;1
258104673238;258104673268;30;2,9;2;1;1
258104673268;258104680673;7405;2,9;2;1;1
258104680673;258104681133;460;2,9;2;1;1
258104681133;258104681138;5;2,9;2;1;1
258104681138;258104681217;79;2,9;2;1;1
258104681217;258104681594;377;2,9;2;1;1
258104681594;258104681678;84;2,9;2;1;1
258104681678;258104681875;197;2,9;2;1;1
258104681875;258104681897;22;2,9;2;1;1
258104681897;258104681933;36;2,9;2;1;1
258104681933;258104681947;14;2,9;2;1;1
258104681947;258104682110;163;2,9;2;1;1
258104682110;258104695823;13713;2,9;2;1;1
258104695823;258104703889;8066;2,9;2;1;1
258104703889;258104704362;473;2,9;2;1;1
258104704362;258104704581;219;2,9;2;1;1
258104704581;258104704878;297;2,9;2;1;1
258104704878;258104705073;195;2,9;2;1;1
258104705073;258104705125;52;2,9;2;1;1
258104705125;258104705397;272;2,9;2;1;1
258104705397;258104705635;238;2,9;2;1;1
258104705635;258104705676;41;2,9;2;1;1
258104705676;258104705775;99;2,9;2;1;1
258104705775;258104706241;466;2,9;2;1;1
258104706241;258104706629;388;2,9;2;1;1
258104706629;258104710747;4118;2,9;2;1;1
258104710747;258104710919;172;2,9;2;1;1
258104710919;258104711068;149;2,9;2;1;1
258104711068;258104711386;318;2,9;2;1;1
258104711386;258104711426;40;2,9;2;1;1
258104711426;258104711713;287;2,9;2;1;1
258104711713;258104711782;69;2,9;2;1;1
258104711782;258104712160;378;2,9;2;1;1
258104712160;258104712358;198;2,9;2;1;1
258104712358;258104712529;171;2,9;2;1;1
258104712529;258104717808;5279;2,9;2;1;1
258104717808;258104719681;1873;2,9;2;1;1
258104719681;258104722555;2874;2,9;2;1;1
258104722555;258104723127;572;2,9;2;1;1
258104723127;258104723323;196;2,9;2;1;1
258104723323;258104723403;80;2,9;2;1;1
258104723403;258104723456;53;2,9;2;1;1
258104723456;258104723517;61;2,9;2;1;1
258104723517;258104723553;36;2,9;2;1;1
258104723553;258104723577;24;2,9;2;1;1
258104723577;258104723757;180;2,9;2;1;1
258104723757;258104723793;36;2,9;2;1;1
258104723793;258104723915;122;2,9;2;1;1
258104723915;258104724614;699;2,9;2;1;1
258104724614;258104729672;5058;2,9;2;1;1
258104729672;258104734179;4507;2,9;2;1;1
258104734179;258104735308;1129;2,9;2;1;1
258104735308;258104737890;2582;2,9;2;1;1
258104737890;258104748039;10149;2,9;2;1;1
258104748039;258104748073;34;2,9;2;1;1
258104748073;258104748769;696;2,9;2;1;1
258104748769;258104752198;3429;2,9;2;1;1
258104752198;258104769304;17106;9;1;1;1
258104769304;258104769489;185;9;1;1;1
258104769489;258104769653;164;9;1;1;1
258104769653;258104769999;346;9;1;1;1
258104769999;258104773129;3130;9;1;1;1
258104773129;258104773444;315;9;1;1;1
258104773444;258104773625;181;9;1;1;1
258104773625;258104774127;502;9;1;1;1
258104774127;258104774164;37;9;1;1;1
258104774164;258104774546;382;9;1;1;1
258104774546;258104774696;150;9;1;1;1
258104774696;258104774922;226;9;1;1;1
258104774922;258104775119;197;9;1;1;1
258104775119;258104775321;202;9;1;1;1
258104775321;258104775390;69;9;1;1;1
258104775390;258104775395;5;2,9;2;1;1
258104775395;258104775552;157;2,9;2;1;1
258104775552;258104775855;303;2,9;2;1;1
258104775855;258104775897;42;2,9;2;1;1
258104775897;258104775919;22;2,9;2;1;1
258104775919;258104775954;35;9;1;1;1
258104775954;258104776060;106;9;1;1;1
258104776060;258104776176;116;9;1;1;1
258104776176;258104776309;133;9;1;1;1
258104776309;258104776628;319;9;1;1;1
258104776628;258104776693;65;9;1;1;1
258104776693;258104776756;63;9;1;1;1
258104776756;258104776787;31;9;1;1;1
258104776787;258104776831;44;9;1;1;1
258104776831;258104777095;264;9;1;1;1
258104777095;258104780532;3437;9;1;1;1
258104780532;258104780735;203;9;1;1;1
258104780735;258104780770;35;9;1;1;1
258104780770;258104780806;36;9;1;1;1
258104780806;258104780828;22;9;1;1;1
258104780828;258104781015;187;9;1;1;1
258104781015;258104781180;165;9;1;1;1
258104781180;258104781429;249;9;1;1;1
258104781429;258104781577;148;9;1;1;1
258104781577;258104781722;145;9;1;1;1
258104781722;258104782384;662;9;1;1;1
258104782384;258104785745;3361;9;1;1;1
258104785745;258104786062;317;9;1;1;1
258104786062;258104789269;3207;9;1;1;1
258104789269;258104796943;7674;9;1;1;1
258104796943;258104801454;4511;9;1;1;1
258104801454;258104809141;7687;9;1;1;1
258104809141;258104810840;1699;2,9;2;1;1
258104810840;258104812208;1368;2,9;2;1;1
258104812208;258104818970;6762;2,9;2;1;1
258104818970;258104819375;405;2,9;2;1;1
258104819375;258104819508;133;2,9;2;1;1
258104819508;258104819727;219;2,9;2;1;1
258104819727;258104819935;208;2,9;2;1;1
258104819935;258104819959;24;2,9;2;1;1
258104819959;258104820062;103;2,9;2;1;1
258104820062;258104820106;44;2,9;2;1;1
258104820106;258104820292;186;2,9;2;1;1
258104820292;258104820409;117;2,9;2;1;1
258104820409;258104820451;42;2,9;2;1;1
258104820451;258104823000;2549;2,9;2;1;1
258104823000;258104827024;4024;2,9;2;1;1
258104827024;258104832327;5303;2,9;2;1;1
258104832327;258104843504;11177;2,9;2;1;1
258104843504;258104845668;2164;2,9;2;1;1
258104845668;258104847462;1794;2,9;2;1;1
258104847462;258104849070;1608;2,9;2;1;1
258104849070;258104849212;142;2,9;2;1;1
258104849212;258104849632;420;2,9;2;1;1
258104849632;258104850203;571;2,9;2;1;1
258104850203;258104852634;2431;2,9;2;1;1
258104852634;258104852912;278;2,9;2;1;1
258104852912;258104854109;1197;2,9;2;1;1
258104854109;258104855279;1170;2,9;2;1;1
258104855279;258104855424;145;2,9;2;1;1
258104855424;258104855799;375;2,9;2;1;1
258104855799;258104856422;623;2,9;2;1;1
258104856422;258104857795;1373;2,9;2;1;1
258104857795;258104857862;67;2,9;2;1;1
258104857862;258104857938;76;2,9;2;1;1
258104857938;258104858146;208;2,9;2;1;1
258104858146;258104858192;46;2,9;2;1;1
258104858192;258104858216;24;2,9;2;1;1
258104858216;258104858238;22;2,9;2;1;1
258104858238;258104858350;112;2,9;2;1;1
258104858350;258104858478;128;2,9;2;1;1
258104858478;258104858624;146;2,9;2;1;1
258104858624;258104859505;881;2,9;2;1;1
258104859505;258104864224;4719;9;1;1;1
258104864224;258104868839;4615;9;1;1;1
258104868839;258104873214;4375;9;1;1;1
258104873214;258104873435;221;9;1;1;1
258104873435;258104878834;5399;9;1;1;1
258104878834;258104878899;65;9;1;1;1
258104878899;258104878931;32;9;1;1;1
258104878931;258104904150;25219;9;1;1;1
258104904150;258104908634;4484;9;1;1;1
258104908634;258104908706;72;9;1;1;1
258104908706;258104908740;34;9;1;1;1
258104908740;258104908907;167;9;1;1;1
258104908907;258104921762;12855;9;1;1;1
258104921762;258104936960;15198;2,9;2;1;1
258104936960;258104937519;559;2,9;2;1;1
258104937519;258104938517;998;2,9;2;1;1
258104938517;258104941296;2779;2,9;2;1;1
258104941296;258104948381;7085;2,9;2;1;1
258104948381;258104951385;3004;9;1;1;1
258104951385;258104951653;268;9;1;1;1
258104951653;258104951682;29;9;1;1;1
258104951682;258104951915;233;9;1;1;1
258104951915;258104952053;138;9;1;1;1
258104952053;258104956821;4768;9;1;1;1
258104956821;258104957091;270;9;1;1;1
258104957091;258104957124;33;9;1;1;1
258104957124;258104957354;230;9;1;1;1
258104957354;258104957397;43;9;1;1;1
258104957397;258104957494;97;9;1;1;1
258104957494;258104957585;91;9;1;1;1
258104957585;258104957818;233;9;1;1;1
258104957818;258104958011;193;9;1;1;1
258104958011;258104958054;43;9;1;1;1
258104958054;258104961479;3425;9;1;1;1
258104961479;258104961665;186;9;1;1;1
258104961665;258104961896;231;9;1;1;1
258104961896;258104962072;176;9;1;1;1
258104962072;258104962340;268;9;1;1;1
258104962340;258104962672;332;9;1;1;1
258104962672;258104962879;207;9;1;1;1
258104962879;258104962955;76;9;1;1;1
258104962955;258104962981;26;9;1;1;1
258104962981;258104963299;318;9;1;1;1
258104963299;258104963652;353;9;1;1;1
258104963652;258104963701;49;9;1;1;1
258104963701;258104964452;751;9;1;1;1
258104964452;258104964514;62;9;1;1;1
258104964514;258104965117;603;9;1;1;1
258104965117;258104965147;30;9;1;1;1
258104965147;258104965271;124;9;1;1;1
258104965271;258104967105;1834;9;1;1;1
258104967105;258104970148;3043;9;1;1;1
258104970148;258104974372;4224;9;1;1;1
258104974372;258104975452;1080;2,9;2;1;1
258104975452;258104975797;345;2,9;2;1;1
258104975797;258104979065;3268;2,9;2;1;1
258104979065;258104980932;1867;2,9;2;1;1
258104980932;258104982429;1497;2,9;2;1;1
258104982429;258104986177;3748;9;1;1;1
258104986177;258104986240;63;9;1;1;1
258104986240;258104986251;11;9;1;1;1
258104986251;258104986275;24;9;1;1;1
258104986275;258104986853;578;9;1;1;1
258104986853;258104988242;1389;9;1;1;1
258104988242;258104989452;1210;2,9;2;1;1
258104989452;258104990628;1176;9;1;1;1
258104990628;258104992367;1739;2,9;2;1;1
258104992367;258104993235;868;2,9;2;1;1
258104993235;258104995561;2326;2,9;2;1;1
258104995561;258104996259;698;2,9;2;1;1
258104996259;258105000674;4415;2,9;2;1;1
258105000674;258105001782;1108;2,9;2;1;1
258105001782;258105001832;50;2,9;2;1;1
258105001832;258105001863;31;2,9;2;1;1
258105001863;258105002230;367;2,9;2;1;1
258105002230;258105002304;74;2,9;2;1;1
258105002304;258105002320;16;2,9;2;1;1
258105002320;258105002381;61;2,9;2;1;1
258105002381;258105003904;1523;2,9;2;1;1
258105003904;258105004407;503;2,9;2;1;1
258105004407;258105004602;195;2,9;2;1;1
258105004602;258105005277;675;2,9;2;1;1
258105005277;258105005779;502;9;1;1;1
258105005779;258105006485;706;2,9;2;1;1
258105006485;258105031978;25493;9;1;1;1
258105031978;258105041696;9718;9;1;1;1
258105041696;258105041913;217;9;1;1;1
258105041913;258105045623;3710;9;1;1;1
258105045623;258105045899;276;9;1;1;1
258105045899;258105045935;36;9;1;1;1
258105045935;258105046295;360;9;1;1;1
258105046295;258105046329;34;9;1;1;1
258105046329;258105046456;127;2,9;2;1;1
258105046456;258105049018;2562;2,9;2;1;1
258105049018;258105049601;583;2,9;2;1;1
258105049601;258105049918;317;2,9;2;1;1
258105049918;258105049954;36;2,9;2;1;1
258105049954;258105050081;127;2,9;2;1;1
258105050081;258105050173;92;2,9;2;1;1
258105050173;258105050217;44;2,9;2;1;1
258105050217;258105050280;63;2,9;2;1;1
258105050280;258105050332;52;2,9;2;1;1
258105050332;258105050358;26;2,9;2;1;1
258105050358;258105050378;20;2,9;2;1;1
258105050378;258105050469;91;2,9;2;1;1
258105050469;258105050599;130;2,9;2;1;1
258105050599;258105050604;5;2,9;2;1;1
258105050604;258105050710;106;2,9;2;1;1
258105050710;258105050789;79;2,9;2;1;1
258105050789;258105050833;44;2,9;2;1;1
258105050833;258105050838;5;2,9;2;1;1
258105050838;258105050908;70;2,9;2;1;1
258105050908;258105050964;56;2,9;2;1;1
258105050964;258105051004;40;2,9;2;1;1
258105051004;258105051215;211;2,9;2;1;1
258105051215;258105055531;4316;2,9;2;1;1
258105055531;258105057995;2464;2,9;2;1;1
258105057995;258105063514;5519;2,9;2;1;1
258105063514;258105066809;3295;2,9;2;1;1
258105066809;258105067054;245;2,9;2;1;1
258105067054;258105069504;2450;2,9;2;1;1
258105069504;258105069555;51;2,9;2;1;1
258105069555;258105069605;50;2,9;2;1;1
258105069605;258105069658;53;2,9;2;1;1
258105069658;258105069692;34;2,9;2;1;1
258105069692;258105069715;23;2,9;2;1;1
258105069715;258105071575;1860;2,9;2;1;1
258105071575;258105071623;48;2,9;2;1;1
258105071623;258105071650;27;2,9;2;1;1
258105071650;258105071793;143;2,9;2;1;1
258105071793;258105071927;134;2,9;2;1;1
258105071927;258105072099;172;2,9;2;1;1
258105072099;258105072284;185;2,9;2;1;1
258105072284;258105072311;27;2,9;2;1;1
258105072311;258105072514;203;2,9;2;1;1
258105072514;258105072555;41;2,9;2;1;1
258105072555;258105074175;1620;2,9;2;1;1
258105074175;258105077195;3020;2,9;2;1;1
258105077195;258105081731;4536;2,9;2;1;1
258105081731;258105083557;1826;2,9;2;1;1
258105083557;258105085861;2304;2,9;2;1;1
258105085861;258105086887;1026;2,9;2;1;1
258105086887;258105087006;119;2,9;2;1;1
258105087006;258105087487;481;2,9;2;1;1
258105087487;258105087500;13;2,9;2;1;1
258105087500;258105087533;33;2,9;2;1;1
258105087533;258105087621;88;2,9;2;1;1
258105087621;258105087636;15;2,9;2;1;1
258105087636;258105087733;97;2,9;2;1;1
258105087733;258105088013;280;2,9;2;1;1
258105088013;258105088212;199;2,9;2;1;1
258105088212;258105088379;167;2,9;2;1;1
258105088379;258105088863;484;2,9;2;1;1
258105088863;258105089133;270;9;1;1;1
258105089133;258105089163;30;9;1;1;1
258105089163;258105089273;110;9;1;1;1
258105089273;258105089385;112;9;1;1;1
258105089385;258105089522;137;9;1;1;1
258105089522;258105089910;388;9;1;1;1
258105089910;258105092235;2325;9;1;1;1
258105092235;258105092254;19;9;1;1;1
258105092254;258105092406;152;9;1;1;1
258105092406;258105092505;99;9;1;1;1
258105092505;258105092532;27;9;1;1;1
258105092532;258105092566;34;9;1;1;1
258105092566;258105092763;197;9;1;1;1
258105092763;258105092769;6;9;1;1;1
258105092769;258105092883;114;9;1;1;1
258105092883;258105092937;54;9;1;1;1
258105092937;258105092967;30;9;1;1;1
258105092967;258105093037;70;9;1;1;1
258105093037;258105093065;28;9;1;1;1
258105093065;258105093264;199;9;1;1;1
258105093264;258105093298;34;9;1;1;1
258105093298;258105093480;182;9;1;1;1
258105093480;258105093630;150;9;1;1;1
258105093630;258105093668;38;9;1;1;1
258105093668;258105093761;93;9;1;1;1
258105093761;258105093881;120;9;1;1;1
258105093881;258105094001;120;9;1;1;1
258105094001;258105094476;475;9;1;1;1
258105094476;258105098304;3828;9;1;1;1
258105098304;258105098788;484;9;1;1;1
258105098788;258105103526;4738;9;1;1;1
258105103526;258105103859;333;9;1;1;1
258105103859;258105104174;315;9;1;1;1
258105104174;258105104225;51;9;1;1;1
258105104225;258105104275;50;9;1;1;1
258105104275;258105104348;73;9;1;1;1
258105104348;258105104358;10;9;1;1;1
258105104358;258105104374;16;9;1;1;1
258105104374;258105104436;62;9;1;1;1
258105104436;258105104443;7;9;1;1;1
258105104443;258105105465;1022;9;1;1;1
258105105465;258105107381;1916;9;1;1;1
258105107381;258105107719;338;9;1;1;1
258105107719;258105107772;53;9;1;1;1
258105107772;258105107808;36;9;1;1;1
258105107808;258105109413;1605;9;1;1;1
258105109413;258105115829;6416;9;1;1;1
258105115829;258105116467;638;9;1;1;1
258105116467;258105116965;498;9;1;1;1
258105116965;258105116973;8;9;1;1;1
258105116973;258105117055;82;9;1;1;1
258105117055;258105117277;222;9;1;1;1
258105117277;258105117348;71;9;1;1;1
258105117348;258105118020;672;9;1;1;1
258105118020;258105120738;2718;9;1;1;1
258105120738;258105120927;189;9;1;1;1
258105120927;258105121064;137;9;1;1;1
258105121064;258105121130;66;9;1;1;1
258105121130;258105121515;385;9;1;1;1
258105121515;258105124350;2835;9;1;1;1
258105124350;258105126631;2281;9;1;1;1
258105126631;258105127209;578;9;1;1;1
258105127209;258105127383;174;9;1;1;1
258105127383;258105128668;1285;9;1;1;1
258105128668;258105129592;924;9;1;1;1
258105129592;258105138689;9097;9;1;1;1
258105138689;258105139307;618;9;1;1;1
258105139307;258105140048;741;9;1;1;1
258105140048;258105141076;1028;9;1;1;1
258105141076;258105142260;1184;2,9;2;1;1
258105142260;258105143898;1638;2,9;2;1;1
258105143898;258105144628;730;2,9;2;1;1
258105144628;258105150675;6047;2,9;2;1;1
258105150675;258105152960;2285;2,9;2;1;1
258105152960;258105153347;387;2,9;2;1;1
258105153347;258105154938;1591;2,9;2;1;1
258105154938;258105157746;2808;2,9;2;1;1
258105157746;258105158227;481;2,9;2;1;1
258105158227;258105159881;1654;2,9;2;1;1
258105159881;258105160179;298;2,9;2;1;1
258105160179;258105160317;138;2,9;2;1;1
258105160317;258105160319;2;2,9;2;1;1
258105160319;258105160478;159;2,9;2;1;1
258105160478;258105160862;384;2,9;2;1;1
258105160862;258105160913;51;2,9;2;1;1
258105160913;258105161142;229;2,9;2;1;1
258105161142;258105161188;46;2,9;2;1;1
258105161188;258105161351;163;2,9;2;1;1
258105161351;258105164259;2908;2,9;2;1;1
258105164259;258105165553;1294;2,9;2;1;1
258105165553;258105169468;3915;2,9;2;1;1
258105169468;258105169518;50;2,9;2;1;1
258105169518;258105171074;1556;2,9;2;1;1
258105171074;258105172989;1915;2,9;2;1;1
258105172989;258105173034;45;2,9;2;1;1
258105173034;258105173089;55;2,9;2;1;1
258105173089;258105173090;1;2,9;2;1;1
258105173090;258105173266;176;2,9;2;1;1
258105173266;258105173427;161;2,9;2;1;1
258105173427;258105173460;33;2,9;2;1;1
258105173460;258105173505;45;2,9;2;1;1
258105173505;258105173568;63;2,9;2;1;1
258105173568;258105173609;41;2,9;2;1;1
258105173609;258105173797;188;2,9;2;1;1
258105173797;258105174390;593;2,9;2;1;1
258105174390;258105175952;1562;2,9;2;1;1
258105175952;258105176204;252;2,9;2;1;1
258105176204;258105179544;3340;2,9;2;1;1
258105179544;258105180525;981;2,9;2;1;1
258105180525;258105185305;4780;2,9;2;1;1
258105185305;258105185600;295;2,9;2;1;1
258105185600;258105185704;104;2,9;2;1;1
258105185704;258105185891;187;2,9;2;1;1
258105185891;258105186520;629;2,9;2;1;1
258105186520;258105187473;953;2,9;2;1;1
258105187473;258105188305;832;2,9;2;1;1
258105188305;258105188952;647;2,9;2;1;1
258105188952;258105189630;678;2,9;2;1;1
258105189630;258105197373;7743;2,9;2;1;1
258105197373;258105198105;732;9;1;1;1
258105198105;258105198191;86;9;1;1;1
258105198191;258105198225;34;9;1;1;1
258105198225;258105198432;207;9;1;1;1
258105198432;258105198498;66;9;1;1;1
258105198498;258105205384;6886;9;1;1;1
258105205384;258105205778;394;9;1;1;1
258105205778;258105205936;158;9;1;1;1
258105205936;258105206342;406;9;1;1;1
258105206342;258105206556;214;9;1;1;1
258105206556;258105206682;126;9;1;1;1
258105206682;258105206724;42;9;1;1;1
258105206724;258105206753;29;9;1;1;1
258105206753;258105206897;144;9;1;1;1
258105206897;258105207230;333;9;1;1;1
258105207230;258105208569;1339;9;1;1;1
258105208569;258105208679;110;9;1;1;1
258105208679;258105212078;3399;9;1;1;1
258105212078;258105214313;2235;9;1;1;1
258105214313;258105214363;50;9;1;1;1
258105214363;258105214376;13;9;1;1;1
258105214376;258105214396;20;9;1;1;1
258105214396;258105214564;168;9;1;1;1
258105214564;258105214999;435;9;1;1;1
258105214999;258105218206;3207;9;1;1;1
258105218206;258105218243;37;9;1;1;1
258105218243;258105218349;106;9;1;1;1
258105218349;258105218487;138;9;1;1;1
258105218487;258105218532;45;9;1;1;1
258105218532;258105218572;40;9;1;1;1
258105218572;258105218577;5;9;1;1;1
258105218577;258105218728;151;9;1;1;1
258105218728;258105218895;167;9;1;1;1
258105218895;258105219071;176;9;1;1;1
258105219071;258105219570;499;9;1;1;1
258105219570;258105228707;9137;9;1;1;1
258105228707;258105229035;328;9;1;1;1
258105229035;258105229755;720;9;1;1;1
258105229755;258105240428;10673;9;1;1;1
258105240428;258105251947;11519;9;1;1;1
258105251947;258105256214;4267;9;1;1;1
258105256214;258105257840;1626;2,9;2;1;1
258105257840;258105260660;2820;2,9;2;1;1
258105260660;258105261596;936;2,9;2;1;1
258105261596;258105261604;8;2,9;2;1;1
258105261604;258105261656;52;2,9;2;1;1
258105261656;258105261943;287;2,9;2;1;1
258105261943;258105270034;8091;2,9;2;1;1
258105270034;258105272300;2266;2,9;2;1;1
258105272300;258105273728;1428;2,9;2;1;1
258105273728;258105278395;4667;2,9;2;1;1
258105278395;258105278402;7;2,9;2;1;1
258105278402;258105278462;60;2,9;2;1;1
258105278462;258105278672;210;2,9;2;1;1
258105278672;258105278708;36;2,9;2;1;1
258105278708;258105278802;94;2,9;2;1;1
258105278802;258105278923;121;2,9;2;1;1
258105278923;258105279163;240;2,9;2;1;1
258105279163;258105279287;124;2,9;2;1;1
258105279287;258105279409;122;2,9;2;1;1
258105279409;258105282107;2698;2,9;2;1;1
258105282107;258105283406;1299;2,9;2;1;1
258105283406;258105284303;897;2,9;2;1;1
258105284303;258105287543;3240;2,9;2;1;1
258105287543;258105288739;1196;2,9;2;1;1
258105288739;258105289008;269;2,9;2;1;1
258105289008;258105294429;5421;2,9;2;1;1
258105294429;258105294557;128;2,9;2;1;1
258105294557;258105294820;263;2,9;2;1;1
258105294820;258105294899;79;2,9;2;1;1
258105294899;258105295624;725;2,9;2;1;1
258105295624;258105295671;47;2,9;2;1;1
258105295671;258105295709;38;2,9;2;1;1
258105295709;258105295747;38;2,9;2;1;1
258105295747;258105298823;3076;2,9;2;1;1
258105298823;258105299378;555;2,9;2;1;1
258105299378;258105299424;46;2,9;2;1;1
258105299424;258105299460;36;2,9;2;1;1
258105299460;258105299496;36;2,9;2;1;1
258105299496;258105299923;427;2,9;2;1;1
258105299923;258105299930;7;2,9;2;1;1
258105299930;258105299966;36;2,9;2;1;1
258105299966;258105300537;571;2,9;2;1;1
258105300537;258105301216;679;2,9;2;1;1
258105301216;258105301880;664;2,9;2;1;1
258105301880;258105304459;2579;2,9;2;1;1
258105304459;258105305342;883;2,9;2;1;1
258105305342;258105305634;292;2,9;2;1;1
258105305634;258105306141;507;2,9;2;1;1
258105306141;258105306754;613;2,9;2;1;1
258105306754;258105307816;1062;2,9;2;1;1
258105307816;258105315808;7992;2,9;2;1;1
258105315808;258105315844;36;2,9;2;1;1
258105315844;258105315912;68;2,9;2;1;1
258105315912;258105316237;325;2,9;2;1;1
258105316237;258105320197;3960;2,9;2;1;1
258105320197;258105332772;12575;9;1;1;1
258105332772;258105337508;4736;2,9;2;1;1
258105337508;258105338603;1095;2,9;2;1;1
258105338603;258105343760;5157;2,9;2;1;1
258105343760;258105358608;14848;2,9;2;1;1
258105358608;258105364047;5439;2,9;2;1;1
258105364047;258105364978;931;2,9;2;1;1
258105364978;258105365766;788;2,9;2;1;1
258105365766;258105366695;929;2,9;2;1;1
258105366695;258105371354;4659;2,9;2;1;1
258105371354;258105372022;668;2,9;2;1;1
258105372022;258105372186;164;2,9;2;1;1
258105372186;258105375966;3780;2,9;2;1;1
258105375966;258105377250;1284;2,9;2;1;1
258105377250;258105377416;166;2,9;2;1;1
258105377416;258105378009;593;2,9;2;1;1
258105378009;258105378427;418;2,9;2;1;1
258105378427;258105378462;35;2,9;2;1;1
258105378462;258105378505;43;2,9;2;1;1
258105378505;258105378547;42;2,9;2;1;1
258105378547;258105378598;51;2,9;2;1;1
258105378598;258105378640;42;2,9;2;1;1
258105378640;258105378680;40;2,9;2;1;1
258105378680;258105385374;6694;2,9;2;1;1
258105385374;258105385986;612;2,9;2;1;1
258105385986;258105386302;316;2,9;2;1;1
258105386302;258105401814;15512;2,9;2;1;1
258105401814;258105413494;11680;9;1;1;1
258105413494;258105413947;453;9;1;1;1
258105413947;258105417157;3210;9;1;1;1
258105417157;258105417500;343;9;1;1;1
258105417500;258105417566;66;9;1;1;1
258105417566;258105417900;334;9;1;1;1
258105417900;258105417934;34;9;1;1;1
258105417934;258105418041;107;9;1;1;1
258105418041;258105418112;71;9;1;1;1
258105418112;258105418133;21;9;1;1;1
258105418133;258105418147;14;9;1;1;1
258105418147;258105418228;81;9;1;1;1
258105418228;258105418288;60;9;1;1;1
258105418288;258105418318;30;9;1;1;1
258105418318;258105418420;102;9;1;1;1
258105418420;258105423593;5173;9;1;1;1
258105423593;258105423692;99;9;1;1;1
258105423692;258105423701;9;9;1;1;1
258105423701;258105423929;228;9;1;1;1
258105423929;258105424316;387;9;1;1;1
258105424316;258105424993;677;9;1;1;1
258105424993;258105428580;3587;9;1;1;1
258105428580;258105428600;20;9;1;1;1
258105428600;258105428887;287;9;1;1;1
258105428887;258105429664;777;9;1;1;1
258105429664;258105429749;85;9;1;1;1
258105429749;258105429779;30;9;1;1;1
258105429779;258105430022;243;9;1;1;1
258105430022;258105430480;458;9;1;1;1
258105430480;258105430672;192;9;1;1;1
258105430672;258105430936;264;9;1;1;1
258105430936;258105431149;213;9;1;1;1
258105431149;258105431249;100;9;1;1;1
258105431249;258105431869;620;9;1;1;1
258105431869;258105432349;480;9;1;1;1
258105432349;258105432385;36;9;1;1;1
258105432385;258105433712;1327;9;1;1;1
258105433712;258105435486;1774;2,9;2;1;1
258105435486;258105437525;2039;2,9;2;1;1
258105437525;258105439397;1872;2,9;2;1;1
258105439397;258105440886;1489;2,9;2;1;1
258105440886;258105441396;510;2,9;2;1;1
258105441396;258105441431;35;2,9;2;1;1
258105441431;258105441466;35;2,9;2;1;1
258105441466;258105441631;165;2,9;2;1;1
258105441631;258105444255;2624;2,9;2;1;1
258105444255;258105447049;2794;2,9;2;1;1
258105447049;258105447164;115;2,9;2;1;1
258105447164;258105452004;4840;2,9;2;1;1
258105452004;258105452041;37;2,9;2;1;1
258105452041;258105452432;391;2,9;2;1;1
258105452432;258105452449;17;2,9;2;1;1
258105452449;258105452555;106;2,9;2;1;1
258105452555;258105452661;106;2,9;2;1;1
258105452661;258105452752;91;2,9;2;1;1
258105452752;258105453164;412;2,9;2;1;1
258105453164;258105457014;3850;2,9;2;1;1
258105457014;258105457409;395;2,9;2;1;1
258105457409;258105457499;90;2,9;2;1;1
258105457499;258105457527;28;2,9;2;1;1
258105457527;258105457629;102;2,9;2;1;1
258105457629;258105457780;151;2,9;2;1;1
258105457780;258105458167;387;2,9;2;1;1
258105458167;258105458221;54;2,9;2;1;1
258105458221;258105458305;84;2,9;2;1;1
258105458305;258105458472;167;2,9;2;1;1
258105458472;258105458520;48;2,9;2;1;1
258105458520;258105458886;366;2,9;2;1;1
258105458886;258105458956;70;2,9;2;1;1
258105458956;258105459196;240;2,9;2;1;1
258105459196;258105459565;369;2,9;2;1;1
258105459565;258105459769;204;2,9;2;1;1
258105459769;258105459810;41;2,9;2;1;1
258105459810;258105459882;72;2,9;2;1;1
258105459882;258105460040;158;2,9;2;1;1
258105460040;258105461717;1677;2,9;2;1;1
258105461717;258105466275;4558;2,9;2;1;1
258105466275;258105467275;1000;2,9;2;1;1
258105467275;258105468603;1328;2,9;2;1;1
258105468603;258105468673;70;2,9;2;1;1
258105468673;258105477267;8594;2,9;2;1;1
258105477267;258105479020;1753;2,9;2;1;1
258105479020;258105480154;1134;2,9;2;1;1
258105480154;258105482007;1853;2,9;2;1;1
258105482007;258105482317;310;2,9;2;1;1
258105482317;258105482914;597;2,9;2;1;1
258105482914;258105483625;711;2,9;2;1;1
258105483625;258105483904;279;2,9;2;1;1
258105483904;258105484198;294;2,9;2;1;1
258105484198;258105484772;574;2,9;2;1;1
258105484772;258105486607;1835;9;1;1;1
258105486607;258105486903;296;9;1;1;1
258105486903;258105512886;25983;9;1;1;1
258105512886;258105513140;254;9;1;1;1
258105513140;258105513191;51;9;1;1;1
258105513191;258105513217;26;9;1;1;1
258105513217;258105513240;23;9;1;1;1
258105513240;258105513618;378;9;1;1;1
258105513618;258105514740;1122;9;1;1;1
258105514740;258105514756;16;9;1;1;1
258105514756;258105516407;1651;9;1;1;1
258105516407;258105526929;10522;9;1;1;1
258105526929;258105533261;6332;9;1;1;1
258105533261;258105537465;4204;9;1;1;1
258105537465;258105537710;245;9;1;1;1
258105537710;258105538015;305;9;1;1;1
258105538015;258105538445;430;9;1;1;1
258105538445;258105538474;29;9;1;1;1
258105538474;258105542005;3531;9;1;1;1
258105542005;258105542049;44;9;1;1;1
258105542049;258105542126;77;9;1;1;1
258105542126;258105542153;27;9;1;1;1
258105542153;258105542309;156;9;1;1;1
258105542309;258105542491;182;9;1;1;1
258105542491;258105542659;168;9;1;1;1
258105542659;258105542688;29;9;1;1;1
258105542688;258105542732;44;9;1;1;1
258105542732;258105542847;115;9;1;1;1
258105542847;258105550539;7692;9;1;1;1
258105550539;258105551426;887;9;1;1;1
258105551426;258105559787;8361;2,9;2;1;1
258105559787;258105559994;207;2,9;2;1;1
258105559994;258105564073;4079;2,9;2;1;1
258105564073;258105575015;10942;2,9;2;1;1
258105575015;258105577764;2749;2,9;2;1;1
258105577764;258105577938;174;2,9;2;1;1
258105577938;258105580000;2062;2,9;2;1;1
258105580000;258105582274;2274;2,9;2;1;1
258105582274;258105585709;3435;2,9;2;1;1
258105585709;258105588279;2570;2,9;2;1;1
258105588279;258105588287;8;2,9;2;1;1
258105588287;258105588314;27;2,9;2;1;1
258105588314;258105588369;55;2,9;2;1;1
258105588369;258105588882;513;2,9;2;1;1
258105588882;258105588893;11;2,9;2;1;1
258105588893;258105589034;141;2,9;2;1;1
258105589034;258105590503;1469;2,9;2;1;1
258105590503;258105590979;476;2,9;2;1;1
258105590979;258105591781;802;2,9;2;1;1
258105591781;258105593688;1907;2,9;2;1;1
258105593688;258105593900;212;2,9;2;1;1
258105593900;258105598385;4485;2,9;2;1;1
258105598385;258105599498;1113;2,9;2;1;1
258105599498;258105599527;29;2,9;2;1;1
258105599527;258105600516;989;2,9;2;1;1
258105600516;258105600537;21;9;1;1;1
258105600537;258105600699;162;9;1;1;1
258105600699;258105601670;971;9;1;1;1
258105601670;258105604705;3035;9;1;1;1
258105604705;258105604723;18;9;1;1;1
258105604723;258105604748;25;9;1;1;1
258105604748;258105604822;74;9;1;1;1
258105604822;258105604889;67;9;1;1;1
258105604889;258105604914;25;9;1;1;1
258105604914;258105604967;53;9;1;1;1
258105604967;258105605085;118;9;1;1;1
258105605085;258105605111;26;9;1;1;1
258105605111;258105605178;67;9;1;1;1
258105605178;258105607201;2023;9;1;1;1
258105607201;258105607233;32;9;1;1;1
258105607233;258105607361;128;9;1;1;1
258105607361;258105607363;2;9;1;1;1
258105607363;258105607365;2;9;1;1;1
258105607365;258105607559;194;9;1;1;1
258105607559;258105607600;41;9;1;1;1
258105607600;258105607729;129;9;1;1;1
258105607729;258105608199;470;9;1;1;1
258105608199;258105616538;8339;9;1;1;1
258105616538;258105621811;5273;9;1;1;1
258105621811;258105623550;1739;9;1;1;1
258105623550;258105625491;1941;9;1;1;1
258105625491;258105625549;58;9;1;1;1
258105625549;258105626056;507;9;1;1;1
258105626056;258105626073;17;9;1;1;1
258105626073;258105626092;19;9;1;1;1
258105626092;258105626465;373;9;1;1;1
258105626465;258105626706;241;9;1;1;1
258105626706;258105638054;11348;9;1;1;1
258105638054;258105638104;50;9;1;1;1
258105638104;258105638164;60;9;1;1;1
258105638164;258105638177;13;9;1;1;1
258105638177;258105638971;794;9;1;1;1
258105638971;258105647079;8108;9;1;1;1
258105647079;258105648838;1759;2,9;2;1;1
258105648838;258105650862;2024;2,9;2;1;1
258105650862;258105650929;67;2,9;2;1;1
258105650929;258105650995;66;2,9;2;1;1
258105650995;258105653846;2851;2,9;2;1;1
258105653846;258105666446;12600;2,9;2;1;1
258105666446;258105666519;73;2,9;2;1;1
258105666519;258105667588;1069;2,9;2;1;1
258105667588;258105668253;665;2,9;2;1;1
258105668253;258105673334;5081;2,9;2;1;1
258105673334;258105680635;7301;2,9;2;1;1
258105680635;258105680782;147;2,9;2;1;1
258105680782;258105682797;2015;2,9;2;1;1
258105682797;258105685125;2328;2,9;2;1;1
258105685125;258105685441;316;2,9;2;1;1
258105685441;258105685495;54;2,9;2;1;1
258105685495;258105685734;239;2,9;2;1;1
258105685734;258105685762;28;2,9;2;1;1
258105685762;258105685834;72;2,9;2;1;1
258105685834;258105686545;711;2,9;2;1;1
258105686545;258105686972;427;2,9;2;1;1
258105686972;258105688468;1496;2,9;2;1;1
258105688468;258105689607;1139;2,9;2;1;1
258105689607;258105690221;614;2,9;2;1;1
258105690221;258105691317;1096;2,9;2;1;1
258105691317;258105696686;5369;9;1;1;1
258105696686;258105696856;170;9;1;1;1
258105696856;258105713451;16595;9;1;1;1
258105713451;258105738838;25387;9;1;1;1
258105738838;258105748614;9776;9;1;1;1
258105748614;258105748761;147;9;1;1;1
258105748761;258105753992;5231;9;1;1;1
258105753992;258105755493;1501;2,9;2;1;1
258105755493;258105761626;6133;2,9;2;1;1
258105761626;258105763673;2047;2,9;2;1;1
258105763673;258105768171;4498;2,9;2;1;1
258105768171;258105770854;2683;2,9;2;1;1
258105770854;258105773680;2826;2,9;2;1;1
258105773680;258105780189;6509;2,9;2;1;1
258105780189;258105786047;5858;2,9;2;1;1
258105786047;258105788979;2932;2,9;2;1;1
258105788979;258105790345;1366;2,9;2;1;1
258105790345;258105790600;255;2,9;2;1;1
258105790600;258105790730;130;2,9;2;1;1
258105790730;258105790799;69;2,9;2;1;1
258105790799;258105791204;405;2,9;2;1;1
258105791204;258105791246;42;2,9;2;1;1
258105791246;258105791874;628;2,9;2;1;1
258105791874;258105791924;50;2,9;2;1;1
258105791924;258105791978;54;2,9;2;1;1
258105791978;258105796069;4091;2,9;2;1;1
258105796069;258105796147;78;2,9;2;1;1
258105796147;258105796244;97;2,9;2;1;1
258105796244;258105796350;106;2,9;2;1;1
258105796350;258105796428;78;2,9;2;1;1
258105796428;258105797169;741;2,9;2;1;1
258105797169;258105797449;280;2,9;2;1;1
258105797449;258105798002;553;2,9;2;1;1
258105798002;258105798449;447;2,9;2;1;1
258105798449;258105798616;167;2,9;2;1;1
258105798616;258105798641;25;2,9;2;1;1
258105798641;258105798743;102;2,9;2;1;1
258105798743;258105798788;45;2,9;2;1;1
258105798788;258105798806;18;2,9;2;1;1
258105798806;258105798845;39;2,9;2;1;1
258105798845;258105799018;173;2,9;2;1;1
258105799018;258105799195;177;2,9;2;1;1
258105799195;258105799299;104;2,9;2;1;1
258105799299;258105799505;206;2,9;2;1;1
258105799505;258105799576;71;2,9;2;1;1
258105799576;258105799607;31;2,9;2;1;1
258105799607;258105799868;261;2,9;2;1;1
258105799868;258105800466;598;2,9;2;1;1
258105800466;258105800592;126;2,9;2;1;1
258105800592;258105800908;316;2,9;2;1;1
258105800908;258105805644;4736;2,9;2;1;1
258105805644;258105807579;1935;2,9;2;1;1
258105807579;258105811660;4081;9;1;1;1
258105811660;258105837601;25941;9;1;1;1
258105837601;258105837634;33;9;1;1;1
258105837634;258105837651;17;9;1;1;1
258105837651;258105837928;277;9;1;1;1
258105837928;258105838010;82;9;1;1;1
258105838010;258105838140;130;9;1;1;1
258105838140;258105838621;481;9;1;1;1
258105838621;258105840090;1469;9;1;1;1
258105840090;258105840176;86;9;1;1;1
258105840176;258105840305;129;9;1;1;1
258105840305;258105840398;93;9;1;1;1
258105840398;258105840514;116;9;1;1;1
258105840514;258105840775;261;9;1;1;1
258105840775;258105841108;333;9;1;1;1
258105841108;258105862125;21017;9;1;1;1
258105862125;258105862148;23;9;1;1;1
258105862148;258105862202;54;9;1;1;1
258105862202;258105862252;50;9;1;1;1
258105862252;258105862302;50;9;1;1;1
258105862302;258105862353;51;9;1;1;1
258105862353;258105862402;49;9;1;1;1
258105862402;258105863037;635;9;1;1;1
258105863037;258105865482;2445;2,9;2;1;1
258105865482;258105865937;455;2,9;2;1;1
258105865937;258105866076;139;2,9;2;1;1
258105866076;258105866130;54;2,9;2;1;1
258105866130;258105866163;33;2,9;2;1;1
258105866163;258105866205;42;2,9;2;1;1
258105866205;258105867488;1283;2,9;2;1;1
258105867488;258105867516;28;2,9;2;1;1
258105867516;258105867543;27;2,9;2;1;1
258105867543;258105868878;1335;2,9;2;1;1
258105868878;258105871604;2726;2,9;2;1;1
258105871604;258105871767;163;2,9;2;1;1
258105871767;258105871783;16;2,9;2;1;1
258105871783;258105871836;53;2,9;2;1;1
258105871836;258105871895;59;2,9;2;1;1
258105871895;258105872019;124;2,9;2;1;1
258105872019;258105872025;6;2,9;2;1;1
258105872025;258105872065;40;2,9;2;1;1
258105872065;258105872244;179;2,9;2;1;1
258105872244;258105872331;87;2,9;2;1;1
258105872331;258105872425;94;2,9;2;1;1
258105872425;258105872628;203;2,9;2;1;1
258105872628;258105872630;2;2,9;2;1;1
258105872630;258105872666;36;2,9;2;1;1
258105872666;258105872694;28;2,9;2;1;1
258105872694;258105872790;96;2,9;2;1;1
258105872790;258105872845;55;2,9;2;1;1
258105872845;258105872870;25;2,9;2;1;1
258105872870;258105872886;16;2,9;2;1;1
258105872886;258105872896;10;2,9;2;1;1
258105872896;258105873091;195;2,9;2;1;1
258105873091;258105882463;9372;2,9;2;1;1
258105882463;258105883091;628;2,9;2;1;1
258105883091;258105883112;21;2,9;2;1;1
258105883112;258105883719;607;2,9;2;1;1
258105883719;258105884221;502;2,9;2;1;1
258105884221;258105884255;34;2,9;2;1;1
258105884255;258105888416;4161;2,9;2;1;1
258105888416;258105892416;4000;2,9;2;1;1
258105892416;258105897393;4977;2,9;2;1;1
258105897393;258105899121;1728;2,9;2;1;1
258105899121;258105899480;359;2,9;2;1;1
258105899480;258105899607;127;2,9;2;1;1
258105899607;258105900218;611;2,9;2;1;1
258105900218;258105901001;783;2,9;2;1;1
258105901001;258105901669;668;2,9;2;1;1
258105901669;258105904506;2837;2,9;2;1;1
258105904506;258105907036;2530;9;1;1;1
258105907036;258105915547;8511;9;1;1;1
258105915547;258105915583;36;9;1;1;1
258105915583;258105916011;428;9;1;1;1
258105916011;258105916046;35;9;1;1;1
258105916046;258105916069;23;9;1;1;1
258105916069;258105916978;909;9;1;1;1
258105916978;258105920051;3073;9;1;1;1
258105920051;258105920137;86;9;1;1;1
258105920137;258105920171;34;9;1;1;1
258105920171;258105920234;63;9;1;1;1
258105920234;258105920328;94;9;1;1;1
258105920328;258105920338;10;9;1;1;1
258105920338;258105920498;160;9;1;1;1
258105920498;258105920534;36;9;1;1;1
258105920534;258105920604;70;9;1;1;1
258105920604;258105920759;155;9;1;1;1
258105920759;258105930827;10068;9;1;1;1
258105930827;258105930856;29;9;1;1;1
258105930856;258105930913;57;9;1;1;1
258105930913;258105931119;206;9;1;1;1
258105931119;258105931136;17;9;1;1;1
258105931136;258105931513;377;9;1;1;1
258105931513;258105931567;54;9;1;1;1
258105931567;258105931580;13;9;1;1;1
258105931580;258105931914;334;9;1;1;1
258105931914;258105939932;8018;9;1;1;1
258105939932;258105943424;3492;9;1;1;1
258105943424;258105948692;5268;9;1;1;1
258105948692;258105956663;7971;9;1;1;1
258105956663;258105957402;739;9;1;1;1
258105957402;258105957553;151;9;1;1;1
258105957553;258105957971;418;9;1;1;1
258105957971;258105958044;73;9;1;1;1
258105958044;258105961779;3735;9;1;1;1
258105961779;258105962060;281;9;1;1;1
258105962060;258105962226;166;9;1;1;1
258105962226;258105962306;80;9;1;1;1
258105962306;258105962315;9;9;1;1;1
258105962315;258105962458;143;9;1;1;1
258105962458;258105962541;83;9;1;1;1
258105962541;258105962588;47;9;1;1;1
258105962588;258105962614;26;9;1;1;1
258105962614;258105962700;86;9;1;1;1
258105962700;258105962726;26;9;1;1;1
258105962726;258105962789;63;9;1;1;1
258105962789;258105962911;122;9;1;1;1
258105962911;258105963011;100;9;1;1;1
258105963011;258105963116;105;9;1;1;1
258105963116;258105963300;184;9;1;1;1
258105963300;258105963456;156;9;1;1;1
258105963456;258105963489;33;9;1;1;1
258105963489;258105963679;190;9;1;1;1
258105963679;258105964366;687;9;1;1;1
258105964366;258105965703;1337;9;1;1;1
258105965703;258105966236;533;2,9;2;1;1
258105966236;258105971080;4844;9;1;1;1
258105971080;258105972513;1433;9;1;1;1
258105972513;258105973936;1423;9;1;1;1
258105973936;258105973969;33;9;1;1;1
258105973969;258105973992;23;9;1;1;1
258105973992;258105974043;51;9;1;1;1
258105974043;258105974125;82;9;1;1;1
258105974125;258105974177;52;9;1;1;1
258105974177;258105974229;52;9;1;1;1
258105974229;258105975892;1663;9;1;1;1
258105975892;258105976413;521;9;1;1;1
258105976413;258105977711;1298;9;1;1;1
258105977711;258105985602;7891;9;1;1;1
258105985602;258105985816;214;9;1;1;1
258105985816;258106001549;15733;9;1;1;1
258106001549;258106006880;5331;9;1;1;1
258106006880;258106011507;4627;9;1;1;1
258106011507;258106011906;399;9;1;1;1
258106011906;258106021021;9115;9;1;1;1
258106021021;258106021071;50;9;1;1;1
258106021071;258106027593;6522;9;1;1;1
258106027593;258106027840;247;9;1;1;1
258106027840;258106028248;408;9;1;1;1
258106028248;258106028344;96;9;1;1;1
258106028344;258106028379;35;9;1;1;1
258106028379;258106028417;38;9;1;1;1
258106028417;258106028461;44;9;1;1;1
258106028461;258106028531;70;9;1;1;1
258106028531;258106028570;39;9;1;1;1
258106028570;258106028718;148;9;1;1;1
258106028718;258106036978;8260;9;1;1;1
258106036978;258106037808;830;2,9;2;1;1
258106037808;258106039813;2005;9;1;1;1
258106039813;258106040048;235;2,9;2;1;1
258106040048;258106044751;4703;2,9;2;1;1
258106044751;258106045998;1247;9;1;1;1
258106045998;258106047343;1345;2,9;2;1;1
258106047343;258106048836;1493;9;1;1;1
258106048836;258106050308;1472;9;1;1;1
258106050308;258106052673;2365;2,9;2;1;1
258106052673;258106053035;362;2,9;2;1;1
258106053035;258106055760;2725;2,9;2;1;1
258106055760;258106056610;850;2,9;2;1;1
258106056610;258106057406;796;2,9;2;1;1
258106057406;258106057718;312;9;1;1;1
258106057718;258106058170;452;2,9;2;1;1
258106058170;258106058226;56;2,9;2;1;1
258106058226;258106061265;3039;2,9;2;1;1
258106061265;258106061353;88;2,9;2;1;1
258106061353;258106062159;806;2,9;2;1;1
258106062159;258106062461;302;2,9;2;1;1
258106062461;258106063072;611;2,9;2;1;1
258106063072;258106063155;83;2,9;2;1;1
258106063155;258106067503;4348;9;1;1;1
258106067503;258106068658;1155;2,9;2;1;1
258106068658;258106071134;2476;9;1;1;1
258106071134;258106071157;23;2,9;2;1;1
258106071157;258106071223;66;2,9;2;1;1
258106071223;258106071309;86;2,9;2;1;1
258106071309;258106071370;61;2,9;2;1;1
258106071370;258106071714;344;2,9;2;1;1
258106071714;258106072128;414;9;1;1;1
258106072128;258106088204;16076;9;1;1;1
258106088204;258106094232;6028;9;1;1;1
258106094232;258106100869;6637;9;1;1;1
258106100869;258106101193;324;9;1;1;1
258106101193;258106101437;244;9;1;1;1
258106101437;258106101634;197;9;1;1;1
258106101634;258106102439;805;9;1;1;1
258106102439;258106102554;115;9;1;1;1
258106102554;258106102683;129;9;1;1;1
258106102683;258106102717;34;9;1;1;1
258106102717;258106103193;476;9;1;1;1
258106103193;258106103344;151;9;1;1;1
258106103344;258106103412;68;9;1;1;1
258106103412;258106103656;244;9;1;1;1
258106103656;258106103845;189;9;1;1;1
258106103845;258106105894;2049;9;1;1;1
258106105894;258106106056;162;9;1;1;1
258106106056;258106106356;300;9;1;1;1
258106106356;258106106389;33;9;1;1;1
258106106389;258106106589;200;9;1;1;1
258106106589;258106106631;42;9;1;1;1
258106106631;258106106842;211;9;1;1;1
258106106842;258106107018;176;9;1;1;1
258106107018;258106107064;46;9;1;1;1
258106107064;258106107112;48;9;1;1;1
258106107112;258106112909;5797;9;1;1;1
258106112909;258106115175;2266;2,9;2;1;1
258106115175;258106115483;308;2,9;2;1;1
258106115483;258106115633;150;2,9;2;1;1
258106115633;258106118167;2534;2,9;2;1;1
258106118167;258106118241;74;2,9;2;1;1
258106118241;258106118538;297;2,9;2;1;1
258106118538;258106118566;28;2,9;2;1;1
258106118566;258106118897;331;2,9;2;1;1
258106118897;258106118976;79;2,9;2;1;1
258106118976;258106118986;10;2,9;2;1;1
258106118986;258106120869;1883;2,9;2;1;1
258106120869;258106121235;366;2,9;2;1;1
258106121235;258106122044;809;2,9;2;1;1
258106122044;258106122150;106;2,9;2;1;1
258106122150;258106122158;8;2,9;2;1;1
258106122158;258106122193;35;2,9;2;1;1
258106122193;258106122556;363;2,9;2;1;1
258106122556;258106127705;5149;2,9;2;1;1
258106127705;258106142497;14792;2,9;2;1;1
258106142497;258106144476;1979;2,9;2;1;1
258106144476;258106145010;534;2,9;2;1;1
258106145010;258106146021;1011;2,9;2;1;1
258106146021;258106146557;536;2,9;2;1;1
258106146557;258106146741;184;2,9;2;1;1
258106146741;258106146770;29;2,9;2;1;1
258106146770;258106146837;67;2,9;2;1;1
258106146837;258106146889;52;2,9;2;1;1
258106146889;258106146908;19;2,9;2;1;1
258106146908;258106146977;69;2,9;2;1;1
258106146977;258106147114;137;2,9;2;1;1
258106147114;258106147336;222;2,9;2;1;1
258106147336;258106147371;35;2,9;2;1;1
258106147371;258106147401;30;2,9;2;1;1
258106147401;258106147467;66;2,9;2;1;1
258106147467;258106148386;919;2,9;2;1;1
258106148386;258106149016;630;2,9;2;1;1
258106149016;258106149058;42;2,9;2;1;1
258106149058;258106149164;106;2,9;2;1;1
258106149164;258106149741;577;2,9;2;1;1
258106149741;258106150791;1050;2,9;2;1;1
258106150791;258106154154;3363;2,9;2;1;1
258106154154;258106156912;2758;9;1;1;1
258106156912;258106164321;7409;9;1;1;1
258106164321;258106167608;3287;9;1;1;1
258106167608;258106167740;132;9;1;1;1
258106167740;258106167868;128;9;1;1;1
258106167868;258106167936;68;9;1;1;1
258106167936;258106168070;134;9;1;1;1
258106168070;258106168099;29;9;1;1;1
258106168099;258106168126;27;9;1;1;1
258106168126;258106196091;27965;9;1;1;1
258106196091;258106196832;741;9;1;1;1
258106196832;258106199553;2721;9;1;1;1
258106199553;258106205710;6157;9;1;1;1
258106205710;258106205858;148;9;1;1;1
258106205858;258106205928;70;9;1;1;1
258106205928;258106206000;72;9;1;1;1
258106206000;258106206170;170;9;1;1;1
258106206170;258106206244;74;9;1;1;1
258106206244;258106206294;50;9;1;1;1
258106206294;258106206316;22;9;1;1;1
258106206316;258106206497;181;9;1;1;1
258106206497;258106206769;272;9;1;1;1
258106206769;258106206815;46;9;1;1;1
258106206815;258106210735;3920;9;1;1;1
258106210735;258106210808;73;9;1;1;1
258106210808;258106210886;78;9;1;1;1
258106210886;258106211093;207;9;1;1;1
258106211093;258106211944;851;9;1;1;1
258106211944;258106213338;1394;9;1;1;1
258106213338;258106213438;100;9;1;1;1
258106213438;258106213545;107;9;1;1;1
258106213545;258106213694;149;9;1;1;1
258106213694;258106213826;132;9;1;1;1
258106213826;258106213968;142;9;1;1;1
258106213968;258106229338;15370;9;1;1;1
258106229338;258106241675;12337;9;1;1;1
258106241675;258106242291;616;9;1;1;1
258106242291;258106242603;312;9;1;1;1
258106242603;258106260584;17981;9;1;1;1
258106260584;258106261647;1063;9;1;1;1
258106261647;258106261861;214;9;1;1;1
258106261861;258106261930;69;9;1;1;1
258106261930;258106261949;19;9;1;1;1
258106261949;258106262372;423;9;1;1;1
258106262372;258106263147;775;9;1;1;1
258106263147;258106263181;34;9;1;1;1
258106263181;258106265151;1970;9;1;1;1
258106265151;258106265871;720;9;1;1;1
258106265871;258106266444;573;9;1;1;1
258106266444;258106266553;109;9;1;1;1
258106266553;258106266609;56;9;1;1;1
258106266609;258106266619;10;9;1;1;1
258106266619;258106266764;145;9;1;1;1
258106266764;258106266776;12;9;1;1;1
258106266776;258106266889;113;9;1;1;1
258106266889;258106266915;26;9;1;1;1
258106266915;258106266933;18;9;1;1;1
258106266933;258106267102;169;9;1;1;1
258106267102;258106268435;1333;9;1;1;1
258106268435;258106268453;18;9;1;1;1
258106268453;258106268477;24;9;1;1;1
258106268477;258106268802;325;9;1;1;1
258106268802;258106268804;2;9;1;1;1
258106268804;258106268840;36;9;1;1;1
258106268840;258106268882;42;9;1;1;1
258106268882;258106268950;68;9;1;1;1
258106268950;258106268958;8;9;1;1;1
258106268958;258106269108;150;9;1;1;1
258106269108;258106269146;38;9;1;1;1
258106269146;258106269322;176;9;1;1;1
258106269322;258106269362;40;9;1;1;1
258106269362;258106269501;139;9;1;1;1
258106269501;258106269729;228;9;1;1;1
258106269729;258106269947;218;9;1;1;1
258106269947;258106270141;194;9;1;1;1
258106270141;258106270151;10;9;1;1;1
258106270151;258106270347;196;9;1;1;1
258106270347;258106270405;58;9;1;1;1
258106270405;258106270412;7;9;1;1;1
258106270412;258106270445;33;9;1;1;1
258106270445;258106270447;2;9;1;1;1
258106270447;258106270459;12;9;1;1;1
258106270459;258106270536;77;9;1;1;1
258106270536;258106270616;80;9;1;1;1
258106270616;258106270654;38;9;1;1;1
258106270654;258106271074;420;9;1;1;1
258106271074;258106271238;164;9;1;1;1
258106271238;258106271414;176;9;1;1;1
258106271414;258106273387;1973;9;1;1;1
258106273387;258106273615;228;9;1;1;1
258106273615;258106273666;51;9;1;1;1
258106273666;258106273685;19;9;1;1;1
258106273685;258106279462;5777;9;1;1;1
258106279462;258106281552;2090;9;1;1;1
258106281552;258106282017;465;9;1;1;1
258106282017;258106284203;2186;9;1;1;1
258106284203;258106291743;7540;9;1;1;1
258106291743;258106295363;3620;9;1;1;1
258106295363;258106295395;32;9;1;1;1
258106295395;258106299501;4106;9;1;1;1
258106299501;258106302929;3428;2,9;2;1;1
258106302929;258106303141;212;2,9;2;1;1
258106303141;258106303372;231;2,9;2;1;1
258106303372;258106303408;36;2,9;2;1;1
258106303408;258106303509;101;2,9;2;1;1
258106303509;258106303517;8;2,9;2;1;1
258106303517;258106303559;42;2,9;2;1;1
258106303559;258106303679;120;2,9;2;1;1
258106303679;258106303723;44;2,9;2;1;1
258106303723;258106303739;16;2,9;2;1;1
258106303739;258106303742;3;2,9;2;1;1
258106303742;258106311376;7634;2,9;2;1;1
258106311376;258106311486;110;2,9;2;1;1
258106311486;258106316903;5417;2,9;2;1;1
258106316903;258106324433;7530;2,9;2;1;1
258106324433;258106329591;5158;2,9;2;1;1
258106329591;258106330415;824;2,9;2;1;1
258106330415;258106332951;2536;2,9;2;1;1
258106332951;258106335343;2392;2,9;2;1;1
258106335343;258106336305;962;2,9;2;1;1
258106336305;258106342456;6151;2,9;2;1;1
258106342456;258106342767;311;2,9;2;1;1
258106342767;258106342903;136;2,9;2;1;1
258106342903;258106343418;515;2,9;2;1;1
258106343418;258106345434;2016;2,9;2;1;1
258106345434;258106345965;531;2,9;2;1;1
258106345965;258106351161;5196;2,9;2;1;1
258106351161;258106351655;494;2,9;2;1;1
258106351655;258106352511;856;2,9;2;1;1
258106352511;258106352750;239;2,9;2;1;1
258106352750;258106353609;859;2,9;2;1;1
258106353609;258106355387;1778;9;1;1;1
258106355387;258106355700;313;9;1;1;1
258106355700;258106356332;632;2,9;2;1;1
258106356332;258106359566;3234;9;1;1;1
258106359566;258106364896;5330;9;1;1;1
258106364896;258106364945;49;9;1;1;1
258106364945;258106365393;448;9;1;1;1
258106365393;258106365435;42;9;1;1;1
258106365435;258106365655;220;9;1;1;1
258106365655;258106369666;4011;9;1;1;1
258106369666;258106369674;8;9;1;1;1
258106369674;258106369724;50;9;1;1;1
258106369724;258106369735;11;9;1;1;1
258106369735;258106369759;24;9;1;1;1
258106369759;258106369787;28;9;1;1;1
258106369787;258106369840;53;9;1;1;1
258106369840;258106417162;47322;9;1;1;1
258106417162;258106417184;22;9;1;1;1
258106417184;258106417266;82;9;1;1;1
258106417266;258106426257;8991;9;1;1;1
258106426257;258106426932;675;2,9;2;1;1
258106426932;258106427673;741;2,9;2;1;1
258106427673;258106427683;10;2,9;2;1;1
258106427683;258106431097;3414;2,9;2;1;1
258106431097;258106431148;51;2,9;2;1;1
258106431148;258106431161;13;2,9;2;1;1
258106431161;258106431192;31;2,9;2;1;1
258106431192;258106431252;60;2,9;2;1;1
258106431252;258106431420;168;2,9;2;1;1
258106431420;258106431424;4;2,9;2;1;1
258106431424;258106431541;117;2,9;2;1;1
258106431541;258106431571;30;2,9;2;1;1
258106431571;258106431602;31;2,9;2;1;1
258106431602;258106432158;556;2,9;2;1;1
258106432158;258106436750;4592;2,9;2;1;1
258106436750;258106440311;3561;2,9;2;1;1
258106440311;258106443630;3319;2,9;2;1;1
258106443630;258106444518;888;2,9;2;1;1
258106444518;258106457589;13071;2,9;2;1;1
258106457589;258106459172;1583;2,9;2;1;1
258106459172;258106460213;1041;2,9;2;1;1
258106460213;258106467562;7349;2,9;2;1;1
258106467562;258106470330;2768;2,9;2;1;1
258106470330;258106470981;651;2,9;2;1;1
258106470981;258106471666;685;2,9;2;1;1
258106471666;258106473614;1948;2,9;2;1;1
258106473614;258106474153;539;2,9;2;1;1
258106474153;258106474970;817;2,9;2;1;1
258106474970;258106477175;2205;2,9;2;1;1
258106477175;258106477651;476;2,9;2;1;1
258106477651;258106479395;1744;9;1;1;1
258106479395;258106492205;12810;9;1;1;1
258106492205;258106502438;10233;9;1;1;1
258106502438;258106502653;215;9;1;1;1
258106502653;258106503127;474;9;1;1;1
258106503127;258106510721;7594;9;1;1;1
258106510721;258106522454;11733;2,9;2;1;1
258106522454;258106523404;950;2,9;2;1;1
258106523404;258106523447;43;2,9;2;1;1
258106523447;258106525344;1897;2,9;2;1;1
258106525344;258106525395;51;2,9;2;1;1
258106525395;258106525407;12;2,9;2;1;1
258106525407;258106525428;21;2,9;2;1;1
258106525428;258106525463;35;2,9;2;1;1
258106525463;258106525723;260;2,9;2;1;1
258106525723;258106525740;17;2,9;2;1;1
258106525740;258106525809;69;2,9;2;1;1
258106525809;258106525927;118;2,9;2;1;1
258106525927;258106526203;276;2,9;2;1;1
258106526203;258106529079;2876;2,9;2;1;1
258106529079;258106529165;86;2,9;2;1;1
258106529165;258106529171;6;2,9;2;1;1
258106529171;258106529238;67;2,9;2;1;1
258106529238;258106529360;122;2,9;2;1;1
258106529360;258106529394;34;2,9;2;1;1
258106529394;258106529638;244;2,9;2;1;1
258106529638;258106529813;175;2,9;2;1;1
258106529813;258106529963;150;2,9;2;1;1
258106529963;258106530175;212;2,9;2;1;1
258106530175;258106531262;1087;2,9;2;1;1
258106531262;258106536396;5134;2,9;2;1;1
258106536396;258106538594;2198;9;1;1;1
258106538594;258106539938;1344;9;1;1;1
258106539938;258106539987;49;9;1;1;1
258106539987;258106540079;92;9;1;1;1
258106540079;258106554418;14339;9;1;1;1
258106554418;258106555073;655;9;1;1;1
258106555073;258106555193;120;9;1;1;1
258106555193;258106555311;118;9;1;1;1
258106555311;258106555348;37;9;1;1;1
258106555348;258106555582;234;9;1;1;1
258106555582;258106571800;16218;9;1;1;1
258106571800;258106584981;13181;9;1;1;1
258106584981;258106594525;9544;9;1;1;1
258106594525;258106601064;6539;9;1;1;1
258106601064;258106603524;2460;2,9;2;1;1
258106603524;258106611623;8099;2,9;2;1;1
258106611623;258106611828;205;2,9;2;1;1
258106611828;258106611831;3;2,9;2;1;1
258106611831;258106611855;24;2,9;2;1;1
258106611855;258106611909;54;2,9;2;1;1
258106611909;258106611972;63;2,9;2;1;1
258106611972;258106612507;535;2,9;2;1;1
258106612507;258106612536;29;2,9;2;1;1
258106612536;258106613009;473;2,9;2;1;1
258106613009;258106613044;35;2,9;2;1;1
258106613044;258106613077;33;2,9;2;1;1
258106613077;258106613309;232;2,9;2;1;1
258106613309;258106613487;178;2,9;2;1;1
258106613487;258106614750;1263;2,9;2;1;1
258106614750;258106616045;1295;2,9;2;1;1
258106616045;258106618421;2376;2,9;2;1;1
258106618421;258106618498;77;2,9;2;1;1
258106618498;258106618564;66;2,9;2;1;1
258106618564;258106618575;11;2,9;2;1;1
258106618575;258106618643;68;2,9;2;1;1
258106618643;258106618714;71;2,9;2;1;1
258106618714;258106619012;298;2,9;2;1;1
258106619012;258106619049;37;2,9;2;1;1
258106619049;258106619144;95;2,9;2;1;1
258106619144;258106619197;53;2,9;2;1;1
258106619197;258106621962;2765;2,9;2;1;1
258106621962;258106625886;3924;2,9;2;1;1
258106625886;258106627847;1961;2,9;2;1;1
258106627847;258106627869;22;2,9;2;1;1
258106627869;258106628138;269;2,9;2;1;1
258106628138;258106628397;259;2,9;2;1;1
258106628397;258106628509;112;2,9;2;1;1
258106628509;258106628554;45;2,9;2;1;1
258106628554;258106628588;34;2,9;2;1;1
258106628588;258106628725;137;2,9;2;1;1
258106628725;258106628755;30;2,9;2;1;1
258106628755;258106628854;99;2,9;2;1;1
258106628854;258106628871;17;2,9;2;1;1
258106628871;258106630104;1233;2,9;2;1;1
258106630104;258106631820;1716;2,9;2;1;1
258106631820;258106633972;2152;2,9;2;1;1
258106633972;258106634385;413;2,9;2;1;1
258106634385;258106637931;3546;2,9;2;1;1
258106637931;258106638591;660;2,9;2;1;1
258106638591;258106639558;967;2,9;2;1;1
258106639558;258106640259;701;2,9;2;1;1
258106640259;258106641693;1434;2,9;2;1;1
258106641693;258106643794;2101;2,9;2;1;1
258106643794;258106646115;2321;2,9;2;1;1
258106646115;258106649290;3175;2,9;2;1;1
258106649290;258106649426;136;9;1;1;1
258106649426;258106653432;4006;9;1;1;1
258106653432;258106653475;43;9;1;1;1
258106653475;258106653491;16;9;1;1;1
258106653491;258106653536;45;9;1;1;1
258106653536;258106653698;162;9;1;1;1
258106653698;258106655212;1514;9;1;1;1
258106655212;258106655925;713;9;1;1;1
258106655925;258106656025;100;9;1;1;1
258106656025;258106656090;65;9;1;1;1
258106656090;258106656135;45;9;1;1;1
258106656135;258106656198;63;9;1;1;1
258106656198;258106656982;784;9;1;1;1
258106656982;258106673039;16057;9;1;1;1
258106673039;258106673740;701;9;1;1;1
258106673740;258106674608;868;9;1;1;1
258106674608;258106675151;543;9;1;1;1
258106675151;258106677024;1873;9;1;1;1
258106677024;258106677078;54;9;1;1;1
258106677078;258106677130;52;9;1;1;1
258106677130;258106677156;26;9;1;1;1
258106677156;258106677272;116;9;1;1;1
258106677272;258106677910;638;9;1;1;1
258106677910;258106680171;2261;9;1;1;1
258106680171;258106680384;213;9;1;1;1
258106680384;258106697431;17047;9;1;1;1
258106697431;258106698290;859;9;1;1;1
258106698290;258106698730;440;9;1;1;1
258106698730;258106698954;224;9;1;1;1
258106698954;258106699129;175;9;1;1;1
258106699129;258106699204;75;9;1;1;1
258106699204;258106707195;7991;9;1;1;1
258106707195;258106708279;1084;9;1;1;1
258106708279;258106708360;81;9;1;1;1
258106708360;258106718725;10365;9;1;1;1
258106718725;258106720114;1389;9;1;1;1
258106720114;258106722793;2679;2,9;2;1;1
258106722793;258106722827;34;2,9;2;1;1
258106722827;258106722915;88;2,9;2;1;1
258106722915;258106723091;176;2,9;2;1;1
258106723091;258106728748;5657;2,9;2;1;1
258106728748;258106728983;235;2,9;2;1;1
258106728983;258106730657;1674;2,9;2;1;1
258106730657;258106730927;270;2,9;2;1;1
258106730927;258106731080;153;2,9;2;1;1
258106731080;258106731259;179;2,9;2;1;1
258106731259;258106731300;41;2,9;2;1;1
258106731300;258106731332;32;2,9;2;1;1
258106731332;258106731477;145;2,9;2;1;1
258106731477;258106731737;260;2,9;2;1;1
258106731737;258106731882;145;2,9;2;1;1
258106731882;258106732028;146;2,9;2;1;1
258106732028;258106738384;6356;2,9;2;1;1
258106738384;258106742257;3873;2,9;2;1;1
258106742257;258106742370;113;2,9;2;1;1
258106742370;258106742397;27;2,9;2;1;1
258106742397;258106742461;64;2,9;2;1;1
258106742461;258106742500;39;2,9;2;1;1
258106742500;258106742512;12;2,9;2;1;1
258106742512;258106746432;3920;2,9;2;1;1
258106746432;258106775734;29302;9;1;1;1
258106775734;258106776396;662;2,9;2;1;1
258106776396;258106783344;6948;9;1;1;1
258106783344;258106788065;4721;9;1;1;1
258106788065;258106788081;16;9;1;1;1
258106788081;258106788101;20;9;1;1;1
258106788101;258106788136;35;9;1;1;1
258106788136;258106788187;51;9;1;1;1
258106788187;258106788238;51;9;1;1;1
258106788238;258106788265;27;9;1;1;1
258106788265;258106788460;195;9;1;1;1
258106788460;258106788481;21;9;1;1;1
258106788481;258106788588;107;9;1;1;1
258106788588;258106806495;17907;9;1;1;1
258106806495;258106806601;106;9;1;1;1
258106806601;258106806713;112;9;1;1;1
258106806713;258106823360;16647;9;1;1;1
258106823360;258106823871;511;9;1;1;1
258106823871;258106823940;69;9;1;1;1
258106823940;258106824053;113;9;1;1;1
258106824053;258106824361;308;9;1;1;1
258106824361;258106830380;6019;9;1;1;1
258106830380;258106834233;3853;9;1;1;1
258106834233;258106837003;2770;9;1;1;1
258106837003;258106837152;149;9;1;1;1
258106837152;258106837240;88;9;1;1;1
258106837240;258106837347;107;9;1;1;1
258106837347;258106837721;374;9;1;1;1
258106837721;258106837761;40;9;1;1;1
258106837761;258106838170;409;9;1;1;1
258106838170;258106838258;88;9;1;1;1
258106838258;258106839431;1173;9;1;1;1
258106839431;258106841575;2144;2,9;2;1;1
258106841575;258106848373;6798;2,9;2;1;1
258106848373;258106850962;2589;2,9;2;1;1
258106850962;258106852097;1135;2,9;2;1;1
258106852097;258106852846;749;2,9;2;1;1
258106852846;258106860581;7735;2,9;2;1;1
258106860581;258106866469;5888;2,9;2;1;1
258106866469;258106869091;2622;2,9;2;1;1
258106869091;258106871934;2843;2,9;2;1;1
258106871934;258106872650;716;2,9;2;1;1
258106872650;258106873481;831;2,9;2;1;1
258106873481;258106873597;116;2,9;2;1;1
258106873597;258106873619;22;2,9;2;1;1
258106873619;258106873881;262;2,9;2;1;1
258106873881;258106874171;290;2,9;2;1;1
258106874171;258106879332;5161;2,9;2;1;1
258106879332;258106881353;2021;2,9;2;1;1
258106881353;258106887746;6393;2,9;2;1;1
258106887746;258106888959;1213;2,9;2;1;1
258106888959;258106888994;35;2,9;2;1;1
258106888994;258106889015;21;2,9;2;1;1
258106889015;258106889310;295;2,9;2;1;1
258106889310;258106889482;172;2,9;2;1;1
258106889482;258106891149;1667;2,9;2;1;1
258106891149;258106891180;31;2,9;2;1;1
258106891180;258106891235;55;2,9;2;1;1
258106891235;258106891367;132;2,9;2;1;1
258106891367;258106891500;133;2,9;2;1;1
258106891500;258106891602;102;2,9;2;1;1
258106891602;258106891865;263;2,9;2;1;1
258106891865;258106893886;2021;2,9;2;1;1
258106893886;258106894409;523;2,9;2;1;1
258106894409;258106894678;269;2,9;2;1;1
258106894678;258106896511;1833;2,9;2;1;1
258106896511;258106896789;278;2,9;2;1;1
258106896789;258106899149;2360;2,9;2;1;1
258106899149;258106900327;1178;2,9;2;1;1
258106900327;258106901141;814;2,9;2;1;1
258106901141;258106902272;1131;2,9;2;1;1
258106902272;258106915868;13596;9;1;1;1
258106915868;258106915917;49;9;1;1;1
258106915917;258106915929;12;9;1;1;1
258106915929;258106916005;76;9;1;1;1
258106916005;258106916060;55;9;1;1;1
258106916060;258106916447;387;9;1;1;1
258106916447;258106937702;21255;9;1;1;1
258106937702;258106940725;3023;9;1;1;1
258106940725;258106940748;23;9;1;1;1
258106940748;258106940786;38;9;1;1;1
258106940786;258106941026;240;9;1;1;1
258106941026;258106950057;9031;9;1;1;1
258106950057;258106950826;769;2,9;2;1;1
258106950826;258106952605;1779;2,9;2;1;1
258106952605;258106957029;4424;2,9;2;1;1
258106957029;258106957941;912;2,9;2;1;1
258106957941;258106959398;1457;2,9;2;1;1
258106959398;258106965422;6024;2,9;2;1;1
258106965422;258106967717;2295;2,9;2;1;1
258106967717;258106972757;5040;2,9;2;1;1
258106972757;258106979024;6267;2,9;2;1;1
258106979024;258106980682;1658;2,9;2;1;1
258106980682;258106986108;5426;2,9;2;1;1
258106986108;258106990196;4088;2,9;2;1;1
258106990196;258106997483;7287;2,9;2;1;1
258106997483;258106998752;1269;2,9;2;1;1
258106998752;258106999357;605;2,9;2;1;1
258106999357;258106999926;569;2,9;2;1;1
258106999926;258107000087;161;2,9;2;1;1
258107000087;258107000572;485;2,9;2;1;1
258107000572;258107000691;119;2,9;2;1;1
258107000691;258107001599;908;2,9;2;1;1
258107001599;258107001678;79;2,9;2;1;1
258107001678;258107003950;2272;2,9;2;1;1
258107003950;258107005043;1093;2,9;2;1;1
258107005043;258107009121;4078;2,9;2;1;1
258107009121;258107009887;766;2,9;2;1;1
258107009887;258107011931;2044;2,9;2;1;1
258107011931;258107022612;10681;2,9;2;1;1
258107022612;258107022621;9;2,9;2;1;1
258107022621;258107022658;37;2,9;2;1;1
258107022658;258107022686;28;2,9;2;1;1
258107022686;258107022739;53;2,9;2;1;1
258107022739;258107022793;54;2,9;2;1;1
258107022793;258107022924;131;2,9;2;1;1
258107022924;258107022975;51;2,9;2;1;1
258107022975;258107023689;714;2,9;2;1;1
258107023689;258107026017;2328;2,9;2;1;1
258107026017;258107026740;723;2,9;2;1;1
258107026740;258107048115;21375;9;1;1;1
258107048115;258107049345;1230;9;1;1;1
258107049345;258107049520;175;9;1;1;1
258107049520;258107087610;38090;9;1;1;1
258107087610;258107087830;220;9;1;1;1
258107087830;258107087861;31;9;1;1;1
258107087861;258107088475;614;9;1;1;1
258107088475;258107088583;108;9;1;1;1
258107088583;258107088771;188;9;1;1;1
258107088771;258107089171;400;9;1;1;1
258107089171;258107089543;372;9;1;1;1
258107089543;258107089886;343;9;1;1;1
258107089886;258107089962;76;9;1;1;1
258107089962;258107091954;1992;9;1;1;1
258107091954;258107094548;2594;9;1;1;1
258107094548;258107095157;609;9;1;1;1
258107095157;258107095511;354;9;1;1;1
258107095511;258107096211;700;9;1;1;1
258107096211;258107096880;669;9;1;1;1
258107096880;258107096923;43;9;1;1;1
258107096923;258107097044;121;9;1;1;1
258107097044;258107097176;132;9;1;1;1
258107097176;258107097405;229;9;1;1;1
258107097405;258107097654;249;9;1;1;1
258107097654;258107097700;46;9;1;1;1
258107097700;258107097705;5;9;1;1;1
258107097705;258107097771;66;9;1;1;1
258107097771;258107097845;74;9;1;1;1
258107097845;258107097954;109;9;1;1;1
258107097954;258107098427;473;9;1;1;1
258107098427;258107103575;5148;9;1;1;1
258107103575;258107103915;340;9;1;1;1
258107103915;258107104055;140;9;1;1;1
258107104055;258107104123;68;9;1;1;1
258107104123;258107104148;25;9;1;1;1
258107104148;258107104247;99;9;1;1;1
258107104247;258107104257;10;9;1;1;1
258107104257;258107104284;27;9;1;1;1
258107104284;258107106225;1941;9;1;1;1
258107106225;258107106261;36;9;1;1;1
258107106261;258107106678;417;9;1;1;1
258107106678;258107108305;1627;9;1;1;1
258107108305;258107108340;35;9;1;1;1
258107108340;258107112041;3701;9;1;1;1
258107112041;258107112643;602;2,9;2;1;1
258107112643;258107118956;6313;2,9;2;1;1
258107118956;258107128353;9397;2,9;2;1;1
258107128353;258107131567;3214;2,9;2;1;1
258107131567;258107132047;480;2,9;2;1;1
258107132047;258107132528;481;2,9;2;1;1
258107132528;258107135550;3022;2,9;2;1;1
258107135550;258107141741;6191;2,9;2;1;1
258107141741;258107141845;104;2,9;2;1;1
258107141845;258107141846;1;2,9;2;1;1
258107141846;258107141877;31;2,9;2;1;1
258107141877;258107142031;154;2,9;2;1;1
258107142031;258107142038;7;2,9;2;1;1
258107142038;258107142183;145;2,9;2;1;1
258107142183;258107142219;36;2,9;2;1;1
258107142219;258107142315;96;2,9;2;1;1
258107142315;258107142495;180;2,9;2;1;1
258107142495;258107144927;2432;2,9;2;1;1
258107144927;258107148236;3309;2,9;2;1;1
258107148236;258107149294;1058;2,9;2;1;1
258107149294;258107150122;828;2,9;2;1;1
258107150122;258107150625;503;2,9;2;1;1
258107150625;258107150643;18;2,9;2;1;1
258107150643;258107150659;16;2,9;2;1;1
258107150659;258107150694;35;2,9;2;1;1
258107150694;258107150718;24;2,9;2;1;1
258107150718;258107150773;55;2,9;2;1;1
258107150773;258107151101;328;2,9;2;1;1
258107151101;258107157202;6101;2,9;2;1;1
258107157202;258107158111;909;2,9;2;1;1
258107158111;258107158799;688;2,9;2;1;1
258107158799;258107159017;218;2,9;2;1;1
258107159017;258107160159;1142;2,9;2;1;1
258107160159;258107160373;214;2,9;2;1;1
258107160373;258107161584;1211;2,9;2;1;1
258107161584;258107162196;612;2,9;2;1;1
258107162196;258107163041;845;2,9;2;1;1
258107163041;258107164525;1484;2,9;2;1;1
258107164525;258107165469;944;2,9;2;1;1
258107165469;258107165896;427;2,9;2;1;1
258107165896;258107166597;701;2,9;2;1;1
258107166597;258107177151;10554;9;1;1;1
258107177151;258107197124;19973;9;1;1;1
258107197124;258107206384;9260;9;1;1;1
258107206384;258107206670;286;9;1;1;1
258107206670;258107221675;15005;9;1;1;1
258107221675;258107222204;529;9;1;1;1
258107222204;258107227325;5121;9;1;1;1
258107227325;258107231749;4424;2,9;2;1;1
258107231749;258107234134;2385;2,9;2;1;1
258107234134;258107236267;2133;2,9;2;1;1
258107236267;258107252114;15847;2,9;2;1;1
258107252114;258107255629;3515;2,9;2;1;1
258107255629;258107260274;4645;2,9;2;1;1
258107260274;258107261975;1701;2,9;2;1;1
258107261975;258107263657;1682;2,9;2;1;1
258107263657;258107265282;1625;2,9;2;1;1
258107265282;258107265383;101;2,9;2;1;1
258107265383;258107265867;484;2,9;2;1;1
258107265867;258107266999;1132;2,9;2;1;1
258107266999;258107267998;999;2,9;2;1;1
258107267998;258107271616;3618;2,9;2;1;1
258107271616;258107272336;720;2,9;2;1;1
258107272336;258107272414;78;2,9;2;1;1
258107272414;258107273025;611;2,9;2;1;1
258107273025;258107294033;21008;9;1;1;1
258107294033;258107294134;101;9;1;1;1
258107294134;258107294215;81;9;1;1;1
258107294215;258107294274;59;9;1;1;1
258107294274;258107294913;639;9;1;1;1
258107294913;258107295007;94;9;1;1;1
258107295007;258107295698;691;9;1;1;1
258107295698;258107295797;99;9;1;1;1
258107295797;258107318977;23180;9;1;1;1
258107318977;258107319005;28;9;1;1;1
258107319005;258107319072;67;9;1;1;1
258107319072;258107319094;22;9;1;1;1
258107319094;258107319186;92;9;1;1;1
258107319186;258107319337;151;9;1;1;1
258107319337;258107328148;8811;9;1;1;1
258107328148;258107340067;11919;9;1;1;1
258107340067;258107340192;125;9;1;1;1
258107340192;258107340319;127;9;1;1;1
258107340319;258107341183;864;9;1;1;1
258107341183;258107342194;1011;9;1;1;1
258107342194;258107343052;858;2,9;2;1;1
258107343052;258107343231;179;2,9;2;1;1
258107343231;258107344319;1088;2,9;2;1;1
258107344319;258107344398;79;2,9;2;1;1
258107344398;258107344452;54;2,9;2;1;1
258107344452;258107344700;248;2,9;2;1;1
258107344700;258107344844;144;2,9;2;1;1
258107344844;258107345285;441;2,9;2;1;1
258107345285;258107345682;397;2,9;2;1;1
258107345682;258107345851;169;2,9;2;1;1
258107345851;258107345916;65;2,9;2;1;1
258107345916;258107345936;20;2,9;2;1;1
258107345936;258107346021;85;2,9;2;1;1
258107346021;258107349509;3488;2,9;2;1;1
258107349509;258107350906;1397;2,9;2;1;1
258107350906;258107352048;1142;2,9;2;1;1
258107352048;258107352099;51;2,9;2;1;1
258107352099;258107352127;28;2,9;2;1;1
258107352127;258107352242;115;2,9;2;1;1
258107352242;258107352320;78;2,9;2;1;1
258107352320;258107352720;400;2,9;2;1;1
258107352720;258107352776;56;2,9;2;1;1
258107352776;258107353375;599;2,9;2;1;1
258107353375;258107357390;4015;2,9;2;1;1
258107357390;258107364089;6699;2,9;2;1;1
258107364089;258107364709;620;2,9;2;1;1
258107364709;258107367653;2944;2,9;2;1;1
258107367653;258107374603;6950;2,9;2;1;1
258107374603;258107376498;1895;2,9;2;1;1
258107376498;258107378826;2328;2,9;2;1;1
258107378826;258107379467;641;2,9;2;1;1
258107379467;258107379932;465;2,9;2;1;1
258107379932;258107386288;6356;2,9;2;1;1
258107386288;258107386487;199;2,9;2;1;1
258107386487;258107386607;120;2,9;2;1;1
258107386607;258107387515;908;2,9;2;1;1
258107387515;258107387577;62;2,9;2;1;1
258107387577;258107387613;36;2,9;2;1;1
258107387613;258107394396;6783;2,9;2;1;1
258107394396;258107394826;430;2,9;2;1;1
258107394826;258107396343;1517;2,9;2;1;1
258107396343;258107397543;1200;2,9;2;1;1
258107397543;258107399065;1522;2,9;2;1;1
258107399065;258107399639;574;2,9;2;1;1
258107399639;258107400426;787;2,9;2;1;1
258107400426;258107408393;7967;9;1;1;1
258107408393;258107413643;5250;9;1;1;1
258107413643;258107420344;6701;9;1;1;1
258107420344;258107420570;226;9;1;1;1
258107420570;258107420705;135;9;1;1;1
258107420705;258107420975;270;9;1;1;1
258107420975;258107421203;228;9;1;1;1
258107421203;258107421308;105;9;1;1;1
258107421308;258107421509;201;9;1;1;1
258107421509;258107422998;1489;9;1;1;1
258107422998;258107423346;348;9;1;1;1
258107423346;258107423354;8;9;1;1;1
258107423354;258107423405;51;9;1;1;1
258107423405;258107430707;7302;9;1;1;1
258107430707;258107435941;5234;9;1;1;1
258107435941;258107442358;6417;9;1;1;1
258107442358;258107443412;1054;9;1;1;1
258107443412;258107443493;81;9;1;1;1
258107443493;258107447675;4182;9;1;1;1
258107447675;258107457901;10226;9;1;1;1
258107457901;258107464332;6431;2,9;2;1;1
258107464332;258107464849;517;2,9;2;1;1
258107464849;258107464969;120;2,9;2;1;1
258107464969;258107467217;2248;2,9;2;1;1
258107467217;258107467863;646;2,9;2;1;1
258107467863;258107468554;691;2,9;2;1;1
258107468554;258107468564;10;2,9;2;1;1
258107468564;258107468589;25;2,9;2;1;1
258107468589;258107468846;257;2,9;2;1;1
258107468846;258107471221;2375;2,9;2;1;1
258107471221;258107484410;13189;2,9;2;1;1
258107484410;258107485735;1325;2,9;2;1;1
258107485735;258107488215;2480;2,9;2;1;1
258107488215;258107488567;352;2,9;2;1;1
258107488567;258107497979;9412;2,9;2;1;1
258107497979;258107498569;590;2,9;2;1;1
258107498569;258107499004;435;2,9;2;1;1
258107499004;258107499095;91;2,9;2;1;1
258107499095;258107515321;16226;2,9;2;1;1
258107515321;258107517401;2080;2,9;2;1;1
258107517401;258107518026;625;2,9;2;1;1
258107518026;258107518901;875;2,9;2;1;1
258107518901;258107519533;632;2,9;2;1;1
258107519533;258107520496;963;2,9;2;1;1
258107520496;258107521557;1061;2,9;2;1;1
258107521557;258107522608;1051;2,9;2;1;1
258107522608;258107583930;61322;9;1;1;1
258107583930;258107585155;1225;2,9;2;1;1
258107585155;258107587367;2212;2,9;2;1;1
258107587367;258107591714;4347;2,9;2;1;1
258107591714;258107596483;4769;2,9;2;1;1
258107596483;258107596720;237;2,9;2;1;1
258107596720;258107596844;124;2,9;2;1;1
258107596844;258107598396;1552;2,9;2;1;1
258107598396;258107598728;332;2,9;2;1;1
258107598728;258107598992;264;2,9;2;1;1
258107598992;258107599046;54;2,9;2;1;1
258107599046;258107601161;2115;2,9;2;1;1
258107601161;258107601411;250;2,9;2;1;1
258107601411;258107601747;336;2,9;2;1;1
258107601747;258107601793;46;2,9;2;1;1
258107601793;258107602008;215;2,9;2;1;1
258107602008;258107602043;35;2,9;2;1;1
258107602043;258107602347;304;2,9;2;1;1
258107602347;258107602552;205;2,9;2;1;1
258107602552;258107602809;257;2,9;2;1;1
258107602809;258107603003;194;2,9;2;1;1
258107603003;258107603231;228;2,9;2;1;1
258107603231;258107603267;36;2,9;2;1;1
258107603267;258107603494;227;2,9;2;1;1
258107603494;258107603617;123;2,9;2;1;1
258107603617;258107603627;10;2,9;2;1;1
258107603627;258107603672;45;2,9;2;1;1
258107603672;258107603690;18;2,9;2;1;1
258107603690;258107603833;143;2,9;2;1;1
258107603833;258107603840;7;2,9;2;1;1
258107603840;258107603870;30;2,9;2;1;1
258107603870;258107603886;16;2,9;2;1;1
258107603886;258107603896;10;2,9;2;1;1
258107603896;258107603964;68;2,9;2;1;1
258107603964;258107604066;102;2,9;2;1;1
258107604066;258107604214;148;2,9;2;1;1
258107604214;258107604286;72;2,9;2;1;1
258107604286;258107604309;23;2,9;2;1;1
258107604309;258107604348;39;2,9;2;1;1
258107604348;258107604355;7;2,9;2;1;1
258107604355;258107604404;49;2,9;2;1;1
258107604404;258107604417;13;2,9;2;1;1
258107604417;258107604578;161;2,9;2;1;1
258107604578;258107605687;1109;2,9;2;1;1
258107605687;258107606059;372;2,9;2;1;1
258107606059;258107606073;14;2,9;2;1;1
258107606073;258107606198;125;2,9;2;1;1
258107606198;258107606432;234;2,9;2;1;1
258107606432;258107606447;15;2,9;2;1;1
258107606447;258107606450;3;2,9;2;1;1
258107606450;258107606493;43;2,9;2;1;1
258107606493;258107606691;198;2,9;2;1;1
258107606691;258107606772;81;2,9;2;1;1
258107606772;258107606833;61;2,9;2;1;1
258107606833;258107606932;99;2,9;2;1;1
258107606932;258107606989;57;2,9;2;1;1
258107606989;258107606993;4;2,9;2;1;1
258107606993;258107607002;9;2,9;2;1;1
258107607002;258107607041;39;2,9;2;1;1
258107607041;258107607067;26;2,9;2;1;1
258107607067;258107607127;60;2,9;2;1;1
258107607127;258107607143;16;2,9;2;1;1
258107607143;258107607155;12;2,9;2;1;1
258107607155;258107607300;145;2,9;2;1;1
258107607300;258107607338;38;2,9;2;1;1
258107607338;258107607355;17;2,9;2;1;1
258107607355;258107607405;50;2,9;2;1;1
258107607405;258107607542;137;2,9;2;1;1
258107607542;258107607774;232;2,9;2;1;1
258107607774;258107607813;39;2,9;2;1;1
258107607813;258107607982;169;2,9;2;1;1
258107607982;258107608071;89;2,9;2;1;1
258107608071;258107608091;20;2,9;2;1;1
258107608091;258107608241;150;2,9;2;1;1
258107608241;258107608455;214;2,9;2;1;1
258107608455;258107608536;81;2,9;2;1;1
258107608536;258107608692;156;2,9;2;1;1
258107608692;258107608721;29;2,9;2;1;1
258107608721;258107608873;152;2,9;2;1;1
258107608873;258107608938;65;2,9;2;1;1
258107608938;258107608967;29;2,9;2;1;1
258107608967;258107609018;51;2,9;2;1;1
258107609018;258107609165;147;2,9;2;1;1
258107609165;258107609191;26;2,9;2;1;1
258107609191;258107609344;153;2,9;2;1;1
258107609344;258107609358;14;2,9;2;1;1
258107609358;258107609417;59;2,9;2;1;1
258107609417;258107609482;65;2,9;2;1;1
258107609482;258107609546;64;2,9;2;1;1
258107609546;258107609581;35;2,9;2;1;1
258107609581;258107609608;27;2,9;2;1;1
258107609608;258107609845;237;2,9;2;1;1
258107609845;258107609848;3;2,9;2;1;1
258107609848;258107609918;70;2,9;2;1;1
258107609918;258107609942;24;2,9;2;1;1
258107609942;258107610042;100;2,9;2;1;1
258107610042;258107610151;109;2,9;2;1;1
258107610151;258107610205;54;2,9;2;1;1
258107610205;258107610282;77;2,9;2;1;1
258107610282;258107610389;107;2,9;2;1;1
258107610389;258107610441;52;2,9;2;1;1
258107610441;258107610455;14;2,9;2;1;1
258107610455;258107610564;109;2,9;2;1;1
258107610564;258107610584;20;2,9;2;1;1
258107610584;258107610823;239;2,9;2;1;1
258107610823;258107610923;100;2,9;2;1;1
258107610923;258107610932;9;2,9;2;1;1
258107610932;258107611024;92;2,9;2;1;1
258107611024;258107611065;41;2,9;2;1;1
258107611065;258107611095;30;2,9;2;1;1
258107611095;258107611119;24;2,9;2;1;1
258107611119;258107611151;32;2,9;2;1;1
258107611151;258107611372;221;2,9;2;1;1
258107611372;258107611432;60;2,9;2;1;1
258107611432;258107611456;24;2,9;2;1;1
258107611456;258107611493;37;2,9;2;1;1
258107611493;258107611581;88;2,9;2;1;1
258107611581;258107611782;201;2,9;2;1;1
258107611782;258107612004;222;2,9;2;1;1
258107612004;258107612049;45;2,9;2;1;1
258107612049;258107612060;11;2,9;2;1;1
258107612060;258107612241;181;2,9;2;1;1
258107612241;258107612331;90;2,9;2;1;1
258107612331;258107612401;70;2,9;2;1;1
258107612401;258107612667;266;2,9;2;1;1
258107612667;258107612999;332;2,9;2;1;1
258107612999;258107613177;178;2,9;2;1;1
258107613177;258107613229;52;2,9;2;1;1
258107613229;258107613275;46;2,9;2;1;1
258107613275;258107613696;421;2,9;2;1;1
258107613696;258107613739;43;2,9;2;1;1
258107613739;258107613927;188;2,9;2;1;1
258107613927;258107613966;39;2,9;2;1;1
258107613966;258107614155;189;2,9;2;1;1
258107614155;258107614174;19;2,9;2;1;1
258107614174;258107614218;44;2,9;2;1;1
258107614218;258107614342;124;2,9;2;1;1
258107614342;258107614358;16;2,9;2;1;1
258107614358;258107614420;62;2,9;2;1;1
258107614420;258107614589;169;2,9;2;1;1
258107614589;258107614655;66;2,9;2;1;1
258107614655;258107614716;61;2,9;2;1;1
258107614716;258107614865;149;2,9;2;1;1
258107614865;258107615196;331;2,9;2;1;1
258107615196;258107615227;31;2,9;2;1;1
258107615227;258107615295;68;2,9;2;1;1
258107615295;258107615316;21;2,9;2;1;1
258107615316;258107615632;316;2,9;2;1;1
258107615632;258107615674;42;2,9;2;1;1
258107615674;258107615728;54;2,9;2;1;1
258107615728;258107615787;59;2,9;2;1;1
258107615787;258107615835;48;2,9;2;1;1
258107615835;258107615998;163;2,9;2;1;1
258107615998;258107616059;61;2,9;2;1;1
258107616059;258107616060;1;2,9;2;1;1
258107616060;258107616090;30;2,9;2;1;1
258107616090;258107616171;81;2,9;2;1;1
258107616171;258107616183;12;2,9;2;1;1
258107616183;258107616211;28;2,9;2;1;1
258107616211;258107616292;81;2,9;2;1;1
258107616292;258107616339;47;2,9;2;1;1
258107616339;258107616357;18;2,9;2;1;1
258107616357;258107616631;274;2,9;2;1;1
258107616631;258107616673;42;2,9;2;1;1
258107616673;258107616718;45;2,9;2;1;1
258107616718;258107616746;28;2,9;2;1;1
258107616746;258107616759;13;2,9;2;1;1
258107616759;258107616802;43;2,9;2;1;1
258107616802;258107616873;71;2,9;2;1;1
258107616873;258107616877;4;2,9;2;1;1
258107616877;258107616929;52;2,9;2;1;1
258107616929;258107616952;23;2,9;2;1;1
258107616952;258107617074;122;2,9;2;1;1
258107617074;258107617147;73;2,9;2;1;1
258107617147;258107617216;69;2,9;2;1;1
258107617216;258107617426;210;2,9;2;1;1
258107617426;258107617757;331;2,9;2;1;1
258107617757;258107618067;310;2,9;2;1;1
258107618067;258107618460;393;2,9;2;1;1
258107618460;258107618515;55;2,9;2;1;1
258107618515;258107618566;51;2,9;2;1;1
258107618566;258107618626;60;2,9;2;1;1
258107618626;258107618788;162;2,9;2;1;1
258107618788;258107618818;30;2,9;2;1;1
258107618818;258107618935;117;2,9;2;1;1
258107618935;258107619012;77;2,9;2;1;1
258107619012;258107619111;99;2,9;2;1;1
258107619111;258107619127;16;2,9;2;1;1
258107619127;258107619188;61;2,9;2;1;1
258107619188;258107619240;52;2,9;2;1;1
258107619240;258107619345;105;2,9;2;1;1
258107619345;258107619444;99;2,9;2;1;1
258107619444;258107619594;150;2,9;2;1;1
258107619594;258107619789;195;2,9;2;1;1
258107619789;258107620003;214;2,9;2;1;1
258107620003;258107620532;529;2,9;2;1;1
258107620532;258107621357;825;2,9;2;1;1
258107621357;258107622631;1274;2,9;2;1;1
258107622631;258107624185;1554;2,9;2;1;1
258107624185;258107624438;253;2,9;2;1;1
258107624438;258107625048;610;2,9;2;1;1
258107625048;258107690728;65680;9;1;1;1
258107690728;258107690802;74;9;1;1;1
258107690802;258107690926;124;9;1;1;1
258107690926;258107691348;422;9;1;1;1
258107691348;258107691602;254;9;1;1;1
258107691602;258107691778;176;9;1;1;1
258107691778;258107696156;4378;9;1;1;1
258107696156;258107696447;291;9;1;1;1
258107696447;258107696496;49;9;1;1;1
258107696496;258107696906;410;9;1;1;1
258107696906;258107696952;46;2,9;2;1;1
258107696952;258107697025;73;2,9;2;1;1
258107697025;258107697178;153;2,9;2;1;1
258107697178;258107697330;152;2,9;2;1;1
258107697330;258107697372;42;2,9;2;1;1
258107697372;258107698415;1043;2,9;2;1;1
258107698415;258107698438;23;2,9;2;1;1
258107698438;258107700532;2094;2,9;2;1;1
258107700532;258107704612;4080;2,9;2;1;1
258107704612;258107705192;580;2,9;2;1;1
258107705192;258107705265;73;2,9;2;1;1
258107705265;258107705457;192;2,9;2;1;1
258107705457;258107705600;143;2,9;2;1;1
258107705600;258107705650;50;2,9;2;1;1
258107705650;258107706625;975;2,9;2;1;1
258107706625;258107706626;1;2,9;2;1;1
258107706626;258107706748;122;2,9;2;1;1
258107706748;258107706840;92;2,9;2;1;1
258107706840;258107707250;410;2,9;2;1;1
258107707250;258107707890;640;2,9;2;1;1
258107707890;258107708167;277;2,9;2;1;1
258107708167;258107708330;163;2,9;2;1;1
258107708330;258107708488;158;2,9;2;1;1
258107708488;258107708628;140;2,9;2;1;1
258107708628;258107709165;537;2,9;2;1;1
258107709165;258107709206;41;2,9;2;1;1
258107709206;258107710146;940;2,9;2;1;1
258107710146;258107710351;205;2,9;2;1;1
258107710351;258107710913;562;2,9;2;1;1
258107710913;258107711053;140;2,9;2;1;1
258107711053;258107711648;595;2,9;2;1;1
258107711648;258107711748;100;2,9;2;1;1
258107711748;258107711781;33;2,9;2;1;1
258107711781;258107711821;40;2,9;2;1;1
258107711821;258107712032;211;2,9;2;1;1
258107712032;258107712217;185;2,9;2;1;1
258107712217;258107712261;44;2,9;2;1;1
258107712261;258107712364;103;2,9;2;1;1
258107712364;258107712636;272;2,9;2;1;1
258107712636;258107712638;2;2,9;2;1;1
258107712638;258107712648;10;2,9;2;1;1
258107712648;258107712721;73;2,9;2;1;1
258107712721;258107712725;4;2,9;2;1;1
258107712725;258107712736;11;2,9;2;1;1
258107712736;258107712805;69;2,9;2;1;1
258107712805;258107712900;95;2,9;2;1;1
258107712900;258107712979;79;2,9;2;1;1
258107712979;258107713156;177;2,9;2;1;1
258107713156;258107713176;20;2,9;2;1;1
258107713176;258107713249;73;2,9;2;1;1
258107713249;258107713368;119;2,9;2;1;1
258107713368;258107713395;27;2,9;2;1;1
258107713395;258107713453;58;2,9;2;1;1
258107713453;258107713576;123;2,9;2;1;1
258107713576;258107713749;173;2,9;2;1;1
258107713749;258107713828;79;2,9;2;1;1
258107713828;258107713880;52;2,9;2;1;1
258107713880;258107713886;6;2,9;2;1;1
258107713886;258107713897;11;2,9;2;1;1
258107713897;258107713923;26;2,9;2;1;1
258107713923;258107714059;136;2,9;2;1;1
258107714059;258107714074;15;2,9;2;1;1
258107714074;258107714098;24;2,9;2;1;1
258107714098;258107714196;98;2,9;2;1;1
258107714196;258107714240;44;2,9;2;1;1
258107714240;258107714277;37;2,9;2;1;1
258107714277;258107714321;44;2,9;2;1;1
258107714321;258107714384;63;2,9;2;1;1
258107714384;258107714457;73;2,9;2;1;1
258107714457;258107714491;34;2,9;2;1;1
258107714491;258107714502;11;2,9;2;1;1
258107714502;258107714615;113;2,9;2;1;1
258107714615;258107714619;4;2,9;2;1;1
258107714619;258107714669;50;2,9;2;1;1
258107714669;258107714754;85;2,9;2;1;1
258107714754;258107714999;245;2,9;2;1;1
258107714999;258107715134;135;2,9;2;1;1
258107715134;258107715270;136;2,9;2;1;1
258107715270;258107715605;335;2,9;2;1;1
258107715605;258107715857;252;2,9;2;1;1
258107715857;258107715914;57;2,9;2;1;1
258107715914;258107716061;147;2,9;2;1;1
258107716061;258107716103;42;2,9;2;1;1
258107716103;258107716650;547;2,9;2;1;1
258107716650;258107716984;334;2,9;2;1;1
258107716984;258107717207;223;2,9;2;1;1
258107717207;258107717279;72;2,9;2;1;1
258107717279;258107717518;239;2,9;2;1;1
258107717518;258107717724;206;2,9;2;1;1
258107717724;258107717851;127;2,9;2;1;1
258107717851;258107717923;72;2,9;2;1;1
258107717923;258107718464;541;2,9;2;1;1
258107718464;258107720772;2308;2,9;2;1;1
258107720772;258107720877;105;2,9;2;1;1
258107720877;258107721238;361;2,9;2;1;1
258107721238;258107721380;142;2,9;2;1;1
258107721380;258107721444;64;2,9;2;1;1
258107721444;258107721861;417;2,9;2;1;1
258107721861;258107722066;205;2,9;2;1;1
258107722066;258107722546;480;2,9;2;1;1
258107722546;258107723242;696;2,9;2;1;1
258107723242;258107723347;105;2,9;2;1;1
258107723347;258107723441;94;2,9;2;1;1
258107723441;258107723653;212;2,9;2;1;1
258107723653;258107723920;267;2,9;2;1;1
258107723920;258107723997;77;2,9;2;1;1
258107723997;258107724255;258;2,9;2;1;1
258107724255;258107724289;34;2,9;2;1;1
258107724289;258107724399;110;2,9;2;1;1
258107724399;258107724509;110;2,9;2;1;1
258107724509;258107724645;136;2,9;2;1;1
258107724645;258107724692;47;2,9;2;1;1
258107724692;258107724745;53;2,9;2;1;1
258107724745;258107724951;206;2,9;2;1;1
258107724951;258107725229;278;2,9;2;1;1
258107725229;258107725488;259;2,9;2;1;1
258107725488;258107725948;460;2,9;2;1;1
258107725948;258107726098;150;2,9;2;1;1
258107726098;258107726242;144;2,9;2;1;1
258107726242;258107726251;9;2,9;2;1;1
258107726251;258107726408;157;2,9;2;1;1
258107726408;258107726423;15;9;1;1;1
258107726423;258107726567;144;9;1;1;1
258107726567;258107726607;40;9;1;1;1
258107726607;258107726648;41;9;1;1;1
258107726648;258107726666;18;9;1;1;1
258107726666;258107726670;4;9;1;1;1
258107726670;258107726728;58;9;1;1;1
258107726728;258107726813;85;9;1;1;1
258107726813;258107726855;42;9;1;1;1
258107726855;258107726863;8;9;1;1;1
258107726863;258107726906;43;9;1;1;1
258107726906;258107726968;62;9;1;1;1
258107726968;258107727004;36;9;1;1;1
258107727004;258107727042;38;9;1;1;1
258107727042;258107727090;48;9;1;1;1
258107727090;258107727137;47;9;1;1;1
258107727137;258107727202;65;9;1;1;1
258107727202;258107727219;17;9;1;1;1
258107727219;258107727292;73;9;1;1;1
258107727292;258107727333;41;9;1;1;1
258107727333;258107727454;121;9;1;1;1
258107727454;258107727568;114;9;1;1;1
258107727568;258107727595;27;9;1;1;1
258107727595;258107727641;46;9;1;1;1
258107727641;258107727668;27;9;1;1;1
258107727668;258107728034;366;9;1;1;1
258107728034;258107728628;594;9;1;1;1
258107728628;258107728803;175;9;1;1;1
258107728803;258107729462;659;9;1;1;1
258107729462;258107729504;42;9;1;1;1
258107729504;258107729919;415;9;1;1;1
258107729919;258107735096;5177;9;1;1;1
258107735096;258107735712;616;9;1;1;1
258107735712;258107735915;203;9;1;1;1
258107735915;258107736136;221;9;1;1;1
258107736136;258107736275;139;9;1;1;1
258107736275;258107738617;2342;9;1;1;1
258107738617;258107738737;120;9;1;1;1
258107738737;258107738832;95;9;1;1;1
258107738832;258107738982;150;9;1;1;1
258107738982;258107739120;138;9;1;1;1
258107739120;258107739879;759;9;1;1;1
258107739879;258107740217;338;9;1;1;1
258107740217;258107740448;231;9;1;1;1
258107740448;258107740618;170;9;1;1;1
258107740618;258107740864;246;9;1;1;1
258107740864;258107741072;208;9;1;1;1
258107741072;258107741485;413;9;1;1;1
258107741485;258107741644;159;9;1;1;1
258107741644;258107741817;173;9;1;1;1
258107741817;258107741910;93;9;1;1;1
258107741910;258107741957;47;9;1;1;1
258107741957;258107742025;68;9;1;1;1
258107742025;258107742120;95;9;1;1;1
258107742120;258107742382;262;9;1;1;1
258107742382;258107745310;2928;9;1;1;1
258107745310;258107745609;299;9;1;1;1
258107745609;258107745663;54;9;1;1;1
258107745663;258107745895;232;9;1;1;1
258107745895;258107745903;8;9;1;1;1
258107745903;258107745954;51;9;1;1;1
258107745954;258107746047;93;9;1;1;1
258107746047;258107746165;118;9;1;1;1
258107746165;258107746305;140;9;1;1;1
258107746305;258107746352;47;9;1;1;1
258107746352;258107746831;479;9;1;1;1
258107746831;258107747691;860;9;1;1;1
258107747691;258107748674;983;9;1;1;1
258107748674;258107748982;308;9;1;1;1
258107748982;258107749133;151;9;1;1;1
258107749133;258107749300;167;9;1;1;1
258107749300;258107749875;575;9;1;1;1
258107749875;258107749925;50;9;1;1;1
258107749925;258107750053;128;9;1;1;1
258107750053;258107750077;24;9;1;1;1
258107750077;258107750216;139;9;1;1;1
258107750216;258107750258;42;9;1;1;1
258107750258;258107750465;207;9;1;1;1
258107750465;258107750557;92;9;1;1;1
258107750557;258107751029;472;9;1;1;1
258107751029;258107752788;1759;9;1;1;1
258107752788;258107755147;2359;9;1;1;1
258107755147;258107755161;14;9;1;1;1
258107755161;258107756672;1511;9;1;1;1
258107756672;258107756785;113;9;1;1;1
258107756785;258107756955;170;9;1;1;1
258107756955;258107758956;2001;2,9;2;1;1
258107758956;258107759062;106;2,9;2;1;1
258107759062;258107759532;470;2,9;2;1;1
258107759532;258107759556;24;2,9;2;1;1
258107759556;258107759836;280;2,9;2;1;1
258107759836;258107759856;20;2,9;2;1;1
258107759856;258107759877;21;2,9;2;1;1
258107759877;258107760226;349;2,9;2;1;1
258107760226;258107760345;119;2,9;2;1;1
258107760345;258107760681;336;2,9;2;1;1
258107760681;258107760954;273;2,9;2;1;1
258107760954;258107761920;966;2,9;2;1;1
258107761920;258107762219;299;2,9;2;1;1
258107762219;258107763738;1519;2,9;2;1;1
258107763738;258107764265;527;2,9;2;1;1
258107764265;258107765738;1473;2,9;2;1;1
258107765738;258107766031;293;2,9;2;1;1
258107766031;258107766243;212;9;1;1;1
258107766243;258107766470;227;9;1;1;1
258107766470;258107766913;443;9;1;1;1
258107766913;258107767213;300;9;1;1;1
258107767213;258107767836;623;9;1;1;1
258107767836;258107768540;704;9;1;1;1
258107768540;258107769501;961;9;1;1;1
258107769501;258107771376;1875;2,9;2;1;1
258107771376;258107771425;49;2,9;2;1;1
258107771425;258107771535;110;2,9;2;1;1
258107771535;258107771579;44;2,9;2;1;1
258107771579;258107771691;112;2,9;2;1;1
258107771691;258107772994;1303;2,9;2;1;1
258107772994;258107774359;1365;2,9;2;1;1
258107774359;258107775366;1007;9;1;1;1
258107775366;258107776901;1535;9;1;1;1
258107776901;258107777475;574;9;1;1;1
258107777475;258107778039;564;2,9;2;1;1
258107778039;258107778654;615;2,9;2;1;1
258107778654;258107778690;36;2,9;2;1;1
258107778690;258107779679;989;2,9;2;1;1
258107779679;258107780243;564;2,9;2;1;1
258107780243;258107782880;2637;9;1;1;1
258107782880;258107783045;165;9;1;1;1
258107783045;258107783155;110;9;1;1;1
258107783155;258107784461;1306;9;1;1;1
258107784461;258107784580;119;9;1;1;1
258107784580;258107784782;202;9;1;1;1
258107784782;258107784902;120;9;1;1;1
258107784902;258107785062;160;9;1;1;1
258107785062;258107785454;392;9;1;1;1
258107785454;258107785642;188;9;1;1;1
258107785642;258107788394;2752;9;1;1;1
258107788394;258107788607;213;9;1;1;1
258107788607;258107788682;75;9;1;1;1
258107788682;258107789714;1032;9;1;1;1
258107789714;258107791325;1611;9;1;1;1
258107791325;258107792602;1277;2,9;2;1;1
258107792602;258107793457;855;9;1;1;1
258107793457;258107793619;162;9;1;1;1
258107793619;258107793739;120;9;1;1;1
258107793739;258107793899;160;9;1;1;1
258107793899;258107794661;762;2,9;2;1;1
258107794661;258107794875;214;2,9;2;1;1
258107794875;258107795187;312;2,9;2;1;1
258107795187;258107795747;560;2,9;2;1;1
258107795747;258107796628;881;2,9;2;1;1
258107796628;258107796740;112;2,9;2;1;1
258107796740;258107797475;735;2,9;2;1;1
258107797475;258107798236;761;2,9;2;1;1
258107798236;258107799758;1522;9;1;1;1
258107799758;258107801252;1494;9;1;1;1
258107801252;258107801964;712;2,9;2;1;1
258107801964;258107802126;162;9;1;1;1
258107802126;258107802702;576;2,9;2;1;1
258107802702;258107802861;159;2,9;2;1;1
258107802861;258107803306;445;2,9;2;1;1
258107803306;258107803480;174;2,9;2;1;1
258107803480;258107803817;337;2,9;2;1;1
258107803817;258107804016;199;2,9;2;1;1
258107804016;258107804289;273;2,9;2;1;1
258107804289;258107805385;1096;9;1;1;1
258107805385;258107805441;56;9;1;1;1
258107805441;258107807020;1579;9;1;1;1
258107807020;258107808353;1333;9;1;1;1
258107808353;258107809532;1179;9;1;1;1
258107809532;258107811912;2380;9;1;1;1
258107811912;258107812086;174;9;1;1;1
258107812086;258107812229;143;9;1;1;1
258107812229;258107812543;314;9;1;1;1
258107812543;258107813382;839;9;1;1;1
258107813382;258107814317;935;9;1;1;1
258107814317;258107814434;117;9;1;1;1
258107814434;258107814527;93;9;1;1;1
258107814527;258107815015;488;9;1;1;1
258107815015;258107816918;1903;9;1;1;1
258107816918;258107817122;204;9;1;1;1
258107817122;258107818617;1495;9;1;1;1
258107818617;258107818875;258;9;1;1;1
258107818875;258107818996;121;9;1;1;1
258107818996;258107819194;198;9;1;1;1
258107819194;258107819536;342;9;1;1;1
258107819536;258107819608;72;9;1;1;1
258107819608;258107820167;559;9;1;1;1
258107820167;258107820265;98;9;1;1;1
258107820265;258107820343;78;9;1;1;1
258107820343;258107820479;136;9;1;1;1
258107820479;258107820866;387;9;1;1;1
258107820866;258107821148;282;9;1;1;1
258107821148;258107829894;8746;9;1;1;1
258107829894;258107829947;53;9;1;1;1
258107829947;258107830059;112;9;1;1;1
258107830059;258107830172;113;9;1;1;1
258107830172;258107830360;188;9;1;1;1
258107830360;258107831638;1278;9;1;1;1
258107831638;258107832189;551;9;1;1;1
258107832189;258107832417;228;9;1;1;1
258107832417;258107833008;591;9;1;1;1
258107833008;258107835205;2197;9;1;1;1
258107835205;258107835299;94;9;1;1;1
258107835299;258107836827;1528;9;1;1;1
258107836827;258107837392;565;9;1;1;1
258107837392;258107837845;453;9;1;1;1
258107837845;258107838483;638;9;1;1;1
258107838483;258107840008;1525;9;1;1;1
258107840008;258107840635;627;9;1;1;1
258107840635;258107840759;124;9;1;1;1
258107840759;258107840949;190;9;1;1;1
258107840949;258107841289;340;9;1;1;1
258107841289;258107841611;322;9;1;1;1
258107841611;258107842238;627;9;1;1;1
258107842238;258107845099;2861;9;1;1;1
258107845099;258107846491;1392;9;1;1;1
258107846491;258107846994;503;9;1;1;1
258107846994;258107847561;567;2,9;2;1;1
258107847561;258107848010;449;2,9;2;1;1
258107848010;258107848091;81;2,9;2;1;1
258107848091;258107848159;68;2,9;2;1;1
258107848159;258107848224;65;2,9;2;1;1
258107848224;258107848714;490;2,9;2;1;1
258107848714;258107848979;265;2,9;2;1;1
258107848979;258107849382;403;2,9;2;1;1
258107849382;258107849498;116;2,9;2;1;1
258107849498;258107849607;109;2,9;2;1;1
258107849607;258107852310;2703;2,9;2;1;1
258107852310;258107852534;224;2,9;2;1;1
258107852534;258107854021;1487;2,9;2;1;1
258107854021;258107854303;282;2,9;2;1;1
258107854303;258107856045;1742;2,9;2;1;1
258107856045;258107856204;159;2,9;2;1;1
258107856204;258107856259;55;2,9;2;1;1
258107856259;258107857882;1623;2,9;2;1;1
258107857882;258107858482;600;2,9;2;1;1
258107858482;258107858507;25;2,9;2;1;1
258107858507;258107858738;231;2,9;2;1;1
258107858738;258107859444;706;2,9;2;1;1
258107859444;258107860460;1016;2,9;2;1;1
258107860460;258107860617;157;2,9;2;1;1
258107860617;258107861195;578;2,9;2;1;1
258107861195;258107861307;112;2,9;2;1;1
258107861307;258107861449;142;2,9;2;1;1
258107861449;258107861697;248;2,9;2;1;1
258107861697;258107861830;133;2,9;2;1;1
258107861830;258107866516;4686;2,9;2;1;1
258107866516;258107867641;1125;2,9;2;1;1
258107867641;258107869476;1835;2,9;2;1;1
258107869476;258107869719;243;2,9;2;1;1
258107869719;258107870563;844;2,9;2;1;1
258107870563;258107871511;948;2,9;2;1;1
258107871511;258107871880;369;2,9;2;1;1
258107871880;258107874107;2227;2,9;2;1;1
258107874107;258107874156;49;2,9;2;1;1
258107874156;258107874243;87;2,9;2;1;1
258107874243;258107874306;63;2,9;2;1;1
258107874306;258107874520;214;2,9;2;1;1
258107874520;258107874694;174;2,9;2;1;1
258107874694;258107875685;991;2,9;2;1;1
258107875685;258107875842;157;2,9;2;1;1
258107875842;258107875925;83;2,9;2;1;1
258107875925;258107876102;177;2,9;2;1;1
258107876102;258107876169;67;2,9;2;1;1
258107876169;258107876364;195;2,9;2;1;1
258107876364;258107876901;537;2,9;2;1;1
258107876901;258107877001;100;2,9;2;1;1
258107877001;258107877050;49;2,9;2;1;1
258107877050;258107877250;200;2,9;2;1;1
258107877250;258107877433;183;2,9;2;1;1
258107877433;258107878254;821;2,9;2;1;1
258107878254;258107878763;509;2,9;2;1;1
258107878763;258107881347;2584;2,9;2;1;1
258107881347;258107881538;191;2,9;2;1;1
258107881538;258107881634;96;2,9;2;1;1
258107881634;258107881846;212;2,9;2;1;1
258107881846;258107882548;702;2,9;2;1;1
258107882548;258107884699;2151;2,9;2;1;1
258107884699;258107885567;868;2,9;2;1;1
258107885567;258107885625;58;2,9;2;1;1
258107885625;258107886046;421;2,9;2;1;1
258107886046;258107886142;96;2,9;2;1;1
258107886142;258107886259;117;2,9;2;1;1
258107886259;258107886707;448;2,9;2;1;1
258107886707;258107887401;694;2,9;2;1;1
258107887401;258107887447;46;2,9;2;1;1
258107887447;258107887636;189;2,9;2;1;1
258107887636;258107887682;46;2,9;2;1;1
258107887682;258107889347;1665;2,9;2;1;1
258107889347;258107889826;479;2,9;2;1;1
258107889826;258107893322;3496;2,9;2;1;1
258107893322;258107893745;423;2,9;2;1;1
258107893745;258107894117;372;2,9;2;1;1
258107894117;258107896461;2344;2,9;2;1;1
258107896461;258107897556;1095;2,9;2;1;1
258107897556;258107902304;4748;2,9;2;1;1
258107902304;258107902568;264;2,9;2;1;1
258107902568;258107903268;700;2,9;2;1;1
258107903268;258107903619;351;2,9;2;1;1
258107903619;258107903929;310;2,9;2;1;1
258107903929;258107904264;335;2,9;2;1;1
258107904264;258107904459;195;2,9;2;1;1
258107904459;258107904628;169;2,9;2;1;1
258107904628;258107904691;63;2,9;2;1;1
258107904691;258107904907;216;2,9;2;1;1
258107904907;258107905378;471;2,9;2;1;1
258107905378;258107905468;90;2,9;2;1;1
258107905468;258107906332;864;2,9;2;1;1
258107906332;258107906800;468;2,9;2;1;1
258107906800;258107907217;417;2,9;2;1;1
258107907217;258107907454;237;2,9;2;1;1
258107907454;258107908023;569;9;1;1;1
258107908023;258107908087;64;9;1;1;1
258107908087;258107908739;652;9;1;1;1
258107908739;258107911567;2828;9;1;1;1
258107911567;258107912124;557;9;1;1;1
258107912124;258107913299;1175;9;1;1;1
258107913299;258107918088;4789;9;1;1;1
258107918088;258107922751;4663;9;1;1;1
258107922751;258107923257;506;9;1;1;1
258107923257;258107925820;2563;9;1;1;1
258107925820;258107925862;42;9;1;1;1
258107925862;258107925894;32;9;1;1;1
258107925894;258107926162;268;9;1;1;1
258107926162;258107926199;37;9;1;1;1
258107926199;258107926237;38;9;1;1;1
258107926237;258107926881;644;9;1;1;1
258107926881;258107929536;2655;9;1;1;1
258107929536;258107937055;7519;9;1;1;1
258107937055;258107949555;12500;9;1;1;1
258107949555;258107960252;10697;9;1;1;1
258107960252;258107963874;3622;2,9;2;1;1
258107963874;258107964698;824;2,9;2;1;1
258107964698;258107967694;2996;2,9;2;1;1
258107967694;258107967746;52;2,9;2;1;1
258107967746;258107967816;70;2,9;2;1;1
258107967816;258107967917;101;2,9;2;1;1
258107967917;258107968056;139;2,9;2;1;1
258107968056;258107968140;84;2,9;2;1;1
258107968140;258107968210;70;2,9;2;1;1
258107968210;258107975692;7482;2,9;2;1;1
258107975692;258107976809;1117;2,9;2;1;1
258107976809;258107987468;10659;2,9;2;1;1
258107987468;258107989464;1996;2,9;2;1;1
258107989464;258107997630;8166;9;1;1;1
258107997630;258107998679;1049;9;1;1;1
258107998679;258108003444;4765;9;1;1;1
258108003444;258108004719;1275;9;1;1;1
258108004719;258108005032;313;9;1;1;1
258108005032;258108009866;4834;9;1;1;1
258108009866;258108009874;8;9;1;1;1
258108009874;258108009924;50;9;1;1;1
258108009924;258108009950;26;9;1;1;1
258108009950;258108012290;2340;9;1;1;1
258108012290;258108012637;347;9;1;1;1
258108012637;258108012811;174;9;1;1;1
258108012811;258108013440;629;9;1;1;1
258108013440;258108015283;1843;9;1;1;1
258108015283;258108015408;125;2,9;2;1;1
258108015408;258108015431;23;2,9;2;1;1
258108015431;258108015487;56;2,9;2;1;1
258108015487;258108015936;449;2,9;2;1;1
258108015936;258108017791;1855;9;1;1;1
258108017791;258108018004;213;9;1;1;1
258108018004;258108024957;6953;9;1;1;1
258108024957;258108026975;2018;9;1;1;1
258108026975;258108027675;700;9;1;1;1
258108027675;258108029426;1751;9;1;1;1
258108029426;258108030145;719;9;1;1;1
258108030145;258108034826;4681;9;1;1;1
258108034826;258108034895;69;9;1;1;1
258108034895;258108035774;879;9;1;1;1
258108035774;258108035787;13;9;1;1;1
258108035787;258108035808;21;9;1;1;1
258108035808;258108052158;16350;9;1;1;1
258108052158;258108062922;10764;9;1;1;1
258108062922;258108063353;431;9;1;1;1
258108063353;258108081122;17769;9;1;1;1
258108081122;258108083272;2150;2,9;2;1;1
258108083272;258108086118;2846;2,9;2;1;1
258108086118;258108090913;4795;2,9;2;1;1
258108090913;258108100022;9109;2,9;2;1;1
258108100022;258108100650;628;2,9;2;1;1
258108100650;258108101587;937;2,9;2;1;1
258108101587;258108102282;695;2,9;2;1;1
258108102282;258108108023;5741;2,9;2;1;1
258108108023;258108111684;3661;2,9;2;1;1
258108111684;258108111733;49;2,9;2;1;1
258108111733;258108112184;451;2,9;2;1;1
258108112184;258108112226;42;2,9;2;1;1
258108112226;258108112466;240;2,9;2;1;1
258108112466;258108113762;1296;2,9;2;1;1
258108113762;258108115969;2207;2,9;2;1;1
258108115969;258108123060;7091;2,9;2;1;1
258108123060;258108132978;9918;2,9;2;1;1
258108132978;258108133228;250;2,9;2;1;1
258108133228;258108134197;969;2,9;2;1;1
258108134197;258108136077;1880;2,9;2;1;1
258108136077;258108136575;498;2,9;2;1;1
258108136575;258108137546;971;2,9;2;1;1
258108137546;258108137754;208;2,9;2;1;1
258108137754;258108138248;494;2,9;2;1;1
258108138248;258108138965;717;2,9;2;1;1
258108138965;258108145170;6205;9;1;1;1
258108145170;258108154694;9524;9;1;1;1
258108154694;258108154729;35;9;1;1;1
258108154729;258108154943;214;9;1;1;1
258108154943;258108155068;125;9;1;1;1
258108155068;258108177609;22541;9;1;1;1
258108177609;258108180849;3240;9;1;1;1
258108180849;258108181164;315;9;1;1;1
258108181164;258108191103;9939;9;1;1;1
258108191103;258108212972;21869;2,9;2;1;1
258108212972;258108219614;6642;2,9;2;1;1
258108219614;258108223278;3664;9;1;1;1
258108223278;258108223327;49;9;1;1;1
258108223327;258108245866;22539;9;1;1;1
258108245866;258108247502;1636;2,9;2;1;1
258108247502;258108248060;558;2,9;2;1;1
258108248060;258108250834;2774;2,9;2;1;1
258108250834;258108253947;3113;9;1;1;1
258108253947;258108254241;294;2,9;2;1;1
258108254241;258108255457;1216;2,9;2;1;1
258108255457;258108255638;181;2,9;2;1;1
258108255638;258108257158;1520;2,9;2;1;1
258108257158;258108259763;2605;9;1;1;1
258108259763;258108260701;938;2,9;2;1;1
258108260701;258108261058;357;2,9;2;1;1
258108261058;258108262801;1743;2,9;2;1;1
258108262801;258108262887;86;2,9;2;1;1
258108262887;258108263059;172;2,9;2;1;1
258108263059;258108263094;35;2,9;2;1;1
258108263094;258108265416;2322;2,9;2;1;1
258108265416;258108265438;22;2,9;2;1;1
258108265438;258108265451;13;2,9;2;1;1
258108265451;258108265489;38;2,9;2;1;1
258108265489;258108265964;475;2,9;2;1;1
258108265964;258108267734;1770;2,9;2;1;1
258108267734;258108270659;2925;9;1;1;1
258108270659;258108271277;618;2,9;2;1;1
258108271277;258108293302;22025;9;1;1;1
258108293302;258108302427;9125;9;1;1;1
258108302427;258108302519;92;9;1;1;1
258108302519;258108302573;54;9;1;1;1
258108302573;258108302816;243;9;1;1;1
258108302816;258108303310;494;9;1;1;1
258108303310;258108312360;9050;9;1;1;1
258108312360;258108314858;2498;2,9;2;1;1
258108314858;258108317143;2285;2,9;2;1;1
258108317143;258108318442;1299;2,9;2;1;1
258108318442;258108321655;3213;2,9;2;1;1
258108321655;258108324942;3287;2,9;2;1;1
258108324942;258108324974;32;2,9;2;1;1
258108324974;258108336536;11562;2,9;2;1;1
258108336536;258108336782;246;2,9;2;1;1
258108336782;258108343858;7076;2,9;2;1;1
258108343858;258108346645;2787;2,9;2;1;1
258108346645;258108348027;1382;2,9;2;1;1
258108348027;258108350605;2578;2,9;2;1;1
258108350605;258108351428;823;2,9;2;1;1
258108351428;258108352018;590;2,9;2;1;1
258108352018;258108352552;534;2,9;2;1;1
258108352552;258108353018;466;2,9;2;1;1
258108353018;258108353295;277;2,9;2;1;1
258108353295;258108354562;1267;2,9;2;1;1
258108354562;258108355411;849;2,9;2;1;1
258108355411;258108355486;75;2,9;2;1;1
258108355486;258108356380;894;2,9;2;1;1
258108356380;258108356494;114;2,9;2;1;1
258108356494;258108362098;5604;9;1;1;1
258108362098;258108365834;3736;9;1;1;1
258108365834;258108366287;453;9;1;1;1
258108366287;258108370048;3761;9;1;1;1
258108370048;258108370056;8;9;1;1;1
258108370056;258108370106;50;9;1;1;1
258108370106;258108370115;9;9;1;1;1
258108370115;258108370166;51;9;1;1;1
258108370166;258108370193;27;9;1;1;1
258108370193;258108370247;54;9;1;1;1
258108370247;258108372506;2259;9;1;1;1
258108372506;258108372523;17;9;1;1;1
258108372523;258108372575;52;9;1;1;1
258108372575;258108372590;15;9;1;1;1
258108372590;258108373066;476;9;1;1;1
258108373066;258108373295;229;9;1;1;1
258108373295;258108373333;38;9;1;1;1
258108373333;258108408683;35350;9;1;1;1
258108408683;258108424219;15536;9;1;1;1
258108424219;258108452849;28630;2,9;2;1;1
258108452849;258108512065;59216;9;1;1;1
258108512065;258108513964;1899;2,9;2;1;1
258108513964;258108516558;2594;2,9;2;1;1
258108516558;258108523615;7057;2,9;2;1;1
258108523615;258108525040;1425;2,9;2;1;1
258108525040;258108527226;2186;2,9;2;1;1
258108527226;258108527299;73;2,9;2;1;1
258108527299;258108527433;134;2,9;2;1;1
258108527433;258108527538;105;2,9;2;1;1
258108527538;258108527629;91;2,9;2;1;1
258108527629;258108532893;5264;2,9;2;1;1
258108532893;258108536023;3130;2,9;2;1;1
258108536023;258108537967;1944;2,9;2;1;1
258108537967;258108540738;2771;2,9;2;1;1
258108540738;258108541723;985;2,9;2;1;1
258108541723;258108550016;8293;2,9;2;1;1
258108550016;258108560953;10937;2,9;2;1;1
258108560953;258108561891;938;2,9;2;1;1
258108561891;258108565115;3224;2,9;2;1;1
258108565115;258108565636;521;2,9;2;1;1
258108565636;258108566114;478;2,9;2;1;1
258108566114;258108566156;42;2,9;2;1;1
258108566156;258108567131;975;2,9;2;1;1
258108567131;258108568072;941;2,9;2;1;1
258108568072;258108569411;1339;2,9;2;1;1
258108569411;258108570423;1012;2,9;2;1;1
258108570423;258108571158;735;2,9;2;1;1
258108571158;258108576808;5650;9;1;1;1
258108576808;258108576859;51;9;1;1;1
258108576859;258108576884;25;9;1;1;1
258108576884;258108576956;72;9;1;1;1
258108576956;258108577060;104;9;1;1;1
258108577060;258108577424;364;9;1;1;1
258108577424;258108577469;45;9;1;1;1
258108577469;258108598396;20927;9;1;1;1
258108598396;258108620026;21630;9;1;1;1
258108620026;258108630057;10031;2,9;2;1;1
258108630057;258108638675;8618;2,9;2;1;1
258108638675;258108638679;4;2,9;2;1;1
258108638679;258108641419;2740;2,9;2;1;1
258108641419;258108646403;4984;2,9;2;1;1
258108646403;258108650522;4119;9;1;1;1
258108650522;258108650633;111;9;1;1;1
258108650633;258108672291;21658;9;1;1;1
258108672291;258108672427;136;9;1;1;1
258108672427;258108673093;666;2,9;2;1;1
258108673093;258108675478;2385;9;1;1;1
258108675478;258108675693;215;9;1;1;1
258108675693;258108700327;24634;9;1;1;1
258108700327;258108730430;30103;9;1;1;1
258108730430;258108731484;1054;9;1;1;1
258108731484;258108733080;1596;2,9;2;1;1
258108733080;258108734222;1142;2,9;2;1;1
258108734222;258108745944;11722;2,9;2;1;1
258108745944;258108748171;2227;2,9;2;1;1
258108748171;258108750047;1876;2,9;2;1;1
258108750047;258108756398;6351;2,9;2;1;1
258108756398;258108760732;4334;2,9;2;1;1
258108760732;258108765492;4760;2,9;2;1;1
258108765492;258108765884;392;2,9;2;1;1
258108765884;258108767210;1326;2,9;2;1;1
258108767210;258108768260;1050;2,9;2;1;1
258108768260;258108771094;2834;2,9;2;1;1
258108771094;258108771984;890;2,9;2;1;1
258108771984;258108776409;4425;9;1;1;1
258108776409;258108776502;93;9;1;1;1
258108776502;258108777365;863;9;1;1;1
258108777365;258108777995;630;2,9;2;1;1
258108777995;258108778038;43;2,9;2;1;1
258108778038;258108779713;1675;2,9;2;1;1
258108779713;258108781691;1978;2,9;2;1;1
258108781691;258108783367;1676;2,9;2;1;1
258108783367;258108783789;422;2,9;2;1;1
258108783789;258108784020;231;2,9;2;1;1
258108784020;258108840720;56700;9;1;1;1
258108840720;258108840930;210;9;1;1;1
258108840930;258108843280;2350;9;1;1;1
258108843280;258108869957;26677;2,9;2;1;1
258108869957;258108884662;14705;9;1;1;1
258108884662;258108895795;11133;9;1;1;1
258108895795;258108895883;88;9;1;1;1
258108895883;258108897767;1884;9;1;1;1
258108897767;258108898591;824;2,9;2;1;1
258108898591;258108935300;36709;9;1;1;1
258108935300;258108944814;9514;9;1;1;1
258108944814;258108945058;244;9;1;1;1
258108945058;258108975331;30273;9;1;1;1
258108975331;258108977274;1943;2,9;2;1;1
258108977274;258108983752;6478;2,9;2;1;1
258108983752;258108992332;8580;2,9;2;1;1
258108992332;258108997582;5250;2,9;2;1;1
258108997582;258109001695;4113;2,9;2;1;1
258109001695;258109001918;223;2,9;2;1;1
258109001918;258109004155;2237;2,9;2;1;1
258109004155;258109004235;80;2,9;2;1;1
258109004235;258109005086;851;2,9;2;1;1
258109005086;258109006989;1903;2,9;2;1;1
258109006989;258109007960;971;2,9;2;1;1
258109007960;258109008241;281;2,9;2;1;1
258109008241;258109008804;563;9;1;1;1
258109008804;258109009081;277;9;1;1;1
258109009081;258109009258;177;9;1;1;1
258109009258;258109009317;59;9;1;1;1
258109009317;258109009359;42;9;1;1;1
258109009359;258109009385;26;2,9;2;1;1
258109009385;258109009416;31;2,9;2;1;1
258109009416;258109010145;729;2,9;2;1;1
258109010145;258109010358;213;2,9;2;1;1
258109010358;258109013607;3249;2,9;2;1;1
258109013607;258109014214;607;9;1;1;1
258109014214;258109014931;717;2,9;2;1;1
258109014931;258109038512;23581;9;1;1;1
258109038512;258109041239;2727;9;1;1;1
258109041239;258109041464;225;9;1;1;1
258109041464;258109051091;9627;9;1;1;1
258109051091;258109080806;29715;9;1;1;1
258109080806;258109092395;11589;2,9;2;1;1
258109092395;258109107321;14926;2,9;2;1;1
258109107321;258109123961;16640;9;1;1;1
258109123961;258109127204;3243;9;1;1;1
258109127204;258109127258;54;9;1;1;1
258109127258;258109127432;174;9;1;1;1
258109127432;258109127712;280;9;1;1;1
258109127712;258109127764;52;9;1;1;1
258109127764;258109133700;5936;9;1;1;1
258109133700;258109136943;3243;2,9;2;1;1
258109136943;258109137299;356;2,9;2;1;1
258109137299;258109137908;609;2,9;2;1;1
258109137908;258109138713;805;2,9;2;1;1
258109138713;258109144370;5657;9;1;1;1
258109144370;258109144391;21;2,9;2;1;1
258109144391;258109145639;1248;2,9;2;1;1
258109145639;258109146826;1187;2,9;2;1;1
258109146826;258109149744;2918;2,9;2;1;1
258109149744;258109151904;2160;2,9;2;1;1
258109151904;258109152526;622;2,9;2;1;1
258109152526;258109155833;3307;2,9;2;1;1
258109155833;258109157572;1739;9;1;1;1
258109157572;258109158625;1053;2,9;2;1;1
258109158625;258109161300;2675;9;1;1;1
258109161300;258109162583;1283;2,9;2;1;1
258109162583;258109184727;22144;9;1;1;1
258109184727;258109189300;4573;9;1;1;1
258109189300;258109189759;459;9;1;1;1
258109189759;258109194998;5239;9;1;1;1
258109194998;258109195047;49;9;1;1;1
258109195047;258109200228;5181;9;1;1;1
258109200228;258109204111;3883;2,9;2;1;1
258109204111;258109204837;726;2,9;2;1;1
258109204837;258109204885;48;2,9;2;1;1
258109204885;258109205205;320;2,9;2;1;1
258109205205;258109206973;1768;2,9;2;1;1
258109206973;258109215403;8430;2,9;2;1;1
258109215403;258109215765;362;2,9;2;1;1
258109215765;258109222197;6432;2,9;2;1;1
258109222197;258109225197;3000;2,9;2;1;1
258109225197;258109227730;2533;2,9;2;1;1
258109227730;258109231098;3368;2,9;2;1;1
258109231098;258109232096;998;2,9;2;1;1
258109232096;258109234691;2595;2,9;2;1;1
258109234691;258109249761;15070;2,9;2;1;1
258109249761;258109251321;1560;2,9;2;1;1
258109251321;258109252629;1308;2,9;2;1;1
258109252629;258109253070;441;2,9;2;1;1
258109253070;258109254117;1047;2,9;2;1;1
258109254117;258109254654;537;2,9;2;1;1
258109254654;258109261708;7054;2,9;2;1;1
258109261708;258109261755;47;2,9;2;1;1
258109261755;258109262581;826;2,9;2;1;1
258109262581;258109263340;759;2,9;2;1;1
258109263340;258109298787;35447;9;1;1;1
258109298787;258109302398;3611;9;1;1;1
258109302398;258109302417;19;9;1;1;1
258109302417;258109302745;328;9;1;1;1
258109302745;258109302772;27;9;1;1;1
258109302772;258109311540;8768;9;1;1;1
258109311540;258109318138;6598;2,9;2;1;1
258109318138;258109320056;1918;2,9;2;1;1
258109320056;258109321322;1266;2,9;2;1;1
258109321322;258109333615;12293;2,9;2;1;1
258109333615;258109333991;376;2,9;2;1;1
258109333991;258109334416;425;2,9;2;1;1
258109334416;258109335572;1156;2,9;2;1;1
258109335572;258109336718;1146;2,9;2;1;1
258109336718;258109339246;2528;2,9;2;1;1
258109339246;258109341522;2276;2,9;2;1;1
258109341522;258109345558;4036;2,9;2;1;1
258109345558;258109345579;21;2,9;2;1;1
258109345579;258109345594;15;2,9;2;1;1
258109345594;258109345634;40;2,9;2;1;1
258109345634;258109345685;51;2,9;2;1;1
258109345685;258109345736;51;2,9;2;1;1
258109345736;258109345762;26;2,9;2;1;1
258109345762;258109345994;232;2,9;2;1;1
258109345994;258109348247;2253;2,9;2;1;1
258109348247;258109353580;5333;2,9;2;1;1
258109353580;258109357404;3824;2,9;2;1;1
258109357404;258109362799;5395;2,9;2;1;1
258109362799;258109363848;1049;2,9;2;1;1
258109363848;258109363859;11;2,9;2;1;1
258109363859;258109369665;5806;2,9;2;1;1
258109369665;258109370259;594;2,9;2;1;1
258109370259;258109370352;93;2,9;2;1;1
258109370352;258109370389;37;2,9;2;1;1
258109370389;258109371308;919;2,9;2;1;1
258109371308;258109388465;17157;9;1;1;1
258109388465;258109397921;9456;9;1;1;1
258109397921;258109398167;246;9;1;1;1
258109398167;258109398177;10;9;1;1;1
258109398177;258109398574;397;9;1;1;1
258109398574;258109398631;57;9;1;1;1
258109398631;258109398657;26;9;1;1;1
258109398657;258109399048;391;9;1;1;1
258109399048;258109426751;27703;9;1;1;1
258109426751;258109427864;1113;9;1;1;1
258109427864;258109429297;1433;2,9;2;1;1
258109429297;258109430000;703;2,9;2;1;1
258109430000;258109430358;358;2,9;2;1;1
258109430358;258109430633;275;2,9;2;1;1
258109430633;258109430670;37;2,9;2;1;1
258109430670;258109430705;35;2,9;2;1;1
258109430705;258109432726;2021;2,9;2;1;1
258109432726;258109442995;10269;2,9;2;1;1
258109442995;258109444946;1951;2,9;2;1;1
258109444946;258109449320;4374;2,9;2;1;1
258109449320;258109449632;312;2,9;2;1;1
258109449632;258109455828;6196;2,9;2;1;1
258109455828;258109457020;1192;2,9;2;1;1
258109457020;258109462693;5673;2,9;2;1;1
258109462693;258109467092;4399;2,9;2;1;1
258109467092;258109472171;5079;2,9;2;1;1
258109472171;258109473322;1151;2,9;2;1;1
258109473322;258109473920;598;2,9;2;1;1
258109473920;258109474421;501;2,9;2;1;1
258109474421;258109475593;1172;2,9;2;1;1
258109475593;258109477824;2231;2,9;2;1;1
258109477824;258109478131;307;2,9;2;1;1
258109478131;258109478549;418;2,9;2;1;1
258109478549;258109478944;395;2,9;2;1;1
258109478944;258109480327;1383;2,9;2;1;1
258109480327;258109480790;463;2,9;2;1;1
258109480790;258109481034;244;2,9;2;1;1
258109481034;258109481768;734;2,9;2;1;1
258109481768;258109497817;16049;9;1;1;1
258109497817;258109497852;35;9;1;1;1
258109497852;258109497912;60;9;1;1;1
258109497912;258109497967;55;9;1;1;1
258109497967;258109498096;129;9;1;1;1
258109498096;258109498268;172;9;1;1;1
258109498268;258109504377;6109;9;1;1;1
258109504377;258109536669;32292;9;1;1;1
258109536669;258109545929;9260;2,9;2;1;1
258109545929;258109546207;278;2,9;2;1;1
258109546207;258109546315;108;2,9;2;1;1
258109546315;258109546477;162;2,9;2;1;1
258109546477;258109546644;167;2,9;2;1;1
258109546644;258109546711;67;2,9;2;1;1
258109546711;258109546863;152;2,9;2;1;1
258109546863;258109547052;189;2,9;2;1;1
258109547052;258109549218;2166;2,9;2;1;1
258109549218;258109551183;1965;2,9;2;1;1
258109551183;258109551225;42;2,9;2;1;1
258109551225;258109551427;202;2,9;2;1;1
258109551427;258109551523;96;2,9;2;1;1
258109551523;258109551552;29;2,9;2;1;1
258109551552;258109551734;182;2,9;2;1;1
258109551734;258109551767;33;2,9;2;1;1
258109551767;258109551886;119;2,9;2;1;1
258109551886;258109559218;7332;2,9;2;1;1
258109559218;258109559534;316;2,9;2;1;1
258109559534;258109563155;3621;2,9;2;1;1
258109563155;258109564262;1107;9;1;1;1
258109564262;258109581623;17361;9;1;1;1
258109581623;258109582247;624;2,9;2;1;1
258109582247;258109612731;30484;9;1;1;1
258109612731;258109622015;9284;9;1;1;1
258109622015;258109622259;244;9;1;1;1
258109622259;258109643606;21347;9;1;1;1
258109643606;258109646899;3293;9;1;1;1
258109646899;258109647000;101;9;1;1;1
258109647000;258109647303;303;9;1;1;1
258109647303;258109647492;189;9;1;1;1
258109647492;258109678144;30652;9;1;1;1
258109678144;258109681112;2968;9;1;1;1
258109681112;258109681161;49;9;1;1;1
258109681161;258109682652;1491;9;1;1;1
258109682652;258109685548;2896;2,9;2;1;1
258109685548;258109689814;4266;2,9;2;1;1
258109689814;258109692640;2826;2,9;2;1;1
258109692640;258109694641;2001;2,9;2;1;1
258109694641;258109702013;7372;2,9;2;1;1
258109702013;258109705550;3537;2,9;2;1;1
258109705550;258109708460;2910;2,9;2;1;1
258109708460;258109711377;2917;2,9;2;1;1
258109711377;258109712177;800;2,9;2;1;1
258109712177;258109713419;1242;2,9;2;1;1
258109713419;258109714413;994;2,9;2;1;1
258109714413;258109715485;1072;2,9;2;1;1
258109715485;258109717855;2370;2,9;2;1;1
258109717855;258109719072;1217;2,9;2;1;1
258109719072;258109719908;836;2,9;2;1;1
258109719908;258109723100;3192;2,9;2;1;1
258109723100;258109724567;1467;2,9;2;1;1
258109724567;258109726013;1446;2,9;2;1;1
258109726013;258109726691;678;9;1;1;1
258109726691;258109726711;20;9;1;1;1
258109726711;258109726727;16;9;1;1;1
258109726727;258109726902;175;9;1;1;1
258109726902;258109727052;150;2,9;2;1;1
258109727052;258109727115;63;2,9;2;1;1
258109727115;258109727507;392;2,9;2;1;1
258109727507;258109756943;29436;9;1;1;1
258109756943;258109765247;8304;9;1;1;1
258109765247;258109766682;1435;9;1;1;1
258109766682;258109766690;8;9;1;1;1
258109766690;258109766743;53;9;1;1;1
258109766743;258109766770;27;9;1;1;1
258109766770;258109767312;542;9;1;1;1
258109767312;258109789815;22503;9;1;1;1
258109789815;258109795495;5680;2,9;2;1;1
258109795495;258109805076;9581;2,9;2;1;1
258109805076;258109815179;10103;2,9;2;1;1
258109815179;258109815206;27;2,9;2;1;1
258109815206;258109815285;79;2,9;2;1;1
258109815285;258109815832;547;2,9;2;1;1
258109815832;258109815867;35;2,9;2;1;1
258109815867;258109816265;398;2,9;2;1;1
258109816265;258109846524;30259;9;1;1;1
258109846524;258109848551;2027;9;1;1;1
258109848551;258109850620;2069;9;1;1;1
258109850620;258109867617;16997;9;1;1;1
258109867617;258109871519;3902;9;1;1;1
258109871519;258109874243;2724;2,9;2;1;1
258109874243;258109876559;2316;2,9;2;1;1
258109876559;258109888524;11965;2,9;2;1;1
258109888524;258109888575;51;2,9;2;1;1
258109888575;258109889167;592;2,9;2;1;1
258109889167;258109889184;17;2,9;2;1;1
258109889184;258109889240;56;2,9;2;1;1
258109889240;258109889294;54;2,9;2;1;1
258109889294;258109889307;13;2,9;2;1;1
258109889307;258109889337;30;2,9;2;1;1
258109889337;258109889351;14;2,9;2;1;1
258109889351;258109889779;428;2,9;2;1;1
258109889779;258109889810;31;2,9;2;1;1
258109889810;258109890345;535;2,9;2;1;1
258109890345;258109890450;105;2,9;2;1;1
258109890450;258109890579;129;2,9;2;1;1
258109890579;258109890590;11;2,9;2;1;1
258109890590;258109890649;59;2,9;2;1;1
258109890649;258109896218;5569;2,9;2;1;1
258109896218;258109898253;2035;2,9;2;1;1
258109898253;258109901145;2892;2,9;2;1;1
258109901145;258109902545;1400;2,9;2;1;1
258109902545;258109902682;137;2,9;2;1;1
258109902682;258109903242;560;2,9;2;1;1
258109903242;258109904449;1207;2,9;2;1;1
258109904449;258109906068;1619;2,9;2;1;1
258109906068;258109906279;211;2,9;2;1;1
258109906279;258109907336;1057;2,9;2;1;1
258109907336;258109908028;692;2,9;2;1;1
258109908028;258109911545;3517;2,9;2;1;1
258109911545;258109914144;2599;9;1;1;1
258109914144;258109914170;26;9;1;1;1
258109914170;258109915455;1285;9;1;1;1
258109915455;258109916670;1215;9;1;1;1
258109916670;258109916909;239;9;1;1;1
258109916909;258109920642;3733;9;1;1;1
258109920642;258109921022;380;9;1;1;1
258109921022;258109921095;73;9;1;1;1
258109921095;258109922906;1811;9;1;1;1
258109922906;258109923144;238;9;1;1;1
258109923144;258109924423;1279;9;1;1;1
258109924423;258109935372;10949;9;1;1;1
258109935372;258109937280;1908;9;1;1;1
258109937280;258109937724;444;9;1;1;1
258109937724;258109938221;497;9;1;1;1
258109938221;258109938625;404;9;1;1;1
258109938625;258109939188;563;9;1;1;1
258109939188;258109939759;571;9;1;1;1
258109939759;258109940211;452;9;1;1;1
258109940211;258109940832;621;9;1;1;1
258109940832;258109940946;114;9;1;1;1
258109940946;258109940981;35;9;1;1;1
258109940981;258109941207;226;9;1;1;1
258109941207;258109941288;81;9;1;1;1
258109941288;258109941603;315;9;1;1;1
258109941603;258109945561;3958;9;1;1;1
258109945561;258109945631;70;9;1;1;1
258109945631;258109945659;28;9;1;1;1
258109945659;258109945749;90;9;1;1;1
258109945749;258109946321;572;9;1;1;1
258109946321;258109952782;6461;9;1;1;1
258109952782;258109952796;14;9;1;1;1
258109952796;258109952817;21;9;1;1;1
258109952817;258109957089;4272;9;1;1;1
258109957089;258109957112;23;9;1;1;1
258109957112;258109957318;206;9;1;1;1
258109957318;258109957515;197;9;1;1;1
258109957515;258109957718;203;9;1;1;1
258109957718;258109957781;63;9;1;1;1
258109957781;258109957995;214;9;1;1;1
258109957995;258109958056;61;9;1;1;1
258109958056;258109960463;2407;9;1;1;1
258109960463;258109960476;13;9;1;1;1
258109960476;258109960500;24;9;1;1;1
258109960500;258109960545;45;9;1;1;1
258109960545;258109960561;16;9;1;1;1
258109960561;258109960632;71;9;1;1;1
258109960632;258109961989;1357;9;1;1;1
258109961989;258109962330;341;9;1;1;1
258109962330;258109964836;2506;9;1;1;1
258109964836;258109965385;549;9;1;1;1
258109965385;258109965964;579;9;1;1;1
258109965964;258109966031;67;9;1;1;1
258109966031;258109966048;17;9;1;1;1
258109966048;258109966146;98;9;1;1;1
258109966146;258109975035;8889;9;1;1;1
258109975035;258109985313;10278;2,9;2;1;1
258109985313;258109985490;177;2,9;2;1;1
258109985490;258109985942;452;2,9;2;1;1
258109985942;258109986839;897;2,9;2;1;1
258109986839;258109986911;72;2,9;2;1;1
258109986911;258109987360;449;2,9;2;1;1
258109987360;258109987570;210;2,9;2;1;1
258109987570;258109987662;92;2,9;2;1;1
258109987662;258109987717;55;2,9;2;1;1
258109987717;258109991488;3771;2,9;2;1;1
258109991488;258109991558;70;2,9;2;1;1
258109991558;258109991673;115;2,9;2;1;1
258109991673;258109991693;20;2,9;2;1;1
258109991693;258110006233;14540;2,9;2;1;1
258110006233;258110006779;546;9;1;1;1
258110006779;258110007544;765;9;1;1;1
258110007544;258110007646;102;9;1;1;1
258110007646;258110008107;461;9;1;1;1
258110008107;258110008819;712;9;1;1;1
258110008819;258110009187;368;9;1;1;1
258110009187;258110009936;749;9;1;1;1
258110009936;258110009982;46;9;1;1;1
258110009982;258110010156;174;9;1;1;1
258110010156;258110018244;8088;9;1;1;1
258110018244;258110018303;59;9;1;1;1
258110018303;258110018322;19;9;1;1;1
258110018322;258110018393;71;9;1;1;1
258110018393;258110018443;50;9;1;1;1
258110018443;258110021973;3530;9;1;1;1
258110021973;258110022006;33;9;1;1;1
258110022006;258110022027;21;9;1;1;1
258110022027;258110024403;2376;9;1;1;1
258110024403;258110025390;987;9;1;1;1
258110025390;258110026757;1367;9;1;1;1
258110026757;258110029180;2423;9;1;1;1
258110029180;258110029507;327;9;1;1;1
258110029507;258110029937;430;9;1;1;1
258110029937;258110030920;983;9;1;1;1
258110030920;258110031054;134;9;1;1;1
258110031054;258110032088;1034;9;1;1;1
258110032088;258110032620;532;9;1;1;1
258110032620;258110034098;1478;9;1;1;1
258110034098;258110034301;203;9;1;1;1
258110034301;258110034337;36;9;1;1;1
258110034337;258110036230;1893;9;1;1;1
258110036230;258110036289;59;9;1;1;1
258110036289;258110036298;9;9;1;1;1
258110036298;258110036347;49;9;1;1;1
258110036347;258110036460;113;9;1;1;1
258110036460;258110040896;4436;9;1;1;1
258110040896;258110042351;1455;2,9;2;1;1
258110042351;258110043558;1207;2,9;2;1;1
258110043558;258110043681;123;2,9;2;1;1
258110043681;258110044064;383;2,9;2;1;1
258110044064;258110045260;1196;2,9;2;1;1
258110045260;258110045520;260;2,9;2;1;1
258110045520;258110045565;45;2,9;2;1;1
258110045565;258110045823;258;2,9;2;1;1
258110045823;258110046101;278;2,9;2;1;1
258110046101;258110046271;170;2,9;2;1;1
258110046271;258110049995;3724;2,9;2;1;1
258110049995;258110053758;3763;2,9;2;1;1
258110053758;258110053781;23;2,9;2;1;1
258110053781;258110053858;77;2,9;2;1;1
258110053858;258110053905;47;2,9;2;1;1
258110053905;258110054211;306;2,9;2;1;1
258110054211;258110054446;235;2,9;2;1;1
258110054446;258110054766;320;2,9;2;1;1
258110054766;258110054833;67;2,9;2;1;1
258110054833;258110055391;558;2,9;2;1;1
258110055391;258110057814;2423;2,9;2;1;1
258110057814;258110057851;37;2,9;2;1;1
258110057851;258110057934;83;2,9;2;1;1
258110057934;258110057943;9;2,9;2;1;1
258110057943;258110058411;468;2,9;2;1;1
258110058411;258110058815;404;2,9;2;1;1
258110058815;258110060591;1776;2,9;2;1;1
258110060591;258110070832;10241;2,9;2;1;1
258110070832;258110072498;1666;2,9;2;1;1
258110072498;258110072924;426;2,9;2;1;1
258110072924;258110073160;236;2,9;2;1;1
258110073160;258110073466;306;2,9;2;1;1
258110073466;258110073515;49;2,9;2;1;1
258110073515;258110073735;220;2,9;2;1;1
258110073735;258110075015;1280;2,9;2;1;1
258110075015;258110075252;237;2,9;2;1;1
258110075252;258110075853;601;2,9;2;1;1
258110075853;258110077019;1166;2,9;2;1;1
258110077019;258110077065;46;2,9;2;1;1
258110077065;258110077084;19;2,9;2;1;1
258110077084;258110077161;77;2,9;2;1;1
258110077161;258110078676;1515;2,9;2;1;1
258110078676;258110079390;714;2,9;2;1;1
258110079390;258110079731;341;2,9;2;1;1
258110079731;258110079784;53;2,9;2;1;1
258110079784;258110080504;720;2,9;2;1;1
258110080504;258110081332;828;2,9;2;1;1
258110081332;258110082113;781;2,9;2;1;1
258110082113;258110083169;1056;2,9;2;1;1
258110083169;258110083297;128;2,9;2;1;1
258110083297;258110083521;224;2,9;2;1;1
258110083521;258110084100;579;2,9;2;1;1
258110084100;258110090220;6120;2,9;2;1;1
258110090220;258110090389;169;2,9;2;1;1
258110090389;258110090546;157;2,9;2;1;1
258110090546;258110090873;327;2,9;2;1;1
258110090873;258110091300;427;2,9;2;1;1
258110091300;258110091491;191;2,9;2;1;1
258110091491;258110094325;2834;2,9;2;1;1
258110094325;258110094657;332;2,9;2;1;1
258110094657;258110094713;56;2,9;2;1;1
258110094713;258110095252;539;2,9;2;1;1
258110095252;258110095341;89;2,9;2;1;1
258110095341;258110095416;75;2,9;2;1;1
258110095416;258110095720;304;2,9;2;1;1
258110095720;258110095919;199;2,9;2;1;1
258110095919;258110097480;1561;2,9;2;1;1
258110097480;258110098487;1007;2,9;2;1;1
258110098487;258110099387;900;2,9;2;1;1
258110099387;258110099792;405;2,9;2;1;1
258110099792;258110099867;75;2,9;2;1;1
258110099867;258110099879;12;2,9;2;1;1
258110099879;258110099989;110;2,9;2;1;1
258110099989;258110101554;1565;2,9;2;1;1
258110101554;258110102822;1268;2,9;2;1;1
258110102822;258110103221;399;2,9;2;1;1
258110103221;258110103470;249;9;1;1;1
258110103470;258110103544;74;9;1;1;1
258110103544;258110103856;312;9;1;1;1
258110103856;258110107286;3430;9;1;1;1
258110107286;258110107320;34;9;1;1;1
258110107320;258110107523;203;9;1;1;1
258110107523;258110108748;1225;9;1;1;1
258110108748;258110109394;646;9;1;1;1
258110109394;258110109475;81;9;1;1;1
258110109475;258110109483;8;9;1;1;1
258110109483;258110109513;30;9;1;1;1
258110109513;258110110028;515;9;1;1;1
258110110028;258110118774;8746;9;1;1;1
258110118774;258110118785;11;9;1;1;1
258110118785;258110118808;23;9;1;1;1
258110118808;258110118838;30;9;1;1;1
258110118838;258110118889;51;9;1;1;1
258110118889;258110118914;25;9;1;1;1
258110118914;258110119292;378;9;1;1;1
258110119292;258110119300;8;9;1;1;1
258110119300;258110119505;205;9;1;1;1
258110119505;258110119684;179;9;1;1;1
258110119684;258110120292;608;9;1;1;1
258110120292;258110120350;58;9;1;1;1
258110120350;258110124315;3965;9;1;1;1
258110124315;258110150612;26297;9;1;1;1
258110150612;258110150733;121;9;1;1;1
258110150733;258110151043;310;9;1;1;1
258110151043;258110151117;74;9;1;1;1
258110151117;258110151710;593;9;1;1;1
258110151710;258110163764;12054;9;1;1;1
258110163764;258110163856;92;9;1;1;1
258110163856;258110163879;23;9;1;1;1
258110163879;258110164017;138;9;1;1;1
258110164017;258110164304;287;9;1;1;1
258110164304;258110165228;924;9;1;1;1
258110165228;258110167132;1904;9;1;1;1
258110167132;258110168750;1618;9;1;1;1
258110168750;258110168815;65;9;1;1;1
258110168815;258110169337;522;9;1;1;1
258110169337;258110170953;1616;9;1;1;1
258110170953;258110171974;1021;9;1;1;1
258110171974;258110174671;2697;2,9;2;1;1
258110174671;258110177925;3254;2,9;2;1;1
258110177925;258110179187;1262;2,9;2;1;1
258110179187;258110179805;618;2,9;2;1;1
258110179805;258110179957;152;2,9;2;1;1
258110179957;258110179981;24;2,9;2;1;1
258110179981;258110180046;65;2,9;2;1;1
258110180046;258110180109;63;2,9;2;1;1
258110180109;258110180128;19;2,9;2;1;1
258110180128;258110180476;348;2,9;2;1;1
258110180476;258110180513;37;2,9;2;1;1
258110180513;258110188539;8026;2,9;2;1;1
258110188539;258110190962;2423;2,9;2;1;1
258110190962;258110194313;3351;2,9;2;1;1
258110194313;258110194978;665;2,9;2;1;1
258110194978;258110199048;4070;2,9;2;1;1
258110199048;258110203479;4431;2,9;2;1;1
258110203479;258110204114;635;2,9;2;1;1
258110204114;258110204497;383;2,9;2;1;1
258110204497;258110208678;4181;2,9;2;1;1
258110208678;258110220055;11377;2,9;2;1;1
258110220055;258110222853;2798;2,9;2;1;1
258110222853;258110223082;229;2,9;2;1;1
258110223082;258110224026;944;2,9;2;1;1
258110224026;258110226038;2012;2,9;2;1;1
258110226038;258110226383;345;2,9;2;1;1
258110226383;258110226935;552;2,9;2;1;1
258110226935;258110227030;95;2,9;2;1;1
258110227030;258110227683;653;2,9;2;1;1
258110227683;258110227834;151;2,9;2;1;1
258110227834;258110228430;596;2,9;2;1;1
258110228430;258110229059;629;2,9;2;1;1
258110229059;258110284252;55193;9;1;1;1
258110284252;258110290369;6117;2,9;2;1;1
258110290369;258110291189;820;2,9;2;1;1
258110291189;258110292929;1740;2,9;2;1;1
258110292929;258110296773;3844;2,9;2;1;1
258110296773;258110307182;10409;2,9;2;1;1
258110307182;258110312451;5269;2,9;2;1;1
258110312451;258110320801;8350;2,9;2;1;1
258110320801;258110320828;27;2,9;2;1;1
258110320828;258110321005;177;2,9;2;1;1
258110321005;258110321676;671;2,9;2;1;1
258110321676;258110322558;882;2,9;2;1;1
258110322558;258110323144;586;2,9;2;1;1
258110323144;258110325653;2509;2,9;2;1;1
258110325653;258110379110;53457;9;1;1;1
258110379110;258110407467;28357;2,9;2;1;1
258110407467;258110437727;30260;9;1;1;1
258110437727;258110438432;705;2,9;2;1;1
258110438432;258110440363;1931;9;1;1;1
258110440363;258110440596;233;9;1;1;1
258110440596;258110444828;4232;9;1;1;1
258110444828;258110447766;2938;9;1;1;1
258110447766;258110447914;148;9;1;1;1
258110447914;258110448163;249;9;1;1;1
258110448163;258110448190;27;9;1;1;1
258110448190;258110448336;146;9;1;1;1
258110448336;258110448576;240;9;1;1;1
258110448576;258110448826;250;9;1;1;1
258110448826;258110449616;790;9;1;1;1
258110449616;258110449775;159;9;1;1;1
258110449775;258110449840;65;9;1;1;1
258110449840;258110450037;197;9;1;1;1
258110450037;258110450281;244;9;1;1;1
258110450281;258110450520;239;9;1;1;1
258110450520;258110450597;77;9;1;1;1
258110450597;258110450647;50;9;1;1;1
258110450647;258110450707;60;9;1;1;1
258110450707;258110450711;4;9;1;1;1
258110450711;258110450936;225;9;1;1;1
258110450936;258110451101;165;9;1;1;1
258110451101;258110451176;75;9;1;1;1
258110451176;258110451229;53;9;1;1;1
258110451229;258110451691;462;9;1;1;1
258110451691;258110451984;293;9;1;1;1
258110451984;258110452549;565;9;1;1;1
258110452549;258110452856;307;9;1;1;1
258110452856;258110453522;666;9;1;1;1
258110453522;258110453564;42;9;1;1;1
258110453564;258110453817;253;9;1;1;1
258110453817;258110453963;146;9;1;1;1
258110453963;258110454070;107;9;1;1;1
258110454070;258110454186;116;9;1;1;1
258110454186;258110454194;8;9;1;1;1
258110454194;258110454251;57;9;1;1;1
258110454251;258110454331;80;9;1;1;1
258110454331;258110454372;41;9;1;1;1
258110454372;258110454404;32;9;1;1;1
258110454404;258110454422;18;9;1;1;1
258110454422;258110454447;25;9;1;1;1
258110454447;258110454469;22;9;1;1;1
258110454469;258110454668;199;9;1;1;1
258110454668;258110454674;6;9;1;1;1
258110454674;258110454791;117;9;1;1;1
258110454791;258110454867;76;9;1;1;1
258110454867;258110454912;45;9;1;1;1
258110454912;258110455189;277;9;1;1;1
258110455189;258110455249;60;9;1;1;1
258110455249;258110455560;311;9;1;1;1
258110455560;258110457261;1701;9;1;1;1
258110457261;258110457361;100;9;1;1;1
258110457361;258110457769;408;9;1;1;1
258110457769;258110457845;76;9;1;1;1
258110457845;258110457876;31;9;1;1;1
258110457876;258110458036;160;9;1;1;1
258110458036;258110458077;41;9;1;1;1
258110458077;258110458171;94;9;1;1;1
258110458171;258110458214;43;9;1;1;1
258110458214;258110458246;32;9;1;1;1
258110458246;258110458278;32;9;1;1;1
258110458278;258110458477;199;9;1;1;1
258110458477;258110458542;65;9;1;1;1
258110458542;258110458589;47;9;1;1;1
258110458589;258110459009;420;9;1;1;1
258110459009;258110459535;526;9;1;1;1
258110459535;258110459750;215;9;1;1;1
258110459750;258110460348;598;9;1;1;1
258110460348;258110460580;232;9;1;1;1
258110460580;258110460714;134;9;1;1;1
258110460714;258110460894;180;9;1;1;1
258110460894;258110460956;62;9;1;1;1
258110460956;258110461052;96;9;1;1;1
258110461052;258110461111;59;9;1;1;1
258110461111;258110461387;276;9;1;1;1
258110461387;258110461437;50;9;1;1;1
258110461437;258110461660;223;9;1;1;1
258110461660;258110461713;53;9;1;1;1
258110461713;258110461935;222;9;1;1;1
258110461935;258110462085;150;9;1;1;1
258110462085;258110462305;220;9;1;1;1
258110462305;258110462331;26;9;1;1;1
258110462331;258110462368;37;9;1;1;1
258110462368;258110462513;145;2,9;2;1;1
258110462513;258110462541;28;2,9;2;1;1
258110462541;258110462658;117;2,9;2;1;1
258110462658;258110462693;35;2,9;2;1;1
258110462693;258110462709;16;2,9;2;1;1
258110462709;258110462768;59;2,9;2;1;1
258110462768;258110462897;129;2,9;2;1;1
258110462897;258110462901;4;2,9;2;1;1
258110462901;258110463067;166;2,9;2;1;1
258110463067;258110463314;247;2,9;2;1;1
258110463314;258110463438;124;2,9;2;1;1
258110463438;258110463469;31;2,9;2;1;1
258110463469;258110467367;3898;2,9;2;1;1
258110467367;258110467764;397;9;1;1;1
258110467764;258110469248;1484;9;1;1;1
258110469248;258110471014;1766;2,9;2;1;1
258110471014;258110471353;339;9;1;1;1
258110471353;258110473626;2273;2,9;2;1;1
258110473626;258110479482;5856;9;1;1;1
258110479482;258110480703;1221;2,9;2;1;1
258110480703;258110480988;285;9;1;1;1
258110480988;258110481063;75;2,9;2;1;1
258110481063;258110481292;229;2,9;2;1;1
258110481292;258110482228;936;2,9;2;1;1
258110482228;258110482285;57;2,9;2;1;1
258110482285;258110482950;665;2,9;2;1;1
258110482950;258110487486;4536;9;1;1;1
258110487486;258110491633;4147;2,9;2;1;1
258110491633;258110492228;595;2,9;2;1;1
258110492228;258110494969;2741;2,9;2;1;1
258110494969;258110495852;883;2,9;2;1;1
258110495852;258110496189;337;2,9;2;1;1
258110496189;258110496723;534;9;1;1;1
258110496723;258110498221;1498;2,9;2;1;1
258110498221;258110499680;1459;9;1;1;1
258110499680;258110500341;661;2,9;2;1;1
258110500341;258110500442;101;9;1;1;1
258110500442;258110501345;903;2,9;2;1;1
258110501345;258110540237;38892;9;1;1;1
258110540237;258110542750;2513;2,9;2;1;1
258110542750;258110546555;3805;2,9;2;1;1
258110546555;258110550608;4053;2,9;2;1;1
258110550608;258110551886;1278;2,9;2;1;1
258110551886;258110551955;69;2,9;2;1;1
258110551955;258110552384;429;2,9;2;1;1
258110552384;258110552430;46;2,9;2;1;1
258110552430;258110552730;300;2,9;2;1;1
258110552730;258110552828;98;2,9;2;1;1
258110552828;258110552932;104;2,9;2;1;1
258110552932;258110553004;72;2,9;2;1;1
258110553004;258110553159;155;2,9;2;1;1
258110553159;258110553321;162;2,9;2;1;1
258110553321;258110553338;17;2,9;2;1;1
258110553338;258110553396;58;2,9;2;1;1
258110553396;258110553447;51;2,9;2;1;1
258110553447;258110553661;214;2,9;2;1;1
258110553661;258110553799;138;2,9;2;1;1
258110553799;258110553884;85;2,9;2;1;1
258110553884;258110553914;30;2,9;2;1;1
258110553914;258110554094;180;2,9;2;1;1
258110554094;258110554127;33;2,9;2;1;1
258110554127;258110556026;1899;2,9;2;1;1
258110556026;258110556100;74;2,9;2;1;1
258110556100;258110556197;97;2,9;2;1;1
258110556197;258110556238;41;2,9;2;1;1
258110556238;258110556257;19;2,9;2;1;1
258110556257;258110556383;126;2,9;2;1;1
258110556383;258110556444;61;2,9;2;1;1
258110556444;258110556465;21;2,9;2;1;1
258110556465;258110556596;131;2,9;2;1;1
258110556596;258110556700;104;2,9;2;1;1
258110556700;258110556741;41;2,9;2;1;1
258110556741;258110556815;74;2,9;2;1;1
258110556815;258110556843;28;2,9;2;1;1
258110556843;258110556864;21;2,9;2;1;1
258110556864;258110556901;37;2,9;2;1;1
258110556901;258110556953;52;2,9;2;1;1
258110556953;258110557085;132;2,9;2;1;1
258110557085;258110557119;34;2,9;2;1;1
258110557119;258110557144;25;2,9;2;1;1
258110557144;258110557264;120;2,9;2;1;1
258110557264;258110557411;147;2,9;2;1;1
258110557411;258110557488;77;2,9;2;1;1
258110557488;258110557695;207;2,9;2;1;1
258110557695;258110557704;9;2,9;2;1;1
258110557704;258110557875;171;2,9;2;1;1
258110557875;258110558073;198;2,9;2;1;1
258110558073;258110558311;238;2,9;2;1;1
258110558311;258110558473;162;2,9;2;1;1
258110558473;258110559077;604;2,9;2;1;1
258110559077;258110559470;393;2,9;2;1;1
258110559470;258110559585;115;2,9;2;1;1
258110559585;258110559618;33;2,9;2;1;1
258110559618;258110559675;57;2,9;2;1;1
258110559675;258110559810;135;2,9;2;1;1
258110559810;258110559823;13;2,9;2;1;1
258110559823;258110559846;23;2,9;2;1;1
258110559846;258110559919;73;2,9;2;1;1
258110559919;258110560050;131;2,9;2;1;1
258110560050;258110560073;23;2,9;2;1;1
258110560073;258110560110;37;2,9;2;1;1
258110560110;258110560166;56;2,9;2;1;1
258110560166;258110560299;133;2,9;2;1;1
258110560299;258110560573;274;2,9;2;1;1
258110560573;258110560623;50;2,9;2;1;1
258110560623;258110560667;44;2,9;2;1;1
258110560667;258110560671;4;2,9;2;1;1
258110560671;258110560701;30;2,9;2;1;1
258110560701;258110560779;78;2,9;2;1;1
258110560779;258110560817;38;2,9;2;1;1
258110560817;258110560825;8;2,9;2;1;1
258110560825;258110560905;80;2,9;2;1;1
258110560905;258110560997;92;2,9;2;1;1
258110560997;258110561001;4;2,9;2;1;1
258110561001;258110561076;75;2,9;2;1;1
258110561076;258110561106;30;2,9;2;1;1
258110561106;258110561201;95;2,9;2;1;1
258110561201;258110561275;74;2,9;2;1;1
258110561275;258110561331;56;2,9;2;1;1
258110561331;258110561395;64;2,9;2;1;1
258110561395;258110561408;13;2,9;2;1;1
258110561408;258110561416;8;2,9;2;1;1
258110561416;258110561564;148;2,9;2;1;1
258110561564;258110561747;183;2,9;2;1;1
258110561747;258110561893;146;2,9;2;1;1
258110561893;258110561908;15;2,9;2;1;1
258110561908;258110561952;44;2,9;2;1;1
258110561952;258110562463;511;2,9;2;1;1
258110562463;258110562566;103;2,9;2;1;1
258110562566;258110562669;103;2,9;2;1;1
258110562669;258110562734;65;2,9;2;1;1
258110562734;258110562818;84;2,9;2;1;1
258110562818;258110562932;114;2,9;2;1;1
258110562932;258110562972;40;2,9;2;1;1
258110562972;258110563014;42;2,9;2;1;1
258110563014;258110563090;76;2,9;2;1;1
258110563090;258110565419;2329;2,9;2;1;1
258110565419;258110565603;184;2,9;2;1;1
258110565603;258110565783;180;2,9;2;1;1
258110565783;258110565855;72;2,9;2;1;1
258110565855;258110565995;140;2,9;2;1;1
258110565995;258110566107;112;2,9;2;1;1
258110566107;258110566279;172;2,9;2;1;1
258110566279;258110566368;89;2,9;2;1;1
258110566368;258110566433;65;2,9;2;1;1
258110566433;258110566465;32;2,9;2;1;1
258110566465;258110566474;9;2,9;2;1;1
258110566474;258110566591;117;2,9;2;1;1
258110566591;258110566660;69;2,9;2;1;1
258110566660;258110566710;50;2,9;2;1;1
258110566710;258110566759;49;2,9;2;1;1
258110566759;258110566808;49;2,9;2;1;1
258110566808;258110566813;5;2,9;2;1;1
258110566813;258110566840;27;2,9;2;1;1
258110566840;258110566940;100;2,9;2;1;1
258110566940;258110566946;6;2,9;2;1;1
258110566946;258110567005;59;2,9;2;1;1
258110567005;258110567084;79;2,9;2;1;1
258110567084;258110567331;247;2,9;2;1;1
258110567331;258110567333;2;2,9;2;1;1
258110567333;258110567341;8;2,9;2;1;1
258110567341;258110567442;101;2,9;2;1;1
258110567442;258110567464;22;2,9;2;1;1
258110567464;258110567506;42;2,9;2;1;1
258110567506;258110567645;139;2,9;2;1;1
258110567645;258110567728;83;2,9;2;1;1
258110567728;258110567968;240;2,9;2;1;1
258110567968;258110568006;38;2,9;2;1;1
258110568006;258110568087;81;2,9;2;1;1
258110568087;258110568123;36;2,9;2;1;1
258110568123;258110568188;65;2,9;2;1;1
258110568188;258110568242;54;2,9;2;1;1
258110568242;258110568296;54;2,9;2;1;1
258110568296;258110568329;33;2,9;2;1;1
258110568329;258110568709;380;2,9;2;1;1
258110568709;258110568961;252;2,9;2;1;1
258110568961;258110569345;384;2,9;2;1;1
258110569345;258110569525;180;2,9;2;1;1
258110569525;258110569620;95;2,9;2;1;1
258110569620;258110569651;31;2,9;2;1;1
258110569651;258110569829;178;2,9;2;1;1
258110569829;258110569997;168;2,9;2;1;1
258110569997;258110570092;95;2,9;2;1;1
258110570092;258110570166;74;2,9;2;1;1
258110570166;258110570350;184;2,9;2;1;1
258110570350;258110570353;3;2,9;2;1;1
258110570353;258110570664;311;2,9;2;1;1
258110570664;258110570799;135;2,9;2;1;1
258110570799;258110570978;179;2,9;2;1;1
258110570978;258110571071;93;2,9;2;1;1
258110571071;258110571119;48;2,9;2;1;1
258110571119;258110571158;39;2,9;2;1;1
258110571158;258110571168;10;2,9;2;1;1
258110571168;258110571209;41;2,9;2;1;1
258110571209;258110571420;211;2,9;2;1;1
258110571420;258110572055;635;2,9;2;1;1
258110572055;258110572639;584;2,9;2;1;1
258110572639;258110573766;1127;2,9;2;1;1
258110573766;258110573819;53;2,9;2;1;1
258110573819;258110575212;1393;2,9;2;1;1
258110575212;258110575437;225;2,9;2;1;1
258110575437;258110576120;683;2,9;2;1;1
258110576120;258110576607;487;2,9;2;1;1
258110576607;258110576805;198;2,9;2;1;1
258110576805;258110576998;193;2,9;2;1;1
258110576998;258110577363;365;2,9;2;1;1
258110577363;258110578731;1368;2,9;2;1;1
258110578731;258110578884;153;2,9;2;1;1
258110578884;258110579207;323;2,9;2;1;1
258110579207;258110579488;281;2,9;2;1;1
258110579488;258110580700;1212;2,9;2;1;1
258110580700;258110580942;242;2,9;2;1;1
258110580942;258110581245;303;2,9;2;1;1
258110581245;258110581963;718;2,9;2;1;1
258110581963;258110582345;382;2,9;2;1;1
258110582345;258110582539;194;2,9;2;1;1
258110582539;258110582603;64;2,9;2;1;1
258110582603;258110583258;655;2,9;2;1;1
258110583258;258110583739;481;2,9;2;1;1
258110583739;258110583798;59;2,9;2;1;1
258110583798;258110583862;64;2,9;2;1;1
258110583862;258110583894;32;2,9;2;1;1
258110583894;258110583965;71;2,9;2;1;1
258110583965;258110584014;49;2,9;2;1;1
258110584014;258110584159;145;2,9;2;1;1
258110584159;258110584344;185;2,9;2;1;1
258110584344;258110584561;217;2,9;2;1;1
258110584561;258110584598;37;2,9;2;1;1
258110584598;258110584641;43;2,9;2;1;1
258110584641;258110584665;24;2,9;2;1;1
258110584665;258110584716;51;2,9;2;1;1
258110584716;258110585402;686;2,9;2;1;1
258110585402;258110586197;795;2,9;2;1;1
258110586197;258110586918;721;2,9;2;1;1
258110586918;258110587521;603;2,9;2;1;1
258110587521;258110587662;141;2,9;2;1;1
258110587662;258110587729;67;2,9;2;1;1
258110587729;258110587768;39;2,9;2;1;1
258110587768;258110590141;2373;2,9;2;1;1
258110590141;258110590434;293;2,9;2;1;1
258110590434;258110590439;5;2,9;2;1;1
258110590439;258110590502;63;2,9;2;1;1
258110590502;258110590601;99;2,9;2;1;1
258110590601;258110591716;1115;2,9;2;1;1
258110591716;258110591755;39;2,9;2;1;1
258110591755;258110591916;161;2,9;2;1;1
258110591916;258110592118;202;2,9;2;1;1
258110592118;258110593329;1211;2,9;2;1;1
258110593329;258110593496;167;2,9;2;1;1
258110593496;258110593500;4;2,9;2;1;1
258110593500;258110593692;192;2,9;2;1;1
258110593692;258110593822;130;2,9;2;1;1
258110593822;258110594096;274;2,9;2;1;1
258110594096;258110594146;50;2,9;2;1;1
258110594146;258110594281;135;2,9;2;1;1
258110594281;258110594298;17;2,9;2;1;1
258110594298;258110594323;25;2,9;2;1;1
258110594323;258110594351;28;2,9;2;1;1
258110594351;258110594523;172;2,9;2;1;1
258110594523;258110594658;135;2,9;2;1;1
258110594658;258110594756;98;2,9;2;1;1
258110594756;258110594792;36;2,9;2;1;1
258110594792;258110594902;110;2,9;2;1;1
258110594902;258110594989;87;2,9;2;1;1
258110594989;258110595024;35;2,9;2;1;1
258110595024;258110595112;88;2,9;2;1;1
258110595112;258110595154;42;2,9;2;1;1
258110595154;258110595171;17;2,9;2;1;1
258110595171;258110595202;31;2,9;2;1;1
258110595202;258110595365;163;2,9;2;1;1
258110595365;258110595376;11;2,9;2;1;1
258110595376;258110595486;110;2,9;2;1;1
258110595486;258110595571;85;2,9;2;1;1
258110595571;258110595626;55;2,9;2;1;1
258110595626;258110595665;39;2,9;2;1;1
258110595665;258110595834;169;2,9;2;1;1
258110595834;258110596008;174;9;1;1;1
258110596008;258110596101;93;9;1;1;1
258110596101;258110597658;1557;9;1;1;1
258110597658;258110597844;186;9;1;1;1
258110597844;258110597982;138;9;1;1;1
258110597982;258110598264;282;9;1;1;1
258110598264;258110598345;81;9;1;1;1
258110598345;258110599748;1403;9;1;1;1
258110599748;258110599861;113;9;1;1;1
258110599861;258110599990;129;9;1;1;1
258110599990;258110600116;126;9;1;1;1
258110600116;258110600222;106;9;1;1;1
258110600222;258110600270;48;9;1;1;1
258110600270;258110600305;35;9;1;1;1
258110600305;258110600329;24;9;1;1;1
258110600329;258110600403;74;9;1;1;1
258110600403;258110601769;1366;9;1;1;1
258110601769;258110601916;147;9;1;1;1
258110601916;258110602053;137;9;1;1;1
258110602053;258110602135;82;9;1;1;1
258110602135;258110603327;1192;9;1;1;1
258110603327;258110609793;6466;9;1;1;1
258110609793;258110609994;201;9;1;1;1
258110609994;258110610273;279;9;1;1;1
258110610273;258110610708;435;9;1;1;1
258110610708;258110611016;308;9;1;1;1
258110611016;258110611568;552;9;1;1;1
258110611568;258110614128;2560;9;1;1;1
258110614128;258110614209;81;9;1;1;1
258110614209;258110614300;91;9;1;1;1
258110614300;258110614382;82;9;1;1;1
258110614382;258110614424;42;9;1;1;1
258110614424;258110625709;11285;9;1;1;1
258110625709;258110625959;250;9;1;1;1
258110625959;258110626373;414;9;1;1;1
258110626373;258110626500;127;9;1;1;1
258110626500;258110626636;136;9;1;1;1
258110626636;258110626814;178;9;1;1;1
258110626814;258110627007;193;9;1;1;1
258110627007;258110627070;63;9;1;1;1
258110627070;258110627125;55;9;1;1;1
258110627125;258110627151;26;9;1;1;1
258110627151;258110627172;21;9;1;1;1
258110627172;258110627210;38;9;1;1;1
258110627210;258110627238;28;9;1;1;1
258110627238;258110628065;827;9;1;1;1
258110628065;258110628248;183;9;1;1;1
258110628248;258110628527;279;9;1;1;1
258110628527;258110632616;4089;9;1;1;1
258110632616;258110632815;199;9;1;1;1
258110632815;258110633428;613;9;1;1;1
258110633428;258110633662;234;9;1;1;1
258110633662;258110633699;37;9;1;1;1
258110633699;258110633833;134;9;1;1;1
258110633833;258110633953;120;9;1;1;1
258110633953;258110633991;38;9;1;1;1
258110633991;258110642497;8506;9;1;1;1
258110642497;258110642559;62;9;1;1;1
258110642559;258110643108;549;9;1;1;1
258110643108;258110643250;142;9;1;1;1
258110643250;258110643515;265;9;1;1;1
258110643515;258110643533;18;9;1;1;1
258110643533;258110643586;53;9;1;1;1
258110643586;258110644135;549;9;1;1;1
258110644135;258110644285;150;9;1;1;1
258110644285;258110644339;54;9;1;1;1
258110644339;258110644474;135;9;1;1;1
258110644474;258110644556;82;9;1;1;1
258110644556;258110645592;1036;9;1;1;1
258110645592;258110645859;267;9;1;1;1
258110645859;258110645945;86;9;1;1;1
258110645945;258110646066;121;9;1;1;1
258110646066;258110650231;4165;9;1;1;1
258110650231;258110654750;4519;2,9;2;1;1
258110654750;258110654810;60;2,9;2;1;1
258110654810;258110654958;148;2,9;2;1;1
258110654958;258110658932;3974;2,9;2;1;1
258110658932;258110659320;388;2,9;2;1;1
258110659320;258110659377;57;2,9;2;1;1
258110659377;258110659422;45;2,9;2;1;1
258110659422;258110659493;71;2,9;2;1;1
258110659493;258110659545;52;2,9;2;1;1
258110659545;258110659602;57;2,9;2;1;1
258110659602;258110659993;391;2,9;2;1;1
258110659993;258110665135;5142;2,9;2;1;1
258110665135;258110665483;348;2,9;2;1;1
258110665483;258110665581;98;2,9;2;1;1
258110665581;258110665728;147;2,9;2;1;1
258110665728;258110666807;1079;2,9;2;1;1
258110666807;258110668383;1576;2,9;2;1;1
258110668383;258110668612;229;2,9;2;1;1
258110668612;258110668721;109;2,9;2;1;1
258110668721;258110676962;8241;2,9;2;1;1
258110676962;258110677024;62;2,9;2;1;1
258110677024;258110677244;220;2,9;2;1;1
258110677244;258110677381;137;2,9;2;1;1
258110677381;258110677431;50;2,9;2;1;1
258110677431;258110677501;70;2,9;2;1;1
258110677501;258110679261;1760;2,9;2;1;1
258110679261;258110682705;3444;9;1;1;1
258110682705;258110682761;56;9;1;1;1
258110682761;258110682935;174;9;1;1;1
258110682935;258110683006;71;9;1;1;1
258110683006;258110683070;64;9;1;1;1
258110683070;258110683103;33;9;1;1;1
258110683103;258110684199;1096;9;1;1;1
258110684199;258110685276;1077;2,9;2;1;1
258110685276;258110686434;1158;9;1;1;1
258110686434;258110687308;874;2,9;2;1;1
258110687308;258110689544;2236;9;1;1;1
258110689544;258110691095;1551;2,9;2;1;1
258110691095;258110691814;719;9;1;1;1
258110691814;258110694340;2526;2,9;2;1;1
258110694340;258110694648;308;2,9;2;1;1
258110694648;258110695019;371;9;1;1;1
258110695019;258110695110;91;9;1;1;1
258110695110;258110695206;96;9;1;1;1
258110695206;258110695653;447;9;1;1;1
258110695653;258110697327;1674;2,9;2;1;1
258110697327;258110698129;802;9;1;1;1
258110698129;258110698344;215;2,9;2;1;1
258110698344;258110699393;1049;2,9;2;1;1
258110699393;258110699727;334;2,9;2;1;1
258110699727;258110709606;9879;9;1;1;1
258110709606;258110711565;1959;2,9;2;1;1
258110711565;258110712096;531;2,9;2;1;1
258110712096;258110712889;793;2,9;2;1;1
258110712889;258110712950;61;2,9;2;1;1
258110712950;258110713056;106;2,9;2;1;1
258110713056;258110715000;1944;2,9;2;1;1
258110715000;258110715618;618;9;1;1;1
258110715618;258110716247;629;2,9;2;1;1
258110716247;258110724527;8280;9;1;1;1
258110724527;258110724542;15;9;1;1;1
258110724542;258110724599;57;9;1;1;1
258110724599;258110724631;32;9;1;1;1
258110724631;258110724679;48;9;1;1;1
258110724679;258110724755;76;9;1;1;1
258110724755;258110724799;44;9;1;1;1
258110724799;258110724802;3;9;1;1;1
258110724802;258110724845;43;9;1;1;1
258110724845;258110724863;18;9;1;1;1
258110724863;258110724968;105;9;1;1;1
258110724968;258110754675;29707;9;1;1;1
258110754675;258110765669;10994;2,9;2;1;1
258110765669;258110766280;611;2,9;2;1;1
258110766280;258110766287;7;2,9;2;1;1
258110766287;258110766341;54;2,9;2;1;1
258110766341;258110766360;19;2,9;2;1;1
258110766360;258110766362;2;2,9;2;1;1
258110766362;258110766373;11;2,9;2;1;1
258110766373;258110766382;9;2,9;2;1;1
258110766382;258110766400;18;2,9;2;1;1
258110766400;258110766409;9;2,9;2;1;1
258110766409;258110766411;2;2,9;2;1;1
258110766411;258110766413;2;2,9;2;1;1
258110766413;258110766416;3;2,9;2;1;1
258110766416;258110766419;3;2,9;2;1;1
258110766419;258110766435;16;2,9;2;1;1
258110766435;258110766441;6;2,9;2;1;1
258110766441;258110766465;24;2,9;2;1;1
258110766465;258110766467;2;2,9;2;1;1
258110766467;258110766470;3;2,9;2;1;1
258110766470;258110766494;24;2,9;2;1;1
258110766494;258110766499;5;2,9;2;1;1
258110766499;258110766501;2;2,9;2;1;1
258110766501;258110766504;3;2,9;2;1;1
258110766504;258110766506;2;2,9;2;1;1
258110766506;258110766511;5;2,9;2;1;1
258110766511;258110766514;3;2,9;2;1;1
258110766514;258110766532;18;2,9;2;1;1
258110766532;258110766543;11;2,9;2;1;1
258110766543;258110766568;25;2,9;2;1;1
258110766568;258110766570;2;2,9;2;1;1
258110766570;258110766578;8;2,9;2;1;1
258110766578;258110766584;6;2,9;2;1;1
258110766584;258110766595;11;2,9;2;1;1
258110766595;258110766610;15;2,9;2;1;1
258110766610;258110766616;6;2,9;2;1;1
258110766616;258110766626;10;2,9;2;1;1
258110766626;258110766631;5;2,9;2;1;1
258110766631;258110766636;5;2,9;2;1;1
258110766636;258110766645;9;2,9;2;1;1
258110766645;258110766657;12;2,9;2;1;1
258110766657;258110766659;2;2,9;2;1;1
258110766659;258110766668;9;2,9;2;1;1
258110766668;258110766676;8;2,9;2;1;1
258110766676;258110766683;7;2,9;2;1;1
258110766683;258110766690;7;2,9;2;1;1
258110766690;258110766699;9;2,9;2;1;1
258110766699;258110766710;11;2,9;2;1;1
258110766710;258110766730;20;2,9;2;1;1
258110766730;258110766749;19;2,9;2;1;1
258110766749;258110766761;12;2,9;2;1;1
258110766761;258110766802;41;2,9;2;1;1
258110766802;258110766818;16;2,9;2;1;1
258110766818;258110766826;8;2,9;2;1;1
258110766826;258110766841;15;2,9;2;1;1
258110766841;258110766855;14;2,9;2;1;1
258110766855;258110766882;27;2,9;2;1;1
258110766882;258110766892;10;2,9;2;1;1
258110766892;258110766901;9;2,9;2;1;1
258110766901;258110766929;28;2,9;2;1;1
258110766929;258110766966;37;2,9;2;1;1
258110766966;258110766968;2;2,9;2;1;1
258110766968;258110766994;26;2,9;2;1;1
258110766994;258110767019;25;2,9;2;1;1
258110767019;258110767020;1;2,9;2;1;1
258110767020;258110767048;28;2,9;2;1;1
258110767048;258110767051;3;2,9;2;1;1
258110767051;258110767067;16;2,9;2;1;1
258110767067;258110767090;23;2,9;2;1;1
258110767090;258110767100;10;2,9;2;1;1
258110767100;258110767104;4;2,9;2;1;1
258110767104;258110767108;4;2,9;2;1;1
258110767108;258110767115;7;2,9;2;1;1
258110767115;258110767140;25;2,9;2;1;1
258110767140;258110767179;39;2,9;2;1;1
258110767179;258110767197;18;2,9;2;1;1
258110767197;258110767250;53;2,9;2;1;1
258110767250;258110767251;1;2,9;2;1;1
258110767251;258110767299;48;2,9;2;1;1
258110767299;258110767303;4;2,9;2;1;1
258110767303;258110767310;7;2,9;2;1;1
258110767310;258110767343;33;2,9;2;1;1
258110767343;258110767346;3;2,9;2;1;1
258110767346;258110767355;9;2,9;2;1;1
258110767355;258110767366;11;2,9;2;1;1
258110767366;258110767375;9;2,9;2;1;1
258110767375;258110767480;105;2,9;2;1;1
258110767480;258110767540;60;2,9;2;1;1
258110767540;258110767707;167;2,9;2;1;1
258110767707;258110767728;21;2,9;2;1;1
258110767728;258110767873;145;2,9;2;1;1
258110767873;258110767894;21;2,9;2;1;1
258110767894;258110767896;2;2,9;2;1;1
258110767896;258110768019;123;2,9;2;1;1
258110768019;258110768107;88;2,9;2;1;1
258110768107;258110781411;13304;2,9;2;1;1
258110781411;258110842298;60887;9;1;1;1
258110842298;258110844194;1896;2,9;2;1;1
258110844194;258110847259;3065;2,9;2;1;1
258110847259;258110847805;546;2,9;2;1;1
258110847805;258110850204;2399;2,9;2;1;1
258110850204;258110855162;4958;2,9;2;1;1
258110855162;258110857207;2045;2,9;2;1;1
258110857207;258110858394;1187;2,9;2;1;1
258110858394;258110860925;2531;2,9;2;1;1
258110860925;258110862610;1685;2,9;2;1;1
258110862610;258110864651;2041;2,9;2;1;1
258110864651;258110866376;1725;2,9;2;1;1
258110866376;258110867465;1089;2,9;2;1;1
258110867465;258110868052;587;2,9;2;1;1
258110868052;258110872545;4493;2,9;2;1;1
258110872545;258110874721;2176;2,9;2;1;1
258110874721;258110875937;1216;2,9;2;1;1
258110875937;258110876122;185;2,9;2;1;1
258110876122;258110881749;5627;2,9;2;1;1
258110881749;258110881780;31;2,9;2;1;1
258110881780;258110882096;316;2,9;2;1;1
258110882096;258110885354;3258;2,9;2;1;1
258110885354;258110885481;127;2,9;2;1;1
258110885481;258110885968;487;2,9;2;1;1
258110885968;258110889369;3401;2,9;2;1;1
258110889369;258110891484;2115;2,9;2;1;1
258110891484;258110892014;530;2,9;2;1;1
258110892014;258110893108;1094;2,9;2;1;1
258110893108;258110894151;1043;2,9;2;1;1
258110894151;258110894610;459;2,9;2;1;1
258110894610;258110894706;96;2,9;2;1;1
258110894706;258110894874;168;2,9;2;1;1
258110894874;258110895556;682;2,9;2;1;1
258110895556;258110896585;1029;2,9;2;1;1
258110896585;258110897128;543;2,9;2;1;1
258110897128;258110897290;162;2,9;2;1;1
258110897290;258110897782;492;2,9;2;1;1
258110897782;258110897803;21;9;1;1;1
258110897803;258110899914;2111;9;1;1;1
258110899914;258110900955;1041;9;1;1;1
258110900955;258110906675;5720;9;1;1;1
258110906675;258110906892;217;9;1;1;1
258110906892;258110907673;781;9;1;1;1
258110907673;258110909415;1742;9;1;1;1
258110909415;258110920667;11252;9;1;1;1
258110920667;258110920996;329;9;1;1;1
258110920996;258110921086;90;9;1;1;1
258110921086;258110923895;2809;9;1;1;1
258110923895;258110926799;2904;9;1;1;1
258110926799;258110932680;5881;9;1;1;1
258110932680;258110933733;1053;9;1;1;1
258110933733;258110936905;3172;9;1;1;1
258110936905;258110938177;1272;9;1;1;1
258110938177;258110939187;1010;9;1;1;1
258110939187;258110939900;713;9;1;1;1
258110939900;258110940026;126;9;1;1;1
258110940026;258110943430;3404;9;1;1;1
258110943430;258110944638;1208;9;1;1;1
258110944638;258110944713;75;9;1;1;1
258110944713;258110944853;140;9;1;1;1
258110944853;258110945131;278;9;1;1;1
258110945131;258110945226;95;9;1;1;1
258110945226;258110945576;350;9;1;1;1
258110945576;258110945764;188;9;1;1;1
258110945764;258110945831;67;9;1;1;1
258110945831;258110945846;15;9;1;1;1
258110945846;258110946099;253;9;1;1;1
258110946099;258110946334;235;9;1;1;1
258110946334;258110946545;211;9;1;1;1
258110946545;258110946583;38;9;1;1;1
258110946583;258110947001;418;9;1;1;1
258110947001;258110947406;405;9;1;1;1
258110947406;258110949791;2385;9;1;1;1
258110949791;258110949965;174;9;1;1;1
258110949965;258110949978;13;9;1;1;1
258110949978;258110950537;559;9;1;1;1
258110950537;258110950911;374;9;1;1;1
258110950911;258110951451;540;9;1;1;1
258110951451;258110952408;957;9;1;1;1
258110952408;258110957442;5034;2,9;2;1;1
258110957442;258110960179;2737;2,9;2;1;1
258110960179;258110963365;3186;2,9;2;1;1
258110963365;258110963802;437;2,9;2;1;1
258110963802;258110965046;1244;2,9;2;1;1
258110965046;258110969408;4362;2,9;2;1;1
258110969408;258110970333;925;2,9;2;1;1
258110970333;258110970653;320;2,9;2;1;1
258110970653;258110977714;7061;2,9;2;1;1
258110977714;258110980614;2900;2,9;2;1;1
258110980614;258110987097;6483;2,9;2;1;1
258110987097;258110990625;3528;2,9;2;1;1
258110990625;258110991816;1191;2,9;2;1;1
258110991816;258110994384;2568;2,9;2;1;1
258110994384;258110995315;931;2,9;2;1;1
258110995315;258110998794;3479;2,9;2;1;1
258110998794;258110999731;937;2,9;2;1;1
258110999731;258111002349;2618;2,9;2;1;1
258111002349;258111002634;285;2,9;2;1;1
258111002634;258111004848;2214;2,9;2;1;1
258111004848;258111006384;1536;2,9;2;1;1
258111006384;258111006618;234;2,9;2;1;1
258111006618;258111006680;62;2,9;2;1;1
258111006680;258111006691;11;2,9;2;1;1
258111006691;258111006715;24;2,9;2;1;1
258111006715;258111006744;29;2,9;2;1;1
258111006744;258111006935;191;2,9;2;1;1
258111006935;258111007032;97;2,9;2;1;1
258111007032;258111007083;51;2,9;2;1;1
258111007083;258111007107;24;2,9;2;1;1
258111007107;258111007211;104;2,9;2;1;1
258111007211;258111007252;41;2,9;2;1;1
258111007252;258111007280;28;2,9;2;1;1
258111007280;258111007524;244;2,9;2;1;1
258111007524;258111007791;267;2,9;2;1;1
258111007791;258111008011;220;2,9;2;1;1
258111008011;258111008439;428;2,9;2;1;1
258111008439;258111008955;516;2,9;2;1;1
258111008955;258111008990;35;2,9;2;1;1
258111008990;258111009294;304;2,9;2;1;1
258111009294;258111009877;583;2,9;2;1;1
258111009877;258111009899;22;2,9;2;1;1
258111009899;258111009936;37;2,9;2;1;1
258111009936;258111010088;152;2,9;2;1;1
258111010088;258111010126;38;2,9;2;1;1
258111010126;258111010135;9;2,9;2;1;1
258111010135;258111011896;1761;2,9;2;1;1
258111011896;258111012567;671;2,9;2;1;1
258111012567;258111012919;352;2,9;2;1;1
258111012919;258111013080;161;2,9;2;1;1
258111013080;258111013904;824;9;1;1;1
258111013904;258111014200;296;9;1;1;1
258111014200;258111014327;127;9;1;1;1
258111014327;258111014328;1;2,9;2;1;1
258111014328;258111014534;206;2,9;2;1;1
258111014534;258111015342;808;2,9;2;1;1
258111015342;258111021197;5855;9;1;1;1
258111021197;258111022473;1276;2,9;2;1;1
258111022473;258111026753;4280;9;1;1;1
258111026753;258111027370;617;9;1;1;1
258111027370;258111028067;697;2,9;2;1;1
258111028067;258111029194;1127;2,9;2;1;1
258111029194;258111029713;519;2,9;2;1;1
258111029713;258111029816;103;9;1;1;1
258111029816;258111030567;751;2,9;2;1;1
258111030567;258111030993;426;9;1;1;1
258111030993;258111031599;606;2,9;2;1;1
258111031599;258111033101;1502;9;1;1;1
258111033101;258111040047;6946;9;1;1;1
258111040047;258111043088;3041;9;1;1;1
258111043088;258111061874;18786;9;1;1;1
258111061874;258111068434;6560;9;1;1;1
258111068434;258111072210;3776;9;1;1;1
258111072210;258111072864;654;9;1;1;1
258111072864;258111075381;2517;2,9;2;1;1
258111075381;258111079214;3833;2,9;2;1;1
258111079214;258111081498;2284;2,9;2;1;1
258111081498;258111088108;6610;2,9;2;1;1
258111088108;258111088285;177;2,9;2;1;1
258111088285;258111089460;1175;2,9;2;1;1
258111089460;258111089850;390;2,9;2;1;1
258111089850;258111095953;6103;2,9;2;1;1
258111095953;258111097555;1602;2,9;2;1;1
258111097555;258111099680;2125;2,9;2;1;1
258111099680;258111099743;63;2,9;2;1;1
258111099743;258111103458;3715;2,9;2;1;1
258111103458;258111106555;3097;2,9;2;1;1
258111106555;258111106713;158;2,9;2;1;1
258111106713;258111107490;777;2,9;2;1;1
258111107490;258111108253;763;2,9;2;1;1
258111108253;258111110077;1824;2,9;2;1;1
258111110077;258111110388;311;2,9;2;1;1
258111110388;258111117334;6946;2,9;2;1;1
258111117334;258111120563;3229;2,9;2;1;1
258111120563;258111121651;1088;2,9;2;1;1
258111121651;258111122507;856;2,9;2;1;1
258111122507;258111123195;688;2,9;2;1;1
258111123195;258111140208;17013;9;1;1;1
258111140208;258111185656;45448;9;1;1;1
258111185656;258111185795;139;9;1;1;1
258111185795;258111189241;3446;2,9;2;1;1
258111189241;258111193172;3931;2,9;2;1;1
258111193172;258111196289;3117;2,9;2;1;1
258111196289;258111196305;16;2,9;2;1;1
258111196305;258111196323;18;2,9;2;1;1
258111196323;258111196358;35;2,9;2;1;1
258111196358;258111196398;40;2,9;2;1;1
258111196398;258111196654;256;2,9;2;1;1
258111196654;258111196685;31;2,9;2;1;1
258111196685;258111196802;117;2,9;2;1;1
258111196802;258111196858;56;2,9;2;1;1
258111196858;258111196894;36;2,9;2;1;1
258111196894;258111197037;143;2,9;2;1;1
258111197037;258111212547;15510;2,9;2;1;1
258111212547;258111212881;334;2,9;2;1;1
258111212881;258111214532;1651;2,9;2;1;1
258111214532;258111219560;5028;2,9;2;1;1
258111219560;258111221401;1841;2,9;2;1;1
258111221401;258111221655;254;2,9;2;1;1
258111221655;258111222428;773;2,9;2;1;1
258111222428;258111223658;1230;2,9;2;1;1
258111223658;258111223764;106;9;1;1;1
258111223764;258111224461;697;2,9;2;1;1
258111224461;258111225559;1098;2,9;2;1;1
258111225559;258111226203;644;2,9;2;1;1
258111226203;258111231209;5006;2,9;2;1;1
258111231209;258111231287;78;2,9;2;1;1
258111231287;258111261215;29928;9;1;1;1
258111261215;258111261501;286;9;1;1;1
258111261501;258111271109;9608;9;1;1;1
258111271109;258111271305;196;9;1;1;1
258111271305;258111271424;119;9;1;1;1
258111271424;258111271577;153;9;1;1;1
258111271577;258111277500;5923;9;1;1;1
258111277500;258111281826;4326;2,9;2;1;1
258111281826;258111283280;1454;2,9;2;1;1
258111283280;258111283328;48;2,9;2;1;1
258111283328;258111283902;574;2,9;2;1;1
258111283902;258111284980;1078;2,9;2;1;1
258111284980;258111287843;2863;2,9;2;1;1
258111287843;258111287932;89;2,9;2;1;1
258111287932;258111289583;1651;2,9;2;1;1
258111289583;258111289648;65;2,9;2;1;1
258111289648;258111289701;53;2,9;2;1;1
258111289701;258111290005;304;2,9;2;1;1
258111290005;258111290210;205;2,9;2;1;1
258111290210;258111290368;158;2,9;2;1;1
258111290368;258111290616;248;2,9;2;1;1
258111290616;258111290899;283;2,9;2;1;1
258111290899;258111291035;136;2,9;2;1;1
258111291035;258111291199;164;2,9;2;1;1
258111291199;258111291252;53;2,9;2;1;1
258111291252;258111291576;324;2,9;2;1;1
258111291576;258111293190;1614;2,9;2;1;1
258111293190;258111293210;20;2,9;2;1;1
258111293210;258111293442;232;2,9;2;1;1
258111293442;258111293594;152;2,9;2;1;1
258111293594;258111297420;3826;2,9;2;1;1
258111297420;258111298820;1400;2,9;2;1;1
258111298820;258111301922;3102;2,9;2;1;1
258111301922;258111305051;3129;2,9;2;1;1
258111305051;258111306906;1855;2,9;2;1;1
258111306906;258111311577;4671;2,9;2;1;1
258111311577;258111312120;543;2,9;2;1;1
258111312120;258111314788;2668;2,9;2;1;1
258111314788;258111331268;16480;2,9;2;1;1
258111331268;258111331404;136;2,9;2;1;1
258111331404;258111331497;93;2,9;2;1;1
258111331497;258111332465;968;2,9;2;1;1
258111332465;258111332805;340;2,9;2;1;1
258111332805;258111335569;2764;2,9;2;1;1
258111335569;258111336052;483;2,9;2;1;1
258111336052;258111337163;1111;2,9;2;1;1
258111337163;258111338306;1143;2,9;2;1;1
258111338306;258111340814;2508;9;1;1;1
258111340814;258111340971;157;9;1;1;1
258111340971;258111344682;3711;9;1;1;1
258111344682;258111363535;18853;9;1;1;1
258111363535;258111373587;10052;9;1;1;1
258111373587;258111376888;3301;9;1;1;1
258111376888;258111379080;2192;9;1;1;1
258111379080;258111379763;683;9;1;1;1
258111379763;258111380113;350;9;1;1;1
258111380113;258111382869;2756;9;1;1;1
258111382869;258111386422;3553;2,9;2;1;1
258111386422;258111386942;520;2,9;2;1;1
258111386942;258111386951;9;2,9;2;1;1
258111386951;258111387002;51;2,9;2;1;1
258111387002;258111387053;51;2,9;2;1;1
258111387053;258111387264;211;2,9;2;1;1
258111387264;258111387662;398;2,9;2;1;1
258111387662;258111387780;118;2,9;2;1;1
258111387780;258111387820;40;2,9;2;1;1
258111387820;258111387964;144;2,9;2;1;1
258111387964;258111388111;147;2,9;2;1;1
258111388111;258111390169;2058;2,9;2;1;1
258111390169;258111390173;4;2,9;2;1;1
258111390173;258111390205;32;2,9;2;1;1
258111390205;258111390450;245;2,9;2;1;1
258111390450;258111390513;63;2,9;2;1;1
258111390513;258111390563;50;2,9;2;1;1
258111390563;258111390575;12;2,9;2;1;1
258111390575;258111390580;5;2,9;2;1;1
258111390580;258111390599;19;2,9;2;1;1
258111390599;258111390627;28;2,9;2;1;1
258111390627;258111390651;24;2,9;2;1;1
258111390651;258111390822;171;2,9;2;1;1
258111390822;258111391064;242;2,9;2;1;1
258111391064;258111391274;210;2,9;2;1;1
258111391274;258111391382;108;2,9;2;1;1
258111391382;258111391491;109;2,9;2;1;1
258111391491;258111391662;171;2,9;2;1;1
258111391662;258111391723;61;2,9;2;1;1
258111391723;258111392504;781;2,9;2;1;1
258111392504;258111394675;2171;2,9;2;1;1
258111394675;258111394866;191;2,9;2;1;1
258111394866;258111395099;233;2,9;2;1;1
258111395099;258111400186;5087;2,9;2;1;1
258111400186;258111402115;1929;2,9;2;1;1
258111402115;258111402981;866;2,9;2;1;1
258111402981;258111414331;11350;2,9;2;1;1
258111414331;258111417100;2769;2,9;2;1;1
258111417100;258111417109;9;2,9;2;1;1
258111417109;258111422283;5174;2,9;2;1;1
258111422283;258111425743;3460;2,9;2;1;1
258111425743;258111425775;32;2,9;2;1;1
258111425775;258111425951;176;2,9;2;1;1
258111425951;258111425981;30;2,9;2;1;1
258111425981;258111426292;311;2,9;2;1;1
258111426292;258111429111;2819;2,9;2;1;1
258111429111;258111429896;785;2,9;2;1;1
258111429896;258111430150;254;2,9;2;1;1
258111430150;258111430787;637;2,9;2;1;1
258111430787;258111431867;1080;2,9;2;1;1
258111431867;258111433189;1322;2,9;2;1;1
258111433189;258111434331;1142;2,9;2;1;1
258111434331;258111434765;434;2,9;2;1;1
258111434765;258111441520;6755;2,9;2;1;1
258111441520;258111456182;14662;9;1;1;1
258111456182;258111456354;172;9;1;1;1
258111456354;258111466368;10014;9;1;1;1
258111466368;258111466571;203;9;1;1;1
258111466571;258111466683;112;9;1;1;1
258111466683;258111466845;162;9;1;1;1
258111466845;258111474788;7943;9;1;1;1
258111474788;258111478768;3980;2,9;2;1;1
258111478768;258111478882;114;2,9;2;1;1
258111478882;258111479061;179;2,9;2;1;1
258111479061;258111485529;6468;2,9;2;1;1
258111485529;258111501776;16247;2,9;2;1;1
258111501776;258111502050;274;9;1;1;1
258111502050;258111502228;178;9;1;1;1
258111502228;258111502512;284;9;1;1;1
258111502512;258111502578;66;9;1;1;1
258111502578;258111502611;33;9;1;1;1
258111502611;258111502645;34;9;1;1;1
258111502645;258111503943;1298;9;1;1;1
258111503943;258111510255;6312;9;1;1;1
258111510255;258111514208;3953;9;1;1;1
258111514208;258111516910;2702;9;1;1;1
258111516910;258111517091;181;9;1;1;1
258111517091;258111517129;38;9;1;1;1
258111517129;258111517260;131;9;1;1;1
258111517260;258111518910;1650;9;1;1;1
258111518910;258111520701;1791;2,9;2;1;1
258111520701;258111575438;54737;9;1;1;1
258111575438;258111584404;8966;9;1;1;1
258111584404;258111584648;244;9;1;1;1
258111584648;258111584731;83;9;1;1;1
258111584731;258111584978;247;9;1;1;1
258111584978;258111591607;6629;9;1;1;1
258111591607;258111594206;2599;2,9;2;1;1
258111594206;258111601595;7389;2,9;2;1;1
258111601595;258111602758;1163;2,9;2;1;1
258111602758;258111613811;11053;2,9;2;1;1
258111613811;258111614563;752;2,9;2;1;1
258111614563;258111614821;258;2,9;2;1;1
258111614821;258111618120;3299;2,9;2;1;1
258111618120;258111619859;1739;2,9;2;1;1
258111619859;258111623348;3489;2,9;2;1;1
258111623348;258111624336;988;2,9;2;1;1
258111624336;258111624490;154;2,9;2;1;1
258111624490;258111624667;177;2,9;2;1;1
258111624667;258111624706;39;2,9;2;1;1
258111624706;258111624835;129;2,9;2;1;1
258111624835;258111625171;336;2,9;2;1;1
258111625171;258111625416;245;2,9;2;1;1
258111625416;258111626103;687;2,9;2;1;1
258111626103;258111626525;422;2,9;2;1;1
258111626525;258111628131;1606;2,9;2;1;1
258111628131;258111633852;5721;2,9;2;1;1
258111633852;258111640415;6563;2,9;2;1;1
258111640415;258111640866;451;2,9;2;1;1
258111640866;258111641840;974;2,9;2;1;1
258111641840;258111643696;1856;2,9;2;1;1
258111643696;258111665459;21763;9;1;1;1
258111665459;258111668813;3354;9;1;1;1
258111668813;258111668919;106;9;1;1;1
258111668919;258111668925;6;9;1;1;1
258111668925;258111668974;49;9;1;1;1
258111668974;258111669007;33;9;1;1;1
258111669007;258111669085;78;9;1;1;1
258111669085;258111669218;133;9;1;1;1
258111669218;258111669397;179;9;1;1;1
258111669397;258111669627;230;9;1;1;1
258111669627;258111669665;38;9;1;1;1
258111669665;258111669702;37;9;1;1;1
258111669702;258111669867;165;9;1;1;1
258111669867;258111670077;210;9;1;1;1
258111670077;258111683503;13426;9;1;1;1
258111683503;258111683538;35;9;1;1;1
258111683538;258111683795;257;9;1;1;1
258111683795;258111691496;7701;9;1;1;1
258111691496;258111693984;2488;2,9;2;1;1
258111693984;258111698322;4338;2,9;2;1;1
258111698322;258111702836;4514;2,9;2;1;1
258111702836;258111702874;38;2,9;2;1;1
258111702874;258111703119;245;2,9;2;1;1
258111703119;258111703341;222;2,9;2;1;1
258111703341;258111707160;3819;2,9;2;1;1
258111707160;258111710466;3306;2,9;2;1;1
258111710466;258111710645;179;2,9;2;1;1
258111710645;258111710763;118;2,9;2;1;1
258111710763;258111710952;189;2,9;2;1;1
258111710952;258111711010;58;2,9;2;1;1
258111711010;258111711125;115;2,9;2;1;1
258111711125;258111711134;9;2,9;2;1;1
258111711134;258111711342;208;2,9;2;1;1
258111711342;258111711450;108;2,9;2;1;1
258111711450;258111711614;164;2,9;2;1;1
258111711614;258111711756;142;2,9;2;1;1
258111711756;258111711960;204;2,9;2;1;1
258111711960;258111712045;85;2,9;2;1;1
258111712045;258111712206;161;2,9;2;1;1
258111712206;258111715462;3256;2,9;2;1;1
258111715462;258111717949;2487;2,9;2;1;1
258111717949;258111718056;107;2,9;2;1;1
258111718056;258111718070;14;2,9;2;1;1
258111718070;258111718190;120;2,9;2;1;1
258111718190;258111718530;340;2,9;2;1;1
258111718530;258111719229;699;2,9;2;1;1
258111719229;258111723157;3928;2,9;2;1;1
258111723157;258111725022;1865;2,9;2;1;1
258111725022;258111725697;675;2,9;2;1;1
258111725697;258111731263;5566;2,9;2;1;1
258111731263;258111748264;17001;9;1;1;1
258111748264;258111749421;1157;9;1;1;1
258111749421;258111751239;1818;9;1;1;1
258111751239;258111759355;8116;9;1;1;1
258111759355;258111759748;393;9;1;1;1
258111759748;258111759973;225;9;1;1;1
258111759973;258111760008;35;9;1;1;1
258111760008;258111760030;22;9;1;1;1
258111760030;258111760064;34;9;1;1;1
258111760064;258111760086;22;9;1;1;1
258111760086;258111760291;205;9;1;1;1
258111760291;258111760436;145;9;1;1;1
258111760436;258111760483;47;9;1;1;1
258111760483;258111760565;82;9;1;1;1
258111760565;258111760641;76;9;1;1;1
258111760641;258111760947;306;9;1;1;1
258111760947;258111761036;89;9;1;1;1
258111761036;258111761075;39;9;1;1;1
258111761075;258111777565;16490;9;1;1;1
258111777565;258111777651;86;9;1;1;1
258111777651;258111777730;79;9;1;1;1
258111777730;258111786005;8275;9;1;1;1
258111786005;258111786067;62;9;1;1;1
258111786067;258111786162;95;9;1;1;1
258111786162;258111793293;7131;9;1;1;1
258111793293;258111793460;167;9;1;1;1
258111793460;258111795415;1955;2,9;2;1;1
258111795415;258111795494;79;2,9;2;1;1
258111795494;258111802380;6886;2,9;2;1;1
258111802380;258111802499;119;2,9;2;1;1
258111802499;258111802696;197;2,9;2;1;1
258111802696;258111802735;39;2,9;2;1;1
258111802735;258111802760;25;2,9;2;1;1
258111802760;258111802895;135;2,9;2;1;1
258111802895;258111803096;201;2,9;2;1;1
258111803096;258111803119;23;2,9;2;1;1
258111803119;258111803938;819;2,9;2;1;1
258111803938;258111815494;11556;2,9;2;1;1
258111815494;258111815557;63;2,9;2;1;1
258111815557;258111815627;70;2,9;2;1;1
258111815627;258111815763;136;2,9;2;1;1
258111815763;258111815793;30;2,9;2;1;1
258111815793;258111816211;418;2,9;2;1;1
258111816211;258111816837;626;2,9;2;1;1
258111816837;258111825873;9036;2,9;2;1;1
258111825873;258111825884;11;2,9;2;1;1
258111825884;258111828676;2792;2,9;2;1;1
258111828676;258111829303;627;2,9;2;1;1
258111829303;258111831281;1978;2,9;2;1;1
258111831281;258111831924;643;2,9;2;1;1
258111831924;258111832105;181;2,9;2;1;1
258111832105;258111832721;616;2,9;2;1;1
258111832721;258111833533;812;9;1;1;1
258111833533;258111844027;10494;9;1;1;1
258111844027;258111844077;50;9;1;1;1
258111844077;258111844087;10;9;1;1;1
258111844087;258111844112;25;9;1;1;1
258111844112;258111844150;38;9;1;1;1
258111844150;258111844372;222;9;1;1;1
258111844372;258111844533;161;9;1;1;1
258111844533;258111844570;37;9;1;1;1
258111844570;258111844675;105;9;1;1;1
258111844675;258111844715;40;9;1;1;1
258111844715;258111844739;24;9;1;1;1
258111844739;258111844751;12;9;1;1;1
258111844751;258111844973;222;9;1;1;1
258111844973;258111845105;132;9;1;1;1
258111845105;258111876235;31130;9;1;1;1
258111876235;258111879575;3340;2,9;2;1;1
258111879575;258111881393;1818;2,9;2;1;1
258111881393;258111888047;6654;2,9;2;1;1
258111888047;258111890895;2848;2,9;2;1;1
258111890895;258111891220;325;2,9;2;1;1
258111891220;258111896275;5055;2,9;2;1;1
258111896275;258111896546;271;2,9;2;1;1
258111896546;258111898887;2341;2,9;2;1;1
258111898887;258111900042;1155;2,9;2;1;1
258111900042;258111900249;207;2,9;2;1;1
258111900249;258111900286;37;2,9;2;1;1
258111900286;258111900466;180;2,9;2;1;1
258111900466;258111904899;4433;2,9;2;1;1
258111904899;258111908714;3815;2,9;2;1;1
258111908714;258111908827;113;2,9;2;1;1
258111908827;258111909030;203;2,9;2;1;1
258111909030;258111910950;1920;2,9;2;1;1
258111910950;258111978608;67658;9;1;1;1
258111978608;258112005764;27156;2,9;2;1;1
258112005764;258112070973;65209;9;1;1;1
258112070973;258112073268;2295;2,9;2;1;1
258112073268;258112082938;9670;2,9;2;1;1
258112082938;258112083536;598;2,9;2;1;1
258112083536;258112089980;6444;2,9;2;1;1
258112089980;258112095912;5932;2,9;2;1;1
258112095912;258112096485;573;2,9;2;1;1
258112096485;258112097852;1367;2,9;2;1;1
258112097852;258112100630;2778;2,9;2;1;1
258112100630;258112101267;637;2,9;2;1;1
258112101267;258112106030;4763;2,9;2;1;1
258112106030;258112111533;5503;2,9;2;1;1
258112111533;258112112131;598;2,9;2;1;1
258112112131;258112119581;7450;2,9;2;1;1
258112119581;258112120680;1099;2,9;2;1;1
258112120680;258112121630;950;2,9;2;1;1
258112121630;258112122435;805;2,9;2;1;1
258112122435;258112122961;526;2,9;2;1;1
258112122961;258112125705;2744;9;1;1;1
258112125705;258112126230;525;2,9;2;1;1
258112126230;258112127044;814;2,9;2;1;1
258112127044;258112127199;155;2,9;2;1;1
258112127199;258112128867;1668;2,9;2;1;1
258112128867;258112128973;106;2,9;2;1;1
258112128973;258112129760;787;9;1;1;1
258112129760;258112130510;750;2,9;2;1;1
258112130510;258112167062;36552;9;1;1;1
258112167062;258112168121;1059;2,9;2;1;1
258112168121;258112170134;2013;9;1;1;1
258112170134;258112170940;806;2,9;2;1;1
258112170940;258112172536;1596;2,9;2;1;1
258112172536;258112172987;451;2,9;2;1;1
258112172987;258112175641;2654;9;1;1;1
258112175641;258112176231;590;2,9;2;1;1
258112176231;258112177106;875;2,9;2;1;1
258112177106;258112178415;1309;2,9;2;1;1
258112178415;258112178727;312;2,9;2;1;1
258112178727;258112179749;1022;2,9;2;1;1
258112179749;258112180605;856;9;1;1;1
258112180605;258112183057;2452;2,9;2;1;1
258112183057;258112184403;1346;2,9;2;1;1
258112184403;258112185113;710;2,9;2;1;1
258112185113;258112185525;412;2,9;2;1;1
258112185525;258112185777;252;2,9;2;1;1
258112185777;258112189177;3400;2,9;2;1;1
258112189177;258112190159;982;2,9;2;1;1
258112190159;258112192101;1942;2,9;2;1;1
258112192101;258112192729;628;2,9;2;1;1
258112192729;258112193749;1020;2,9;2;1;1
258112193749;258112194840;1091;2,9;2;1;1
258112194840;258112198582;3742;2,9;2;1;1
258112198582;258112199756;1174;2,9;2;1;1
258112199756;258112200409;653;2,9;2;1;1
258112200409;258112200489;80;2,9;2;1;1
258112200489;258112203807;3318;9;1;1;1
258112203807;258112204356;549;2,9;2;1;1
258112204356;258112242912;38556;9;1;1;1
258112242912;258112247126;4214;2,9;2;1;1
258112247126;258112273166;26040;9;1;1;1
258112273166;258112273509;343;9;1;1;1
258112273509;258112277163;3654;9;1;1;1
258112277163;258112277376;213;9;1;1;1
258112277376;258112277725;349;9;1;1;1
258112277725;258112277762;37;9;1;1;1
258112277762;258112277798;36;9;1;1;1
258112277798;258112277833;35;9;1;1;1
258112277833;258112277870;37;9;1;1;1
258112277870;258112277999;129;9;1;1;1
258112277999;258112278118;119;9;1;1;1
258112278118;258112278286;168;9;1;1;1
258112278286;258112278404;118;9;1;1;1
258112278404;258112278525;121;9;1;1;1
258112278525;258112278561;36;9;1;1;1
258112278561;258112278695;134;9;1;1;1
258112278695;258112290574;11879;9;1;1;1
258112290574;258112291195;621;2,9;2;1;1
258112291195;258112320782;29587;9;1;1;1
258112320782;258112324638;3856;9;1;1;1
258112324638;258112324757;119;9;1;1;1
258112324757;258112324796;39;9;1;1;1
258112324796;258112324954;158;9;1;1;1
258112324954;258112325209;255;9;1;1;1
258112325209;258112327526;2317;9;1;1;1
258112327526;258112327891;365;9;1;1;1
258112327891;258112328707;816;9;1;1;1
258112328707;258112329103;396;9;1;1;1
258112329103;258112329529;426;9;1;1;1
258112329529;258112331751;2222;9;1;1;1
258112331751;258112331968;217;9;1;1;1
258112331968;258112332009;41;9;1;1;1
258112332009;258112332234;225;9;1;1;1
258112332234;258112338812;6578;9;1;1;1
258112338812;258112359941;21129;9;1;1;1
258112359941;258112360497;556;2,9;2;1;1
258112360497;258112363149;2652;9;1;1;1
258112363149;258112406171;43022;9;1;1;1
258112406171;258112407081;910;9;1;1;1
258112407081;258112407924;843;2,9;2;1;1
258112407924;258112416503;8579;9;1;1;1
258112416503;258112416517;14;9;1;1;1
258112416517;258112416566;49;9;1;1;1
258112416566;258112416574;8;9;1;1;1
258112416574;258112416599;25;9;1;1;1
258112416599;258112416793;194;9;1;1;1
258112416793;258112416836;43;9;1;1;1
258112416836;258112416936;100;9;1;1;1
258112416936;258112416996;60;9;1;1;1
258112416996;258112417075;79;9;1;1;1
258112417075;258112438533;21458;9;1;1;1
258112438533;258112438766;233;9;1;1;1
258112438766;258112438797;31;9;1;1;1
258112438797;258112438811;14;9;1;1;1
258112438811;258112440174;1363;9;1;1;1
258112440174;258112467340;27166;9;1;1;1
258112467340;258112473374;6034;9;1;1;1
258112473374;258112481182;7808;9;1;1;1
258112481182;258112482207;1025;2,9;2;1;1
258112482207;258112485145;2938;9;1;1;1
258112485145;258112486060;915;2,9;2;1;1
258112486060;258112486177;117;9;1;1;1
258112486177;258112487382;1205;2,9;2;1;1
258112487382;258112487683;301;9;1;1;1
258112487683;258112489272;1589;2,9;2;1;1
258112489272;258112492402;3130;9;1;1;1
258112492402;258112493780;1378;2,9;2;1;1
258112493780;258112497269;3489;9;1;1;1
258112497269;258112498927;1658;2,9;2;1;1
258112498927;258112510857;11930;9;1;1;1
258112510857;258112521184;10327;9;1;1;1
258112521184;258112521387;203;9;1;1;1
258112521387;258112521441;54;9;1;1;1
258112521441;258112521616;175;9;1;1;1
258112521616;258112525723;4107;9;1;1;1
258112525723;258112525909;186;9;1;1;1
258112525909;258112526033;124;9;1;1;1
258112526033;258112526073;40;9;1;1;1
258112526073;258112526108;35;9;1;1;1
258112526108;258112543610;17502;9;1;1;1
258112543610;258112550907;7297;9;1;1;1
258112550907;258112558507;7600;9;1;1;1
258112558507;258112560375;1868;2,9;2;1;1
258112560375;258112563723;3348;2,9;2;1;1
258112563723;258112564178;455;2,9;2;1;1
258112564178;258112564486;308;2,9;2;1;1
258112564486;258112568470;3984;2,9;2;1;1
258112568470;258112573361;4891;2,9;2;1;1
258112573361;258112573640;279;2,9;2;1;1
258112573640;258112573855;215;2,9;2;1;1
258112573855;258112573978;123;2,9;2;1;1
258112573978;258112574145;167;2,9;2;1;1
258112574145;258112575430;1285;2,9;2;1;1
258112575430;258112576336;906;2,9;2;1;1
258112576336;258112581372;5036;2,9;2;1;1
258112581372;258112582244;872;2,9;2;1;1
258112582244;258112582269;25;2,9;2;1;1
258112582269;258112582465;196;2,9;2;1;1
258112582465;258112582589;124;2,9;2;1;1
258112582589;258112582620;31;2,9;2;1;1
258112582620;258112582652;32;2,9;2;1;1
258112582652;258112582705;53;2,9;2;1;1
258112582705;258112582877;172;2,9;2;1;1
258112582877;258112582917;40;2,9;2;1;1
258112582917;258112583076;159;2,9;2;1;1
258112583076;258112584707;1631;2,9;2;1;1
258112584707;258112585334;627;2,9;2;1;1
258112585334;258112585781;447;2,9;2;1;1
258112585781;258112586182;401;2,9;2;1;1
258112586182;258112586186;4;2,9;2;1;1
258112586186;258112593955;7769;2,9;2;1;1
258112593955;258112594673;718;2,9;2;1;1
258112594673;258112611126;16453;2,9;2;1;1
258112611126;258112611397;271;2,9;2;1;1
258112611397;258112612357;960;2,9;2;1;1
258112612357;258112612618;261;2,9;2;1;1
258112612618;258112613318;700;2,9;2;1;1
258112613318;258112613818;500;2,9;2;1;1
258112613818;258112614593;775;2,9;2;1;1
258112614593;258112615924;1331;2,9;2;1;1
258112615924;258112616733;809;2,9;2;1;1
258112616733;258112617165;432;2,9;2;1;1
258112617165;258112630127;12962;9;1;1;1
258112630127;258112638762;8635;9;1;1;1
258112638762;258112638789;27;9;1;1;1
258112638789;258112638843;54;9;1;1;1
258112638843;258112639044;201;9;1;1;1
258112639044;258112639077;33;9;1;1;1
258112639077;258112639169;92;9;1;1;1
258112639169;258112639256;87;9;1;1;1
258112639256;258112639410;154;9;1;1;1
258112639410;258112641662;2252;9;1;1;1
258112641662;258112644437;2775;9;1;1;1
258112644437;258112644528;91;9;1;1;1
258112644528;258112644613;85;9;1;1;1
258112644613;258112644706;93;9;1;1;1
258112644706;258112644784;78;9;1;1;1
258112644784;258112644820;36;9;1;1;1
258112644820;258112644967;147;9;1;1;1
258112644967;258112645087;120;9;1;1;1
258112645087;258112662972;17885;9;1;1;1
258112662972;258112663092;120;9;1;1;1
258112663092;258112663408;316;9;1;1;1
258112663408;258112663651;243;9;1;1;1
258112663651;258112664616;965;9;1;1;1
258112664616;258112664655;39;9;1;1;1
258112664655;258112667844;3189;9;1;1;1
258112667844;258112668038;194;9;1;1;1
258112668038;258112669722;1684;9;1;1;1
258112669722;258112669911;189;9;1;1;1
258112669911;258112670058;147;9;1;1;1
258112670058;258112676449;6391;9;1;1;1
258112676449;258112679694;3245;9;1;1;1
258112679694;258112679796;102;9;1;1;1
258112679796;258112679847;51;9;1;1;1
258112679847;258112681440;1593;9;1;1;1
258112681440;258112689720;8280;9;1;1;1
258112689720;258112689801;81;9;1;1;1
258112689801;258112695302;5501;9;1;1;1
258112695302;258112697479;2177;9;1;1;1
258112697479;258112699201;1722;9;1;1;1
258112699201;258112699859;658;2,9;2;1;1
258112699859;258112708860;9001;9;1;1;1
258112708860;258112708912;52;9;1;1;1
258112708912;258112708938;26;9;1;1;1
258112708938;258112708995;57;9;1;1;1
258112708995;258112709003;8;9;1;1;1
258112709003;258112709054;51;9;1;1;1
258112709054;258112709081;27;9;1;1;1
258112709081;258112709405;324;9;1;1;1
258112709405;258112709592;187;9;1;1;1
258112709592;258112709651;59;9;1;1;1
258112709651;258112709753;102;9;1;1;1
258112709753;258112709804;51;9;1;1;1
258112709804;258112709983;179;9;1;1;1
258112709983;258112710028;45;9;1;1;1
258112710028;258112741317;31289;9;1;1;1
258112741317;258112750376;9059;9;1;1;1
258112750376;258112751658;1282;9;1;1;1
258112751658;258112751982;324;9;1;1;1
258112751982;258112752035;53;9;1;1;1
258112752035;258112752063;28;9;1;1;1
258112752063;258112752119;56;9;1;1;1
258112752119;258112752130;11;9;1;1;1
258112752130;258112752153;23;9;1;1;1
258112752153;258112752341;188;9;1;1;1
258112752341;258112752496;155;9;1;1;1
258112752496;258112752537;41;9;1;1;1
258112752537;258112752695;158;9;1;1;1
258112752695;258112752737;42;9;1;1;1
258112752737;258112752837;100;9;1;1;1
258112752837;258112752928;91;9;1;1;1
258112752928;258112753095;167;9;1;1;1
258112753095;258112757806;4711;9;1;1;1
258112757806;258112757829;23;9;1;1;1
258112757829;258112757882;53;9;1;1;1
258112757882;258112760574;2692;9;1;1;1
258112760574;258112760593;19;9;1;1;1
258112760593;258112761002;409;9;1;1;1
258112761002;258112761057;55;9;1;1;1
258112761057;258112763688;2631;9;1;1;1
258112763688;258112764017;329;9;1;1;1
258112764017;258112764070;53;9;1;1;1
258112764070;258112764366;296;9;1;1;1
258112764366;258112766933;2567;9;1;1;1
258112766933;258112767031;98;9;1;1;1
258112767031;258112767150;119;9;1;1;1
258112767150;258112770316;3166;9;1;1;1
258112770316;258112772517;2201;2,9;2;1;1
258112772517;258112773510;993;2,9;2;1;1
258112773510;258112774850;1340;2,9;2;1;1
258112774850;258112775411;561;2,9;2;1;1
258112775411;258112776850;1439;2,9;2;1;1
258112776850;258112777704;854;9;1;1;1
258112777704;258112778148;444;2,9;2;1;1
258112778148;258112779376;1228;2,9;2;1;1
258112779376;258112780235;859;2,9;2;1;1
258112780235;258112780765;530;9;1;1;1
258112780765;258112781680;915;2,9;2;1;1
258112781680;258112785439;3759;9;1;1;1
258112785439;258112788106;2667;2,9;2;1;1
258112788106;258112789106;1000;2,9;2;1;1
258112789106;258112789722;616;2,9;2;1;1
258112789722;258112790503;781;2,9;2;1;1
258112790503;258112790594;91;2,9;2;1;1
258112790594;258112791305;711;2,9;2;1;1
258112791305;258112791884;579;2,9;2;1;1
258112791884;258112799503;7619;2,9;2;1;1
258112799503;258112801437;1934;9;1;1;1
258112801437;258112801509;72;9;1;1;1
258112801509;258112801610;101;9;1;1;1
258112801610;258112801676;66;9;1;1;1
258112801676;258112803058;1382;9;1;1;1
258112803058;258112803575;517;2,9;2;1;1
258112803575;258112803908;333;2,9;2;1;1
258112803908;258112804818;910;2,9;2;1;1
258112804818;258112805595;777;2,9;2;1;1
258112805595;258112806024;429;2,9;2;1;1
258112806024;258112806547;523;2,9;2;1;1
258112806547;258112807064;517;2,9;2;1;1
258112807064;258112808126;1062;2,9;2;1;1
258112808126;258112808253;127;2,9;2;1;1
258112808253;258112808687;434;2,9;2;1;1
258112808687;258112809091;404;2,9;2;1;1
258112809091;258112810271;1180;2,9;2;1;1
258112810271;258112822433;12162;9;1;1;1
258112822433;258112822563;130;9;1;1;1
258112822563;258112822687;124;9;1;1;1
258112822687;258112823122;435;9;1;1;1
258112823122;258112823170;48;9;1;1;1
258112823170;258112830441;7271;9;1;1;1
258112830441;258112830580;139;9;1;1;1
258112830580;258112830641;61;9;1;1;1
258112830641;258112830908;267;9;1;1;1
258112830908;258112830994;86;9;1;1;1
258112830994;258112831026;32;9;1;1;1
258112831026;258112831052;26;9;1;1;1
258112831052;258112854953;23901;9;1;1;1
258112854953;258112855062;109;9;1;1;1
258112855062;258112855107;45;9;1;1;1
258112855107;258112858277;3170;9;1;1;1
258112858277;258112862776;4499;2,9;2;1;1
258112862776;258112862840;64;2,9;2;1;1
258112862840;258112862999;159;2,9;2;1;1
258112862999;258112863147;148;2,9;2;1;1
258112863147;258112863249;102;2,9;2;1;1
258112863249;258112869008;5759;2,9;2;1;1
258112869008;258112872246;3238;2,9;2;1;1
258112872246;258112872705;459;2,9;2;1;1
258112872705;258112872899;194;2,9;2;1;1
258112872899;258112872928;29;2,9;2;1;1
258112872928;258112872955;27;2,9;2;1;1
258112872955;258112872970;15;2,9;2;1;1
258112872970;258112873216;246;2,9;2;1;1
258112873216;258112873246;30;2,9;2;1;1
258112873246;258112873279;33;2,9;2;1;1
258112873279;258112873321;42;2,9;2;1;1
258112873321;258112873445;124;2,9;2;1;1
258112873445;258112873488;43;2,9;2;1;1
258112873488;258112873672;184;2,9;2;1;1
258112873672;258112873842;170;2,9;2;1;1
258112873842;258112882724;8882;2,9;2;1;1
258112882724;258112882848;124;2,9;2;1;1
258112882848;258112883020;172;2,9;2;1;1
258112883020;258112883225;205;2,9;2;1;1
258112883225;258112883634;409;2,9;2;1;1
258112883634;258112888963;5329;2,9;2;1;1
258112888963;258112898736;9773;9;1;1;1
258112898736;258112898794;58;9;1;1;1
258112898794;258112899058;264;9;1;1;1
258112899058;258112899187;129;9;1;1;1
258112899187;258112899533;346;9;1;1;1
258112899533;258112899607;74;9;1;1;1
258112899607;258112899657;50;9;1;1;1
258112899657;258112899708;51;9;1;1;1
258112899708;258112900787;1079;9;1;1;1
258112900787;258112900975;188;9;1;1;1
258112900975;258112904303;3328;9;1;1;1
258112904303;258112904686;383;2,9;2;1;1
258112904686;258112904781;95;2,9;2;1;1
258112904781;258112904937;156;2,9;2;1;1
258112904937;258112905126;189;9;1;1;1
258112905126;258112906230;1104;9;1;1;1
258112906230;258112908885;2655;9;1;1;1
258112908885;258112909009;124;9;1;1;1
258112909009;258112909224;215;9;1;1;1
258112909224;258112909477;253;9;1;1;1
258112909477;258112956509;47032;9;1;1;1
258112956509;258112966045;9536;9;1;1;1
258112966045;258112966093;48;9;1;1;1
258112966093;258112966290;197;9;1;1;1
258112966290;258112966432;142;9;1;1;1
258112966432;258112967393;961;9;1;1;1
258112967393;258112969506;2113;9;1;1;1
258112969506;258112969687;181;9;1;1;1
258112969687;258112969770;83;9;1;1;1
258112969770;258112969820;50;9;1;1;1
258112969820;258112969876;56;9;1;1;1
258112969876;258112970808;932;9;1;1;1
258112970808;258112972619;1811;9;1;1;1
258112972619;258112975364;2745;2,9;2;1;1
258112975364;258112976463;1099;2,9;2;1;1
258112976463;258112978525;2062;2,9;2;1;1
258112978525;258112981480;2955;2,9;2;1;1
258112981480;258112990813;9333;2,9;2;1;1
258112990813;258112992500;1687;2,9;2;1;1
258112992500;258112993702;1202;2,9;2;1;1
258112993702;258112995416;1714;2,9;2;1;1
258112995416;258112995816;400;2,9;2;1;1
258112995816;258112997215;1399;2,9;2;1;1
258112997215;258112997347;132;2,9;2;1;1
258112997347;258112997455;108;2,9;2;1;1
258112997455;258113003879;6424;2,9;2;1;1
258113003879;258113004277;398;2,9;2;1;1
258113004277;258113004619;342;2,9;2;1;1
258113004619;258113005687;1068;2,9;2;1;1
258113005687;258113005979;292;2,9;2;1;1
258113005979;258113007013;1034;2,9;2;1;1
258113007013;258113007391;378;2,9;2;1;1
258113007391;258113007544;153;2,9;2;1;1
258113007544;258113007576;32;2,9;2;1;1
258113007576;258113007595;19;2,9;2;1;1
258113007595;258113007745;150;2,9;2;1;1
258113007745;258113007911;166;2,9;2;1;1
258113007911;258113008096;185;2,9;2;1;1
258113008096;258113008352;256;2,9;2;1;1
258113008352;258113008500;148;2,9;2;1;1
258113008500;258113008602;102;2,9;2;1;1
258113008602;258113010637;2035;2,9;2;1;1
258113010637;258113011005;368;2,9;2;1;1
258113011005;258113011118;113;2,9;2;1;1
258113011118;258113012055;937;2,9;2;1;1
258113012055;258113012119;64;2,9;2;1;1
258113012119;258113014026;1907;2,9;2;1;1
258113014026;258113015529;1503;2,9;2;1;1
258113015529;258113016397;868;2,9;2;1;1
258113016397;258113016481;84;2,9;2;1;1
258113016481;258113017460;979;2,9;2;1;1
258113017460;258113018122;662;2,9;2;1;1
258113018122;258113018834;712;2,9;2;1;1
258113018834;258113019492;658;2,9;2;1;1
258113019492;258113022680;3188;2,9;2;1;1
258113022680;258113022766;86;2,9;2;1;1
258113022766;258113023216;450;2,9;2;1;1
258113023216;258113023356;140;2,9;2;1;1
258113023356;258113025066;1710;9;1;1;1
258113025066;258113036849;11783;9;1;1;1
258113036849;258113057956;21107;9;1;1;1
258113057956;258113060001;2045;9;1;1;1
258113060001;258113060051;50;9;1;1;1
258113060051;258113060078;27;9;1;1;1
258113060078;258113060132;54;9;1;1;1
258113060132;258113060183;51;9;1;1;1
258113060183;258113060191;8;9;1;1;1
258113060191;258113060244;53;9;1;1;1
258113060244;258113060294;50;9;1;1;1
258113060294;258113062137;1843;9;1;1;1
258113062137;258113063185;1048;9;1;1;1
258113063185;258113075332;12147;9;1;1;1
258113075332;258113080817;5485;9;1;1;1
258113080817;258113090965;10148;2,9;2;1;1
258113090965;258113092206;1241;2,9;2;1;1
258113092206;258113092270;64;2,9;2;1;1
258113092270;258113092605;335;2,9;2;1;1
258113092605;258113092630;25;2,9;2;1;1
258113092630;258113092663;33;2,9;2;1;1
258113092663;258113092679;16;2,9;2;1;1
258113092679;258113092693;14;2,9;2;1;1
258113092693;258113092841;148;2,9;2;1;1
258113092841;258113092882;41;2,9;2;1;1
258113092882;258113092888;6;2,9;2;1;1
258113092888;258113092916;28;2,9;2;1;1
258113092916;258113092957;41;2,9;2;1;1
258113092957;258113093011;54;2,9;2;1;1
258113093011;258113093022;11;2,9;2;1;1
258113093022;258113093047;25;2,9;2;1;1
258113093047;258113093173;126;2,9;2;1;1
258113093173;258113093248;75;2,9;2;1;1
258113093248;258113093508;260;2,9;2;1;1
258113093508;258113098557;5049;2,9;2;1;1
258113098557;258113098629;72;2,9;2;1;1
258113098629;258113099474;845;2,9;2;1;1
258113099474;258113099542;68;2,9;2;1;1
258113099542;258113099651;109;2,9;2;1;1
258113099651;258113099827;176;2,9;2;1;1
258113099827;258113099881;54;2,9;2;1;1
258113099881;258113099921;40;2,9;2;1;1
258113099921;258113099992;71;2,9;2;1;1
258113099992;258113100042;50;2,9;2;1;1
258113100042;258113101063;1021;2,9;2;1;1
258113101063;258113101278;215;2,9;2;1;1
258113101278;258113102247;969;2,9;2;1;1
258113102247;258113102585;338;2,9;2;1;1
258113102585;258113103053;468;2,9;2;1;1
258113103053;258113103105;52;2,9;2;1;1
258113103105;258113104655;1550;2,9;2;1;1
258113104655;258113105000;345;2,9;2;1;1
258113105000;258113105147;147;2,9;2;1;1
258113105147;258113111340;6193;2,9;2;1;1
258113111340;258113111635;295;9;1;1;1
258113111635;258113111684;49;9;1;1;1
258113111684;258113111736;52;9;1;1;1
258113111736;258113111770;34;9;1;1;1
258113111770;258113111792;22;9;1;1;1
258113111792;258113112844;1052;9;1;1;1
258113112844;258113112906;62;9;1;1;1
258113112906;258113115231;2325;9;1;1;1
258113115231;258113115239;8;9;1;1;1
258113115239;258113115752;513;9;1;1;1
258113115752;258113115776;24;9;1;1;1
258113115776;258113115896;120;9;1;1;1
258113115896;258113116226;330;9;1;1;1
258113116226;258113116362;136;9;1;1;1
258113116362;258113116418;56;9;1;1;1
258113116418;258113117603;1185;9;1;1;1
258113117603;258113117676;73;9;1;1;1
258113117676;258113118128;452;9;1;1;1
258113118128;258113118285;157;9;1;1;1
258113118285;258113118358;73;9;1;1;1
258113118358;258113118451;93;9;1;1;1
258113118451;258113118609;158;9;1;1;1
258113118609;258113118688;79;9;1;1;1
258113118688;258113119039;351;9;1;1;1
258113119039;258113122590;3551;9;1;1;1
258113122590;258113122933;343;9;1;1;1
258113122933;258113122982;49;9;1;1;1
258113122982;258113123033;51;9;1;1;1
258113123033;258113123041;8;9;1;1;1
258113123041;258113123047;6;9;1;1;1
258113123047;258113123106;59;9;1;1;1
258113123106;258113123174;68;9;1;1;1
258113123174;258113123343;169;9;1;1;1
258113123343;258113123490;147;9;1;1;1
258113123490;258113123653;163;9;1;1;1
258113123653;258113123682;29;9;1;1;1
258113123682;258113125526;1844;9;1;1;1
258113125526;258113125585;59;9;1;1;1
258113125585;258113125659;74;9;1;1;1
258113125659;258113126034;375;9;1;1;1
258113126034;258113126378;344;2,9;2;1;1
258113126378;258113126662;284;2,9;2;1;1
258113126662;258113127080;418;9;1;1;1
258113127080;258113127236;156;9;1;1;1
258113127236;258113127256;20;9;1;1;1
258113127256;258113127435;179;9;1;1;1
258113127435;258113128527;1092;9;1;1;1
258113128527;258113129486;959;9;1;1;1
258113129486;258113130756;1270;9;1;1;1
258113130756;258113131262;506;9;1;1;1
258113131262;258113131295;33;9;1;1;1
258113131295;258113131554;259;9;1;1;1
258113131554;258113131692;138;9;1;1;1
258113131692;258113131763;71;9;1;1;1
258113131763;258113132532;769;9;1;1;1
258113132532;258113132779;247;9;1;1;1
258113132779;258113135621;2842;9;1;1;1
258113135621;258113136962;1341;9;1;1;1
258113136962;258113137287;325;9;1;1;1
258113137287;258113139888;2601;9;1;1;1
258113139888;258113144705;4817;9;1;1;1
258113144705;258113144991;286;9;1;1;1
258113144991;258113147407;2416;9;1;1;1
258113147407;258113148069;662;9;1;1;1
258113148069;258113148381;312;9;1;1;1
258113148381;258113148398;17;9;1;1;1
258113148398;258113148476;78;9;1;1;1
258113148476;258113148547;71;9;1;1;1
258113148547;258113148600;53;9;1;1;1
258113148600;258113156007;7407;9;1;1;1
258113156007;258113156062;55;9;1;1;1
258113156062;258113156171;109;9;1;1;1
258113156171;258113156376;205;9;1;1;1
258113156376;258113156387;11;9;1;1;1
258113156387;258113159489;3102;9;1;1;1
258113159489;258113159585;96;9;1;1;1
258113159585;258113159624;39;9;1;1;1
258113159624;258113159696;72;9;1;1;1
258113159696;258113159804;108;9;1;1;1
258113159804;258113159909;105;9;1;1;1
258113159909;258113160021;112;9;1;1;1
258113160021;258113160118;97;9;1;1;1
258113160118;258113161825;1707;9;1;1;1
258113161825;258113162020;195;9;1;1;1
258113162020;258113162814;794;9;1;1;1
258113162814;258113164574;1760;9;1;1;1
258113164574;258113164875;301;9;1;1;1
258113164875;258113164894;19;9;1;1;1
258113164894;258113164924;30;9;1;1;1
258113164924;258113165086;162;9;1;1;1
258113165086;258113166613;1527;9;1;1;1
258113166613;258113166682;69;9;1;1;1
258113166682;258113166709;27;9;1;1;1
258113166709;258113166961;252;9;1;1;1
258113166961;258113167057;96;9;1;1;1
258113167057;258113167381;324;9;1;1;1
258113167381;258113168756;1375;9;1;1;1
258113168756;258113168953;197;9;1;1;1
258113168953;258113169012;59;9;1;1;1
258113169012;258113169126;114;9;1;1;1
258113169126;258113169157;31;9;1;1;1
258113169157;258113172444;3287;9;1;1;1
258113172444;258113172648;204;9;1;1;1
258113172648;258113173126;478;9;1;1;1
258113173126;258113173298;172;9;1;1;1
258113173298;258113173490;192;9;1;1;1
258113173490;258113175610;2120;9;1;1;1
258113175610;258113177033;1423;9;1;1;1
258113177033;258113177233;200;9;1;1;1
258113177233;258113177458;225;9;1;1;1
258113177458;258113178271;813;9;1;1;1
258113178271;258113178484;213;9;1;1;1
258113178484;258113178734;250;9;1;1;1
258113178734;258113178868;134;9;1;1;1
258113178868;258113178904;36;9;1;1;1
258113178904;258113178943;39;9;1;1;1
258113178943;258113179095;152;9;1;1;1
258113179095;258113182867;3772;9;1;1;1
258113182867;258113184800;1933;9;1;1;1
258113184800;258113184844;44;9;1;1;1
258113184844;258113184873;29;9;1;1;1
258113184873;258113184888;15;9;1;1;1
258113184888;258113186172;1284;9;1;1;1
258113186172;258113189868;3696;9;1;1;1
258113189868;258113190831;963;9;1;1;1
258113190831;258113191116;285;9;1;1;1
258113191116;258113193007;1891;9;1;1;1
258113193007;258113193078;71;9;1;1;1
258113193078;258113193179;101;9;1;1;1
258113193179;258113194162;983;9;1;1;1
258113194162;258113194513;351;9;1;1;1
258113194513;258113195567;1054;9;1;1;1
258113195567;258113195709;142;9;1;1;1
258113195709;258113195778;69;9;1;1;1
258113195778;258113198151;2373;9;1;1;1
258113198151;258113198311;160;9;1;1;1
258113198311;258113198512;201;9;1;1;1
258113198512;258113199867;1355;9;1;1;1
258113199867;258113200032;165;9;1;1;1
258113200032;258113201530;1498;9;1;1;1
258113201530;258113202164;634;2,9;2;1;1
258113202164;258113202220;56;9;1;1;1
258113202220;258113202719;499;9;1;1;1
258113202719;258113205085;2366;9;1;1;1
258113205085;258113205134;49;9;1;1;1
258113205134;258113205319;185;9;1;1;1
258113205319;258113205431;112;9;1;1;1
258113205431;258113205482;51;9;1;1;1
258113205482;258113205792;310;9;1;1;1
258113205792;258113205871;79;9;1;1;1
258113205871;258113205914;43;9;1;1;1
258113205914;258113206898;984;9;1;1;1
258113206898;258113207039;141;9;1;1;1
258113207039;258113207448;409;9;1;1;1
258113207448;258113208670;1222;9;1;1;1
258113208670;258113209550;880;9;1;1;1
258113209550;258113209606;56;9;1;1;1
258113209606;258113209659;53;9;1;1;1
258113209659;258113209767;108;9;1;1;1
258113209767;258113209815;48;9;1;1;1
258113209815;258113210400;585;9;1;1;1
258113210400;258113210934;534;9;1;1;1
258113210934;258113210983;49;9;1;1;1
258113210983;258113211063;80;9;1;1;1
258113211063;258113211071;8;9;1;1;1
258113211071;258113211191;120;9;1;1;1
258113211191;258113211206;15;9;1;1;1
258113211206;258113216214;5008;9;1;1;1
258113216214;258113217709;1495;9;1;1;1
258113217709;258113221867;4158;9;1;1;1
258113221867;258113222170;303;9;1;1;1
258113222170;258113222340;170;9;1;1;1
258113222340;258113222436;96;9;1;1;1
258113222436;258113222494;58;9;1;1;1
258113222494;258113222546;52;9;1;1;1
258113222546;258113222602;56;9;1;1;1
258113222602;258113222608;6;9;1;1;1
258113222608;258113223264;656;9;1;1;1
258113223264;258113223309;45;9;1;1;1
258113223309;258113224497;1188;9;1;1;1
258113224497;258113224756;259;9;1;1;1
258113224756;258113224887;131;9;1;1;1
258113224887;258113225071;184;9;1;1;1
258113225071;258113227353;2282;9;1;1;1
258113227353;258113227381;28;9;1;1;1
258113227381;258113227785;404;9;1;1;1
258113227785;258113227991;206;9;1;1;1
258113227991;258113228222;231;9;1;1;1
258113228222;258113228474;252;9;1;1;1
258113228474;258113228874;400;9;1;1;1
258113228874;258113229102;228;9;1;1;1
258113229102;258113229228;126;9;1;1;1
258113229228;258113229419;191;9;1;1;1
258113229419;258113230995;1576;9;1;1;1
258113230995;258113231931;936;9;1;1;1
258113231931;258113232082;151;9;1;1;1
258113232082;258113232223;141;9;1;1;1
258113232223;258113234152;1929;9;1;1;1
258113234152;258113234947;795;9;1;1;1
258113234947;258113235386;439;9;1;1;1
258113235386;258113236983;1597;9;1;1;1
258113236983;258113238866;1883;9;1;1;1
258113238866;258113239716;850;9;1;1;1
258113239716;258113241144;1428;9;1;1;1
258113241144;258113243966;2822;9;1;1;1
258113243966;258113245712;1746;9;1;1;1
258113245712;258113245890;178;9;1;1;1
258113245890;258113245918;28;9;1;1;1
258113245918;258113248935;3017;9;1;1;1
258113248935;258113251788;2853;9;1;1;1
258113251788;258113252430;642;2,9;2;1;1
258113252430;258113252625;195;9;1;1;1
258113252625;258113252647;22;9;1;1;1
258113252647;258113252697;50;9;1;1;1
258113252697;258113259487;6790;9;1;1;1
258113259487;258113259514;27;9;1;1;1
258113259514;258113260538;1024;9;1;1;1
258113260538;258113261144;606;9;1;1;1
258113261144;258113261324;180;9;1;1;1
258113261324;258113261614;290;9;1;1;1
258113261614;258113261683;69;9;1;1;1
258113261683;258113263853;2170;9;1;1;1
258113263853;258113264042;189;9;1;1;1
258113264042;258113264052;10;9;1;1;1
258113264052;258113264092;40;9;1;1;1
258113264092;258113264353;261;9;1;1;1
258113264353;258113264467;114;9;1;1;1
258113264467;258113264800;333;9;1;1;1
258113264800;258113264873;73;9;1;1;1
258113264873;258113264965;92;9;1;1;1
258113264965;258113265173;208;9;1;1;1
258113265173;258113265302;129;9;1;1;1
258113265302;258113265377;75;9;1;1;1
258113265377;258113265545;168;9;1;1;1
258113265545;258113269210;3665;9;1;1;1
258113269210;258113271616;2406;9;1;1;1
258113271616;258113271679;63;9;1;1;1
258113271679;258113271947;268;9;1;1;1
258113271947;258113273600;1653;9;1;1;1
258113273600;258113274355;755;9;1;1;1
258113274355;258113275078;723;9;1;1;1
258113275078;258113275879;801;9;1;1;1
258113275879;258113276045;166;9;1;1;1
258113276045;258113276220;175;9;1;1;1
258113276220;258113276362;142;9;1;1;1
258113276362;258113276485;123;9;1;1;1
258113276485;258113276486;1;9;1;1;1
258113276486;258113276540;54;9;1;1;1
258113276540;258113276597;57;9;1;1;1
258113276597;258113276697;100;9;1;1;1
258113276697;258113276733;36;9;1;1;1
258113276733;258113277856;1123;9;1;1;1
258113277856;258113277947;91;9;1;1;1
258113277947;258113278124;177;9;1;1;1
258113278124;258113278746;622;9;1;1;1
258113278746;258113279184;438;9;1;1;1
258113279184;258113282862;3678;9;1;1;1
258113282862;258113283415;553;9;1;1;1
258113283415;258113285652;2237;9;1;1;1
258113285652;258113290776;5124;9;1;1;1
258113290776;258113290817;41;9;1;1;1
258113290817;258113290842;25;9;1;1;1
258113290842;258113290885;43;9;1;1;1
258113290885;258113290909;24;9;1;1;1
258113290909;258113291300;391;9;1;1;1
258113291300;258113291656;356;9;1;1;1
258113291656;258113291973;317;9;1;1;1
258113291973;258113293691;1718;9;1;1;1
258113293691;258113293935;244;9;1;1;1
258113293935;258113293995;60;9;1;1;1
258113293995;258113295616;1621;9;1;1;1
258113295616;258113299437;3821;9;1;1;1
258113299437;258113299792;355;9;1;1;1
258113299792;258113300172;380;9;1;1;1
258113300172;258113300532;360;9;1;1;1
258113300532;258113301346;814;9;1;1;1
258113301346;258113301868;522;9;1;1;1
258113301868;258113301993;125;9;1;1;1
258113301993;258113302024;31;9;1;1;1
258113302024;258113302226;202;9;1;1;1
258113302226;258113302266;40;9;1;1;1
258113302266;258113302294;28;9;1;1;1
258113302294;258113302480;186;9;1;1;1
258113302480;258113302546;66;9;1;1;1
258113302546;258113302674;128;9;1;1;1
258113302674;258113302965;291;9;1;1;1
258113302965;258113303152;187;9;1;1;1
258113303152;258113305554;2402;9;1;1;1
258113305554;258113305761;207;9;1;1;1
258113305761;258113305848;87;9;1;1;1
258113305848;258113305964;116;9;1;1;1
258113305964;258113306820;856;9;1;1;1
258113306820;258113306960;140;9;1;1;1
258113306960;258113307060;100;9;1;1;1
258113307060;258113307096;36;9;1;1;1
258113307096;258113307501;405;9;1;1;1
258113307501;258113311604;4103;9;1;1;1
258113311604;258113311919;315;9;1;1;1
258113311919;258113313442;1523;9;1;1;1
258113313442;258113314296;854;9;1;1;1
258113314296;258113314429;133;9;1;1;1
258113314429;258113314879;450;9;1;1;1
258113314879;258113316393;1514;9;1;1;1
258113316393;258113322580;6187;9;1;1;1
258113322580;258113323551;971;9;1;1;1
258113323551;258113327562;4011;9;1;1;1
258113327562;258113331728;4166;9;1;1;1
258113331728;258113332367;639;2,9;2;1;1
258113332367;258113339129;6762;9;1;1;1
258113339129;258113339135;6;9;1;1;1
258113339135;258113341879;2744;9;1;1;1
258113341879;258113342024;145;9;1;1;1
258113342024;258113343334;1310;9;1;1;1
258113343334;258113343515;181;9;1;1;1
258113343515;258113343892;377;9;1;1;1
258113343892;258113344098;206;9;1;1;1
258113344098;258113344290;192;9;1;1;1
258113344290;258113344424;134;9;1;1;1
258113344424;258113344558;134;9;1;1;1
258113344558;258113344677;119;9;1;1;1
258113344677;258113354833;10156;9;1;1;1
258113354833;258113362546;7713;9;1;1;1
258113362546;258113362621;75;9;1;1;1
258113362621;258113362778;157;9;1;1;1
258113362778;258113362818;40;9;1;1;1
258113362818;258113362896;78;9;1;1;1
258113362896;258113363035;139;9;1;1;1
258113363035;258113365668;2633;9;1;1;1
258113365668;258113365731;63;9;1;1;1
258113365731;258113366127;396;2,9;2;1;1
258113366127;258113366182;55;2,9;2;1;1
258113366182;258113366372;190;2,9;2;1;1
258113366372;258113366399;27;9;1;1;1
258113366399;258113366495;96;9;1;1;1
258113366495;258113366674;179;9;1;1;1
258113366674;258113368797;2123;9;1;1;1
258113368797;258113368845;48;9;1;1;1
258113368845;258113368906;61;9;1;1;1
258113368906;258113372872;3966;9;1;1;1
258113372872;258113373945;1073;9;1;1;1
258113373945;258113374099;154;9;1;1;1
258113374099;258113374275;176;9;1;1;1
258113374275;258113375656;1381;9;1;1;1
258113375656;258113375693;37;9;1;1;1
258113375693;258113375769;76;9;1;1;1
258113375769;258113382782;7013;9;1;1;1
258113382782;258113385711;2929;9;1;1;1
258113385711;258113385779;68;9;1;1;1
258113385779;258113385880;101;9;1;1;1
258113385880;258113388434;2554;9;1;1;1
258113388434;258113388593;159;9;1;1;1
258113388593;258113388619;26;9;1;1;1
258113388619;258113390560;1941;9;1;1;1
258113390560;258113398259;7699;9;1;1;1
258113398259;258113399608;1349;9;1;1;1
258113399608;258113399988;380;9;1;1;1
258113399988;258113400122;134;9;1;1;1
258113400122;258113400218;96;9;1;1;1
258113400218;258113400448;230;9;1;1;1
258113400448;258113400518;70;9;1;1;1
258113400518;258113400555;37;9;1;1;1
258113400555;258113400628;73;9;1;1;1
258113400628;258113408192;7564;9;1;1;1
258113408192;258113409056;864;9;1;1;1
258113409056;258113409139;83;9;1;1;1
258113409139;258113409330;191;9;1;1;1
258113409330;258113418912;9582;9;1;1;1
258113418912;258113419955;1043;9;1;1;1
258113419955;258113419987;32;9;1;1;1
258113419987;258113420059;72;9;1;1;1
258113420059;258113420117;58;9;1;1;1
258113420117;258113420155;38;9;1;1;1
258113420155;258113421124;969;9;1;1;1
258113421124;258113422401;1277;9;1;1;1
258113422401;258113422598;197;9;1;1;1
258113422598;258113422692;94;9;1;1;1
258113422692;258113422902;210;9;1;1;1
258113422902;258113424827;1925;9;1;1;1
258113424827;258113424847;20;9;1;1;1
258113424847;258113424867;20;9;1;1;1
258113424867;258113425025;158;9;1;1;1
258113425025;258113425237;212;9;1;1;1
258113425237;258113425372;135;9;1;1;1
258113425372;258113425733;361;9;1;1;1
258113425733;258113425856;123;9;1;1;1
258113425856;258113425899;43;9;1;1;1
258113425899;258113425942;43;9;1;1;1
258113425942;258113426055;113;9;1;1;1
258113426055;258113426307;252;9;1;1;1
258113426307;258113428159;1852;9;1;1;1
258113428159;258113428483;324;9;1;1;1
258113428483;258113428742;259;9;1;1;1
258113428742;258113428846;104;9;1;1;1
258113428846;258113428980;134;9;1;1;1
258113428980;258113429402;422;9;1;1;1
258113429402;258113438021;8619;9;1;1;1
258113438021;258113439009;988;9;1;1;1
258113439009;258113442381;3372;9;1;1;1
258113442381;258113470489;28108;9;1;1;1
258113470489;258113470547;58;9;1;1;1
258113470547;258113470675;128;9;1;1;1
258113470675;258113471057;382;9;1;1;1
258113471057;258113471177;120;9;1;1;1
258113471177;258113471223;46;9;1;1;1
258113471223;258113472129;906;9;1;1;1
258113472129;258113473057;928;2,9;2;1;1
258113473057;258113474477;1420;9;1;1;1
258113474477;258113480144;5667;9;1;1;1
258113480144;258113541220;61076;9;1;1;1
258113541220;258113544419;3199;2,9;2;1;1
258113544419;258113548514;4095;9;1;1;1
258113548514;258113549435;921;9;1;1;1
258113549435;258113550020;585;2,9;2;1;1
258113550020;258113550702;682;2,9;2;1;1
258113550702;258113551276;574;2,9;2;1;1
258113551276;258113551671;395;2,9;2;1;1
258113551671;258113551751;80;2,9;2;1;1
258113551751;258113552384;633;2,9;2;1;1
258113552384;258113554988;2604;2,9;2;1;1
258113554988;258113555835;847;2,9;2;1;1
258113555835;258113557364;1529;9;1;1;1
258113557364;258113557602;238;2,9;2;1;1
258113557602;258113558501;899;2,9;2;1;1
258113558501;258113559231;730;9;1;1;1
258113559231;258113559802;571;2,9;2;1;1
258113559802;258113559873;71;2,9;2;1;1
258113559873;258113559993;120;2,9;2;1;1
258113559993;258113562674;2681;2,9;2;1;1
258113562674;258113563390;716;2,9;2;1;1
258113563390;258113564178;788;2,9;2;1;1
258113564178;258113564664;486;9;1;1;1
258113564664;258113565432;768;2,9;2;1;1
258113565432;258113569601;4169;9;1;1;1
258113569601;258113570017;416;2,9;2;1;1
258113570017;258113571076;1059;2,9;2;1;1
258113571076;258113571781;705;2,9;2;1;1
258113571781;258113602109;30328;9;1;1;1
258113602109;258113610779;8670;9;1;1;1
258113610779;258113619992;9213;9;1;1;1
258113619992;258113621933;1941;2,9;2;1;1
258113621933;258113628457;6524;2,9;2;1;1
258113628457;258113628633;176;2,9;2;1;1
258113628633;258113640827;12194;2,9;2;1;1
258113640827;258113641283;456;2,9;2;1;1
258113641283;258113643559;2276;2,9;2;1;1
258113643559;258113647473;3914;2,9;2;1;1
258113647473;258113649620;2147;2,9;2;1;1
258113649620;258113651356;1736;2,9;2;1;1
258113651356;258113651783;427;2,9;2;1;1
258113651783;258113658811;7028;2,9;2;1;1
258113658811;258113664018;5207;2,9;2;1;1
258113664018;258113666523;2505;2,9;2;1;1
258113666523;258113666743;220;2,9;2;1;1
258113666743;258113666887;144;2,9;2;1;1
258113666887;258113667070;183;2,9;2;1;1
258113667070;258113667274;204;2,9;2;1;1
258113667274;258113669227;1953;2,9;2;1;1
258113669227;258113670389;1162;2,9;2;1;1
258113670389;258113672323;1934;2,9;2;1;1
258113672323;258113672493;170;2,9;2;1;1
258113672493;258113702018;29525;9;1;1;1
258113702018;258113704954;2936;9;1;1;1
258113704954;258113728123;23169;9;1;1;1
258113728123;258113739646;11523;2,9;2;1;1
258113739646;258113743030;3384;2,9;2;1;1
258113743030;258113756786;13756;2,9;2;1;1
258113756786;258113792518;35732;9;1;1;1
258113792518;258113793524;1006;2,9;2;1;1
258113793524;258113793976;452;2,9;2;1;1
258113793976;258113795085;1109;2,9;2;1;1
258113795085;258113796658;1573;9;1;1;1
258113796658;258113797875;1217;2,9;2;1;1
258113797875;258113797878;3;9;1;1;1
258113797878;258113799496;1618;2,9;2;1;1
258113799496;258113799922;426;9;1;1;1
258113799922;258113804755;4833;2,9;2;1;1
258113804755;258113805524;769;2,9;2;1;1
258113805524;258113807589;2065;2,9;2;1;1
258113807589;258113810119;2530;9;1;1;1
258113810119;258113812856;2737;9;1;1;1
258113812856;258113841523;28667;9;1;1;1
258113841523;258113842064;541;2,9;2;1;1
258113842064;258113846419;4355;9;1;1;1
258113846419;258113855105;8686;9;1;1;1
258113855105;258113871998;16893;9;1;1;1
258113871998;258113873323;1325;2,9;2;1;1
258113873323;258113876533;3210;9;1;1;1
258113876533;258113879096;2563;2,9;2;1;1
258113879096;258113879280;184;9;1;1;1
258113879280;258113881884;2604;2,9;2;1;1
258113881884;258113882747;863;2,9;2;1;1
258113882747;258113884205;1458;2,9;2;1;1
258113884205;258113884290;85;2,9;2;1;1
258113884290;258113884865;575;9;1;1;1
258113884865;258113885365;500;2,9;2;1;1
258113885365;258113886269;904;2,9;2;1;1
258113886269;258113886776;507;9;1;1;1
258113886776;258113888160;1384;2,9;2;1;1
258113888160;258113889739;1579;2,9;2;1;1
258113889739;258113890072;333;2,9;2;1;1
258113890072;258113891874;1802;9;1;1;1
258113891874;258113892401;527;2,9;2;1;1
258113892401;258113899466;7065;2,9;2;1;1
258113899466;258113899701;235;2,9;2;1;1
258113899701;258113901312;1611;9;1;1;1
258113901312;258113902714;1402;2,9;2;1;1
258113902714;258113933746;31032;9;1;1;1
258113933746;258113943230;9484;9;1;1;1
258113943230;258113944464;1234;9;1;1;1
258113944464;258113944540;76;9;1;1;1
258113944540;258113946337;1797;9;1;1;1
258113946337;258113946392;55;9;1;1;1
258113946392;258113946570;178;9;1;1;1
258113946570;258113955275;8705;9;1;1;1
258113955275;258113955741;466;2,9;2;1;1
258113955741;258113956446;705;2,9;2;1;1
258113956446;258113961075;4629;2,9;2;1;1
258113961075;258113961390;315;2,9;2;1;1
258113961390;258113962300;910;2,9;2;1;1
258113962300;258113962356;56;2,9;2;1;1
258113962356;258113963237;881;2,9;2;1;1
258113963237;258113964142;905;2,9;2;1;1
258113964142;258113967901;3759;2,9;2;1;1
258113967901;258113988976;21075;2,9;2;1;1
258113988976;258113989329;353;2,9;2;1;1
258113989329;258113989917;588;2,9;2;1;1
258113989917;258113994610;4693;2,9;2;1;1
258113994610;258113998803;4193;2,9;2;1;1
258113998803;258113999377;574;2,9;2;1;1
258113999377;258114002157;2780;2,9;2;1;1
258114002157;258114018014;15857;9;1;1;1
258114018014;258114026738;8724;9;1;1;1
258114026738;258114059916;33178;9;1;1;1
258114059916;258114061744;1828;2,9;2;1;1
258114061744;258114062611;867;2,9;2;1;1
258114062611;258114063188;577;2,9;2;1;1
258114063188;258114065451;2263;9;1;1;1
258114065451;258114067114;1663;2,9;2;1;1
258114067114;258114069052;1938;9;1;1;1
258114069052;258114071058;2006;2,9;2;1;1
258114071058;258114071573;515;9;1;1;1
258114071573;258114073995;2422;2,9;2;1;1
258114073995;258114076421;2426;2,9;2;1;1
258114076421;258114076528;107;2,9;2;1;1
258114076528;258114077243;715;2,9;2;1;1
258114077243;258114078353;1110;9;1;1;1
258114078353;258114079302;949;2,9;2;1;1
258114079302;258114081369;2067;2,9;2;1;1
258114081369;258114082558;1189;2,9;2;1;1
258114082558;258114083808;1250;2,9;2;1;1
258114083808;258114085555;1747;2,9;2;1;1
258114085555;258114085563;8;2,9;2;1;1
258114085563;258114086185;622;2,9;2;1;1
258114086185;258114089857;3672;2,9;2;1;1
258114089857;258114090657;800;9;1;1;1
258114090657;258114093260;2603;2,9;2;1;1
258114093260;258114093725;465;9;1;1;1
258114093725;258114095622;1897;2,9;2;1;1
258114095622;258114096052;430;2,9;2;1;1
258114096052;258114096531;479;2,9;2;1;1
258114096531;258114097589;1058;2,9;2;1;1
258114097589;258114098072;483;2,9;2;1;1
258114098072;258114145136;47064;9;1;1;1
258114145136;258114148211;3075;9;1;1;1
258114148211;258114153219;5008;2,9;2;1;1
258114153219;258114153855;636;2,9;2;1;1
258114153855;258114156768;2913;2,9;2;1;1
258114156768;258114161237;4469;2,9;2;1;1
258114161237;258114166428;5191;2,9;2;1;1
258114166428;258114169818;3390;2,9;2;1;1
258114169818;258114174802;4984;2,9;2;1;1
258114174802;258114179986;5184;2,9;2;1;1
258114179986;258114181542;1556;2,9;2;1;1
258114181542;258114184484;2942;2,9;2;1;1
258114184484;258114185012;528;2,9;2;1;1
258114185012;258114187148;2136;2,9;2;1;1
258114187148;258114187562;414;2,9;2;1;1
258114187562;258114189767;2205;2,9;2;1;1
258114189767;258114190932;1165;2,9;2;1;1
258114190932;258114191436;504;2,9;2;1;1
258114191436;258114192188;752;2,9;2;1;1
258114192188;258114193636;1448;9;1;1;1
258114193636;258114204521;10885;9;1;1;1
258114204521;258114213445;8924;9;1;1;1
258114213445;258114237479;24034;9;1;1;1
258114237479;258114237785;306;9;1;1;1
258114237785;258114238427;642;2,9;2;1;1
258114238427;258114246355;7928;9;1;1;1
258114246355;258114288517;42162;9;1;1;1
258114288517;258114289147;630;2,9;2;1;1
258114289147;258114325230;36083;9;1;1;1
258114325230;258114328218;2988;9;1;1;1
258114328218;258114361934;33716;9;1;1;1
258114361934;258114367947;6013;2,9;2;1;1
258114367947;258114369357;1410;2,9;2;1;1
258114369357;258114374502;5145;2,9;2;1;1
258114374502;258114377367;2865;2,9;2;1;1
258114377367;258114379834;2467;2,9;2;1;1
258114379834;258114380493;659;2,9;2;1;1
258114380493;258114383018;2525;2,9;2;1;1
258114383018;258114386431;3413;2,9;2;1;1
258114386431;258114399552;13121;2,9;2;1;1
258114399552;258114401823;2271;2,9;2;1;1
258114401823;258114405141;3318;2,9;2;1;1
258114405141;258114405584;443;2,9;2;1;1
258114405584;258114406717;1133;2,9;2;1;1
258114406717;258114407648;931;2,9;2;1;1
258114407648;258114408723;1075;2,9;2;1;1
258114408723;258114409645;922;2,9;2;1;1
258114409645;258114410668;1023;2,9;2;1;1
258114410668;258114410824;156;2,9;2;1;1
258114410824;258114411127;303;2,9;2;1;1
258114411127;258114411820;693;2,9;2;1;1
258114411820;258114413761;1941;9;1;1;1
258114413761;258114454538;40777;9;1;1;1
258114454538;258114455169;631;2,9;2;1;1
258114455169;258114458671;3502;9;1;1;1
258114458671;258114467377;8706;9;1;1;1
258114467377;258114494321;26944;9;1;1;1
258114494321;258114496396;2075;2,9;2;1;1
258114496396;258114498673;2277;9;1;1;1
258114498673;258114501091;2418;9;1;1;1
258114501091;258114504146;3055;2,9;2;1;1
258114504146;258114507435;3289;9;1;1;1
258114507435;258114507972;537;9;1;1;1
258114507972;258114509072;1100;2,9;2;1;1
258114509072;258114509509;437;9;1;1;1
258114509509;258114510502;993;2,9;2;1;1
258114510502;258114511421;919;2,9;2;1;1
258114511421;258114513854;2433;2,9;2;1;1
258114513854;258114513863;9;2,9;2;1;1
258114513863;258114514623;760;2,9;2;1;1
258114514623;258114514630;7;2,9;2;1;1
258114514630;258114519905;5275;2,9;2;1;1
258114519905;258114519923;18;2,9;2;1;1
258114519923;258114521411;1488;2,9;2;1;1
258114521411;258114523915;2504;9;1;1;1
258114523915;258114524564;649;2,9;2;1;1
258114524564;258114525441;877;9;1;1;1
258114525441;258114525981;540;2,9;2;1;1
258114525981;258114570979;44998;9;1;1;1
258114570979;258114573845;2866;2,9;2;1;1
258114573845;258114581706;7861;2,9;2;1;1
258114581706;258114581865;159;2,9;2;1;1
258114581865;258114582282;417;2,9;2;1;1
258114582282;258114582745;463;2,9;2;1;1
258114582745;258114590751;8006;2,9;2;1;1
258114590751;258114594269;3518;2,9;2;1;1
258114594269;258114596243;1974;2,9;2;1;1
258114596243;258114597822;1579;2,9;2;1;1
258114597822;258114600061;2239;2,9;2;1;1
258114600061;258114600356;295;2,9;2;1;1
258114600356;258114603898;3542;2,9;2;1;1
258114603898;258114604890;992;2,9;2;1;1
258114604890;258114605901;1011;2,9;2;1;1
258114605901;258114609162;3261;2,9;2;1;1
258114609162;258114613011;3849;2,9;2;1;1
258114613011;258114613645;634;2,9;2;1;1
258114613645;258114613865;220;2,9;2;1;1
258114613865;258114615944;2079;2,9;2;1;1
258114615944;258114618107;2163;2,9;2;1;1
258114618107;258114618716;609;2,9;2;1;1
258114618716;258114654632;35916;9;1;1;1
258114654632;258114663305;8673;9;1;1;1
258114663305;258114674766;11461;9;1;1;1
258114674766;258114676797;2031;2,9;2;1;1
258114676797;258114679664;2867;2,9;2;1;1
258114679664;258114684586;4922;2,9;2;1;1
258114684586;258114685479;893;2,9;2;1;1
258114685479;258114693156;7677;2,9;2;1;1
258114693156;258114697162;4006;2,9;2;1;1
258114697162;258114698561;1399;2,9;2;1;1
258114698561;258114700874;2313;2,9;2;1;1
258114700874;258114703505;2631;2,9;2;1;1
258114703505;258114703673;168;2,9;2;1;1
258114703673;258114705847;2174;2,9;2;1;1
258114705847;258114706359;512;2,9;2;1;1
258114706359;258114712433;6074;2,9;2;1;1
258114712433;258114713405;972;2,9;2;1;1
258114713405;258114714745;1340;2,9;2;1;1
258114714745;258114716336;1591;2,9;2;1;1
258114716336;258114718691;2355;2,9;2;1;1
258114718691;258114722411;3720;2,9;2;1;1
258114722411;258114723107;696;2,9;2;1;1
258114723107;258114723726;619;2,9;2;1;1
258114723726;258114724342;616;2,9;2;1;1
258114724342;258114725118;776;2,9;2;1;1
258114725118;258114726369;1251;2,9;2;1;1
258114726369;258114778435;52066;9;1;1;1
258114778435;258114781048;2613;9;1;1;1
258114781048;258114791065;10017;9;1;1;1
258114791065;258114791692;627;2,9;2;1;1
258114791692;258114797055;5363;9;1;1;1
258114797055;258114805802;8747;9;1;1;1
258114805802;258114823181;17379;9;1;1;1
258114823181;258114824470;1289;2,9;2;1;1
258114824470;258114827679;3209;9;1;1;1
258114827679;258114830034;2355;2,9;2;1;1
258114830034;258114830917;883;2,9;2;1;1
258114830917;258114832134;1217;2,9;2;1;1
258114832134;258114832166;32;9;1;1;1
258114832166;258114833492;1326;2,9;2;1;1
258114833492;258114834336;844;2,9;2;1;1
258114834336;258114836004;1668;2,9;2;1;1
258114836004;258114837322;1318;9;1;1;1
258114837322;258114839491;2169;2,9;2;1;1
258114839491;258114840750;1259;2,9;2;1;1
258114840750;258114846039;5289;2,9;2;1;1
258114846039;258114847370;1331;2,9;2;1;1
258114847370;258114848743;1373;2,9;2;1;1
258114848743;258114852172;3429;2,9;2;1;1
258114852172;258114854717;2545;2,9;2;1;1
258114854717;258114856146;1429;2,9;2;1;1
258114856146;258114857225;1079;2,9;2;1;1
258114857225;258114898267;41042;9;1;1;1
258114898267;258114900603;2336;2,9;2;1;1
258114900603;258114913974;13371;2,9;2;1;1
258114913974;258114917563;3589;2,9;2;1;1
258114917563;258114919641;2078;2,9;2;1;1
258114919641;258114919958;317;2,9;2;1;1
258114919958;258114920760;802;2,9;2;1;1
258114920760;258114922035;1275;2,9;2;1;1
258114922035;258114924049;2014;2,9;2;1;1
258114924049;258114924698;649;2,9;2;1;1
258114924698;258114928820;4122;2,9;2;1;1
258114928820;258114929512;692;2,9;2;1;1
258114929512;258114929568;56;2,9;2;1;1
258114929568;258114930401;833;9;1;1;1
258114930401;258114932908;2507;9;1;1;1
258114932908;258114945461;12553;2,9;2;1;1
258114945461;258114945636;175;2,9;2;1;1
258114945636;258114946265;629;2,9;2;1;1
258114946265;258114946876;611;2,9;2;1;1
258114946876;258114947402;526;2,9;2;1;1
258114947402;258114948400;998;2,9;2;1;1
258114948400;258114948573;173;2,9;2;1;1
258114948573;258114984187;35614;9;1;1;1
258114984187;258114996592;12405;9;1;1;1
258114996592;258115021086;24494;9;1;1;1
258115021086;258115021633;547;2,9;2;1;1
258115021633;258115031002;9369;9;1;1;1
258115031002;258115039591;8589;9;1;1;1
258115039591;258115060396;20805;9;1;1;1
258115060396;258115061550;1154;2,9;2;1;1
258115061550;258115065676;4126;9;1;1;1
258115065676;258115066495;819;2,9;2;1;1
258115066495;258115068753;2258;2,9;2;1;1
258115068753;258115069709;956;2,9;2;1;1
258115069709;258115070688;979;9;1;1;1
258115070688;258115070797;109;2,9;2;1;1
258115070797;258115073749;2952;2,9;2;1;1
258115073749;258115073842;93;2,9;2;1;1
258115073842;258115074581;739;2,9;2;1;1
258115074581;258115076470;1889;2,9;2;1;1
258115076470;258115076627;157;2,9;2;1;1
258115076627;258115077251;624;2,9;2;1;1
258115077251;258115078829;1578;2,9;2;1;1
258115078829;258115079735;906;9;1;1;1
258115079735;258115080724;989;9;1;1;1
258115080724;258115081876;1152;2,9;2;1;1
258115081876;258115082250;374;2,9;2;1;1
258115082250;258115083904;1654;2,9;2;1;1
258115083904;258115084282;378;2,9;2;1;1
258115084282;258115085282;1000;2,9;2;1;1
258115085282;258115086869;1587;2,9;2;1;1
258115086869;258115087571;702;2,9;2;1;1
258115087571;258115090061;2490;2,9;2;1;1
258115090061;258115090329;268;2,9;2;1;1
258115090329;258115091729;1400;2,9;2;1;1
258115091729;258115092717;988;2,9;2;1;1
258115092717;258115093024;307;2,9;2;1;1
258115093024;258115093743;719;2,9;2;1;1
258115093743;258115096647;2904;9;1;1;1
258115096647;258115097525;878;2,9;2;1;1
258115097525;258115098430;905;9;1;1;1
258115098430;258115098976;546;2,9;2;1;1
258115098976;258115137422;38446;9;1;1;1
258115137422;258115144228;6806;9;1;1;1
258115144228;258115145298;1070;2,9;2;1;1
258115145298;258115146698;1400;2,9;2;1;1
258115146698;258115147619;921;2,9;2;1;1
258115147619;258115154395;6776;2,9;2;1;1
258115154395;258115162864;8469;2,9;2;1;1
258115162864;258115169109;6245;2,9;2;1;1
258115169109;258115172526;3417;2,9;2;1;1
258115172526;258115172995;469;2,9;2;1;1
258115172995;258115173296;301;2,9;2;1;1
258115173296;258115174086;790;2,9;2;1;1
258115174086;258115175058;972;2,9;2;1;1
258115175058;258115176098;1040;2,9;2;1;1
258115176098;258115176440;342;2,9;2;1;1
258115176440;258115178740;2300;2,9;2;1;1
258115178740;258115181033;2293;2,9;2;1;1
258115181033;258115182146;1113;2,9;2;1;1
258115182146;258115182506;360;2,9;2;1;1
258115182506;258115187814;5308;2,9;2;1;1
258115187814;258115188182;368;2,9;2;1;1
258115188182;258115193454;5272;2,9;2;1;1
258115193454;258115193918;464;2,9;2;1;1
258115193918;258115195056;1138;2,9;2;1;1
258115195056;258115214086;19030;9;1;1;1
258115214086;258115216915;2829;9;1;1;1
258115216915;258115217281;366;9;1;1;1
258115217281;258115217474;193;9;1;1;1
258115217474;258115219908;2434;9;1;1;1
258115219908;258115221412;1504;9;1;1;1
258115221412;258115242618;21206;9;1;1;1
258115242618;258115245272;2654;9;1;1;1
258115245272;258115264596;19324;9;1;1;1
258115264596;258115269601;5005;2,9;2;1;1
258115269601;258115270917;1316;2,9;2;1;1
258115270917;258115282487;11570;2,9;2;1;1
258115282487;258115284126;1639;2,9;2;1;1
258115284126;258115285348;1222;2,9;2;1;1
258115285348;258115289934;4586;2,9;2;1;1
258115289934;258115290297;363;2,9;2;1;1
258115290297;258115293263;2966;2,9;2;1;1
258115293263;258115294260;997;2,9;2;1;1
258115294260;258115296793;2533;2,9;2;1;1
258115296793;258115299435;2642;2,9;2;1;1
258115299435;258115301563;2128;2,9;2;1;1
258115301563;258115302268;705;2,9;2;1;1
258115302268;258115302854;586;2,9;2;1;1
258115302854;258115303097;243;2,9;2;1;1
258115303097;258115306664;3567;2,9;2;1;1
258115306664;258115306774;110;2,9;2;1;1
258115306774;258115320302;13528;2,9;2;1;1
258115320302;258115320546;244;2,9;2;1;1
258115320546;258115321692;1146;2,9;2;1;1
258115321692;258115323139;1447;2,9;2;1;1
258115323139;258115326603;3464;9;1;1;1
258115326603;258115335476;8873;9;1;1;1
258115335476;258115360150;24674;9;1;1;1
258115360150;258115360711;561;2,9;2;1;1
258115360711;258115362629;1918;9;1;1;1
258115362629;258115371507;8878;9;1;1;1
258115371507;258115397996;26489;9;1;1;1
258115397996;258115399079;1083;2,9;2;1;1
258115399079;258115400036;957;9;1;1;1
258115400036;258115401294;1258;2,9;2;1;1
258115401294;258115403559;2265;9;1;1;1
258115403559;258115405344;1785;9;1;1;1
258115405344;258115405817;473;2,9;2;1;1
258115405817;258115406490;673;2,9;2;1;1
258115406490;258115408811;2321;2,9;2;1;1
258115408811;258115409173;362;2,9;2;1;1
258115409173;258115409689;516;9;1;1;1
258115409689;258115410235;546;2,9;2;1;1
258115410235;258115411136;901;2,9;2;1;1
258115411136;258115411818;682;2,9;2;1;1
258115411818;258115412474;656;9;1;1;1
258115412474;258115415440;2966;9;1;1;1
258115415440;258115418061;2621;9;1;1;1
258115418061;258115419004;943;2,9;2;1;1
258115419004;258115420553;1549;9;1;1;1
258115420553;258115421574;1021;2,9;2;1;1
258115421574;258115422269;695;2,9;2;1;1
258115422269;258115422818;549;2,9;2;1;1
258115422818;258115431885;9067;9;1;1;1
258115431885;258115433923;2038;2,9;2;1;1
258115433923;258115436229;2306;2,9;2;1;1
258115436229;258115437415;1186;2,9;2;1;1
258115437415;258115437940;525;2,9;2;1;1
258115437940;258115438150;210;2,9;2;1;1
258115438150;258115438728;578;2,9;2;1;1
258115438728;258115439621;893;2,9;2;1;1
258115439621;258115439743;122;2,9;2;1;1
258115439743;258115440710;967;2,9;2;1;1
258115440710;258115441244;534;2,9;2;1;1
258115441244;258115441535;291;2,9;2;1;1
258115441535;258115442179;644;9;1;1;1
258115442179;258115442326;147;2,9;2;1;1
258115442326;258115443246;920;2,9;2;1;1
258115443246;258115443391;145;2,9;2;1;1
258115443391;258115443535;144;2,9;2;1;1
258115443535;258115452666;9131;9;1;1;1
258115452666;258115454295;1629;9;1;1;1
258115454295;258115456365;2070;9;1;1;1
258115456365;258115464757;8392;9;1;1;1
258115464757;258115465761;1004;9;1;1;1
258115465761;258115465917;156;9;1;1;1
258115465917;258115466153;236;9;1;1;1
258115466153;258115467749;1596;9;1;1;1
258115467749;258115475829;8080;9;1;1;1
258115475829;258115476180;351;9;1;1;1
258115476180;258115477803;1623;9;1;1;1
258115477803;258115481076;3273;2,9;2;1;1
258115481076;258115481213;137;2,9;2;1;1
258115481213;258115482839;1626;2,9;2;1;1
258115482839;258115483590;751;2,9;2;1;1
258115483590;258115483865;275;2,9;2;1;1
258115483865;258115484086;221;2,9;2;1;1
258115484086;258115484242;156;2,9;2;1;1
258115484242;258115487785;3543;2,9;2;1;1
258115487785;258115493034;5249;2,9;2;1;1
258115493034;258115495621;2587;2,9;2;1;1
258115495621;258115503228;7607;2,9;2;1;1
258115503228;258115503790;562;2,9;2;1;1
258115503790;258115508686;4896;2,9;2;1;1
258115508686;258115509255;569;2,9;2;1;1
258115509255;258115516461;7206;2,9;2;1;1
258115516461;258115517075;614;2,9;2;1;1
258115517075;258115518865;1790;2,9;2;1;1
258115518865;258115519325;460;2,9;2;1;1
258115519325;258115520485;1160;2,9;2;1;1
258115520485;258115521585;1100;2,9;2;1;1
258115521585;258115522145;560;2,9;2;1;1
258115522145;258115523259;1114;2,9;2;1;1
258115523259;258115524028;769;2,9;2;1;1
258115524028;258115524706;678;2,9;2;1;1
258115524706;258115530450;5744;2,9;2;1;1
258115530450;258115530536;86;2,9;2;1;1
258115530536;258115531263;727;2,9;2;1;1
258115531263;258115533658;2395;9;1;1;1
258115533658;258115564333;30675;9;1;1;1
258115564333;258115566090;1757;9;1;1;1
258115566090;258115573436;7346;9;1;1;1
258115573436;258115574443;1007;9;1;1;1
258115574443;258115575055;612;9;1;1;1
258115575055;258115582862;7807;9;1;1;1
258115582862;258115629905;47043;9;1;1;1
258115629905;258115634595;4690;2,9;2;1;1
258115634595;258115642513;7918;9;1;1;1
258115642513;258115642784;271;9;1;1;1
258115642784;258115651733;8949;9;1;1;1
258115651733;258115652304;571;9;1;1;1
258115652304;258115652582;278;9;1;1;1
258115652582;258115661079;8497;9;1;1;1
258115661079;258115686507;25428;9;1;1;1
258115686507;258115687128;621;2,9;2;1;1
258115687128;258115702231;15103;9;1;1;1
258115702231;258115707419;5188;9;1;1;1
258115707419;258115765983;58564;9;1;1;1
258115765983;258115766598;615;2,9;2;1;1
258115766598;258115771370;4772;9;1;1;1
258115771370;258115780082;8712;9;1;1;1
258115780082;258115809593;29511;9;1;1;1
258115809593;258115812793;3200;9;1;1;1
258115812793;258115816850;4057;2,9;2;1;1
258115816850;258115818929;2079;9;1;1;1
258115818929;258115851544;32615;9;1;1;1
258115851544;258115854335;2791;9;1;1;1
258115854335;258115891413;37078;9;1;1;1
258115891413;258115895241;3828;9;1;1;1
258115895241;258115896013;772;9;1;1;1
258115896013;258115896248;235;9;1;1;1
258115896248;258115896430;182;9;1;1;1
258115896430;258115898011;1581;2,9;2;1;1
258115898011;258115899101;1090;9;1;1;1
258115899101;258115899489;388;9;1;1;1
258115899489;258115899938;449;2,9;2;1;1
258115899938;258115901263;1325;2,9;2;1;1
258115901263;258115901656;393;2,9;2;1;1
258115901656;258115902333;677;2,9;2;1;1
258115902333;258115902444;111;9;1;1;1
258115902444;258115903192;748;9;1;1;1
258115903192;258115903530;338;9;1;1;1
258115903530;258115903554;24;9;1;1;1
258115903554;258115904830;1276;2,9;2;1;1
258115904830;258115906038;1208;9;1;1;1
258115906038;258115906230;192;2,9;2;1;1
258115906230;258115906480;250;2,9;2;1;1
258115906480;258115907204;724;2,9;2;1;1
258115907204;258115907887;683;9;1;1;1
258115907887;258115910070;2183;9;1;1;1
258115910070;258115910181;111;9;1;1;1
258115910181;258115911874;1693;2,9;2;1;1
258115911874;258115912970;1096;2,9;2;1;1
258115912970;258115913746;776;9;1;1;1
258115913746;258115914733;987;2,9;2;1;1
258115914733;258115915913;1180;2,9;2;1;1
258115915913;258115918314;2401;2,9;2;1;1
258115918314;258115918480;166;2,9;2;1;1
258115918480;258115919045;565;2,9;2;1;1
258115919045;258115919270;225;2,9;2;1;1
258115919270;258115922115;2845;2,9;2;1;1
258115922115;258115922459;344;9;1;1;1
258115922459;258115923007;548;2,9;2;1;1
258115923007;258115923958;951;2,9;2;1;1
258115923958;258115926318;2360;2,9;2;1;1
258115926318;258115926616;298;2,9;2;1;1
258115926616;258115928968;2352;2,9;2;1;1
258115928968;258115929613;645;2,9;2;1;1
258115929613;258115933641;4028;2,9;2;1;1
258115933641;258115936485;2844;9;1;1;1
258115936485;258115936586;101;2,9;2;1;1
258115936586;258115937723;1137;2,9;2;1;1
258115937723;258115938176;453;2,9;2;1;1
258115938176;258115944357;6181;9;1;1;1
258115944357;258115944658;301;2,9;2;1;1
258115944658;258115946037;1379;2,9;2;1;1
258115946037;258115947271;1234;9;1;1;1
258115947271;258115983190;35919;9;1;1;1
258115983190;258115986029;2839;2,9;2;1;1
258115986029;258115991089;5060;2,9;2;1;1
258115991089;258115994610;3521;2,9;2;1;1
258115994610;258115998562;3952;2,9;2;1;1
258115998562;258116000487;1925;2,9;2;1;1
258116000487;258116005960;5473;2,9;2;1;1
258116005960;258116008285;2325;2,9;2;1;1
258116008285;258116012213;3928;2,9;2;1;1
258116012213;258116012989;776;2,9;2;1;1
258116012989;258116015353;2364;2,9;2;1;1
258116015353;258116023154;7801;2,9;2;1;1
258116023154;258116025130;1976;2,9;2;1;1
258116025130;258116025737;607;2,9;2;1;1
258116025737;258116028507;2770;2,9;2;1;1
258116028507;258116029334;827;2,9;2;1;1
258116029334;258116029821;487;2,9;2;1;1
258116029821;258116030321;500;2,9;2;1;1
258116030321;258116030929;608;2,9;2;1;1
258116030929;258116031599;670;2,9;2;1;1
258116031599;258116032841;1242;2,9;2;1;1
258116032841;258116035113;2272;2,9;2;1;1
258116035113;258116043664;8551;2,9;2;1;1
258116043664;258116044250;586;2,9;2;1;1
258116044250;258116079157;34907;9;1;1;1
258116079157;258116080299;1142;9;1;1;1
258116080299;258116082213;1914;9;1;1;1
258116082213;258116084611;2398;9;1;1;1
258116084611;258116089806;5195;9;1;1;1
258116089806;258116089947;141;9;1;1;1
258116089947;258116090770;823;9;1;1;1
258116090770;258116091223;453;9;1;1;1
258116091223;258116091633;410;9;1;1;1
258116091633;258116092935;1302;9;1;1;1
258116092935;258116097979;5044;9;1;1;1
258116097979;258116100347;2368;2,9;2;1;1
258116100347;258116111635;11288;2,9;2;1;1
258116111635;258116112016;381;2,9;2;1;1
258116112016;258116114017;2001;2,9;2;1;1
258116114017;258116118257;4240;2,9;2;1;1
258116118257;258116119651;1394;2,9;2;1;1
258116119651;258116120616;965;2,9;2;1;1
258116120616;258116124877;4261;2,9;2;1;1
258116124877;258116125085;208;2,9;2;1;1
258116125085;258116126357;1272;2,9;2;1;1
258116126357;258116128314;1957;2,9;2;1;1
258116128314;258116128389;75;2,9;2;1;1
258116128389;258116130042;1653;2,9;2;1;1
258116130042;258116130191;149;2,9;2;1;1
258116130191;258116135024;4833;2,9;2;1;1
258116135024;258116136753;1729;2,9;2;1;1
258116136753;258116142589;5836;2,9;2;1;1
258116142589;258116144665;2076;2,9;2;1;1
258116144665;258116145327;662;2,9;2;1;1
258116145327;258116145369;42;2,9;2;1;1
258116145369;258116145521;152;2,9;2;1;1
258116145521;258116146093;572;2,9;2;1;1
258116146093;258116146352;259;2,9;2;1;1
258116146352;258116146750;398;2,9;2;1;1
258116146750;258116146999;249;2,9;2;1;1
258116146999;258116147183;184;2,9;2;1;1
258116147183;258116148087;904;2,9;2;1;1
258116148087;258116152184;4097;9;1;1;1
258116152184;258116153291;1107;9;1;1;1
258116153291;258116167231;13940;9;1;1;1
258116167231;258116175532;8301;9;1;1;1
258116175532;258116208650;33118;9;1;1;1
258116208650;258116210762;2112;2,9;2;1;1
258116210762;258116223053;12291;2,9;2;1;1
258116223053;258116223409;356;2,9;2;1;1
258116223409;258116229018;5609;2,9;2;1;1
258116229018;258116230325;1307;2,9;2;1;1
258116230325;258116238058;7733;2,9;2;1;1
258116238058;258116239916;1858;2,9;2;1;1
258116239916;258116245067;5151;2,9;2;1;1
258116245067;258116246022;955;2,9;2;1;1
258116246022;258116246709;687;2,9;2;1;1
258116246709;258116247152;443;2,9;2;1;1
258116247152;258116247445;293;2,9;2;1;1
258116247445;258116247661;216;2,9;2;1;1
258116247661;258116248393;732;9;1;1;1
258116248393;258116249736;1343;2,9;2;1;1
258116249736;258116249983;247;2,9;2;1;1
258116249983;258116251550;1567;2,9;2;1;1
258116251550;258116252007;457;2,9;2;1;1
258116252007;258116252927;920;2,9;2;1;1
258116252927;258116274111;21184;9;1;1;1
258116274111;258116276745;2634;9;1;1;1
258116276745;258116320766;44021;9;1;1;1
258116320766;258116329549;8783;9;1;1;1
258116329549;258116356447;26898;9;1;1;1
258116356447;258116358623;2176;2,9;2;1;1
258116358623;258116358774;151;9;1;1;1
258116358774;258116359799;1025;2,9;2;1;1
258116359799;258116362496;2697;9;1;1;1
258116362496;258116362938;442;9;1;1;1
258116362938;258116364755;1817;2,9;2;1;1
258116364755;258116365381;626;2,9;2;1;1
258116365381;258116366591;1210;2,9;2;1;1
258116366591;258116367371;780;2,9;2;1;1
258116367371;258116368218;847;2,9;2;1;1
258116368218;258116368261;43;2,9;2;1;1
258116368261;258116368745;484;2,9;2;1;1
258116368745;258116369693;948;2,9;2;1;1
258116369693;258116370332;639;9;1;1;1
258116370332;258116372544;2212;2,9;2;1;1
258116372544;258116374921;2377;2,9;2;1;1
258116374921;258116376291;1370;2,9;2;1;1
258116376291;258116377126;835;2,9;2;1;1
258116377126;258116377464;338;2,9;2;1;1
258116377464;258116381634;4170;9;1;1;1
258116381634;258116383093;1459;2,9;2;1;1
258116383093;258116384933;1840;2,9;2;1;1
258116384933;258116385039;106;2,9;2;1;1
258116385039;258116385992;953;2,9;2;1;1
258116385992;258116386627;635;2,9;2;1;1
258116386627;258116386887;260;9;1;1;1
258116386887;258116387536;649;2,9;2;1;1
258116387536;258116398424;10888;9;1;1;1
258116398424;258116399143;719;2,9;2;1;1
258116399143;258116400006;863;2,9;2;1;1
258116400006;258116400316;310;2,9;2;1;1
258116400316;258116400396;80;2,9;2;1;1
258116400396;258116401092;696;2,9;2;1;1
258116401092;258116401236;144;2,9;2;1;1
258116401236;258116401674;438;2,9;2;1;1
258116401674;258116401788;114;2,9;2;1;1
258116401788;258116402655;867;2,9;2;1;1
258116402655;258116433573;30918;9;1;1;1
258116433573;258116436308;2735;9;1;1;1
258116436308;258116453743;17435;9;1;1;1
258116453743;258116457536;3793;2,9;2;1;1
258116457536;258116468682;11146;2,9;2;1;1
258116468682;258116476688;8006;2,9;2;1;1
258116476688;258116478783;2095;2,9;2;1;1
258116478783;258116479383;600;2,9;2;1;1
258116479383;258116483774;4391;2,9;2;1;1
258116483774;258116484994;1220;2,9;2;1;1
258116484994;258116485388;394;2,9;2;1;1
258116485388;258116485975;587;2,9;2;1;1
258116485975;258116487607;1632;2,9;2;1;1
258116487607;258116487886;279;2,9;2;1;1
258116487886;258116488104;218;2,9;2;1;1
258116488104;258116488981;877;2,9;2;1;1
258116488981;258116489252;271;2,9;2;1;1
258116489252;258116489571;319;2,9;2;1;1
258116489571;258116490840;1269;2,9;2;1;1
258116490840;258116491088;248;2,9;2;1;1
258116491088;258116491337;249;2,9;2;1;1
258116491337;258116492266;929;2,9;2;1;1
258116492266;258116493139;873;2,9;2;1;1
258116493139;258116493240;101;2,9;2;1;1
258116493240;258116493944;704;2,9;2;1;1
258116493944;258116494381;437;2,9;2;1;1
258116494381;258116494869;488;2,9;2;1;1
258116494869;258116495634;765;9;1;1;1
258116495634;258116496178;544;2,9;2;1;1
258116496178;258116498590;2412;9;1;1;1
258116498590;258116499559;969;9;1;1;1
258116499559;258116499939;380;9;1;1;1
258116499939;258116538155;38216;9;1;1;1
258116538155;258116546808;8653;9;1;1;1
258116546808;258116561832;15024;9;1;1;1
258116561832;258116563638;1806;2,9;2;1;1
258116563638;258116569250;5612;2,9;2;1;1
258116569250;258116577230;7980;2,9;2;1;1
258116577230;258116578054;824;2,9;2;1;1
258116578054;258116580482;2428;2,9;2;1;1
258116580482;258116580625;143;2,9;2;1;1
258116580625;258116580703;78;2,9;2;1;1
258116580703;258116581896;1193;2,9;2;1;1
258116581896;258116584911;3015;2,9;2;1;1
258116584911;258116595345;10434;2,9;2;1;1
258116595345;258116595424;79;2,9;2;1;1
258116595424;258116595753;329;2,9;2;1;1
258116595753;258116596019;266;2,9;2;1;1
258116596019;258116596569;550;2,9;2;1;1
258116596569;258116597253;684;2,9;2;1;1
258116597253;258116598029;776;2,9;2;1;1
258116598029;258116599573;1544;2,9;2;1;1
258116599573;258116601786;2213;2,9;2;1;1
258116601786;258116610803;9017;2,9;2;1;1
258116610803;258116614903;4100;9;1;1;1
258116614903;258116617782;2879;9;1;1;1
258116617782;258116659890;42108;9;1;1;1
258116659890;258116669593;9703;9;1;1;1
258116669593;258116681581;11988;9;1;1;1
258116681581;258116690185;8604;2,9;2;1;1
258116690185;258116691825;1640;2,9;2;1;1
258116691825;258116696474;4649;2,9;2;1;1
258116696474;258116701302;4828;2,9;2;1;1
258116701302;258116706367;5065;2,9;2;1;1
258116706367;258116706378;11;2,9;2;1;1
258116706378;258116706921;543;2,9;2;1;1
258116706921;258116712104;5183;2,9;2;1;1
258116712104;258116713874;1770;2,9;2;1;1
258116713874;258116714508;634;2,9;2;1;1
258116714508;258116715092;584;2,9;2;1;1
258116715092;258116716107;1015;2,9;2;1;1
258116716107;258116719361;3254;2,9;2;1;1
258116719361;258116721374;2013;2,9;2;1;1
258116721374;258116721526;152;2,9;2;1;1
258116721526;258116723396;1870;2,9;2;1;1
258116723396;258116724255;859;2,9;2;1;1
258116724255;258116724468;213;2,9;2;1;1
258116724468;258116726566;2098;2,9;2;1;1
258116726566;258116774260;47694;9;1;1;1
258116774260;258116775408;1148;2,9;2;1;1
258116775408;258116824630;49222;9;1;1;1
258116824630;258116825510;880;2,9;2;1;1
258116825510;258116872684;47174;9;1;1;1
258116872684;258116877319;4635;9;1;1;1
258116877319;258116878101;782;9;1;1;1
258116878101;258116884304;6203;9;1;1;1
258116884304;258116884377;73;9;1;1;1
258116884377;258116884663;286;9;1;1;1
258116884663;258116884697;34;9;1;1;1
258116884697;258116885717;1020;9;1;1;1
258116885717;258116894513;8796;9;1;1;1
258116894513;258116897117;2604;9;1;1;1
258116897117;258116902524;5407;9;1;1;1
258116902524;258116902599;75;2,9;2;1;1
258116902599;258116903131;532;2,9;2;1;1
258116903131;258116904197;1066;9;1;1;1
258116904197;258116915943;11746;9;1;1;1
258116915943;258116917166;1223;9;1;1;1
258116917166;258116917731;565;9;1;1;1
258116917731;258116917749;18;9;1;1;1
258116917749;258116949049;31300;9;1;1;1
258116949049;258116949610;561;2,9;2;1;1
258116949610;258116986167;36557;9;1;1;1
258116986167;258116987712;1545;2,9;2;1;1
258116987712;258116988516;804;9;1;1;1
258116988516;258116989799;1283;2,9;2;1;1
258116989799;258116992399;2600;9;1;1;1
258116992399;258116993419;1020;9;1;1;1
258116993419;258116993819;400;2,9;2;1;1
258116993819;258116995577;1758;2,9;2;1;1
258116995577;258116996627;1050;2,9;2;1;1
258116996627;258116997141;514;2,9;2;1;1
258116997141;258116997535;394;2,9;2;1;1
258116997535;258116998278;743;2,9;2;1;1
258116998278;258116998753;475;2,9;2;1;1
258116998753;258116999593;840;9;1;1;1
258116999593;258117001024;1431;2,9;2;1;1
258117001024;258117001196;172;2,9;2;1;1
258117001196;258117007924;6728;9;1;1;1
258117007924;258117009607;1683;2,9;2;1;1
258117009607;258117010548;941;9;1;1;1
258117010548;258117011170;622;2,9;2;1;1
258117011170;258117018769;7599;9;1;1;1
258117018769;258117028179;9410;9;1;1;1
258117028179;258117059003;30824;9;1;1;1
258117059003;258117059540;537;2,9;2;1;1
258117059540;258117059886;346;2,9;2;1;1
258117059886;258117060296;410;2,9;2;1;1
258117060296;258117063678;3382;2,9;2;1;1
258117063678;258117072483;8805;2,9;2;1;1
258117072483;258117073498;1015;2,9;2;1;1
258117073498;258117078589;5091;2,9;2;1;1
258117078589;258117083298;4709;2,9;2;1;1
258117083298;258117084982;1684;2,9;2;1;1
258117084982;258117085776;794;2,9;2;1;1
258117085776;258117091427;5651;2,9;2;1;1
258117091427;258117092691;1264;2,9;2;1;1
258117092691;258117101320;8629;2,9;2;1;1
258117101320;258117102363;1043;2,9;2;1;1
258117102363;258117103924;1561;2,9;2;1;1
258117103924;258117104641;717;2,9;2;1;1
258117104641;258117108406;3765;2,9;2;1;1
258117108406;258117111597;3191;2,9;2;1;1
258117111597;258117111607;10;2,9;2;1;1
258117111607;258117111832;225;2,9;2;1;1
258117111832;258117113086;1254;2,9;2;1;1
258117113086;258117113213;127;2,9;2;1;1
258117113213;258117113927;714;2,9;2;1;1
258117113927;258117148430;34503;9;1;1;1
258117148430;258117151487;3057;9;1;1;1
258117151487;258117158760;7273;9;1;1;1
258117158760;258117162637;3877;2,9;2;1;1
258117162637;258117164598;1961;2,9;2;1;1
258117164598;258117168530;3932;2,9;2;1;1
258117168530;258117174454;5924;2,9;2;1;1
258117174454;258117178966;4512;2,9;2;1;1
258117178966;258117180890;1924;2,9;2;1;1
258117180890;258117187820;6930;2,9;2;1;1
258117187820;258117188297;477;2,9;2;1;1
258117188297;258117190689;2392;2,9;2;1;1
258117190689;258117192167;1478;2,9;2;1;1
258117192167;258117196120;3953;2,9;2;1;1
258117196120;258117196754;634;2,9;2;1;1
258117196754;258117197941;1187;2,9;2;1;1
258117197941;258117199394;1453;2,9;2;1;1
258117199394;258117199801;407;2,9;2;1;1
258117199801;258117206656;6855;2,9;2;1;1
258117206656;258117210389;3733;2,9;2;1;1
258117210389;258117210553;164;2,9;2;1;1
258117210553;258117210824;271;2,9;2;1;1
258117210824;258117210982;158;2,9;2;1;1
258117210982;258117211707;725;2,9;2;1;1
258117211707;258117230306;18599;9;1;1;1
258117230306;258117239745;9439;9;1;1;1
258117239745;258117257893;18148;9;1;1;1
258117257893;258117258505;612;2,9;2;1;1
258117258505;258117268927;10422;9;1;1;1
258117268927;258117277988;9061;9;1;1;1
258117277988;258117290763;12775;9;1;1;1
258117290763;258117292084;1321;2,9;2;1;1
258117292084;258117300465;8381;9;1;1;1
258117300465;258117301522;1057;9;1;1;1
258117301522;258117302218;696;9;1;1;1
258117302218;258117303332;1114;9;1;1;1
258117303332;258117311377;8045;9;1;1;1
258117311377;258117311770;393;9;1;1;1
258117311770;258117330745;18975;9;1;1;1
258117330745;258117332227;1482;9;1;1;1
258117332227;258117340394;8167;9;1;1;1
258117340394;258117340798;404;9;1;1;1
258117340798;258117370601;29803;9;1;1;1
258117370601;258117371252;651;2,9;2;1;1
258117371252;258117419147;47895;9;1;1;1
258117419147;258117419716;569;2,9;2;1;1
258117419716;258117456995;37279;9;1;1;1
258117456995;258117457558;563;2,9;2;1;1
258117457558;258117492998;35440;9;1;1;1
258117492998;258117493728;730;2,9;2;1;1
258117493728;258117618787;125059;9;1;1;1
258117618787;258117620564;1777;2,9;2;1;1
258117620564;258117620798;234;9;1;1;1
258117620798;258117622790;1992;2,9;2;1;1
258117622790;258117623620;830;9;1;1;1
258117623620;258117624884;1264;2,9;2;1;1
258117624884;258117626279;1395;9;1;1;1
258117626279;258117629096;2817;2,9;2;1;1
258117629096;258117631446;2350;9;1;1;1
258117631446;258117632000;554;2,9;2;1;1
258117632000;258117634928;2928;2,9;2;1;1
258117634928;258117635176;248;2,9;2;1;1
258117635176;258117635507;331;2,9;2;1;1
258117635507;258117637380;1873;2,9;2;1;1
258117637380;258117639211;1831;2,9;2;1;1
258117639211;258117648826;9615;2,9;2;1;1
258117648826;258117649581;755;2,9;2;1;1
258117649581;258117650024;443;2,9;2;1;1
258117650024;258117653296;3272;9;1;1;1
258117653296;258117653939;643;2,9;2;1;1
258117653939;258117713111;59172;9;1;1;1
258117713111;258117716630;3519;2,9;2;1;1
258117716630;258117763139;46509;9;1;1;1
258117763139;258117772057;8918;9;1;1;1
258117772057;258117793820;21763;9;1;1;1
258117793820;258117795203;1383;2,9;2;1;1
258117795203;258117796596;1393;2,9;2;1;1
258117796596;258117797370;774;2,9;2;1;1
258117797370;258117798080;710;2,9;2;1;1
258117798080;258117799148;1068;2,9;2;1;1
258117799148;258117800267;1119;9;1;1;1
258117800267;258117801105;838;2,9;2;1;1
258117801105;258117802793;1688;2,9;2;1;1
258117802793;258117803373;580;2,9;2;1;1
258117803373;258117806860;3487;9;1;1;1
258117806860;258117815186;8326;9;1;1;1
258117815186;258117860911;45725;9;1;1;1
258117860911;258117863772;2861;9;1;1;1
258117863772;258117891450;27678;9;1;1;1
258117891450;258117892708;1258;2,9;2;1;1
258117892708;258117893777;1069;2,9;2;1;1
258117893777;258117897629;3852;2,9;2;1;1
258117897629;258117899918;2289;2,9;2;1;1
258117899918;258117901426;1508;2,9;2;1;1
258117901426;258117901559;133;2,9;2;1;1
258117901559;258117904444;2885;2,9;2;1;1
258117904444;258117905189;745;2,9;2;1;1
258117905189;258117908876;3687;2,9;2;1;1
258117908876;258117909534;658;2,9;2;1;1
258117909534;258117915928;6394;2,9;2;1;1
258117915928;258117918154;2226;2,9;2;1;1
258117918154;258117925422;7268;2,9;2;1;1
258117925422;258117954338;28916;9;1;1;1
258117954338;258117955173;835;9;1;1;1
258117955173;258117963917;8744;9;1;1;1
258117963917;258117964568;651;9;1;1;1
258117964568;258117975617;11049;9;1;1;1
258117975617;258117978601;2984;9;1;1;1
258117978601;258118017801;39200;9;1;1;1
258118017801;258118018724;923;9;1;1;1
258118018724;258118024182;5458;9;1;1;1
258118024182;258118029097;4915;9;1;1;1
258118029097;258118035963;6866;9;1;1;1
258118035963;258118036160;197;9;1;1;1
258118036160;258118037061;901;9;1;1;1
258118037061;258118045648;8587;9;1;1;1
258118045648;258118108616;62968;9;1;1;1
258118108616;258118111395;2779;9;1;1;1
258118111395;258118147618;36223;9;1;1;1
258118147618;258118156477;8859;9;1;1;1
258118156477;258118216618;60141;9;1;1;1
258118216618;258118223856;7238;9;1;1;1
258118223856;258118224457;601;9;1;1;1
258118224457;258118226240;1783;9;1;1;1
258118226240;258118227158;918;9;1;1;1
258118227158;258118233850;6692;9;1;1;1
258118233850;258118262685;28835;9;1;1;1
258118262685;258118271891;9206;9;1;1;1
258118271891;258118288783;16892;9;1;1;1
258118288783;258118291513;2730;9;1;1;1
258118291513;258118363664;72151;9;1;1;1
258118363664;258118372587;8923;9;1;1;1
258118372587;258118420280;47693;9;1;1;1
258118420280;258118428972;8692;9;1;1;1
258118428972;258118469723;40751;9;1;1;1
258118469723;258118479113;9390;9;1;1;1
258118479113;258118482435;3322;9;1;1;1
258118482435;258118482731;296;9;1;1;1
258118482731;258118492063;9332;9;1;1;1
258118492063;258118492670;607;9;1;1;1
258118492670;258118496308;3638;9;1;1;1
258118496308;258118499247;2939;9;1;1;1
258118499247;258118534757;35510;9;1;1;1
258118534757;258118543294;8537;9;1;1;1
258118543294;258118587619;44325;9;1;1;1
258118587619;258118596256;8637;9;1;1;1
258118596256;258118618128;21872;9;1;1;1
258118618128;258118621461;3333;9;1;1;1
258118621461;258118660250;38789;9;1;1;1
258118660250;258118660923;673;9;1;1;1
258118660923;258118670120;9197;9;1;1;1
258118670120;258118671176;1056;9;1;1;1
258118671176;258118671998;822;9;1;1;1
258118671998;258118677126;5128;9;1;1;1
258118677126;258118679734;2608;9;1;1;1
258118679734;258118686408;6674;9;1;1;1
258118686408;258118708091;21683;9;1;1;1
258118708091;258118710977;2886;9;1;1;1
258118710977;258118748314;37337;9;1;1;1
258118748314;258118757581;9267;9;1;1;1
258118757581;258118788575;30994;9;1;1;1
258118788575;258118793161;4586;9;1;1;1
258118793161;258118793838;677;9;1;1;1
258118793838;258118796350;2512;9;1;1;1
258118796350;258118838420;42070;9;1;1;1
258118838420;258118847617;9197;9;1;1;1
258118847617;258118881773;34156;9;1;1;1
258118881773;258118890323;8550;9;1;1;1
258118890323;258118917526;27203;9;1;1;1
258118917526;258118920334;2808;9;1;1;1
258118920334;258118957440;37106;9;1;1;1
258118957440;258118966273;8833;9;1;1;1
258118966273;258118999129;32856;9;1;1;1
258118999129;258119000533;1404;9;1;1;1
258119000533;258119002487;1954;9;1;1;1
258119002487;258119003847;1360;9;1;1;1
258119003847;258119018655;14808;9;1;1;1
258119018655;258119023019;4364;9;1;1;1
258119023019;258119095033;72014;9;1;1;1
258119095033;258119103914;8881;9;1;1;1
258119103914;258119135636;31722;9;1;1;1
258119135636;258119144391;8755;9;1;1;1
258119144391;258119184875;40484;9;1;1;1
258119184875;258119188634;3759;9;1;1;1
258119188634;258119188813;179;9;1;1;1
258119188813;258119193092;4279;9;1;1;1
258119193092;258119193644;552;9;1;1;1
258119193644;258119194132;488;9;1;1;1
258119194132;258119195898;1766;9;1;1;1
258119195898;258119196457;559;9;1;1;1
258119196457;258119197781;1324;9;1;1;1
258119197781;258119205038;7257;9;1;1;1
258119205038;258119234939;29901;9;1;1;1
258119234939;258119243282;8343;9;1;1;1
258119243282;258119292236;48954;9;1;1;1
258119292236;258119301683;9447;9;1;1;1
258119301683;258119338580;36897;9;1;1;1
258119338580;258119341480;2900;9;1;1;1
258119341480;258119379385;37905;9;1;1;1
258119379385;258119388425;9040;9;1;1;1
258119388425;258119390963;2538;9;1;1;1
258119390963;258119393225;2262;9;1;1;1
258119393225;258119394281;1056;9;1;1;1
258119394281;258119396202;1921;9;1;1;1
258119396202;258119430824;34622;9;1;1;1
258119430824;258119432987;2163;9;1;1;1
258119432987;258119439728;6741;9;1;1;1
258119439728;258119440102;374;9;1;1;1
258119440102;258119467146;27044;9;1;1;1
258119467146;258119470116;2970;9;1;1;1
258119470116;258119518677;48561;9;1;1;1
258119518677;258119527236;8559;9;1;1;1
258119527236;258119560734;33498;9;1;1;1
258119560734;258119570222;9488;9;1;1;1
258119570222;258119598669;28447;9;1;1;1
258119598669;258119606108;7439;9;1;1;1
258119606108;258119607420;1312;9;1;1;1
258119607420;258119616304;8884;9;1;1;1
258119616304;258119793826;177522;9;1;1;1
258119793826;258119799486;5660;9;1;1;1
258119799486;258119801670;2184;9;1;1;1
258119801670;258119802937;1267;9;1;1;1
258119802937;258119857678;54741;9;1;1;1
258119857678;258119858198;520;9;1;1;1
258119858198;258119858818;620;9;1;1;1
258119858818;258119860522;1704;9;1;1;1
258119860522;258119861408;886;9;1;1;1
258119861408;258119861531;123;9;1;1;1
258119861531;258119899491;37960;9;1;1;1
258119899491;258119900213;722;9;1;1;1
258119900213;258119908083;7870;9;1;1;1
258119908083;258119909035;952;9;1;1;1
258119909035;258119937578;28543;9;1;1;1
258119937578;258119940469;2891;9;1;1;1
258119940469;258119941779;1310;9;1;1;1
258119941779;258119942263;484;9;1;1;1
258119942263;258119950863;8600;9;1;1;1
258119950863;258119951524;661;9;1;1;1
258119951524;258119979629;28105;9;1;1;1
258119979629;258119989109;9480;9;1;1;1
258119989109;258120010695;21586;9;1;1;1
258120010695;258120017714;7019;2,9;2;1;1
258120017714;258120018012;298;2,9;2;1;1
258120018012;258120020287;2275;9;1;1;1
258120020287;258120027214;6927;9;1;1;1
258120027214;258120027816;602;9;1;1;1
258120027816;258120102938;75122;9;1;1;1
258120102938;258120103596;658;2,9;2;1;1
258120103596;258120143986;40390;9;1;1;1
258120143986;258120144621;635;2,9;2;1;1
258120144621;258120190169;45548;9;1;1;1
258120190169;258120191068;899;2,9;2;1;1
258120191068;258120196439;5371;9;1;1;1
258120196439;258120199383;2944;9;1;1;1
258120199383;258120206270;6887;9;1;1;1
258120206270;258120209277;3007;9;1;1;1
258120209277;258120241464;32187;9;1;1;1
258120241464;258120242023;559;2,9;2;1;1
258120242023;258120248039;6016;9;1;1;1
258120248039;258120256355;8316;9;1;1;1
258120256355;258120257864;1509;9;1;1;1
258120257864;258120266795;8931;9;1;1;1
258120266795;258120267323;528;9;1;1;1
258120267323;258120269523;2200;9;1;1;1
258120269523;258120270597;1074;9;1;1;1
258120270597;258120272707;2110;9;1;1;1
258120272707;258120308113;35406;9;1;1;1
258120308113;258120316932;8819;9;1;1;1
258120316932;258120334833;17901;9;1;1;1
258120334833;258120344053;9220;9;1;1;1
258120344053;258120359150;15097;9;1;1;1
258120359150;258120360757;1607;2,9;2;1;1
258120360757;258120377599;16842;9;1;1;1
258120377599;258120386400;8801;9;1;1;1
258120386400;258120417032;30632;9;1;1;1
258120417032;258120417663;631;2,9;2;1;1
258120417663;258120498244;80581;9;1;1;1
258120498244;258120499238;994;9;1;1;1
258120499238;258120503218;3980;9;1;1;1
258120503218;258120504074;856;9;1;1;1
258120504074;258120504588;514;9;1;1;1
258120504588;258120504995;407;9;1;1;1
258120504995;258120507216;2221;9;1;1;1
258120507216;258120513428;6212;9;1;1;1
258120513428;258120545797;32369;9;1;1;1
258120545797;258120548511;2714;9;1;1;1
258120548511;258120599322;50811;9;1;1;1
258120599322;258120608481;9159;9;1;1;1
258120608481;258120608669;188;9;1;1;1
258120608669;258120618802;10133;9;1;1;1
258120618802;258120621480;2678;9;1;1;1
258120621480;258120630934;9454;9;1;1;1
258120630934;258120634146;3212;9;1;1;1
258120634146;258120643000;8854;9;1;1;1
258120643000;258120652821;9821;9;1;1;1
258120652821;258120653432;611;2,9;2;1;1
258120653432;258120676861;23429;9;1;1;1
258120676861;258120679808;2947;9;1;1;1
258120679808;258120709758;29950;9;1;1;1
258120709758;258120711369;1611;2,9;2;1;1
258120711369;258120721763;10394;9;1;1;1
258120721763;258120724751;2988;9;1;1;1
258120724751;258120756385;31634;9;1;1;1
258120756385;258120761368;4983;2,9;2;1;1
258120761368;258120800179;38811;9;1;1;1
258120800179;258120800381;202;9;1;1;1
258120800381;258120805374;4993;9;1;1;1
258120805374;258120808655;3281;2,9;2;1;1
258120808655;258120809685;1030;2,9;2;1;1
258120809685;258120815139;5454;9;1;1;1
258120815139;258120828016;12877;9;1;1;1
258120828016;258120837181;9165;9;1;1;1
258120837181;258120858953;21772;9;1;1;1
258120858953;258120867921;8968;9;1;1;1
258120867921;258120936632;68711;9;1;1;1
258120936632;258120939354;2722;9;1;1;1
258120939354;258120976636;37282;9;1;1;1
258120976636;258120979611;2975;9;1;1;1
258120979611;258121008612;29001;9;1;1;1
258121008612;258121009332;720;2,9;2;1;1
258121009332;258121027946;18614;9;1;1;1
258121027946;258121037670;9724;9;1;1;1
258121037670;258121047799;10129;9;1;1;1
258121047799;258121056434;8635;9;1;1;1
258121056434;258121061114;4680;9;1;1;1
258121061114;258121063959;2845;9;1;1;1
258121063959;258121086883;22924;9;1;1;1
258121086883;258121091298;4415;2,9;2;1;1
258121091298;258121091752;454;2,9;2;1;1
258121091752;258121092267;515;9;1;1;1
258121092267;258121092865;598;2,9;2;1;1
258121092865;258121099650;6785;9;1;1;1
258121099650;258121124219;24569;9;1;1;1
258121124219;258121124806;587;2,9;2;1;1
258121124806;258121128895;4089;9;1;1;1
258121128895;258121137405;8510;9;1;1;1
258121137405;258121174482;37077;9;1;1;1
258121174482;258121175031;549;2,9;2;1;1
258121175031;258121204766;29735;9;1;1;1
258121204766;258121213536;8770;9;1;1;1
258121213536;258121234019;20483;9;1;1;1
258121234019;258121234646;627;2,9;2;1;1
258121234646;258121241888;7242;9;1;1;1
258121241888;258121251253;9365;9;1;1;1
258121251253;258121281247;29994;9;1;1;1
258121281247;258121284278;3031;9;1;1;1
258121284278;258121291181;6903;9;1;1;1
258121291181;258121293929;2748;9;1;1;1
258121293929;258121330451;36522;9;1;1;1
258121330451;258121331616;1165;2,9;2;1;1
258121331616;258121353767;22151;9;1;1;1
258121353767;258121358759;4992;9;1;1;1
258121358759;258121359391;632;9;1;1;1
258121359391;258121360942;1551;9;1;1;1
258121360942;258121362492;1550;9;1;1;1
258121362492;258121364805;2313;9;1;1;1
258121364805;258121365768;963;9;1;1;1
258121365768;258121366836;1068;9;1;1;1
258121366836;258121366873;37;9;1;1;1
258121366873;258121376599;9726;9;1;1;1
258121376599;258121377659;1060;9;1;1;1
258121377659;258121381085;3426;9;1;1;1
258121381085;258121382823;1738;9;1;1;1
258121382823;258121389299;6476;9;1;1;1
258121389299;258121390210;911;2,9;2;1;1
258121390210;258121391517;1307;9;1;1;1
258121391517;258121432787;41270;9;1;1;1
258121432787;258121433738;951;9;1;1;1
258121433738;258121441483;7745;2,9;2;1;1
258121441483;258121469762;28279;2,9;2;1;1
258121469762;258121473223;3461;9;1;1;1
258121473223;258121481703;8480;9;1;1;1
258121481703;258121497755;16052;9;1;1;1
258121497755;258121498380;625;2,9;2;1;1
258121498380;258121552157;53777;9;1;1;1
258121552157;258121561231;9074;9;1;1;1
258121561231;258121562523;1292;9;1;1;1
258121562523;258121572446;9923;9;1;1;1
258121572446;258121600848;28402;9;1;1;1
258121600848;258121601879;1031;2,9;2;1;1
258121601879;258121602845;966;2,9;2;1;1
258121602845;258121604546;1701;9;1;1;1
258121604546;258121605098;552;9;1;1;1
258121605098;258121608292;3194;9;1;1;1
258121608292;258121644392;36100;9;1;1;1
258121644392;258121645046;654;2,9;2;1;1
258121645046;258121682813;37767;9;1;1;1
258121682813;258121686123;3310;9;1;1;1
258121686123;258121694055;7932;9;1;1;1
258121694055;258121695187;1132;2,9;2;1;1
258121695187;258121722627;27440;9;1;1;1
258121722627;258121732134;9507;9;1;1;1
258121732134;258121760039;27905;9;1;1;1
258121760039;258121760825;786;9;1;1;1
258121760825;258121763809;2984;9;1;1;1
258121763809;258121764373;564;2,9;2;1;1
258121764373;258121768874;4501;9;1;1;1
258121768874;258121775947;7073;9;1;1;1
258121775947;258121787950;12003;9;1;1;1
258121787950;258121796498;8548;9;1;1;1
258121796498;258121811376;14878;9;1;1;1
258121811376;258121812051;675;2,9;2;1;1
258121812051;258121824093;12042;9;1;1;1
258121824093;258121824826;733;9;1;1;1
258121824826;258121826971;2145;9;1;1;1
258121826971;258121833605;6634;9;1;1;1
258121833605;258121835841;2236;9;1;1;1
258121835841;258121844260;8419;9;1;1;1
258121844260;258121871060;26800;9;1;1;1
258121871060;258121881146;10086;9;1;1;1
258121881146;258121899318;18172;9;1;1;1
258121899318;258121900151;833;2,9;2;1;1
258121900151;258121954070;53919;9;1;1;1
258121954070;258121954756;686;2,9;2;1;1
258121954756;258121982331;27575;9;1;1;1
258121982331;258121984858;2527;9;1;1;1
258121984858;258121985367;509;9;1;1;1
258121985367;258121986224;857;9;1;1;1
258121986224;258121988312;2088;9;1;1;1
258121988312;258121989234;922;9;1;1;1
258121989234;258122070243;81009;9;1;1;1
258122070243;258122073401;3158;9;1;1;1
258122073401;258122073417;16;2,9;2;1;1
258122073417;258122074528;1111;2,9;2;1;1
258122074528;258122077827;3299;9;1;1;1
258122077827;258122078423;596;2,9;2;1;1
258122078423;258122078504;81;9;1;1;1
258122078504;258122079340;836;2,9;2;1;1
258122079340;258122111509;32169;9;1;1;1
258122111509;258122120140;8631;9;1;1;1
258122120140;258122122442;2302;9;1;1;1
258122122442;258122131606;9164;9;1;1;1
258122131606;258122134136;2530;9;1;1;1
258122134136;258122135059;923;2,9;2;1;1
258122135059;258122169517;34458;9;1;1;1
258122169517;258122172328;2811;9;1;1;1
258122172328;258122184408;12080;9;1;1;1
258122184408;258122187491;3083;2,9;2;1;1
258122187491;258122196082;8591;2,9;2;1;1
258122196082;258122213418;17336;2,9;2;1;1
258122213418;258122233244;19826;9;1;1;1
258122233244;258122236752;3508;9;1;1;1
258122236752;258122237390;638;2,9;2;1;1
258122237390;258122242727;5337;9;1;1;1
258122242727;258122277339;34612;9;1;1;1
258122277339;258122280053;2714;9;1;1;1
258122280053;258122310496;30443;9;1;1;1
258122310496;258122313119;2623;9;1;1;1
258122313119;258122319958;6839;9;1;1;1
258122319958;258122320526;568;2,9;2;1;1
258122320526;258122341649;21123;9;1;1;1
258122341649;258122350439;8790;9;1;1;1
258122350439;258122382242;31803;9;1;1;1
258122382242;258122383447;1205;2,9;2;1;1
258122383447;258122432005;48558;9;1;1;1
258122432005;258122440766;8761;9;1;1;1
258122440766;258122458614;17848;9;1;1;1
258122458614;258122459247;633;2,9;2;1;1
258122459247;258122472664;13417;9;1;1;1
258122472664;258122474917;2253;9;1;1;1
258122474917;258122481305;6388;9;1;1;1
258122481305;258122482969;1664;9;1;1;1
258122482969;258122483864;895;9;1;1;1
258122483864;258122485108;1244;9;1;1;1
258122485108;258122493227;8119;9;1;1;1
258122493227;258122494302;1075;9;1;1;1
258122494302;258122501496;7194;9;1;1;1
258122501496;258122503427;1931;9;1;1;1
258122503427;258122525581;22154;9;1;1;1
258122525581;258122526228;647;2,9;2;1;1
258122526228;258122533895;7667;9;1;1;1
258122533895;258122536028;2133;9;1;1;1
258122536028;258122537285;1257;9;1;1;1
258122537285;258122538887;1602;9;1;1;1
258122538887;258122553190;14303;9;1;1;1
258122553190;258122553727;537;2,9;2;1;1
258122553727;258122572433;18706;9;1;1;1
258122572433;258122581219;8786;9;1;1;1
258122581219;258122601573;20354;9;1;1;1
258122601573;258122604604;3031;9;1;1;1
258122604604;258122609784;5180;9;1;1;1
258122609784;258122610703;919;2,9;2;1;1
258122610703;258122659482;48779;9;1;1;1
258122659482;258122660102;620;2,9;2;1;1
258122660102;258122666672;6570;9;1;1;1
258122666672;258122675250;8578;9;1;1;1
258122675250;258122707397;32147;9;1;1;1
258122707397;258122710462;3065;9;1;1;1
258122710462;258122722326;11864;9;1;1;1
258122722326;258122722873;547;2,9;2;1;1
258122722873;258122768999;46126;9;1;1;1
258122768999;258122769800;801;2,9;2;1;1
258122769800;258122779171;9371;9;1;1;1
258122779171;258122788752;9581;9;1;1;1
258122788752;258122809195;20443;9;1;1;1
258122809195;258122817559;8364;9;1;1;1
258122817559;258122821196;3637;9;1;1;1
258122821196;258122824802;3606;9;1;1;1
258122824802;258122824833;31;9;1;1;1
258122824833;258122827748;2915;9;1;1;1
258122827748;258122832071;4323;9;1;1;1
258122832071;258122841529;9458;9;1;1;1
258122841529;258122857597;16068;9;1;1;1
258122857597;258122858492;895;2,9;2;1;1
258122858492;258122882389;23897;9;1;1;1
258122882389;258122891088;8699;9;1;1;1
258122891088;258122905612;14524;9;1;1;1
258122905612;258122906249;637;2,9;2;1;1
258122906249;258122911810;5561;9;1;1;1
258122911810;258122914443;2633;9;1;1;1
258122914443;258122986243;71800;9;1;1;1
258122986243;258122987297;1054;2,9;2;1;1
258122987297;258123009716;22419;9;1;1;1
258123009716;258123010276;560;2,9;2;1;1
258123010276;258123061226;50950;9;1;1;1
258123061226;258123069777;8551;9;1;1;1
258123069777;258123100702;30925;9;1;1;1
258123100702;258123102637;1935;9;1;1;1
258123102637;258123103915;1278;9;1;1;1
258123103915;258123105873;1958;9;1;1;1
258123105873;258123117454;11581;9;1;1;1
258123117454;258123118006;552;2,9;2;1;1
258123118006;258123173216;55210;9;1;1;1
258123173216;258123182488;9272;9;1;1;1
258123182488;258123185108;2620;9;1;1;1
258123185108;258123194138;9030;9;1;1;1
258123194138;258123195766;1628;9;1;1;1
258123195766;258123199106;3340;9;1;1;1
258123199106;258123199680;574;9;1;1;1
258123199680;258123203452;3772;9;1;1;1
258123203452;258123203601;149;9;1;1;1
258123203601;258123204846;1245;9;1;1;1
258123204846;258123207040;2194;9;1;1;1
258123207040;258123207621;581;9;1;1;1
258123207621;258123208375;754;9;1;1;1
258123208375;258123209849;1474;9;1;1;1
258123209849;258123210415;566;9;1;1;1
258123210415;258123211206;791;2,9;2;1;1
258123211206;258123246744;35538;9;1;1;1
258123246744;258123255983;9239;9;1;1;1
258123255983;258123285537;29554;9;1;1;1
258123285537;258123294446;8909;9;1;1;1
258123294446;258123322682;28236;9;1;1;1
258123322682;258123324783;2101;9;1;1;1
258123324783;258123326044;1261;9;1;1;1
258123326044;258123328027;1983;9;1;1;1
258123328027;258123363294;35267;9;1;1;1
258123363294;258123371895;8601;9;1;1;1
258123371895;258123372420;525;9;1;1;1
258123372420;258123373215;795;2,9;2;1;1
258123373215;258123402899;29684;9;1;1;1
258123402899;258123411665;8766;9;1;1;1
258123411665;258123421950;10285;9;1;1;1
258123421950;258123422701;751;2,9;2;1;1
258123422701;258123433833;11132;9;1;1;1
258123433833;258123442422;8589;9;1;1;1
258123442422;258123476164;33742;9;1;1;1
258123476164;258123480945;4781;2,9;2;1;1
258123480945;258123522498;41553;9;1;1;1
258123522498;258123526092;3594;2,9;2;1;1
258123526092;258123528823;2731;2,9;2;1;1
258123528823;258123557193;28370;2,9;2;1;1
258123557193;258123567789;10596;9;1;1;1
258123567789;258123568137;348;9;1;1;1
258123568137;258123570429;2292;9;1;1;1
258123570429;258123578281;7852;9;1;1;1
258123578281;258123597756;19475;9;1;1;1
258123597756;258123598305;549;2,9;2;1;1
258123598305;258123606772;8467;9;1;1;1
258123606772;258123608942;2170;9;1;1;1
258123608942;258123610424;1482;9;1;1;1
258123610424;258123612051;1627;9;1;1;1
258123612051;258123616793;4742;9;1;1;1
258123616793;258123626669;9876;9;1;1;1
258123626669;258123658007;31338;9;1;1;1
258123658007;258123666532;8525;9;1;1;1
258123666532;258123696799;30267;9;1;1;1
258123696799;258123698178;1379;9;1;1;1
258123698178;258123706206;8028;9;1;1;1
258123706206;258123706898;692;9;1;1;1
258123706898;258123707836;938;9;1;1;1
258123707836;258123711151;3315;9;1;1;1
258123711151;258123713168;2017;2,9;2;1;1
258123713168;258123714801;1633;9;1;1;1
258123714801;258123739287;24486;9;1;1;1
258123739287;258123739860;573;2,9;2;1;1
258123739860;258123813477;73617;9;1;1;1
258123813477;258123814034;557;2,9;2;1;1
258123814034;258123831093;17059;9;1;1;1
258123831093;258123840429;9336;9;1;1;1
258123840429;258123890797;50368;9;1;1;1
258123890797;258123891344;547;2,9;2;1;1
258123891344;258123929171;37827;9;1;1;1
258123929171;258123937993;8822;9;1;1;1
258123937993;258123953835;15842;9;1;1;1
258123953835;258123955239;1404;2,9;2;1;1
258123955239;258123968267;13028;9;1;1;1
258123968267;258123970746;2479;9;1;1;1
258123970746;258123971056;310;9;1;1;1
258123971056;258123974116;3060;9;1;1;1
258123974116;258123982551;8435;9;1;1;1
258123982551;258123985227;2676;9;1;1;1
258123985227;258124022998;37771;9;1;1;1
258124022998;258124023701;703;9;1;1;1
258124023701;258124032058;8357;9;1;1;1
258124032058;258124039233;7175;9;1;1;1
258124039233;258124042809;3576;9;1;1;1
258124042809;258124043390;581;2,9;2;1;1
258124043390;258124096515;53125;9;1;1;1
258124096515;258124097173;658;2,9;2;1;1
258124097173;258124198446;101273;9;1;1;1
258124198446;258124199076;630;2,9;2;1;1
258124199076;258124248709;49633;9;1;1;1
258124248709;258124249353;644;2,9;2;1;1
258124249353;258124333372;84019;9;1;1;1
258124333372;258124333998;626;2,9;2;1;1
258124333998;258124356489;22491;9;1;1;1
258124356489;258124365388;8899;9;1;1;1
258124365388;258124380222;14834;9;1;1;1
258124380222;258124380844;622;2,9;2;1;1
258124380844;258124412167;31323;9;1;1;1
258124412167;258124413063;896;9;1;1;1
258124413063;258124421103;8040;9;1;1;1
258124421103;258124421490;387;9;1;1;1
258124421490;258124487175;65685;9;1;1;1
258124487175;258124496736;9561;9;1;1;1
258124496736;258124515836;19100;9;1;1;1
258124515836;258124516444;608;2,9;2;1;1
258124516444;258124527268;10824;9;1;1;1
258124527268;258124530346;3078;9;1;1;1
258124530346;258124543507;13161;9;1;1;1
258124543507;258124544142;635;9;1;1;1
258124544142;258124552842;8700;9;1;1;1
258124552842;258124553305;463;9;1;1;1
258124553305;258124558974;5669;9;1;1;1
258124558974;258124601688;42714;2,9;2;1;1
258124601688;258124604953;3265;2,9;2;1;1
258124604953;258124610208;5255;2,9;2;1;1
258124610208;258124640907;30699;9;1;1;1
258124640907;258124643901;2994;9;1;1;1
258124643901;258124670264;26363;9;1;1;1
258124670264;258124670906;642;2,9;2;1;1
258124670906;258124677628;6722;9;1;1;1
258124677628;258124687334;9706;9;1;1;1
258124687334;258124721650;34316;9;1;1;1
258124721650;258124724499;2849;9;1;1;1
258124724499;258124731537;7038;9;1;1;1
258124731537;258124740416;8879;9;1;1;1
258124740416;258124745076;4660;9;1;1;1
258124745076;258124745731;655;2,9;2;1;1
258124745731;258124751586;5855;9;1;1;1
258124751586;258124759814;8228;9;1;1;1
258124759814;258124789194;29380;9;1;1;1
258124789194;258124789823;629;2,9;2;1;1
258124789823;258124823248;33425;9;1;1;1
258124823248;258124826183;2935;9;1;1;1
258124826183;258124846518;20335;9;1;1;1
258124846518;258124847644;1126;2,9;2;1;1
258124847644;258124861610;13966;9;1;1;1
258124861610;258124871074;9464;9;1;1;1
258124871074;258124894174;23100;9;1;1;1
258124894174;258124894313;139;9;1;1;1
258124894313;258124902866;8553;9;1;1;1
258124902866;258124903923;1057;9;1;1;1
258124903923;258124938920;34997;9;1;1;1
258124938920;258124939616;696;2,9;2;1;1
258124939616;258124956686;17070;9;1;1;1
258124956686;258124965735;9049;9;1;1;1
258124965735;258125013593;47858;9;1;1;1
258125013593;258125014152;559;2,9;2;1;1
258125014152;258125021826;7674;9;1;1;1
258125021826;258125024602;2776;9;1;1;1
258125024602;258125032507;7905;9;1;1;1
258125032507;258125035439;2932;9;1;1;1
258125035439;258125044047;8608;9;1;1;1
258125044047;258125052404;8357;9;1;1;1
258125052404;258125084938;32534;9;1;1;1
258125084938;258125087972;3034;9;1;1;1
258125087972;258125088615;643;2,9;2;1;1
258125088615;258125094208;5593;9;1;1;1
258125094208;258125135375;41167;9;1;1;1
258125135375;258125144292;8917;9;1;1;1
258125144292;258125172938;28646;9;1;1;1
258125172938;258125175640;2702;9;1;1;1
258125175640;258125178321;2681;9;1;1;1
258125178321;258125178973;652;2,9;2;1;1
258125178973;258125246141;67168;9;1;1;1
258125246141;258125247311;1170;9;1;1;1
258125247311;258125248612;1301;2,9;2;1;1
258125248612;258125254730;6118;9;1;1;1
258125254730;258125301891;47161;9;1;1;1
258125301891;258125302488;597;2,9;2;1;1
258125302488;258125309914;7426;9;1;1;1
258125309914;258125318719;8805;9;1;1;1
258125318719;258125350687;31968;9;1;1;1
258125350687;258125351236;549;2,9;2;1;1
258125351236;258125352195;959;9;1;1;1
258125352195;258125354843;2648;9;1;1;1
258125354843;258125364982;10139;9;1;1;1
258125364982;258125366976;1994;9;1;1;1
258125366976;258125368870;1894;9;1;1;1
258125368870;258125369447;577;9;1;1;1
258125369447;258125370383;936;9;1;1;1
258125370383;258125372205;1822;9;1;1;1
258125372205;258125400446;28241;9;1;1;1
258125400446;258125407966;7520;2,9;2;1;1
258125407966;258125423196;15230;9;1;1;1
258125423196;258125431955;8759;9;1;1;1
258125431955;258125454256;22301;9;1;1;1
258125454256;258125454889;633;2,9;2;1;1
258125454889;258125465620;10731;9;1;1;1
258125465620;258125474537;8917;9;1;1;1
258125474537;258125502280;27743;9;1;1;1
258125502280;258125508895;6615;9;1;1;1
258125508895;258125509454;559;2,9;2;1;1
258125509454;258125511723;2269;9;1;1;1
258125511723;258125555142;43419;9;1;1;1
258125555142;258125558074;2932;9;1;1;1
258125558074;258125604711;46637;9;1;1;1
258125604711;258125613278;8567;9;1;1;1
258125613278;258125625963;12685;9;1;1;1
258125625963;258125626520;557;2,9;2;1;1
258125626520;258125647482;20962;9;1;1;1
258125647482;258125656214;8732;9;1;1;1
258125656214;258125656845;631;9;1;1;1
258125656845;258125665525;8680;9;1;1;1
258125665525;258125696272;30747;9;1;1;1
258125696272;258125697421;1149;2,9;2;1;1
258125697421;258125732710;35289;9;1;1;1
258125732710;258125735457;2747;9;1;1;1
258125735457;258125760680;25223;9;1;1;1
258125760680;258125761101;421;2,9;2;1;1
258125761101;258125761390;289;2,9;2;1;1
258125761390;258125761753;363;2,9;2;1;1
258125761753;258125777698;15945;9;1;1;1
258125777698;258125782380;4682;9;1;1;1
258125782380;258125783925;1545;9;1;1;1
258125783925;258125786019;2094;9;1;1;1
258125786019;258125808771;22752;9;1;1;1
258125808771;258125810498;1727;9;1;1;1
258125810498;258125811130;632;2,9;2;1;1
258125811130;258125817954;6824;9;1;1;1
258125817954;258125818064;110;9;1;1;1
258125818064;258125826827;8763;9;1;1;1
258125826827;258125851995;25168;9;1;1;1
258125851995;258125861283;9288;9;1;1;1
258125861283;258125882018;20735;9;1;1;1
258125882018;258125883513;1495;2,9;2;1;1
258125883513;258125885278;1765;9;1;1;1
258125885278;258125885920;642;2,9;2;1;1
258125885920;258125893671;7751;9;1;1;1
258125893671;258125900656;6985;9;1;1;1
258125900656;258125901168;512;9;1;1;1
258125901168;258125902654;1486;9;1;1;1
258125902654;258125903643;989;9;1;1;1
258125903643;258125910443;6800;9;1;1;1
258125910443;258125933327;22884;9;1;1;1
258125933327;258125933870;543;2,9;2;1;1
258125933870;258125951168;17298;9;1;1;1
258125951168;258125960024;8856;9;1;1;1
258125960024;258125981550;21526;9;1;1;1
258125981550;258125984510;2960;9;1;1;1
258125984510;258126021082;36572;9;1;1;1
258126021082;258126029605;8523;9;1;1;1
258126029605;258126030812;1207;9;1;1;1
258126030812;258126031757;945;2,9;2;1;1
258126031757;258126077876;46119;9;1;1;1
258126077876;258126078693;817;2,9;2;1;1
258126078693;258126098431;19738;9;1;1;1
258126098431;258126101082;2651;9;1;1;1
258126101082;258126135244;34162;9;1;1;1
258126135244;258126135757;513;2,9;2;1;1
258126135757;258126182065;46308;9;1;1;1
258126182065;258126182787;722;9;1;1;1
258126182787;258126188972;6185;9;1;1;1
258126188972;258126191170;2198;9;1;1;1
258126191170;258126192356;1186;9;1;1;1
258126192356;258126192966;610;9;1;1;1
258126192966;258126198455;5489;9;1;1;1
258126198455;258126199555;1100;9;1;1;1
258126199555;258126201679;2124;9;1;1;1
258126201679;258126208327;6648;9;1;1;1
258126208327;258126210414;2087;9;1;1;1
258126210414;258126212576;2162;9;1;1;1
258126212576;258126214044;1468;9;1;1;1
258126214044;258126216337;2293;9;1;1;1
258126216337;258126230572;14235;9;1;1;1
258126230572;258126231191;619;2,9;2;1;1
258126231191;258126242071;10880;9;1;1;1
258126242071;258126244713;2642;9;1;1;1
258126244713;258126272057;27344;9;1;1;1
258126272057;258126272601;544;2,9;2;1;1
258126272601;258126280446;7845;9;1;1;1
258126280446;258126288984;8538;9;1;1;1
258126288984;258126319951;30967;9;1;1;1
258126319951;258126328246;8295;9;1;1;1
258126328246;258126348920;20674;9;1;1;1
258126348920;258126349616;696;2,9;2;1;1
258126349616;258126389386;39770;9;1;1;1
258126389386;258126393081;3695;9;1;1;1
258126393081;258126395489;2408;9;1;1;1
258126395489;258126396191;702;9;1;1;1
258126396191;258126399134;2943;9;1;1;1
258126399134;258126400484;1350;9;1;1;1
258126400484;258126421680;21196;9;1;1;1
258126421680;258126431247;9567;9;1;1;1
258126431247;258126472866;41619;9;1;1;1
258126472866;258126473335;469;2,9;2;1;1
258126473335;258126515054;41719;9;1;1;1
258126515054;258126524696;9642;9;1;1;1
258126524696;258126524834;138;2,9;2;1;1
258126524834;258126525193;359;2,9;2;1;1
258126525193;258126551193;26000;9;1;1;1
258126551193;258126551992;799;9;1;1;1
258126551992;258126554518;2526;9;1;1;1
258126554518;258126561127;6609;9;1;1;1
258126561127;258126566566;5439;9;1;1;1
258126566566;258126567043;477;2,9;2;1;1
258126567043;258126595474;28431;9;1;1;1
258126595474;258126604445;8971;9;1;1;1
258126604445;258126606854;2409;9;1;1;1
258126606854;258126607395;541;2,9;2;1;1
258126607395;258126656124;48729;9;1;1;1
258126656124;258126657887;1763;9;1;1;1
258126657887;258126658883;996;9;1;1;1
258126658883;258126660740;1857;9;1;1;1
258126660740;258126678190;17450;9;1;1;1
258126678190;258126680333;2143;9;1;1;1
258126680333;258126688583;8250;9;1;1;1
258126688583;258126689251;668;9;1;1;1
258126689251;258126701367;12116;9;1;1;1
258126701367;258126710659;9292;9;1;1;1
258126710659;258126720032;9373;9;1;1;1
258126720032;258126720562;530;2,9;2;1;1
258126720562;258126745276;24714;9;1;1;1
258126745276;258126748258;2982;9;1;1;1
258126748258;258126789629;41371;9;1;1;1
258126789629;258126790118;489;2,9;2;1;1
258126790118;258126790352;234;9;1;1;1
258126790352;258126801431;11079;9;1;1;1
258126801431;258126822959;21528;9;1;1;1
258126822959;258126826989;4030;9;1;1;1
258126826989;258126831049;4060;2,9;2;1;1
258126831049;258126831445;396;9;1;1;1
258126831445;258126832767;1322;9;1;1;1
258126832767;258126840104;7337;9;1;1;1
258126840104;258126864547;24443;9;1;1;1
258126864547;258126873784;9237;9;1;1;1
258126873784;258126917802;44018;9;1;1;1
258126917802;258126918274;472;2,9;2;1;1
258126918274;258126924994;6720;9;1;1;1
258126924994;258126928490;3496;9;1;1;1
258126928490;258126980695;52205;9;1;1;1
258126980695;258126983739;3044;9;1;1;1
258126983739;258126997327;13588;9;1;1;1
258126997327;258127006889;9562;9;1;1;1
258127006889;258127041834;34945;9;1;1;1
258127041834;258127045383;3549;9;1;1;1
258127045383;258127055421;10038;9;1;1;1
258127055421;258127059697;4276;2,9;2;1;1
258127059697;258127081840;22143;9;1;1;1
258127081840;258127090215;8375;9;1;1;1
258127090215;258127091236;1021;9;1;1;1
258127091236;258127100862;9626;9;1;1;1
258127100862;258127163603;62741;9;1;1;1
258127163603;258127164634;1031;2,9;2;1;1
258127164634;258127194475;29841;9;1;1;1
258127194475;258127194781;306;9;1;1;1
258127194781;258127197252;2471;9;1;1;1
258127197252;258127203769;6517;9;1;1;1
258127203769;258127205510;1741;9;1;1;1
258127205510;258127215097;9587;9;1;1;1
258127215097;258127226887;11790;9;1;1;1
258127226887;258127227368;481;2,9;2;1;1
258127227368;258127247022;19654;9;1;1;1
258127247022;258127255729;8707;9;1;1;1
258127255729;258127324509;68780;9;1;1;1
258127324509;258127327507;2998;9;1;1;1
258127327507;258127335032;7525;9;1;1;1
258127335032;258127336902;1870;9;1;1;1
258127336902;258127337938;1036;9;1;1;1
258127337938;258127339867;1929;9;1;1;1
258127339867;258127340885;1018;9;1;1;1
258127340885;258127341376;491;2,9;2;1;1
258127341376;258127344234;2858;9;1;1;1
258127344234;258127344724;490;2,9;2;1;1
258127344724;258127345214;490;9;1;1;1
258127345214;258127345807;593;2,9;2;1;1
258127345807;258127379497;33690;9;1;1;1
258127379497;258127379965;468;2,9;2;1;1
258127379965;258127384597;4632;9;1;1;1
258127384597;258127393341;8744;9;1;1;1
258127393341;258127418879;25538;9;1;1;1
258127418879;258127419461;582;2,9;2;1;1
258127419461;258127442090;22629;9;1;1;1
258127442090;258127444885;2795;9;1;1;1
258127444885;258127481258;36373;9;1;1;1
258127481258;258127481533;275;9;1;1;1
258127481533;258127489867;8334;9;1;1;1
258127489867;258127496726;6859;9;1;1;1
258127496726;258127541362;44636;9;1;1;1
258127541362;258127541842;480;2,9;2;1;1
258127541842;258127585124;43282;9;1;1;1
258127585124;258127585734;610;2,9;2;1;1
258127585734;258127617887;32153;9;1;1;1
258127617887;258127627230;9343;9;1;1;1
258127627230;258127640028;12798;9;1;1;1
258127640028;258127640659;631;2,9;2;1;1
258127640659;258127649941;9282;9;1;1;1
258127649941;258127660077;10136;9;1;1;1
258127660077;258127660221;144;9;1;1;1
258127660221;258127661205;984;9;1;1;1
258127661205;258127663964;2759;9;1;1;1
258127663964;258127664137;173;9;1;1;1
258127664137;258127665051;914;9;1;1;1
258127665051;258127665212;161;9;1;1;1
258127665212;258127668394;3182;9;1;1;1
258127668394;258127669256;862;9;1;1;1
258127669256;258127692981;23725;9;1;1;1
258127692981;258127695776;2795;9;1;1;1
258127695776;258127704779;9003;9;1;1;1
258127704779;258127705310;531;2,9;2;1;1
258127705310;258127731810;26500;9;1;1;1
258127731810;258127738227;6417;9;1;1;1
258127738227;258127740297;2070;9;1;1;1
258127740297;258127741831;1534;9;1;1;1
258127741831;258127744189;2358;9;1;1;1
258127744189;258127744678;489;2,9;2;1;1
258127744678;258127747263;2585;9;1;1;1
258127747263;258127748891;1628;9;1;1;1
258127748891;258127789028;40137;9;1;1;1
258127789028;258127798527;9499;9;1;1;1
258127798527;258127799840;1313;9;1;1;1
258127799840;258127809427;9587;9;1;1;1
258127809427;258127845507;36080;9;1;1;1
258127845507;258127848161;2654;9;1;1;1
258127848161;258127854745;6584;9;1;1;1
258127854745;258127855209;464;2,9;2;1;1
258127855209;258127887398;32189;9;1;1;1
258127887398;258127890049;2651;9;1;1;1
258127890049;258127897779;7730;9;1;1;1
258127897779;258127907310;9531;9;1;1;1
258127907310;258127922448;15138;9;1;1;1
258127922448;258127923005;557;2,9;2;1;1
258127923005;258127967625;44620;9;1;1;1
258127967625;258127968092;467;2,9;2;1;1
258127968092;258128046564;78472;9;1;1;1
258128046564;258128047587;1023;2,9;2;1;1
258128047587;258128131656;84069;9;1;1;1
258128131656;258128132153;497;2,9;2;1;1
258128132153;258128197196;65043;9;1;1;1
258128197196;258128197660;464;2,9;2;1;1
258128197660;258128232723;35063;9;1;1;1
258128232723;258128233325;602;2,9;2;1;1
258128233325;258128244229;10904;9;1;1;1
258128244229;258128247536;3307;9;1;1;1
258128247536;258128247958;422;9;1;1;1
258128247958;258128251142;3184;9;1;1;1
258128251142;258128313131;61989;9;1;1;1
258128313131;258128313852;721;2,9;2;1;1
258128313852;258128333820;19968;9;1;1;1
258128333820;258128342382;8562;9;1;1;1
258128342382;258128380097;37715;9;1;1;1
258128380097;258128383247;3150;9;1;1;1
258128383247;258128383711;464;2,9;2;1;1
258128383711;258128388452;4741;9;1;1;1
258128388452;258128391430;2978;9;1;1;1
258128391430;258128393127;1697;9;1;1;1
258128393127;258128400477;7350;9;1;1;1
258128400477;258128400901;424;9;1;1;1
258128400901;258128402887;1986;9;1;1;1
258128402887;258128403230;343;9;1;1;1
258128403230;258128404956;1726;9;1;1;1
258128404956;258128406057;1101;9;1;1;1
258128406057;258128408221;2164;9;1;1;1
258128408221;258128410944;2723;9;1;1;1
258128410944;258128444376;33432;9;1;1;1
258128444376;258128445106;730;9;1;1;1
258128445106;258128447450;2344;9;1;1;1
258128447450;258128448575;1125;9;1;1;1
258128448575;258128463921;15346;9;1;1;1
258128463921;258128464396;475;2,9;2;1;1
258128464396;258128554319;89923;9;1;1;1
258128554319;258128554381;62;9;1;1;1
258128554381;258128555025;644;2,9;2;1;1
258128555025;258128557019;1994;9;1;1;1
258128557019;258128600656;43637;9;1;1;1
258128600656;258128609603;8947;9;1;1;1
258128609603;258128611764;2161;9;1;1;1
258128611764;258128614030;2266;9;1;1;1
258128614030;258128614834;804;2,9;2;1;1
258128614834;258128620970;6136;9;1;1;1
258128620970;258128623975;3005;9;1;1;1
258128623975;258128632723;8748;9;1;1;1
258128632723;258128669026;36303;9;1;1;1
258128669026;258128671787;2761;9;1;1;1
258128671787;258128692270;20483;9;1;1;1
258128692270;258128692897;627;2,9;2;1;1
258128692897;258128752449;59552;9;1;1;1
258128752449;258128755141;2692;9;1;1;1
258128755141;258128756067;926;9;1;1;1
258128756067;258128756384;317;9;1;1;1
258128756384;258128765889;9505;9;1;1;1
258128765889;258128771599;5710;9;1;1;1
258128771599;258128773411;1812;9;1;1;1
258128773411;258128773878;467;2,9;2;1;1
258128773878;258128804538;30660;9;1;1;1
258128804538;258128812672;8134;9;1;1;1
258128812672;258128814145;1473;9;1;1;1
258128814145;258128815987;1842;9;1;1;1
258128815987;258128822058;6071;9;1;1;1
258128822058;258128824457;2399;9;1;1;1
258128824457;258128829920;5463;9;1;1;1
258128829920;258128830549;629;2,9;2;1;1
258128830549;258128859636;29087;9;1;1;1
258128859636;258128862309;2673;9;1;1;1
258128862309;258128875316;13007;9;1;1;1
258128875316;258128875815;499;2,9;2;1;1
258128875815;258128953867;78052;9;1;1;1
258128953867;258128954342;475;2,9;2;1;1
258128954342;258128957121;2779;9;1;1;1
258128957121;258128958960;1839;9;1;1;1
258128958960;258128960337;1377;9;1;1;1
258128960337;258128961789;1452;9;1;1;1
258128961789;258128966958;5169;9;1;1;1
258128966958;258128976188;9230;9;1;1;1
258128976188;258129006700;30512;9;1;1;1
258129006700;258129015844;9144;9;1;1;1
258129015844;258129016396;552;2,9;2;1;1
258129016396;258129016491;95;9;1;1;1
258129016491;258129016681;190;9;1;1;1
258129016681;258129019962;3281;9;1;1;1
258129019962;258129064240;44278;9;1;1;1
258129064240;258129064704;464;2,9;2;1;1
258129064704;258129078685;13981;9;1;1;1
258129078685;258129081435;2750;9;1;1;1
258129081435;258129096856;15421;9;1;1;1
258129096856;258129097368;512;2,9;2;1;1
258129097368;258129118236;20868;9;1;1;1
258129118236;258129121053;2817;9;1;1;1
258129121053;258129159165;38112;9;1;1;1
258129159165;258129159851;686;9;1;1;1
258129159851;258129161779;1928;9;1;1;1
258129161779;258129167723;5944;9;1;1;1
258129167723;258129170273;2550;9;1;1;1
258129170273;258129170671;398;9;1;1;1
258129170671;258129173290;2619;9;1;1;1
258129173290;258129173742;452;2,9;2;1;1
258129173742;258129213192;39450;9;1;1;1
258129213192;258129213645;453;2,9;2;1;1
258129213645;258129231286;17641;9;1;1;1
258129231286;258129240005;8719;9;1;1;1
258129240005;258129242671;2666;9;1;1;1
258129242671;258129252067;9396;9;1;1;1
258129252067;258129277187;25120;9;1;1;1
258129277187;258129277753;566;2,9;2;1;1
258129277753;258129298683;20930;9;1;1;1
258129298683;258129307569;8886;9;1;1;1
258129307569;258129311566;3997;9;1;1;1
258129311566;258129313130;1564;9;1;1;1
258129313130;258129313274;144;9;1;1;1
258129313274;258129321229;7955;9;1;1;1
258129321229;258129322377;1148;9;1;1;1
258129322377;258129323751;1374;9;1;1;1
258129323751;258129349977;26226;9;1;1;1
258129349977;258129354035;4058;2,9;2;1;1
258129354035;258129369385;15350;9;1;1;1
258129369385;258129378056;8671;9;1;1;1
258129378056;258129381452;3396;9;1;1;1
258129381452;258129391446;9994;9;1;1;1
258129391446;258129411668;20222;9;1;1;1
258129411668;258129421557;9889;9;1;1;1
258129421557;258129451592;30035;9;1;1;1
258129451592;258129460338;8746;9;1;1;1
258129460338;258129493137;32799;9;1;1;1
258129493137;258129493441;304;9;1;1;1
258129493441;258129503016;9575;9;1;1;1
258129503016;258129503481;465;9;1;1;1
258129503481;258129507069;3588;9;1;1;1
258129507069;258129507572;503;2,9;2;1;1
258129507572;258129526388;18816;9;1;1;1
258129526388;258129535675;9287;9;1;1;1
258129535675;258129567577;31902;9;1;1;1
258129567577;258129576423;8846;9;1;1;1
258129576423;258129595636;19213;9;1;1;1
258129595636;258129604199;8563;9;1;1;1
258129604199;258129612083;7884;9;1;1;1
258129612083;258129613070;987;2,9;2;1;1
258129613070;258129634986;21916;9;1;1;1
258129634986;258129635316;330;9;1;1;1
258129635316;258129643946;8630;9;1;1;1
258129643946;258129644330;384;9;1;1;1
258129644330;258129711919;67589;9;1;1;1
258129711919;258129712904;985;9;1;1;1
258129712904;258129716400;3496;9;1;1;1
258129716400;258129716951;551;2,9;2;1;1
258129716951;258129725692;8741;9;1;1;1
258129725692;258129782346;56654;9;1;1;1
258129782346;258129782884;538;9;1;1;1
258129782884;258129795631;12747;9;1;1;1
258129795631;258129799042;3411;9;1;1;1
258129799042;258129799855;813;9;1;1;1
258129799855;258129803466;3611;9;1;1;1
258129803466;258129815112;11646;9;1;1;1
258129815112;258129830457;15345;9;1;1;1
258129830457;258129848001;17544;9;1;1;1
258129848001;258129851314;3313;9;1;1;1
258129851314;258129860412;9098;9;1;1;1
258129860412;258129862144;1732;9;1;1;1
258129862144;258129872008;9864;9;1;1;1
258129872008;258129872883;875;9;1;1;1
258129872883;258129887445;14562;9;1;1;1
258129887445;258129888258;813;9;1;1;1
258129888258;258129891001;2743;9;1;1;1
258129891001;258129891804;803;9;1;1;1
258129891804;258129928737;36933;9;1;1;1
258129928737;258129934781;6044;9;1;1;1
258129934781;258129944500;9719;9;1;1;1
258129944500;258129953910;9410;9;1;1;1
258129953910;258129957167;3257;9;1;1;1
258129957167;258129957481;314;9;1;1;1
258129957481;258129958906;1425;9;1;1;1
258129958906;258129962821;3915;9;1;1;1
258129962821;258129963645;824;9;1;1;1
258129963645;258129964787;1142;9;1;1;1
258129964787;258129965417;630;2,9;2;1;1
258129965417;258129967051;1634;9;1;1;1
258129967051;258129969442;2391;9;1;1;1
258129969442;258129974018;4576;9;1;1;1
258129974018;258129974950;932;9;1;1;1
258129974950;258129976852;1902;9;1;1;1
258129976852;258129977677;825;9;1;1;1
258129977677;258129980433;2756;9;1;1;1
258129980433;258129981236;803;9;1;1;1
258129981236;258129987752;6516;9;1;1;1
258129987752;258129990802;3050;9;1;1;1
258129990802;258129999992;9190;9;1;1;1
258129999992;258130002152;2160;9;1;1;1
258130002152;258130009028;6876;9;1;1;1
258130009028;258130009989;961;9;1;1;1
258130009989;258130014082;4093;9;1;1;1
258130014082;258130014321;239;9;1;1;1
258130014321;258130014992;671;9;1;1;1
258130014992;258130015229;237;9;1;1;1
258130015229;258130032323;17094;9;1;1;1
258130032323;258130033219;896;9;1;1;1
258130033219;258130038938;5719;9;1;1;1
258130038938;258130039481;543;2,9;2;1;1
258130039481;258130042081;2600;9;1;1;1
258130042081;258130047344;5263;9;1;1;1
258130047344;258130049542;2198;9;1;1;1
258130049542;258130049652;110;9;1;1;1
258130049652;258130050454;802;9;1;1;1
258130050454;258130051725;1271;9;1;1;1
258130051725;258130053709;1984;9;1;1;1
258130053709;258130054513;804;9;1;1;1
258130054513;258130058651;4138;9;1;1;1
258130058651;258130060505;1854;9;1;1;1
258130060505;258130064896;4391;9;1;1;1
258130064896;258130066073;1177;9;1;1;1
258130066073;258130066678;605;9;1;1;1
258130066678;258130066777;99;9;1;1;1
258130066777;258130070255;3478;9;1;1;1
258130070255;258130077715;7460;9;1;1;1
258130077715;258130078658;943;9;1;1;1
258130078658;258130078912;254;9;1;1;1
258130078912;258130087758;8846;9;1;1;1
258130087758;258130088584;826;9;1;1;1
258130088584;258130088654;70;9;1;1;1
258130088654;258130089722;1068;9;1;1;1
258130089722;258130096459;6737;9;1;1;1
258130096459;258130104607;8148;9;1;1;1
258130104607;258130114535;9928;9;1;1;1
258130114535;258130114933;398;9;1;1;1
258130114933;258130115755;822;9;1;1;1
258130115755;258130117751;1996;9;1;1;1
258130117751;258130118237;486;2,9;2;1;1
258130118237;258130124688;6451;9;1;1;1
258130124688;258130125005;317;9;1;1;1
258130125005;258130125402;397;9;1;1;1
258130125402;258130127805;2403;9;1;1;1
258130127805;258130128868;1063;9;1;1;1
258130128868;258130132920;4052;9;1;1;1
258130132920;258130134164;1244;9;1;1;1
258130134164;258130149904;15740;9;1;1;1
258130149904;258130158455;8551;9;1;1;1
258130158455;258130160127;1672;9;1;1;1
258130160127;258130162304;2177;9;1;1;1
258130162304;258130165145;2841;9;1;1;1
258130165145;258130165671;526;9;1;1;1
258130165671;258130165907;236;9;1;1;1
258130165907;258130166249;342;9;1;1;1
258130166249;258130171449;5200;9;1;1;1
258130171449;258130179209;7760;9;1;1;1
258130179209;258130180388;1179;9;1;1;1
258130180388;258130182599;2211;9;1;1;1
258130182599;258130185423;2824;9;1;1;1
258130185423;258130187111;1688;9;1;1;1
258130187111;258130187987;876;9;1;1;1
258130187987;258130190120;2133;9;1;1;1
258130190120;258130207238;17118;9;1;1;1
258130207238;258130207767;529;9;1;1;1
258130207767;258130207994;227;9;1;1;1
258130207994;258130208828;834;9;1;1;1
258130208828;258130211962;3134;9;1;1;1
258130211962;258130212878;916;9;1;1;1
258130212878;258130212894;16;9;1;1;1
258130212894;258130214479;1585;9;1;1;1
258130214479;258130215520;1041;9;1;1;1
258130215520;258130224064;8544;9;1;1;1
258130224064;258130230968;6904;9;1;1;1
258130230968;258130232050;1082;9;1;1;1
258130232050;258130246075;14025;9;1;1;1
258130246075;258130247313;1238;9;1;1;1
258130247313;258130251359;4046;9;1;1;1
258130251359;258130256654;5295;9;1;1;1
258130256654;258130257288;634;2,9;2;1;1
258130257288;258130259370;2082;9;1;1;1
258130259370;258130260851;1481;9;1;1;1
258130260851;258130261941;1090;9;1;1;1
258130261941;258130263095;1154;9;1;1;1
258130263095;258130263652;557;9;1;1;1
258130263652;258130264207;555;9;1;1;1
258130264207;258130266594;2387;9;1;1;1
258130266594;258130267507;913;9;1;1;1
258130267507;258130272440;4933;9;1;1;1
258130272440;258130277054;4614;9;1;1;1
258130277054;258130278529;1475;9;1;1;1
258130278529;258130279940;1411;9;1;1;1
258130279940;258130282248;2308;9;1;1;1
258130282248;258130288967;6719;9;1;1;1
258130288967;258130293776;4809;9;1;1;1
258130293776;258130294893;1117;9;1;1;1
258130294893;258130299266;4373;9;1;1;1
258130299266;258130300988;1722;9;1;1;1
258130300988;258130308042;7054;9;1;1;1
258130308042;258130311219;3177;9;1;1;1
258130311219;258130311668;449;9;1;1;1
258130311668;258130313433;1765;9;1;1;1
258130313433;258130315150;1717;9;1;1;1
258130315150;258130323807;8657;9;1;1;1
258130323807;258130331721;7914;9;1;1;1
258130331721;258130332502;781;9;1;1;1
258130332502;258130332676;174;9;1;1;1
258130332676;258130339977;7301;9;1;1;1
258130339977;258130340638;661;2,9;2;1;1
258130340638;258130343327;2689;9;1;1;1
258130343327;258130344436;1109;9;1;1;1
258130344436;258130348185;3749;9;1;1;1
258130348185;258130348481;296;9;1;1;1
258130348481;258130349094;613;9;1;1;1
258130349094;258130349796;702;9;1;1;1
258130349796;258130354577;4781;9;1;1;1
258130354577;258130355820;1243;9;1;1;1
258130355820;258130360703;4883;9;1;1;1
258130360703;258130364015;3312;9;1;1;1
258130364015;258130371497;7482;9;1;1;1
258130371497;258130373992;2495;9;1;1;1
258130373992;258130381635;7643;9;1;1;1
258130381635;258130382898;1263;9;1;1;1
258130382898;258130383395;497;9;1;1;1
258130383395;258130385179;1784;9;1;1;1
258130385179;258130386928;1749;9;1;1;1
258130386928;258130387850;922;9;1;1;1
258130387850;258130388789;939;9;1;1;1
258130388789;258130397506;8717;9;1;1;1
258130397506;258130398330;824;9;1;1;1
258130398330;258130399057;727;9;1;1;1
258130399057;258130402752;3695;9;1;1;1
258130402752;258130403029;277;9;1;1;1
258130403029;258130404095;1066;9;1;1;1
258130404095;258130407146;3051;9;1;1;1
258130407146;258130410544;3398;9;1;1;1
258130410544;258130411520;976;9;1;1;1
258130411520;258130415389;3869;9;1;1;1
258130415389;258130416228;839;9;1;1;1
258130416228;258130419396;3168;9;1;1;1
258130419396;258130420371;975;9;1;1;1
258130420371;258130444813;24442;9;1;1;1
258130444813;258130445452;639;2,9;2;1;1
258130445452;258130450728;5276;9;1;1;1
258130450728;258130451645;917;9;1;1;1
258130451645;258130456326;4681;9;1;1;1
258130456326;258130456714;388;9;1;1;1
258130456714;258130457263;549;9;1;1;1
258130457263;258130457917;654;9;1;1;1
258130457917;258130469112;11195;9;1;1;1
258130469112;258130471269;2157;9;1;1;1
258130471269;258130488323;17054;9;1;1;1
258130488323;258130491260;2937;9;1;1;1
258130491260;258130492068;808;9;1;1;1
258130492068;258130499969;7901;9;1;1;1
258130499969;258130500516;547;2,9;2;1;1
258130500516;258130505281;4765;9;1;1;1
258130505281;258130508786;3505;9;1;1;1
258130508786;258130509494;708;9;1;1;1
258130509494;258130512189;2695;9;1;1;1
258130512189;258130513501;1312;9;1;1;1
258130513501;258130514358;857;9;1;1;1
258130514358;258130515345;987;9;1;1;1
258130515345;258130515350;5;9;1;1;1
258130515350;258130519549;4199;9;1;1;1
258130519549;258130541131;21582;9;1;1;1
258130541131;258130541696;565;2,9;2;1;1
258130541696;258130548209;6513;9;1;1;1
258130548209;258130548313;104;9;1;1;1
258130548313;258130549684;1371;9;1;1;1
258130549684;258130550551;867;9;1;1;1
258130550551;258130551810;1259;9;1;1;1
258130551810;258130552789;979;9;1;1;1
258130552789;258130553006;217;9;1;1;1
258130553006;258130554230;1224;9;1;1;1
258130554230;258130554599;369;9;1;1;1
258130554599;258130560108;5509;9;1;1;1
258130560108;258130562420;2312;9;1;1;1
258130562420;258130562871;451;9;1;1;1
258130562871;258130563805;934;9;1;1;1
258130563805;258130566609;2804;9;1;1;1
258130566609;258130570716;4107;9;1;1;1
258130570716;258130573948;3232;9;1;1;1
258130573948;258130574187;239;9;1;1;1
258130574187;258130576202;2015;9;1;1;1
258130576202;258130576842;640;9;1;1;1
258130576842;258130577724;882;9;1;1;1
258130577724;258130578242;518;9;1;1;1
258130578242;258130579369;1127;9;1;1;1
258130579369;258130579691;322;9;1;1;1
258130579691;258130579847;156;9;1;1;1
258130579847;258130581478;1631;9;1;1;1
258130581478;258130585021;3543;9;1;1;1
258130585021;258130586048;1027;9;1;1;1
258130586048;258130586451;403;9;1;1;1
258130586451;258130586723;272;9;1;1;1
258130586723;258130589327;2604;9;1;1;1
258130589327;258130590452;1125;9;1;1;1
258130590452;258130593033;2581;9;1;1;1
258130593033;258130596629;3596;9;1;1;1
258130596629;258130602102;5473;9;1;1;1
258130602102;258130603538;1436;9;1;1;1
258130603538;258130604290;752;9;1;1;1
258130604290;258130610847;6557;9;1;1;1
258130610847;258130612066;1219;9;1;1;1
258130612066;258130614936;2870;9;1;1;1
258130614936;258130616338;1402;9;1;1;1
258130616338;258130616847;509;9;1;1;1
258130616847;258130618116;1269;9;1;1;1
258130618116;258130618615;499;9;1;1;1
258130618615;258130619076;461;2,9;2;1;1
258130619076;258130619576;500;2,9;2;1;1
258130619576;258130621072;1496;9;1;1;1
258130621072;258130622503;1431;9;1;1;1
258130622503;258130623309;806;9;1;1;1
258130623309;258130626378;3069;9;1;1;1
258130626378;258130628003;1625;9;1;1;1
258130628003;258130631383;3380;9;1;1;1
258130631383;258130640859;9476;9;1;1;1
258130640859;258130664364;23505;9;1;1;1
258130664364;258130664647;283;9;1;1;1
258130664647;258130666713;2066;9;1;1;1
258130666713;258130667538;825;9;1;1;1
258130667538;258130676356;8818;9;1;1;1
258130676356;258130677259;903;9;1;1;1
258130677259;258130684635;7376;9;1;1;1
258130684635;258130701152;16517;9;1;1;1
258130701152;258130701683;531;2,9;2;1;1
258130701683;258130715176;13493;9;1;1;1
258130715176;258130719859;4683;9;1;1;1
258130719859;258130726040;6181;9;1;1;1
258130726040;258130730539;4499;9;1;1;1
258130730539;258130732504;1965;9;1;1;1
258130732504;258130732732;228;9;1;1;1
258130732732;258130733508;776;9;1;1;1
258130733508;258130733590;82;9;1;1;1
258130733590;258130733680;90;9;1;1;1
258130733680;258130733865;185;9;1;1;1
258130733865;258130736318;2453;9;1;1;1
258130736318;258130737123;805;9;1;1;1
258130737123;258130737430;307;9;1;1;1
258130737430;258130737566;136;9;1;1;1
258130737566;258130738251;685;9;1;1;1
258130738251;258130738382;131;9;1;1;1
258130738382;258130738912;530;9;1;1;1
258130738912;258130739312;400;9;1;1;1
258130739312;258130739520;208;9;1;1;1
258130739520;258130742949;3429;9;1;1;1
258130742949;258130745570;2621;9;1;1;1
258130745570;258130746456;886;9;1;1;1
258130746456;258130748819;2363;9;1;1;1
258130748819;258130752693;3874;9;1;1;1
258130752693;258130753253;560;9;1;1;1
258130753253;258130753401;148;9;1;1;1
258130753401;258130754247;846;9;1;1;1
258130754247;258130755157;910;9;1;1;1
258130755157;258130755414;257;9;1;1;1
258130755414;258130755586;172;9;1;1;1
258130755586;258130756535;949;9;1;1;1
258130756535;258130758541;2006;9;1;1;1
258130758541;258130765609;7068;9;1;1;1
258130765609;258130772746;7137;9;1;1;1
258130772746;258130773864;1118;9;1;1;1
258130773864;258130780231;6367;9;1;1;1
258130780231;258130780495;264;9;1;1;1
258130780495;258130781407;912;9;1;1;1
258130781407;258130786447;5040;9;1;1;1
258130786447;258130787008;561;2,9;2;1;1
258130787008;258130788561;1553;9;1;1;1
258130788561;258130788796;235;9;1;1;1
258130788796;258130788905;109;9;1;1;1
258130788905;258130789833;928;9;1;1;1
258130789833;258130791532;1699;9;1;1;1
258130791532;258130792555;1023;9;1;1;1
258130792555;258130797890;5335;9;1;1;1
258130797890;258130798882;992;9;1;1;1
258130798882;258130802318;3436;9;1;1;1
258130802318;258130802508;190;9;1;1;1
258130802508;258130803609;1101;9;1;1;1
258130803609;258130829062;25453;9;1;1;1
258130829062;258130829481;419;9;1;1;1
258130829481;258130829657;176;9;1;1;1
258130829657;258130830206;549;2,9;2;1;1
258130830206;258130831028;822;9;1;1;1
258130831028;258130832042;1014;9;1;1;1
258130832042;258130832222;180;9;1;1;1
258130832222;258130834481;2259;9;1;1;1
258130834481;258130838061;3580;9;1;1;1
258130838061;258130838084;23;9;1;1;1
258130838084;258130838293;209;9;1;1;1
258130838293;258130838997;704;9;1;1;1
258130838997;258130839437;440;9;1;1;1
258130839437;258130840715;1278;9;1;1;1
258130840715;258130840757;42;9;1;1;1
258130840757;258130843372;2615;9;1;1;1
258130843372;258130843863;491;9;1;1;1
258130843863;258130844596;733;9;1;1;1
258130844596;258130844895;299;9;1;1;1
258130844895;258130845619;724;9;1;1;1
258130845619;258130847357;1738;9;1;1;1
258130847357;258130851202;3845;9;1;1;1
258130851202;258130851657;455;9;1;1;1
258130851657;258130856828;5171;9;1;1;1
258130856828;258130857329;501;9;1;1;1
258130857329;258130860653;3324;9;1;1;1
258130860653;258130861257;604;9;1;1;1
258130861257;258130865576;4319;9;1;1;1
258130865576;258130865940;364;9;1;1;1
258130865940;258130866680;740;9;1;1;1
258130866680;258130867220;540;2,9;2;1;1
258130867220;258130867461;241;9;1;1;1
258130867461;258130867508;47;9;1;1;1
258130867508;258130868612;1104;9;1;1;1
258130868612;258130870386;1774;9;1;1;1
258130870386;258130872247;1861;9;1;1;1
258130872247;258130873016;769;9;1;1;1
258130873016;258130876483;3467;9;1;1;1
258130876483;258130880824;4341;9;1;1;1
258130880824;258130881018;194;9;1;1;1
258130881018;258130881975;957;9;1;1;1
258130881975;258130883326;1351;9;1;1;1
258130883326;258130883768;442;9;1;1;1
258130883768;258130887460;3692;9;1;1;1
258130887460;258130888146;686;9;1;1;1
258130888146;258130891417;3271;9;1;1;1
258130891417;258130891434;17;9;1;1;1
258130891434;258130892365;931;9;1;1;1
258130892365;258130892387;22;9;1;1;1
258130892387;258130893241;854;9;1;1;1
258130893241;258130896408;3167;9;1;1;1
258130896408;258130900081;3673;9;1;1;1
258130900081;258130900292;211;9;1;1;1
258130900292;258130900628;336;9;1;1;1
258130900628;258130907295;6667;9;1;1;1
258130907295;258130926643;19348;9;1;1;1
258130926643;258130931002;4359;9;1;1;1
258130931002;258130933267;2265;9;1;1;1
258130933267;258130934136;869;9;1;1;1
258130934136;258130936474;2338;9;1;1;1
258130936474;258130936869;395;2,9;2;1;1
258130936869;258130936944;75;2,9;2;1;1
258130936944;258130940037;3093;9;1;1;1
258130940037;258130941640;1603;9;1;1;1
258130941640;258130941834;194;9;1;1;1
258130941834;258130951071;9237;9;1;1;1
258130951071;258130953181;2110;9;1;1;1
258130953181;258130954038;857;9;1;1;1
258130954038;258130958470;4432;9;1;1;1
258130958470;258130960566;2096;9;1;1;1
258130960566;258130961672;1106;9;1;1;1
258130961672;258130967102;5430;9;1;1;1
258130967102;258130972171;5069;9;1;1;1
258130972171;258130974016;1845;9;1;1;1
258130974016;258130978314;4298;9;1;1;1
258130978314;258130982771;4457;9;1;1;1
258130982771;258130985355;2584;9;1;1;1
258130985355;258130985407;52;9;1;1;1
258130985407;258130986599;1192;9;1;1;1
258130986599;258130986840;241;9;1;1;1
258130986840;258130987274;434;9;1;1;1
258130987274;258130987751;477;9;1;1;1
258130987751;258130988370;619;9;1;1;1
258130988370;258130988540;170;9;1;1;1
258130988540;258130988550;10;9;1;1;1
258130988550;258130988612;62;9;1;1;1
258130988612;258130990761;2149;9;1;1;1
258130990761;258130991836;1075;9;1;1;1
258130991836;258130991895;59;9;1;1;1
258130991895;258130991931;36;9;1;1;1
258130991931;258130992710;779;9;1;1;1
258130992710;258130993920;1210;9;1;1;1
258130993920;258130994596;676;9;1;1;1
258130994596;258130994599;3;9;1;1;1
258130994599;258130994913;314;9;1;1;1
258130994913;258130994994;81;9;1;1;1
258130994994;258130995226;232;9;1;1;1
258130995226;258130995376;150;9;1;1;1
258130995376;258130995573;197;9;1;1;1
258130995573;258130996674;1101;9;1;1;1
258130996674;258130997458;784;9;1;1;1
258130997458;258130997904;446;9;1;1;1
258130997904;258130998414;510;9;1;1;1
258130998414;258130998536;122;9;1;1;1
258130998536;258130999283;747;9;1;1;1
258130999283;258131002210;2927;9;1;1;1
258131002210;258131002262;52;9;1;1;1
258131002262;258131002547;285;9;1;1;1
258131002547;258131002736;189;9;1;1;1
258131002736;258131003920;1184;9;1;1;1
258131003920;258131004225;305;9;1;1;1
258131004225;258131004368;143;9;1;1;1
258131004368;258131004693;325;9;1;1;1
258131004693;258131004941;248;9;1;1;1
258131004941;258131006830;1889;9;1;1;1
258131006830;258131007652;822;9;1;1;1
258131007652;258131007808;156;9;1;1;1
258131007808;258131011490;3682;9;1;1;1
258131011490;258131012577;1087;9;1;1;1
258131012577;258131013156;579;9;1;1;1
258131013156;258131013588;432;9;1;1;1
258131013588;258131014512;924;9;1;1;1
258131014512;258131015009;497;2,9;2;1;1
258131015009;258131015037;28;2,9;2;1;1
258131015037;258131019622;4585;9;1;1;1
258131019622;258131020995;1373;9;1;1;1
258131020995;258131021272;277;9;1;1;1
258131021272;258131021826;554;9;1;1;1
258131021826;258131023609;1783;9;1;1;1
258131023609;258131024252;643;9;1;1;1
258131024252;258131027393;3141;9;1;1;1
258131027393;258131032765;5372;9;1;1;1
258131032765;258131045300;12535;9;1;1;1
258131045300;258131046389;1089;9;1;1;1
258131046389;258131047849;1460;9;1;1;1
258131047849;258131048111;262;9;1;1;1
258131048111;258131050814;2703;9;1;1;1
258131050814;258131053089;2275;9;1;1;1
258131053089;258131058277;5188;9;1;1;1
258131058277;258131061781;3504;9;1;1;1
258131061781;258131063450;1669;9;1;1;1
258131063450;258131064343;893;9;1;1;1
258131064343;258131068311;3968;9;1;1;1
258131068311;258131071230;2919;9;1;1;1
258131071230;258131074577;3347;9;1;1;1
258131074577;258131076297;1720;9;1;1;1
258131076297;258131076967;670;9;1;1;1
258131076967;258131077320;353;9;1;1;1
258131077320;258131078865;1545;9;1;1;1
258131078865;258131082518;3653;9;1;1;1
258131082518;258131084480;1962;9;1;1;1
258131084480;258131084543;63;9;1;1;1
258131084543;258131085419;876;9;1;1;1
258131085419;258131086039;620;9;1;1;1
258131086039;258131087541;1502;9;1;1;1
258131087541;258131094473;6932;9;1;1;1
258131094473;258131097860;3387;9;1;1;1
258131097860;258131099110;1250;9;1;1;1
258131099110;258131100195;1085;9;1;1;1
258131100195;258131104077;3882;9;1;1;1
258131104077;258131104691;614;2,9;2;1;1
258131104691;258131106058;1367;9;1;1;1
258131106058;258131107545;1487;9;1;1;1
258131107545;258131108372;827;9;1;1;1
258131108372;258131112585;4213;9;1;1;1
258131112585;258131113787;1202;9;1;1;1
258131113787;258131120619;6832;9;1;1;1
258131120619;258131128286;7667;9;1;1;1
258131128286;258131138755;10469;9;1;1;1
258131138755;258131140126;1371;9;1;1;1
258131140126;258131144215;4089;9;1;1;1
258131144215;258131145313;1098;9;1;1;1
258131145313;258131160519;15206;9;1;1;1
258131160519;258131165607;5088;9;1;1;1
258131165607;258131166945;1338;9;1;1;1
258131166945;258131168270;1325;9;1;1;1
258131168270;258131169234;964;9;1;1;1
258131169234;258131173038;3804;9;1;1;1
258131173038;258131174010;972;2,9;2;1;1
258131174010;258131176237;2227;9;1;1;1
258131176237;258131178584;2347;9;1;1;1
258131178584;258131179182;598;9;1;1;1
258131179182;258131189839;10657;9;1;1;1
258131189839;258131190680;841;9;1;1;1
258131190680;258131190997;317;9;1;1;1
258131190997;258131196031;5034;9;1;1;1
258131196031;258131205943;9912;9;1;1;1
258131205943;258131206937;994;9;1;1;1
258131206937;258131210802;3865;9;1;1;1
258131210802;258131211810;1008;9;1;1;1
258131211810;258131214426;2616;9;1;1;1
258131214426;258131229140;14714;9;1;1;1
258131229140;258131230573;1433;9;1;1;1
258131230573;258131231423;850;9;1;1;1
258131231423;258131239260;7837;9;1;1;1
258131239260;258131240011;751;9;1;1;1
258131240011;258131240547;536;2,9;2;1;1
258131240547;258131241796;1249;9;1;1;1
258131241796;258131242641;845;9;1;1;1
258131242641;258131243052;411;9;1;1;1
258131243052;258131245471;2419;9;1;1;1
258131245471;258131246157;686;9;1;1;1
258131246157;258131247208;1051;9;1;1;1
258131247208;258131248289;1081;9;1;1;1
258131248289;258131248303;14;9;1;1;1
258131248303;258131249547;1244;9;1;1;1
258131249547;258131249945;398;9;1;1;1
258131249945;258131252734;2789;9;1;1;1
258131252734;258131252782;48;9;1;1;1
258131252782;258131252790;8;9;1;1;1
258131252790;258131253350;560;9;1;1;1
258131253350;258131253608;258;9;1;1;1
258131253608;258131255443;1835;9;1;1;1
258131255443;258131257336;1893;9;1;1;1
258131257336;258131257718;382;9;1;1;1
258131257718;258131259009;1291;9;1;1;1
258131259009;258131259435;426;9;1;1;1
258131259435;258131261638;2203;9;1;1;1
258131261638;258131263366;1728;9;1;1;1
258131263366;258131264012;646;9;1;1;1
258131264012;258131264613;601;9;1;1;1
258131264613;258131264907;294;9;1;1;1
258131264907;258131267169;2262;9;1;1;1
258131267169;258131268506;1337;9;1;1;1
258131268506;258131269269;763;9;1;1;1
258131269269;258131271266;1997;9;1;1;1
258131271266;258131271587;321;9;1;1;1
258131271587;258131272422;835;9;1;1;1
258131272422;258131275842;3420;9;1;1;1
258131275842;258131285654;9812;9;1;1;1
258131285654;258131298758;13104;9;1;1;1
258131298758;258131299036;278;9;1;1;1
258131299036;258131299117;81;9;1;1;1
258131299117;258131299313;196;9;1;1;1
258131299313;258131299391;78;9;1;1;1
258131299391;258131300222;831;9;1;1;1
258131300222;258131300232;10;9;1;1;1
258131300232;258131300595;363;9;1;1;1
258131300595;258131301320;725;9;1;1;1
258131301320;258131303889;2569;9;1;1;1
258131303889;258131304546;657;9;1;1;1
258131304546;258131306252;1706;9;1;1;1
258131306252;258131310506;4254;9;1;1;1
258131310506;258131314632;4126;9;1;1;1
258131314632;258131317207;2575;9;1;1;1
258131317207;258131317838;631;2,9;2;1;1
258131317838;258131319330;1492;9;1;1;1
258131319330;258131319952;622;9;1;1;1
258131319952;258131327249;7297;9;1;1;1
258131327249;258131329274;2025;9;1;1;1
258131329274;258131330683;1409;9;1;1;1
258131330683;258131335775;5092;9;1;1;1
258131335775;258131340374;4599;9;1;1;1
258131340374;258131347033;6659;9;1;1;1
258131347033;258131352390;5357;9;1;1;1
258131352390;258131362502;10112;9;1;1;1
258131362502;258131365941;3439;9;1;1;1
258131365941;258131369094;3153;9;1;1;1
258131369094;258131372119;3025;9;1;1;1
258131372119;258131375132;3013;9;1;1;1
258131375132;258131383016;7884;9;1;1;1
258131383016;258131385045;2029;9;1;1;1
258131385045;258131385647;602;9;1;1;1
258131385647;258131386764;1117;9;1;1;1
258131386764;258131390420;3656;9;1;1;1
258131390420;258131390735;315;9;1;1;1
258131390735;258131391124;389;2,9;2;1;1
258131391124;258131391203;79;2,9;2;1;1
258131391203;258131393400;2197;9;1;1;1
258131393400;258131393878;478;9;1;1;1
258131393878;258131394260;382;9;1;1;1
258131394260;258131395507;1247;9;1;1;1
258131395507;258131395554;47;9;1;1;1
258131395554;258131397154;1600;9;1;1;1
258131397154;258131398922;1768;9;1;1;1
258131398922;258131399020;98;9;1;1;1
258131399020;258131399378;358;9;1;1;1
258131399378;258131399627;249;9;1;1;1
258131399627;258131399653;26;9;1;1;1
258131399653;258131400604;951;9;1;1;1
258131400604;258131401534;930;9;1;1;1
258131401534;258131402817;1283;9;1;1;1
258131402817;258131404590;1773;9;1;1;1
258131404590;258131404713;123;9;1;1;1
258131404713;258131405668;955;9;1;1;1
258131405668;258131405782;114;9;1;1;1
258131405782;258131407563;1781;9;1;1;1
258131407563;258131407982;419;9;1;1;1
258131407982;258131408770;788;9;1;1;1
258131408770;258131409213;443;9;1;1;1
258131409213;258131410511;1298;9;1;1;1
258131410511;258131410784;273;9;1;1;1
258131410784;258131411297;513;9;1;1;1
258131411297;258131411532;235;9;1;1;1
258131411532;258131412608;1076;9;1;1;1
258131412608;258131413060;452;9;1;1;1
258131413060;258131415392;2332;9;1;1;1
258131415392;258131415502;110;9;1;1;1
258131415502;258131418048;2546;9;1;1;1
258131418048;258131420276;2228;9;1;1;1
258131420276;258131420973;697;9;1;1;1
258131420973;258131424433;3460;9;1;1;1
258131424433;258131425138;705;9;1;1;1
258131425138;258131425286;148;9;1;1;1
258131425286;258131427229;1943;9;1;1;1
258131427229;258131433570;6341;9;1;1;1
258131433570;258131433644;74;9;1;1;1
258131433644;258131433923;279;9;1;1;1
258131433923;258131435048;1125;9;1;1;1
258131435048;258131437510;2462;9;1;1;1
258131437510;258131438695;1185;9;1;1;1
258131438695;258131440139;1444;9;1;1;1
258131440139;258131441183;1044;9;1;1;1
258131441183;258131443374;2191;9;1;1;1
258131443374;258131445977;2603;9;1;1;1
258131445977;258131447450;1473;9;1;1;1
258131447450;258131453927;6477;9;1;1;1
258131453927;258131455099;1172;9;1;1;1
258131455099;258131455717;618;9;1;1;1
258131455717;258131455724;7;9;1;1;1
258131455724;258131455919;195;2,9;2;1;1
258131455919;258131456171;252;2,9;2;1;1
258131456171;258131456362;191;2,9;2;1;1
258131456362;258131460807;4445;9;1;1;1
258131460807;258131462350;1543;9;1;1;1
258131462350;258131464266;1916;9;1;1;1
258131464266;258131465491;1225;9;1;1;1
258131465491;258131466075;584;9;1;1;1
258131466075;258131469443;3368;9;1;1;1
258131469443;258131472971;3528;9;1;1;1
258131472971;258131474419;1448;9;1;1;1
258131474419;258131475351;932;9;1;1;1
258131475351;258131477354;2003;9;1;1;1
258131477354;258131479020;1666;9;1;1;1
258131479020;258131479280;260;9;1;1;1
258131479280;258131486783;7503;9;1;1;1
258131486783;258131488552;1769;9;1;1;1
258131488552;258131489943;1391;9;1;1;1
258131489943;258131491611;1668;9;1;1;1
258131491611;258131493071;1460;9;1;1;1
258131493071;258131493441;370;9;1;1;1
258131493441;258131497091;3650;9;1;1;1
258131497091;258131497901;810;9;1;1;1
258131497901;258131502116;4215;9;1;1;1
258131502116;258131503063;947;9;1;1;1
258131503063;258131504141;1078;9;1;1;1
258131504141;258131505273;1132;9;1;1;1
258131505273;258131505375;102;9;1;1;1
258131505375;258131513959;8584;9;1;1;1
258131513959;258131514490;531;2,9;2;1;1
258131514490;258131517449;2959;9;1;1;1
258131517449;258131518975;1526;9;1;1;1
258131518975;258131521730;2755;9;1;1;1
258131521730;258131534450;12720;9;1;1;1
258131534450;258131536507;2057;9;1;1;1
258131536507;258131551182;14675;9;1;1;1
258131551182;258131551250;68;9;1;1;1
258131551250;258131551815;565;9;1;1;1
258131551815;258131552638;823;9;1;1;1
258131552638;258131553414;776;9;1;1;1
258131553414;258131558404;4990;9;1;1;1
258131558404;258131565050;6646;9;1;1;1
258131565050;258131574953;9903;9;1;1;1
258131574953;258131575021;68;9;1;1;1
258131575021;258131580592;5571;9;1;1;1
258131580592;258131586793;6201;9;1;1;1
258131586793;258131586930;137;9;1;1;1
258131586930;258131587859;929;9;1;1;1
258131587859;258131592774;4915;9;1;1;1
258131592774;258131593718;944;9;1;1;1
258131593718;258131594028;310;9;1;1;1
258131594028;258131597238;3210;9;1;1;1
258131597238;258131597605;367;2,9;2;1;1
258131597605;258131597748;143;2,9;2;1;1
258131597748;258131597753;5;2,9;2;1;1
258131597753;258131598216;463;9;1;1;1
258131598216;258131599979;1763;9;1;1;1
258131599979;258131601399;1420;9;1;1;1
258131601399;258131607858;6459;9;1;1;1
258131607858;258131607946;88;9;1;1;1
258131607946;258131608647;701;9;1;1;1
258131608647;258131618143;9496;9;1;1;1
258131618143;258131619872;1729;9;1;1;1
258131619872;258131619909;37;9;1;1;1
258131619909;258131622053;2144;9;1;1;1
258131622053;258131622226;173;9;1;1;1
258131622226;258131622500;274;9;1;1;1
258131622500;258131622779;279;9;1;1;1
258131622779;258131626246;3467;9;1;1;1
258131626246;258131627372;1126;9;1;1;1
258131627372;258131627419;47;9;1;1;1
258131627419;258131633469;6050;9;1;1;1
258131633469;258131634520;1051;9;1;1;1
258131634520;258131635322;802;9;1;1;1
258131635322;258131635495;173;9;1;1;1
258131635495;258131640024;4529;9;1;1;1
258131640024;258131643976;3952;9;1;1;1
258131643976;258131644217;241;9;1;1;1
258131644217;258131645949;1732;9;1;1;1
258131645949;258131646140;191;9;1;1;1
258131646140;258131649268;3128;9;1;1;1
258131649268;258131650139;871;9;1;1;1
258131650139;258131659288;9149;9;1;1;1
258131659288;258131662260;2972;9;1;1;1
258131662260;258131662789;529;2,9;2;1;1
258131662789;258131667403;4614;9;1;1;1
258131667403;258131669430;2027;9;1;1;1
258131669430;258131674858;5428;9;1;1;1
258131674858;258131675968;1110;9;1;1;1
258131675968;258131678755;2787;9;1;1;1
258131678755;258131679981;1226;9;1;1;1
258131679981;258131680232;251;9;1;1;1
258131680232;258131681166;934;9;1;1;1
258131681166;258131681429;263;9;1;1;1
258131681429;258131681820;391;9;1;1;1
258131681820;258131690948;9128;9;1;1;1
258131690948;258131693160;2212;9;1;1;1
258131693160;258131695256;2096;9;1;1;1
258131695256;258131697053;1797;9;1;1;1
258131697053;258131699312;2259;9;1;1;1
258131699312;258131700356;1044;9;1;1;1
258131700356;258131703166;2810;9;1;1;1
258131703166;258131709120;5954;9;1;1;1
258131709120;258131711663;2543;9;1;1;1
258131711663;258131715067;3404;9;1;1;1
258131715067;258131718170;3103;9;1;1;1
258131718170;258131718952;782;9;1;1;1
258131718952;258131719192;240;9;1;1;1
258131719192;258131720544;1352;9;1;1;1
258131720544;258131721778;1234;9;1;1;1
258131721778;258131722956;1178;9;1;1;1
258131722956;258131723345;389;9;1;1;1
258131723345;258131727396;4051;9;1;1;1
258131727396;258131731349;3953;9;1;1;1
258131731349;258131733879;2530;9;1;1;1
258131733879;258131734304;425;9;1;1;1
258131734304;258131734921;617;2,9;2;1;1
258131734921;258131739670;4749;9;1;1;1
258131739670;258131754779;15109;9;1;1;1
258131754779;258131758857;4078;9;1;1;1
258131758857;258131759801;944;9;1;1;1
258131759801;258131767774;7973;9;1;1;1
258131767774;258131769600;1826;9;1;1;1
258131769600;258131770142;542;2,9;2;1;1
258131770142;258131773486;3344;9;1;1;1
258131773486;258131774371;885;9;1;1;1
258131774371;258131775546;1175;9;1;1;1
258131775546;258131775610;64;9;1;1;1
258131775610;258131776475;865;9;1;1;1
258131776475;258131777031;556;9;1;1;1
258131777031;258131788159;11128;9;1;1;1
258131788159;258131788691;532;9;1;1;1
258131788691;258131790702;2011;9;1;1;1
258131790702;258131792798;2096;9;1;1;1
258131792798;258131794102;1304;9;1;1;1
258131794102;258131794484;382;9;1;1;1
258131794484;258131794943;459;9;1;1;1
258131794943;258131795381;438;9;1;1;1
258131795381;258131795852;471;9;1;1;1
258131795852;258131798329;2477;9;1;1;1
258131798329;258131801783;3454;9;1;1;1
258131801783;258131802088;305;9;1;1;1
258131802088;258131802763;675;9;1;1;1
258131802763;258131823674;20911;9;1;1;1
258131823674;258131838577;14903;9;1;1;1
258131838577;258131838583;6;9;1;1;1
258131838583;258131840172;1589;9;1;1;1
258131840172;258131840664;492;9;1;1;1
258131840664;258131844212;3548;9;1;1;1
258131844212;258131854698;10486;9;1;1;1
258131854698;258131856585;1887;9;1;1;1
258131856585;258131857527;942;9;1;1;1
258131857527;258131857615;88;9;1;1;1
258131857615;258131858348;733;9;1;1;1
258131858348;258131860367;2019;9;1;1;1
258131860367;258131860618;251;9;1;1;1
258131860618;258131861625;1007;9;1;1;1
258131861625;258131862398;773;9;1;1;1
258131862398;258131863208;810;9;1;1;1
258131863208;258131864161;953;9;1;1;1
258131864161;258131865108;947;9;1;1;1
258131865108;258131865296;188;9;1;1;1
258131865296;258131865882;586;9;1;1;1
258131865882;258131865994;112;9;1;1;1
258131865994;258131866714;720;9;1;1;1
258131866714;258131866899;185;9;1;1;1
258131866899;258131866994;95;9;1;1;1
258131866994;258131867290;296;9;1;1;1
258131867290;258131868909;1619;9;1;1;1
258131868909;258131869860;951;9;1;1;1
258131869860;258131872807;2947;9;1;1;1
258131872807;258131873351;544;9;1;1;1
258131873351;258131873648;297;9;1;1;1
258131873648;258131874849;1201;9;1;1;1
258131874849;258131876485;1636;9;1;1;1
258131876485;258131877198;713;9;1;1;1
258131877198;258131880672;3474;9;1;1;1
258131880672;258131881671;999;9;1;1;1
258131881671;258131884315;2644;9;1;1;1
258131884315;258131884583;268;9;1;1;1
258131884583;258131892483;7900;9;1;1;1
258131892483;258131892850;367;9;1;1;1
258131892850;258131895109;2259;9;1;1;1
258131895109;258131896010;901;9;1;1;1
258131896010;258131897182;1172;9;1;1;1
258131897182;258131897477;295;9;1;1;1
258131897477;258131898226;749;9;1;1;1
258131898226;258131902759;4533;9;1;1;1
258131902759;258131903202;443;9;1;1;1
258131903202;258131904478;1276;9;1;1;1
258131904478;258131908310;3832;9;1;1;1
258131908310;258131913156;4846;9;1;1;1
258131913156;258131914821;1665;9;1;1;1
258131914821;258131915003;182;9;1;1;1
258131915003;258131919679;4676;9;1;1;1
258131919679;258131920462;783;9;1;1;1
258131920462;258131923084;2622;9;1;1;1
258131923084;258131924413;1329;9;1;1;1
258131924413;258131925862;1449;9;1;1;1
258131925862;258131926202;340;9;1;1;1
258131926202;258131929385;3183;9;1;1;1
258131929385;258131930178;793;2,9;2;1;1
258131930178;258131930505;327;2,9;2;1;1
258131930505;258131953789;23284;9;1;1;1
258131953789;258131958301;4512;9;1;1;1
258131958301;258131962759;4458;9;1;1;1
258131962759;258131964488;1729;9;1;1;1
258131964488;258131969326;4838;9;1;1;1
258131969326;258131975859;6533;9;1;1;1
258131975859;258131976187;328;9;1;1;1
258131976187;258131979992;3805;9;1;1;1
258131979992;258131980276;284;2,9;2;1;1
258131980276;258131980459;183;2,9;2;1;1
258131980459;258131983883;3424;9;1;1;1
258131983883;258131986311;2428;9;1;1;1
258131986311;258131992435;6124;9;1;1;1
258131992435;258131997062;4627;9;1;1;1
258131997062;258131998730;1668;9;1;1;1
258131998730;258131999124;394;9;1;1;1
258131999124;258132001133;2009;9;1;1;1
258132001133;258132001787;654;9;1;1;1
258132001787;258132002929;1142;9;1;1;1
258132002929;258132005149;2220;9;1;1;1
258132005149;258132005796;647;9;1;1;1
258132005796;258132012050;6254;9;1;1;1
258132012050;258132013248;1198;9;1;1;1
258132013248;258132013800;552;9;1;1;1
258132013800;258132015331;1531;9;1;1;1
258132015331;258132016084;753;9;1;1;1
258132016084;258132016861;777;9;1;1;1
258132016861;258132023154;6293;9;1;1;1
258132023154;258132023697;543;9;1;1;1
258132023697;258132026347;2650;9;1;1;1
258132026347;258132035410;9063;9;1;1;1
258132035410;258132036643;1233;9;1;1;1
258132036643;258132037676;1033;9;1;1;1
258132037676;258132038730;1054;9;1;1;1
258132038730;258132047410;8680;9;1;1;1
258132047410;258132048895;1485;9;1;1;1
258132048895;258132053946;5051;9;1;1;1
258132053946;258132054601;655;2,9;2;1;1
258132054601;258132060615;6014;9;1;1;1
258132060615;258132071178;10563;9;1;1;1
258132071178;258132073632;2454;9;1;1;1
258132073632;258132075878;2246;9;1;1;1
258132075878;258132092485;16607;9;1;1;1
258132092485;258132096418;3933;9;1;1;1
258132096418;258132097085;667;9;1;1;1
258132097085;258132108539;11454;9;1;1;1
258132108539;258132109283;744;9;1;1;1
258132109283;258132111511;2228;9;1;1;1
258132111511;258132114060;2549;9;1;1;1
258132114060;258132116541;2481;9;1;1;1
258132116541;258132117139;598;9;1;1;1
258132117139;258132117917;778;9;1;1;1
258132117917;258132118298;381;9;1;1;1
258132118298;258132118972;674;9;1;1;1
258132118972;258132119725;753;9;1;1;1
258132119725;258132120022;297;9;1;1;1
258132120022;258132121492;1470;9;1;1;1
258132121492;258132123877;2385;9;1;1;1
258132123877;258132125481;1604;9;1;1;1
258132125481;258132127547;2066;9;1;1;1
258132127547;258132128966;1419;9;1;1;1
258132128966;258132135918;6952;9;1;1;1
258132135918;258132139720;3802;9;1;1;1
258132139720;258132140087;367;9;1;1;1
258132140087;258132140232;145;9;1;1;1
258132140232;258132140260;28;9;1;1;1
258132140260;258132140536;276;9;1;1;1
258132140536;258132140916;380;9;1;1;1
258132140916;258132142636;1720;9;1;1;1
258132142636;258132144649;2013;9;1;1;1
258132144649;258132150435;5786;9;1;1;1
258132150435;258132151161;726;9;1;1;1
258132151161;258132152017;856;9;1;1;1
258132152017;258132152234;217;9;1;1;1
258132152234;258132153159;925;9;1;1;1
258132153159;258132154999;1840;9;1;1;1
258132154999;258132156006;1007;9;1;1;1
258132156006;258132156835;829;9;1;1;1
258132156835;258132173987;17152;9;1;1;1
258132173987;258132174041;54;9;1;1;1
258132174041;258132179079;5038;9;1;1;1
258132179079;258132180270;1191;9;1;1;1
258132180270;258132181640;1370;9;1;1;1
258132181640;258132185792;4152;9;1;1;1
258132185792;258132186493;701;9;1;1;1
258132186493;258132188171;1678;9;1;1;1
258132188171;258132188710;539;9;1;1;1
258132188710;258132190182;1472;9;1;1;1
258132190182;258132198198;8016;9;1;1;1
258132198198;258132202102;3904;9;1;1;1
258132202102;258132202310;208;9;1;1;1
258132202310;258132203587;1277;9;1;1;1
258132203587;258132204068;481;9;1;1;1
258132204068;258132205483;1415;9;1;1;1
258132205483;258132207338;1855;9;1;1;1
258132207338;258132208173;835;9;1;1;1
258132208173;258132210215;2042;9;1;1;1
258132210215;258132210245;30;9;1;1;1
258132210245;258132210808;563;9;1;1;1
258132210808;258132211346;538;9;1;1;1
258132211346;258132211649;303;9;1;1;1
258132211649;258132211979;330;9;1;1;1
258132211979;258132212345;366;9;1;1;1
258132212345;258132220684;8339;9;1;1;1
258132220684;258132230514;9830;9;1;1;1
258132230514;258132232185;1671;9;1;1;1
258132232185;258132232797;612;2,9;2;1;1
258132232797;258132235523;2726;9;1;1;1
258132235523;258132236479;956;9;1;1;1
258132236479;258132236598;119;9;1;1;1
258132236598;258132237848;1250;9;1;1;1
258132237848;258132238514;666;9;1;1;1
258132238514;258132239848;1334;9;1;1;1
258132239848;258132240522;674;9;1;1;1
258132240522;258132240572;50;9;1;1;1
258132240572;258132242415;1843;9;1;1;1
258132242415;258132244561;2146;9;1;1;1
258132244561;258132246726;2165;9;1;1;1
258132246726;258132247077;351;9;1;1;1
258132247077;258132247202;125;9;1;1;1
258132247202;258132247378;176;9;1;1;1
258132247378;258132250950;3572;9;1;1;1
258132250950;258132251643;693;9;1;1;1
258132251643;258132252602;959;9;1;1;1
258132252602;258132252693;91;9;1;1;1
258132252693;258132252906;213;9;1;1;1
258132252906;258132253442;536;9;1;1;1
258132253442;258132255590;2148;9;1;1;1
258132255590;258132258708;3118;9;1;1;1
258132258708;258132261265;2557;9;1;1;1
258132261265;258132262676;1411;9;1;1;1
258132262676;258132262899;223;9;1;1;1
258132262899;258132263900;1001;9;1;1;1
258132263900;258132264974;1074;9;1;1;1
258132264974;258132266213;1239;9;1;1;1
258132266213;258132266744;531;9;1;1;1
258132266744;258132268675;1931;9;1;1;1
258132268675;258132269128;453;9;1;1;1
258132269128;258132269536;408;9;1;1;1
258132269536;258132284671;15135;9;1;1;1
258132284671;258132287139;2468;9;1;1;1
258132287139;258132287696;557;9;1;1;1
258132287696;258132290005;2309;9;1;1;1
258132290005;258132291652;1647;9;1;1;1
258132291652;258132296537;4885;9;1;1;1
258132296537;258132297064;527;9;1;1;1
258132297064;258132307468;10404;9;1;1;1
258132307468;258132324525;17057;9;1;1;1
258132324525;258132327822;3297;9;1;1;1
258132327822;258132336625;8803;9;1;1;1
258132336625;258132339000;2375;9;1;1;1
258132339000;258132339835;835;9;1;1;1
258132339835;258132340683;848;9;1;1;1
258132340683;258132344111;3428;9;1;1;1
258132344111;258132349439;5328;9;1;1;1
258132349439;258132349455;16;9;1;1;1
258132349455;258132349713;258;9;1;1;1
258132349713;258132350775;1062;9;1;1;1
258132350775;258132351420;645;9;1;1;1
258132351420;258132351902;482;9;1;1;1
258132351902;258132352730;828;9;1;1;1
258132352730;258132353475;745;9;1;1;1
258132353475;258132353960;485;2,9;2;1;1
258132353960;258132354152;192;9;1;1;1
258132354152;258132355087;935;9;1;1;1
258132355087;258132355819;732;9;1;1;1
258132355819;258132365824;10005;9;1;1;1
258132365824;258132370585;4761;9;1;1;1
258132370585;258132371696;1111;9;1;1;1
258132371696;258132394111;22415;9;1;1;1
258132394111;258132394932;821;9;1;1;1
258132394932;258132401594;6662;9;1;1;1
258132401594;258132402794;1200;9;1;1;1
258132402794;258132420620;17826;9;1;1;1
258132420620;258132422094;1474;9;1;1;1
258132422094;258132425351;3257;9;1;1;1
258132425351;258132438120;12769;9;1;1;1
258132438120;258132438594;474;9;1;1;1
258132438594;258132448761;10167;9;1;1;1
258132448761;258132455466;6705;9;1;1;1
258132455466;258132457800;2334;9;1;1;1
258132457800;258132466316;8516;9;1;1;1
258132466316;258132466902;586;2,9;2;1;1
258132466902;258132467005;103;2,9;2;1;1
258132467005;258132467068;63;2,9;2;1;1
258132467068;258132467811;743;2,9;2;1;1
258132467811;258132469891;2080;9;1;1;1
258132469891;258132470228;337;9;1;1;1
258132470228;258132470745;517;9;1;1;1
258132470745;258132471352;607;9;1;1;1
258132471352;258132471688;336;9;1;1;1
258132471688;258132473378;1690;9;1;1;1
258132473378;258132475690;2312;9;1;1;1
258132475690;258132475873;183;9;1;1;1
258132475873;258132477246;1373;9;1;1;1
258132477246;258132480583;3337;9;1;1;1
258132480583;258132483622;3039;9;1;1;1
258132483622;258132483964;342;9;1;1;1
258132483964;258132542961;58997;9;1;1;1
258132542961;258132546781;3820;9;1;1;1
258132546781;258132548430;1649;9;1;1;1
258132548430;258132548578;148;9;1;1;1
258132548578;258132549224;646;9;1;1;1
258132549224;258132550402;1178;9;1;1;1
258132550402;258132555097;4695;9;1;1;1
258132555097;258132560453;5356;9;1;1;1
258132560453;258132561005;552;2,9;2;1;1
258132561005;258132569108;8103;9;1;1;1
258132569108;258132573379;4271;9;1;1;1
258132573379;258132594555;21176;9;1;1;1
258132594555;258132595008;453;2,9;2;1;1
258132595008;258132605896;10888;9;1;1;1
258132605896;258132607292;1396;9;1;1;1
258132607292;258132618122;10830;9;1;1;1
258132618122;258132631594;13472;9;1;1;1
258132631594;258132632640;1046;9;1;1;1
258132632640;258132634678;2038;9;1;1;1
258132634678;258132635095;417;9;1;1;1
258132635095;258132635621;526;2,9;2;1;1
258132635621;258132637756;2135;9;1;1;1
258132637756;258132638196;440;9;1;1;1
258132638196;258132638970;774;9;1;1;1
258132638970;258132643365;4395;9;1;1;1
258132643365;258132646889;3524;9;1;1;1
258132646889;258132648374;1485;9;1;1;1
258132648374;258132650749;2375;9;1;1;1
258132650749;258132653319;2570;9;1;1;1
258132653319;258132654303;984;9;1;1;1
258132654303;258132654488;185;9;1;1;1
258132654488;258132655419;931;9;1;1;1
258132655419;258132656072;653;9;1;1;1
258132656072;258132657056;984;9;1;1;1
258132657056;258132660560;3504;9;1;1;1
258132660560;258132664323;3763;9;1;1;1
258132664323;258132664370;47;9;1;1;1
258132664370;258132667339;2969;9;1;1;1
258132667339;258132672166;4827;9;1;1;1
258132672166;258132674946;2780;9;1;1;1
258132674946;258132677911;2965;9;1;1;1
258132677911;258132679167;1256;9;1;1;1
258132679167;258132679237;70;9;1;1;1
258132679237;258132680196;959;9;1;1;1
258132680196;258132680564;368;9;1;1;1
258132680564;258132680832;268;9;1;1;1
258132680832;258132680941;109;9;1;1;1
258132680941;258132681272;331;9;1;1;1
258132681272;258132681430;158;9;1;1;1
258132681430;258132681622;192;9;1;1;1
258132681622;258132681988;366;2,9;2;1;1
258132681988;258132682088;100;2,9;2;1;1
258132682088;258132682962;874;9;1;1;1
258132682962;258132683894;932;9;1;1;1
258132683894;258132684001;107;9;1;1;1
258132684001;258132685406;1405;9;1;1;1
258132685406;258132688686;3280;9;1;1;1
258132688686;258132693347;4661;9;1;1;1
258132693347;258132695506;2159;9;1;1;1
258132695506;258132701917;6411;9;1;1;1
258132701917;258132704504;2587;9;1;1;1
258132704504;258132714964;10460;9;1;1;1
258132714964;258132717188;2224;9;1;1;1
258132717188;258132718129;941;9;1;1;1
258132718129;258132723558;5429;9;1;1;1
258132723558;258132725126;1568;2,9;2;1;1
258132725126;258132725746;620;9;1;1;1
258132725746;258132726785;1039;2,9;2;1;1
258132726785;258132727284;499;9;1;1;1
258132727284;258132728091;807;9;1;1;1
258132728091;258132728717;626;2,9;2;1;1
258132728717;258132742547;13830;9;1;1;1
258132742547;258132751230;8683;9;1;1;1
258132751230;258132753445;2215;9;1;1;1
258132753445;258132757709;4264;9;1;1;1
258132757709;258132762096;4387;9;1;1;1
258132762096;258132773855;11759;9;1;1;1
258132773855;258132785373;11518;9;1;1;1
258132785373;258132786653;1280;9;1;1;1
258132786653;258132793912;7259;9;1;1;1
258132793912;258132811279;17367;9;1;1;1
258132811279;258132835820;24541;9;1;1;1
258132835820;258132838347;2527;9;1;1;1
258132838347;258132848298;9951;9;1;1;1
258132848298;258132848416;118;9;1;1;1
258132848416;258132849882;1466;9;1;1;1
258132849882;258132850692;810;9;1;1;1
258132850692;258132852565;1873;9;1;1;1
258132852565;258132852588;23;9;1;1;1
258132852588;258132857440;4852;9;1;1;1
258132857440;258132862639;5199;9;1;1;1
258132862639;258132872502;9863;9;1;1;1
258132872502;258132897306;24804;9;1;1;1
258132897306;258132921843;24537;9;1;1;1
258132921843;258132925950;4107;9;1;1;1
258132925950;258132927170;1220;9;1;1;1
258132927170;258132928400;1230;9;1;1;1
258132928400;258132928619;219;9;1;1;1
258132928619;258132928841;222;9;1;1;1
258132928841;258132929724;883;9;1;1;1
258132929724;258132929875;151;9;1;1;1
258132929875;258132930358;483;2,9;2;1;1
258132930358;258132930534;176;2,9;2;1;1
258132930534;258132930882;348;9;1;1;1
258132930882;258132931421;539;9;1;1;1
258132931421;258132931949;528;9;1;1;1
258132931949;258132932203;254;9;1;1;1
258132932203;258132932435;232;9;1;1;1
258132932435;258132933251;816;9;1;1;1
258132933251;258132934748;1497;9;1;1;1
258132934748;258132936132;1384;9;1;1;1
258132936132;258132936232;100;9;1;1;1
258132936232;258132936776;544;9;1;1;1
258132936776;258132938207;1431;9;1;1;1
258132938207;258132938458;251;9;1;1;1
258132938458;258132939282;824;9;1;1;1
258132939282;258132949451;10169;9;1;1;1
258132949451;258132949487;36;9;1;1;1
258132949487;258132949856;369;9;1;1;1
258132949856;258132949897;41;9;1;1;1
258132949897;258132952907;3010;9;1;1;1
258132952907;258132953411;504;9;1;1;1
258132953411;258132954687;1276;9;1;1;1
258132954687;258132954958;271;9;1;1;1
258132954958;258132955945;987;9;1;1;1
258132955945;258132957960;2015;9;1;1;1
258132957960;258132958323;363;9;1;1;1
258132958323;258132958700;377;9;1;1;1
258132958700;258132959092;392;9;1;1;1
258132959092;258132959206;114;9;1;1;1
258132959206;258132959770;564;9;1;1;1
258132959770;258132960538;768;9;1;1;1
258132960538;258132961052;514;9;1;1;1
258132961052;258132961555;503;9;1;1;1
258132961555;258132962055;500;9;1;1;1
258132962055;258132962700;645;9;1;1;1
258132962700;258132962904;204;9;1;1;1
258132962904;258132963969;1065;9;1;1;1
258132963969;258132964006;37;9;1;1;1
258132964006;258132964232;226;9;1;1;1
258132964232;258132965422;1190;9;1;1;1
258132965422;258132965535;113;9;1;1;1
258132965535;258132965615;80;9;1;1;1
258132965615;258132966542;927;9;1;1;1
258132966542;258132966795;253;9;1;1;1
258132966795;258132967086;291;9;1;1;1
258132967086;258132967312;226;9;1;1;1
258132967312;258132968786;1474;9;1;1;1
258132968786;258132969595;809;9;1;1;1
258132969595;258132969937;342;9;1;1;1
258132969937;258132970187;250;9;1;1;1
258132970187;258132970314;127;9;1;1;1
258132970314;258132971989;1675;9;1;1;1
258132971989;258132973364;1375;9;1;1;1
258132973364;258132974291;927;9;1;1;1
258132974291;258132974366;75;9;1;1;1
258132974366;258132975044;678;9;1;1;1
258132975044;258132979933;4889;9;1;1;1
258132979933;258132983172;3239;9;1;1;1
258132983172;258132983903;731;9;1;1;1
258132983903;258132984833;930;9;1;1;1
258132984833;258132985243;410;9;1;1;1
258132985243;258132988237;2994;9;1;1;1
258132988237;258133003578;15341;9;1;1;1
258133003578;258133003787;209;2,9;2;1;1
258133003787;258133003854;67;2,9;2;1;1
258133003854;258133004228;374;2,9;2;1;1
258133004228;258133005905;1677;9;1;1;1
258133005905;258133013268;7363;9;1;1;1
258133013268;258133033372;20104;9;1;1;1
258133033372;258133045243;11871;9;1;1;1
258133045243;258133050489;5246;9;1;1;1
258133050489;258133052025;1536;9;1;1;1
258133052025;258133063432;11407;9;1;1;1
258133063432;258133075056;11624;9;1;1;1
258133075056;258133080844;5788;9;1;1;1
258133080844;258133081414;570;2,9;2;1;1
258133081414;258133146183;64769;9;1;1;1
258133146183;258133148037;1854;2,9;2;1;1
258133148037;258133150145;2108;2,9;2;1;1
258133150145;258133176958;26813;2,9;2;1;1
258133176958;258133182623;5665;2,9;2;1;1
258133182623;258133183358;735;2,9;2;1;1
258133183358;258133186482;3124;2,9;2;1;1
258133186482;258133186946;464;2,9;2;1;1
258133186946;258133187027;81;2,9;2;1;1
258133187027;258133187420;393;2,9;2;1;1
258133187420;258133187787;367;2,9;2;1;1
258133187787;258133189177;1390;2,9;2;1;1
258133189177;258133191545;2368;2,9;2;1;1
258133191545;258133193829;2284;2,9;2;1;1
258133193829;258133194929;1100;2,9;2;1;1
258133194929;258133195673;744;2,9;2;1;1
258133195673;258133197304;1631;2,9;2;1;1
258133197304;258133197570;266;2,9;2;1;1
258133197570;258133197886;316;2,9;2;1;1
258133197886;258133198149;263;2,9;2;1;1
258133198149;258133198425;276;2,9;2;1;1
258133198425;258133199360;935;2,9;2;1;1
258133199360;258133201060;1700;2,9;2;1;1
258133201060;258133204229;3169;2,9;2;1;1
258133204229;258133205993;1764;2,9;2;1;1
258133205993;258133206312;319;2,9;2;1;1
258133206312;258133207057;745;2,9;2;1;1
258133207057;258133207278;221;9;1;1;1
258133207278;258133207339;61;9;1;1;1
258133207339;258133207552;213;2,9;2;1;1
258133207552;258133208367;815;2,9;2;1;1
258133208367;258133209207;840;9;1;1;1
258133209207;258133209588;381;9;1;1;1
258133209588;258133210145;557;2,9;2;1;1
258133210145;258133211874;1729;9;1;1;1
258133211874;258133211897;23;9;1;1;1
258133211897;258133212874;977;9;1;1;1
258133212874;258133213079;205;9;1;1;1
258133213079;258133216877;3798;9;1;1;1
258133216877;258133217312;435;9;1;1;1
258133217312;258133218606;1294;9;1;1;1
258133218606;258133218942;336;9;1;1;1
258133218942;258133220769;1827;9;1;1;1
258133220769;258133222118;1349;9;1;1;1
258133222118;258133222596;478;9;1;1;1
258133222596;258133224187;1591;9;1;1;1
258133224187;258133227092;2905;9;1;1;1
258133227092;258133237438;10346;9;1;1;1
258133237438;258133237913;475;2,9;2;1;1
258133237913;258133255408;17495;9;1;1;1
258133255408;258133255637;229;9;1;1;1
258133255637;258133267176;11539;9;1;1;1
258133267176;258133270380;3204;9;1;1;1
258133270380;258133272591;2211;9;1;1;1
258133272591;258133280150;7559;9;1;1;1
258133280150;258133329426;49276;9;1;1;1
258133329426;258133330363;937;2,9;2;1;1
258133330363;258133331578;1215;9;1;1;1
258133331578;258133332549;971;2,9;2;1;1
258133332549;258133333859;1310;9;1;1;1
258133333859;258133334525;666;2,9;2;1;1
258133334525;258133335801;1276;9;1;1;1
258133335801;258133352567;16766;9;1;1;1
258133352567;258133355628;3061;9;1;1;1
258133355628;258133361194;5566;9;1;1;1
258133361194;258133362292;1098;9;1;1;1
258133362292;258133363033;741;9;1;1;1
258133363033;258133363322;289;9;1;1;1
258133363322;258133363341;19;9;1;1;1
258133363341;258133364840;1499;9;1;1;1
258133364840;258133365343;503;9;1;1;1
258133365343;258133368131;2788;9;1;1;1
258133368131;258133381901;13770;9;1;1;1
258133381901;258133389052;7151;9;1;1;1
258133389052;258133389107;55;9;1;1;1
258133389107;258133400722;11615;9;1;1;1
258133400722;258133400750;28;9;1;1;1
258133400750;258133401137;387;9;1;1;1
258133401137;258133403092;1955;9;1;1;1
258133403092;258133403965;873;9;1;1;1
258133403965;258133404593;628;2,9;2;1;1
258133404593;258133409538;4945;9;1;1;1
258133409538;258133410039;501;9;1;1;1
258133410039;258133412872;2833;9;1;1;1
258133412872;258133413300;428;9;1;1;1
258133413300;258133414127;827;9;1;1;1
258133414127;258133416064;1937;9;1;1;1
258133416064;258133416512;448;9;1;1;1
258133416512;258133416972;460;9;1;1;1
258133416972;258133417992;1020;9;1;1;1
258133417992;258133419260;1268;9;1;1;1
258133419260;258133420966;1706;9;1;1;1
258133420966;258133423312;2346;9;1;1;1
258133423312;258133429198;5886;9;1;1;1
258133429198;258133429256;58;9;1;1;1
258133429256;258133431745;2489;9;1;1;1
258133431745;258133431931;186;9;1;1;1
258133431931;258133432870;939;9;1;1;1
258133432870;258133433551;681;9;1;1;1
258133433551;258133433758;207;9;1;1;1
258133433758;258133434931;1173;9;1;1;1
258133434931;258133435431;500;9;1;1;1
258133435431;258133436200;769;9;1;1;1
258133436200;258133436704;504;9;1;1;1
258133436704;258133438318;1614;9;1;1;1
258133438318;258133449306;10988;9;1;1;1
258133449306;258133458113;8807;9;1;1;1
258133458113;258133479173;21060;9;1;1;1
258133479173;258133479724;551;9;1;1;1
258133479724;258133486085;6361;9;1;1;1
258133486085;258133486719;634;2,9;2;1;1
258133486719;258133486925;206;9;1;1;1
258133486925;258133489291;2366;9;1;1;1
258133489291;258133498021;8730;9;1;1;1
258133498021;258133499439;1418;9;1;1;1
258133499439;258133501383;1944;9;1;1;1
258133501383;258133501386;3;9;1;1;1
258133501386;258133501650;264;9;1;1;1
258133501650;258133501814;164;9;1;1;1
258133501814;258133502402;588;9;1;1;1
258133502402;258133503621;1219;9;1;1;1
258133503621;258133513097;9476;9;1;1;1
258133513097;258133513124;27;9;1;1;1
258133513124;258133515298;2174;9;1;1;1
258133582749;258133591752;9003;9;1;1;1
258133591752;258133601628;9876;9;1;1;1
258133601628;258133602174;546;2,9;2;1;1
258133602174;258133611201;9027;9;1;1;1
258133611201;258133654326;43125;9;1;1;1
258133707912;258133736942;29030;9;1;1;1
258133736942;258133738033;1091;2,9;2;1;1
258133738033;258133739220;1187;9;1;1;1
258133739220;258133739792;572;2,9;2;1;1
258133739792;258133753847;14055;9;1;1;1
258133753847;258133780456;26609;9;1;1;1
258133780456;258133813790;33334;9;1;1;1
258133813790;258133814285;495;2,9;2;1;1
258133814285;258133840914;26629;9;1;1;1
