start;end;duration;jobs;njobs;days;ndays
258096948738;258096948810;72;2,9;2;1;1
258096948810;258096948852;42;2,9;2;1;1
258096948852;258096948876;24;2,9;2;1;1
258096948876;258096948885;9;2,9;2;1;1
258096948885;258096948926;41;2,9;2;1;1
258096948926;258096949047;121;2,9;2;1;1
258096949047;258096949114;67;2,9;2;1;1
258097000508;258097000598;90;2,9;2;1;1
258097000598;258097000675;77;2,9;2;1;1
258097000675;258097000684;9;2,9;2;1;1
258097007753;258097007777;24;2,9;2;1;1
258097007777;258097007883;106;2,9;2;1;1
258097007883;258097007964;81;2,9;2;1;1
258097061426;258097061537;111;2,9;2;1;1
258097061537;258097061623;86;2,9;2;1;1
258097061623;258097061663;40;2,9;2;1;1
258097061663;258097061746;83;2,9;2;1;1
258097402440;258097402588;148;2,9;2;1;1
258097402588;258097402638;50;2,9;2;1;1
258097440272;258097440471;199;2,9;2;1;1
258097501389;258097501637;248;2,9;2;1;1
258097501637;258097501716;79;2,9;2;1;1
258097501716;258097501750;34;2,9;2;1;1
258097501750;258097501791;41;2,9;2;1;1
258097501791;258097501825;34;2,9;2;1;1
258097501825;258097501860;35;2,9;2;1;1
258097569328;258097569524;196;2,9;2;1;1
258097638499;258097638665;166;2,9;2;1;1
258097645140;258097645274;134;2,9;2;1;1
258097660779;258097660991;212;2,9;2;1;1
258098389384;258098389510;126;2,9;2;1;1
258098389510;258098389604;94;2,9;2;1;1
258098389604;258098389628;24;2,9;2;1;1
258098399690;258098399954;264;2,9;2;1;1
258098399954;258098400081;127;2,9;2;1;1
258098400081;258098400117;36;2,9;2;1;1
258098400117;258098400139;22;2,9;2;1;1
258098400139;258098400173;34;2,9;2;1;1
258098400173;258098400285;112;2,9;2;1;1
258098400285;258098400290;5;2,9;2;1;1
258098400290;258098400346;56;2,9;2;1;1
258098400346;258098400409;63;2,9;2;1;1
258098400409;258098400518;109;2,9;2;1;1
258098400518;258098400631;113;2,9;2;1;1
258098400631;258098400750;119;2,9;2;1;1
258098416003;258098416082;79;2,9;2;1;1
258098416082;258098416142;60;2,9;2;1;1
258098416142;258098416153;11;2,9;2;1;1
258098416153;258098416210;57;2,9;2;1;1
258098416210;258098416357;147;2,9;2;1;1
258098416357;258098416418;61;2,9;2;1;1
258098428403;258098428672;269;2,9;2;1;1
258098428672;258098428707;35;2,9;2;1;1
258098440201;258098440283;82;2,9;2;1;1
258098440283;258098440391;108;2,9;2;1;1
258098440391;258098440417;26;2,9;2;1;1
258098440417;258098440640;223;2,9;2;1;1
258098440640;258098440648;8;2,9;2;1;1
258098440648;258098440688;40;2,9;2;1;1
258098440688;258098440760;72;2,9;2;1;1
258098462720;258098462885;165;2,9;2;1;1
258098465930;258098466065;135;2,9;2;1;1
258098466065;258098466147;82;2,9;2;1;1
258098510695;258098510915;220;2,9;2;1;1
258098616580;258098616777;197;2,9;2;1;1
258098620351;258098620454;103;2,9;2;1;1
258098620454;258098620477;23;2,9;2;1;1
258098620477;258098620589;112;2,9;2;1;1
258098620589;258098620666;77;2,9;2;1;1
258098673175;258098673323;148;2,9;2;1;1
258098746372;258098746522;150;2,9;2;1;1
258098746522;258098746556;34;2,9;2;1;1
258098746556;258098746864;308;2,9;2;1;1
258098746864;258098746902;38;2,9;2;1;1
258098781402;258098781560;158;2,9;2;1;1
258098781560;258098781607;47;2,9;2;1;1
258098781607;258098781615;8;2,9;2;1;1
258098781615;258098781681;66;2,9;2;1;1
258098781681;258098781731;50;2,9;2;1;1
258098781731;258098781764;33;2,9;2;1;1
258098781764;258098781774;10;2,9;2;1;1
258098832572;258098832621;49;2,9;2;1;1
258098832621;258098832874;253;2,9;2;1;1
258098832874;258098832898;24;2,9;2;1;1
258098832898;258098833090;192;2,9;2;1;1
258098833090;258098833116;26;2,9;2;1;1
258098833116;258098833175;59;2,9;2;1;1
258098833175;258098833185;10;2,9;2;1;1
258098833253;258098833451;198;2,9;2;1;1
258098838359;258098838544;185;2,9;2;1;1
258098838544;258098838561;17;2,9;2;1;1
258098856144;258098856168;24;2,9;2;1;1
258098856168;258098856331;163;2,9;2;1;1
258098856331;258098856348;17;2,9;2;1;1
258098856348;258098856494;146;2,9;2;1;1
258098856494;258098856522;28;2,9;2;1;1
258098856522;258098856622;100;2,9;2;1;1
258098856622;258098856649;27;2,9;2;1;1
258098856649;258098856734;85;2,9;2;1;1
258098863320;258098863612;292;2,9;2;1;1
258098864061;258098864170;109;2,9;2;1;1
258098864170;258098864244;74;2,9;2;1;1
258098864244;258098864281;37;2,9;2;1;1
258098864281;258098864462;181;2,9;2;1;1
258098864462;258098864507;45;2,9;2;1;1
258098893097;258098893110;13;2,9;2;1;1
258098893110;258098893235;125;2,9;2;1;1
258098893235;258098893307;72;2,9;2;1;1
258098919240;258098919447;207;2,9;2;1;1
258098919447;258098919483;36;2,9;2;1;1
258098951103;258098951112;9;2,9;2;1;1
258098951112;258098951412;300;2,9;2;1;1
258098951412;258098951432;20;2,9;2;1;1
258098951432;258098951492;60;2,9;2;1;1
258098951492;258098951542;50;2,9;2;1;1
258098951542;258098951589;47;2,9;2;1;1
258098951589;258098951624;35;2,9;2;1;1
258098951770;258098951783;13;2,9;2;1;1
258098951783;258098951903;120;2,9;2;1;1
258098951903;258098951918;15;2,9;2;1;1
258098951918;258098952065;147;2,9;2;1;1
258098952065;258098952088;23;2,9;2;1;1
258098952088;258098952190;102;2,9;2;1;1
258098952190;258098952233;43;2,9;2;1;1
258098952233;258098952378;145;2,9;2;1;1
258098957636;258098957827;191;2,9;2;1;1
258098957827;258098957833;6;2,9;2;1;1
258099006904;258099007099;195;2,9;2;1;1
258099017072;258099017221;149;2,9;2;1;1
258099024167;258099024217;50;2,9;2;1;1
258099024217;258099024278;61;2,9;2;1;1
258099024278;258099024300;22;2,9;2;1;1
258099024300;258099024420;120;2,9;2;1;1
258099024420;258099024448;28;2,9;2;1;1
258099024448;258099024482;34;2,9;2;1;1
258099030172;258099030303;131;2,9;2;1;1
258099031793;258099031988;195;2,9;2;1;1
258099147428;258099147492;64;2,9;2;1;1
258099147492;258099147642;150;2,9;2;1;1
258099147642;258099147759;117;2,9;2;1;1
258099170727;258099170881;154;2,9;2;1;1
258099170881;258099171037;156;2,9;2;1;1
258099266113;258099266275;162;2,9;2;1;1
258099286513;258099286580;67;2,9;2;1;1
258099286580;258099286748;168;2,9;2;1;1
258099290570;258099290759;189;2,9;2;1;1
258099349399;258099349444;45;2,9;2;1;1
258099349444;258099349591;147;2,9;2;1;1
258099349591;258099349600;9;2,9;2;1;1
258099349600;258099349640;40;2,9;2;1;1
258099349640;258099349779;139;2,9;2;1;1
258099349779;258099349962;183;2,9;2;1;1
258099349962;258099349996;34;2,9;2;1;1
258099371447;258099371674;227;2,9;2;1;1
258099371674;258099371755;81;2,9;2;1;1
258099407253;258099407411;158;2,9;2;1;1
258099407411;258099407452;41;2,9;2;1;1
258099407452;258099407556;104;2,9;2;1;1
258099407556;258099407805;249;2,9;2;1;1
258099612564;258099612816;252;2,9;2;1;1
258099612816;258099612946;130;2,9;2;1;1
258099612946;258099612988;42;2,9;2;1;1
258099612988;258099613020;32;2,9;2;1;1
258099613020;258099613199;179;2,9;2;1;1
258099613199;258099613296;97;2,9;2;1;1
258099613296;258099613354;58;2,9;2;1;1
258099635008;258099635179;171;2,9;2;1;1
258099680322;258099680487;165;2,9;2;1;1
258099744369;258099744501;132;2,9;2;1;1
258099744501;258099744619;118;2,9;2;1;1
258099744619;258099744739;120;2,9;2;1;1
258099819584;258099819744;160;2,9;2;1;1
258099882762;258099882856;94;2,9;2;1;1
258099882856;258099882982;126;2,9;2;1;1
258099882982;258099883024;42;2,9;2;1;1
258099883024;258099883053;29;2,9;2;1;1
258099883053;258099883089;36;2,9;2;1;1
258099883089;258099883162;73;2,9;2;1;1
258099883162;258099883219;57;2,9;2;1;1
258099883219;258099883283;64;2,9;2;1;1
258099884103;258099884347;244;2,9;2;1;1
258099899299;258099899463;164;2,9;2;1;1
258099991975;258099992116;141;2,9;2;1;1
258099992116;258099992163;47;2,9;2;1;1
258099992163;258099992257;94;2,9;2;1;1
258099992257;258099992335;78;2,9;2;1;1
258099992335;258099992470;135;2,9;2;1;1
258100174545;258100174629;84;2,9;2;1;1
258100174629;258100174671;42;2,9;2;1;1
258100174671;258100174786;115;2,9;2;1;1
258100174786;258100174814;28;2,9;2;1;1
258100174814;258100174932;118;2,9;2;1;1
258100174932;258100175152;220;2,9;2;1;1
258100175152;258100175268;116;2,9;2;1;1
258100186483;258100186723;240;2,9;2;1;1
258100202327;258100202531;204;2,9;2;1;1
258100212221;258100212250;29;2,9;2;1;1
258100212250;258100212379;129;2,9;2;1;1
258100212379;258100212512;133;2,9;2;1;1
258100212512;258100212692;180;2,9;2;1;1
258100212692;258100212729;37;2,9;2;1;1
258100212729;258100212817;88;2,9;2;1;1
258100212817;258100212824;7;2,9;2;1;1
258100218671;258100218748;77;2,9;2;1;1
258100218748;258100218823;75;2,9;2;1;1
258100218823;258100218888;65;2,9;2;1;1
258100273942;258100274089;147;2,9;2;1;1
258100274089;258100274209;120;2,9;2;1;1
258100298205;258100298281;76;2,9;2;1;1
258100298281;258100298576;295;2,9;2;1;1
258100298576;258100298903;327;2,9;2;1;1
258100375895;258100376065;170;2,9;2;1;1
258100402337;258100402510;173;2,9;2;1;1
258100421556;258100421719;163;2,9;2;1;1
258100430961;258100430985;24;2,9;2;1;1
258100430985;258100431001;16;2,9;2;1;1
258100431001;258100431113;112;2,9;2;1;1
258100431113;258100431133;20;2,9;2;1;1
258100431133;258100431148;15;2,9;2;1;1
258100431148;258100431284;136;2,9;2;1;1
258100431284;258100438119;6835;2,9;2;1;1
258100438119;258100438430;311;2,9;2;1;1
258100438430;258100441422;2992;2,9;2;1;1
258100441422;258100441787;365;2,9;2;1;1
258100441787;258100454361;12574;2,9;2;1;1
258100474400;258100474526;126;2,9;2;1;1
258100474526;258100474599;73;2,9;2;1;1
258100506430;258100506434;4;2,9;2;1;1
258100506434;258100506562;128;2,9;2;1;1
258100518374;258100518472;98;2,9;2;1;1
258100518472;258100518535;63;2,9;2;1;1
258100518535;258100518637;102;2,9;2;1;1
258100518637;258100518800;163;2,9;2;1;1
258100518800;258100518846;46;2,9;2;1;1
258100535724;258100535855;131;2,9;2;1;1
258100535855;258100535910;55;2,9;2;1;1
258100535910;258100535956;46;2,9;2;1;1
258100535956;258100535982;26;2,9;2;1;1
258100539770;258100539898;128;2,9;2;1;1
258100539898;258100540046;148;2,9;2;1;1
258100540046;258100540240;194;2,9;2;1;1
258100540240;258100540371;131;2,9;2;1;1
258100709722;258100709893;171;2,9;2;1;1
258100709893;258100709972;79;2,9;2;1;1
258100763164;258100763325;161;2,9;2;1;1
258100774200;258100774412;212;2,9;2;1;1
258100787194;258100787203;9;2,9;2;1;1
258100787203;258100787234;31;2,9;2;1;1
258100787234;258100787278;44;2,9;2;1;1
258100787278;258100787344;66;2,9;2;1;1
258100787344;258100787404;60;2,9;2;1;1
258100787404;258100787530;126;2,9;2;1;1
258100787530;258100787607;77;2,9;2;1;1
258100812464;258100812488;24;2,9;2;1;1
258100812488;258100812567;79;2,9;2;1;1
258100812567;258100812576;9;2,9;2;1;1
258100812576;258100812676;100;2,9;2;1;1
258100812676;258100812705;29;2,9;2;1;1
258100812705;258100812715;10;2,9;2;1;1
258100812715;258100812773;58;2,9;2;1;1
258100812773;258100812921;148;2,9;2;1;1
258100850175;258100850182;7;2,9;2;1;1
258100850182;258100850313;131;2,9;2;1;1
258100850313;258100850315;2;2,9;2;1;1
258100850315;258100850350;35;2,9;2;1;1
258100850350;258100850422;72;2,9;2;1;1
258100850422;258100850448;26;2,9;2;1;1
258101070500;258101070599;99;2,9;2;1;1
258101070599;258101070758;159;2,9;2;1;1
258101070758;258101070778;20;2,9;2;1;1
258101070778;258101070888;110;2,9;2;1;1
258101070888;258101071014;126;2,9;2;1;1
258101071014;258101071075;61;2,9;2;1;1
258101071075;258101071176;101;2,9;2;1;1
258101071176;258101071178;2;2,9;2;1;1
258101071178;258101071312;134;2,9;2;1;1
258101079898;258101079943;45;2,9;2;1;1
258101079943;258101080004;61;2,9;2;1;1
258101080004;258101080081;77;2,9;2;1;1
258101080081;258101080104;23;2,9;2;1;1
258101080104;258101080135;31;2,9;2;1;1
258101101671;258101101834;163;2,9;2;1;1
258101101834;258101101950;116;2,9;2;1;1
258101133918;258101134071;153;2,9;2;1;1
258101134071;258101134220;149;2,9;2;1;1
258101134220;258101134356;136;2,9;2;1;1
258101134356;258101134494;138;2,9;2;1;1
258101134494;258101134632;138;2,9;2;1;1
258101134632;258101134766;134;2,9;2;1;1
258101134766;258101134899;133;2,9;2;1;1
258101155352;258101156594;1242;2,9;2;1;1
258101156594;258101156700;106;2,9;2;1;1
258101156700;258101156738;38;2,9;2;1;1
258101156738;258101157263;525;2,9;2;1;1
258101157263;258101157432;169;2,9;2;1;1
258101157432;258101157476;44;2,9;2;1;1
258101157476;258101157519;43;2,9;2;1;1
258101157519;258101157563;44;2,9;2;1;1
258101157563;258101173804;16241;2,9;2;1;1
258101173804;258101173855;51;2,9;2;1;1
258101173855;258101173995;140;2,9;2;1;1
258101173995;258101177418;3423;2,9;2;1;1
258101177418;258101177601;183;2,9;2;1;1
258101177601;258101177614;13;2,9;2;1;1
258101177614;258101177644;30;2,9;2;1;1
258101177644;258101177649;5;2,9;2;1;1
258101177649;258101177718;69;2,9;2;1;1
258101177718;258101177752;34;2,9;2;1;1
258101177752;258101177845;93;2,9;2;1;1
258101177845;258101177994;149;2,9;2;1;1
258101177994;258101178141;147;2,9;2;1;1
258101178141;258101178320;179;2,9;2;1;1
258101242113;258101260003;17890;2,9;2;1;1
258101260003;258101260671;668;2,9;2;1;1
258101265801;258101265884;83;2,9;2;1;1
258101265884;258101266058;174;2,9;2;1;1
258101266058;258101266315;257;2,9;2;1;1
258101266315;258101266349;34;2,9;2;1;1
258101266349;258101266442;93;2,9;2;1;1
258101270744;258101270921;177;2,9;2;1;1
258101292441;258101292447;6;2,9;2;1;1
258101292447;258101292536;89;2,9;2;1;1
258101292536;258101292625;89;2,9;2;1;1
258101292625;258101292636;11;2,9;2;1;1
258101296667;258101296729;62;2,9;2;1;1
258101296729;258101296814;85;2,9;2;1;1
258101350979;258101351120;141;2,9;2;1;1
258101434324;258101434384;60;2,9;2;1;1
258101434384;258101434549;165;2,9;2;1;1
258101434549;258101434569;20;2,9;2;1;1
258101434569;258101434604;35;2,9;2;1;1
258101434604;258101434753;149;2,9;2;1;1
258101434753;258101434790;37;2,9;2;1;1
258101463312;258101463424;112;2,9;2;1;1
258101463424;258101463452;28;2,9;2;1;1
258101463452;258101463460;8;2,9;2;1;1
258101463460;258101463583;123;2,9;2;1;1
258101463583;258101463637;54;2,9;2;1;1
258101463637;258101463676;39;2,9;2;1;1
258101604600;258101604794;194;2,9;2;1;1
258101662048;258101662147;99;2,9;2;1;1
258101662147;258101662198;51;2,9;2;1;1
258101662198;258101662358;160;2,9;2;1;1
258101662358;258101662362;4;2,9;2;1;1
258101662362;258101662447;85;2,9;2;1;1
258101680098;258101680211;113;2,9;2;1;1
258101680211;258101680236;25;2,9;2;1;1
258101680236;258101680254;18;2,9;2;1;1
258101680254;258101680291;37;2,9;2;1;1
258101680291;258101680302;11;2,9;2;1;1
258101680302;258101680422;120;2,9;2;1;1
258101680422;258101680437;15;2,9;2;1;1
258101765398;258101765600;202;2,9;2;1;1
258101765600;258101765608;8;2,9;2;1;1
258101765608;258101765614;6;2,9;2;1;1
258101796427;258101796500;73;2,9;2;1;1
258101796500;258101796517;17;2,9;2;1;1
258101796517;258101796636;119;2,9;2;1;1
258101840536;258101840616;80;2,9;2;1;1
258101840616;258101840639;23;2,9;2;1;1
258101840639;258101840676;37;2,9;2;1;1
258101840676;258101840807;131;2,9;2;1;1
258101840807;258101840914;107;2,9;2;1;1
258101840914;258101841041;127;2,9;2;1;1
258101841041;258101841125;84;2,9;2;1;1
258101861750;258101861842;92;2,9;2;1;1
258101861842;258101861907;65;2,9;2;1;1
258101861907;258101861916;9;2,9;2;1;1
258101861916;258101862057;141;2,9;2;1;1
258101862057;258101862122;65;2,9;2;1;1
258101862122;258101862177;55;2,9;2;1;1
258101862177;258101862201;24;2,9;2;1;1
258101862201;258101862438;237;2,9;2;1;1
258101862438;258101862471;33;2,9;2;1;1
258101862471;258101873362;10891;2,9;2;1;1
258101873362;258101873418;56;2,9;2;1;1
258101873418;258101873538;120;2,9;2;1;1
258101873538;258101873650;112;2,9;2;1;1
258101873650;258101873826;176;2,9;2;1;1
258101873826;258101873911;85;2,9;2;1;1
258101873911;258101874043;132;2,9;2;1;1
258101874043;258101874275;232;2,9;2;1;1
258101874275;258101874467;192;2,9;2;1;1
258101874467;258101874999;532;2,9;2;1;1
258101874999;258101878696;3697;2,9;2;1;1
258101878696;258101878783;87;2,9;2;1;1
258101878783;258101878842;59;2,9;2;1;1
258101878842;258101878894;52;2,9;2;1;1
258101878894;258101879844;950;2,9;2;1;1
258101879844;258101881523;1679;2,9;2;1;1
258101881523;258101881939;416;2,9;2;1;1
258101881939;258101881979;40;2,9;2;1;1
258101881979;258101882256;277;2,9;2;1;1
258101882256;258101882330;74;2,9;2;1;1
258101882330;258101882442;112;2,9;2;1;1
258101882442;258101883002;560;2,9;2;1;1
258101883002;258101883047;45;2,9;2;1;1
258101883047;258101883253;206;2,9;2;1;1
258101883253;258101883355;102;2,9;2;1;1
258101883355;258101883533;178;2,9;2;1;1
258101883533;258101883703;170;2,9;2;1;1
258101883703;258101883891;188;2,9;2;1;1
258101883891;258101884268;377;2,9;2;1;1
258101885177;258101885316;139;2,9;2;1;1
258101885316;258101885454;138;2,9;2;1;1
258101885454;258101885666;212;2,9;2;1;1
258101885948;258101885965;17;2,9;2;1;1
258101885965;258101886147;182;2,9;2;1;1
258101886147;258101886198;51;2,9;2;1;1
258101935459;258101935648;189;2,9;2;1;1
258101935648;258101935712;64;2,9;2;1;1
258101960674;258101960792;118;2,9;2;1;1
258101960792;258101960797;5;2,9;2;1;1
258101960797;258101960935;138;2,9;2;1;1
258101960935;258101961087;152;2,9;2;1;1
258101961087;258101961143;56;2,9;2;1;1
258101969811;258101970019;208;2,9;2;1;1
258101970019;258101970043;24;2,9;2;1;1
258101970043;258101970146;103;2,9;2;1;1
258101970146;258101970189;43;2,9;2;1;1
258101970189;258101970336;147;2,9;2;1;1
258101970336;258101970457;121;2,9;2;1;1
258101970457;258101970499;42;2,9;2;1;1
258102448586;258102448667;81;2,9;2;1;1
258102448667;258102448795;128;2,9;2;1;1
258102448795;258102448839;44;2,9;2;1;1
258102448839;258102448871;32;2,9;2;1;1
258102448871;258102448921;50;2,9;2;1;1
258102448921;258102449024;103;2,9;2;1;1
258102449024;258102449048;24;2,9;2;1;1
258102449048;258102449163;115;2,9;2;1;1
258102449163;258102449182;19;2,9;2;1;1
258102449182;258102449406;224;2,9;2;1;1
258102449406;258102449446;40;2,9;2;1;1
258102449446;258102449592;146;2,9;2;1;1
258102449592;258102449742;150;2,9;2;1;1
258102449742;258102449781;39;2,9;2;1;1
258102588953;258102589244;291;2,9;2;1;1
258102593196;258102593359;163;2,9;2;1;1
258102653798;258102653960;162;2,9;2;1;1
258102668412;258102668535;123;2,9;2;1;1
258102668535;258102668589;54;2,9;2;1;1
258102668589;258102668743;154;2,9;2;1;1
258102668743;258102668950;207;2,9;2;1;1
258102668950;258102668972;22;2,9;2;1;1
258102668972;258102669007;35;2,9;2;1;1
258102792448;258102792552;104;2,9;2;1;1
258102792552;258102792673;121;2,9;2;1;1
258102792673;258102792701;28;2,9;2;1;1
258102869556;258102869578;22;2,9;2;1;1
258102869578;258102869607;29;2,9;2;1;1
258102869607;258102869656;49;2,9;2;1;1
258102869656;258102869767;111;2,9;2;1;1
258102869767;258102869787;20;2,9;2;1;1
258102875527;258102875651;124;2,9;2;1;1
258102875651;258102875731;80;2,9;2;1;1
258102875731;258102875980;249;2,9;2;1;1
258102875980;258102876023;43;2,9;2;1;1
258102876023;258102876277;254;2,9;2;1;1
258102876277;258102876566;289;2,9;2;1;1
258102876566;258102876617;51;2,9;2;1;1
258102876617;258102876750;133;2,9;2;1;1
258102876750;258102878378;1628;2,9;2;1;1
258102878378;258102878466;88;2,9;2;1;1
258102878466;258102878549;83;2,9;2;1;1
258102878549;258102878604;55;2,9;2;1;1
258102878604;258102878655;51;2,9;2;1;1
258102878655;258102878823;168;2,9;2;1;1
258102878823;258102878931;108;2,9;2;1;1
258102878931;258102879004;73;2,9;2;1;1
258102879004;258102880914;1910;2,9;2;1;1
258102880914;258102884152;3238;2,9;2;1;1
258102884152;258102884377;225;2,9;2;1;1
258102884377;258102884601;224;2,9;2;1;1
258102884601;258102887290;2689;2,9;2;1;1
258102887290;258102887651;361;2,9;2;1;1
258102887651;258102887723;72;2,9;2;1;1
258102887723;258102888014;291;2,9;2;1;1
258102888014;258102888337;323;2,9;2;1;1
258102888337;258102888582;245;2,9;2;1;1
258102888582;258102888793;211;2,9;2;1;1
258102888793;258102889079;286;2,9;2;1;1
258102889079;258102901011;11932;2,9;2;1;1
258102901011;258102901031;20;2,9;2;1;1
258102901031;258102901601;570;2,9;2;1;1
258102901601;258102901654;53;2,9;2;1;1
258102901654;258102901841;187;2,9;2;1;1
258102901841;258102901884;43;2,9;2;1;1
258102901884;258102902234;350;2,9;2;1;1
258102902234;258102902247;13;2,9;2;1;1
258102902247;258102902303;56;2,9;2;1;1
258102902303;258102902534;231;2,9;2;1;1
258102902534;258102902819;285;2,9;2;1;1
258102902819;258102903152;333;2,9;2;1;1
258102903152;258102903316;164;2,9;2;1;1
258102903316;258102903580;264;2,9;2;1;1
258102903580;258102903945;365;2,9;2;1;1
258102903945;258102903988;43;2,9;2;1;1
258102903988;258102904076;88;2,9;2;1;1
258102904076;258102904110;34;2,9;2;1;1
258102904110;258102904272;162;2,9;2;1;1
258102904272;258102904447;175;2,9;2;1;1
258102904447;258102904617;170;2,9;2;1;1
258102904617;258102907121;2504;2,9;2;1;1
258102907121;258102907257;136;2,9;2;1;1
258102907257;258102907299;42;2,9;2;1;1
258102907299;258102907379;80;2,9;2;1;1
258102907379;258102907513;134;2,9;2;1;1
258102907513;258102907673;160;2,9;2;1;1
258102907673;258102907862;189;2,9;2;1;1
258102907862;258102907901;39;2,9;2;1;1
258102907901;258102908206;305;2,9;2;1;1
258102908206;258102909938;1732;2,9;2;1;1
258102909938;258102913945;4007;2,9;2;1;1
258102913945;258102918686;4741;2,9;2;1;1
258102918686;258102918835;149;2,9;2;1;1
258102918835;258102918873;38;2,9;2;1;1
258102918873;258102920562;1689;2,9;2;1;1
258102920562;258102921061;499;2,9;2;1;1
258102921061;258102921107;46;2,9;2;1;1
258102921107;258102921158;51;2,9;2;1;1
258102921158;258102921453;295;2,9;2;1;1
258102921453;258102921485;32;2,9;2;1;1
258102921485;258102921628;143;2,9;2;1;1
258102921628;258102921675;47;2,9;2;1;1
258102921675;258102922938;1263;2,9;2;1;1
258102922938;258102926465;3527;2,9;2;1;1
258102926465;258102926865;400;2,9;2;1;1
258102926865;258102929084;2219;2,9;2;1;1
258102929084;258102931181;2097;2,9;2;1;1
258102931181;258102941471;10290;2,9;2;1;1
258102970513;258102970714;201;2,9;2;1;1
258103071378;258103071541;163;2,9;2;1;1
258103076618;258103076776;158;2,9;2;1;1
258103076776;258103076998;222;2,9;2;1;1
258103076998;258103077201;203;2,9;2;1;1
258103077201;258103077403;202;2,9;2;1;1
258103077403;258103077615;212;2,9;2;1;1
258103077615;258103077755;140;2,9;2;1;1
258103077755;258103081661;3906;2,9;2;1;1
258103081661;258103081845;184;2,9;2;1;1
258103081845;258103082087;242;2,9;2;1;1
258103082087;258103082158;71;2,9;2;1;1
258103082158;258103082301;143;2,9;2;1;1
258103082301;258103082443;142;2,9;2;1;1
258103082443;258103082472;29;2,9;2;1;1
258103082472;258103082636;164;2,9;2;1;1
258103082636;258103082672;36;2,9;2;1;1
258103082672;258103082704;32;2,9;2;1;1
258103082704;258103082898;194;2,9;2;1;1
258103082898;258103083386;488;2,9;2;1;1
258103083386;258103083965;579;2,9;2;1;1
258103083965;258103086823;2858;2,9;2;1;1
258103086823;258103086930;107;2,9;2;1;1
258103086930;258103087243;313;2,9;2;1;1
258103087243;258103087432;189;2,9;2;1;1
258103087432;258103088347;915;2,9;2;1;1
258103088347;258103088356;9;2,9;2;1;1
258103088356;258103088371;15;2,9;2;1;1
258103088371;258103088425;54;2,9;2;1;1
258103088425;258103093157;4732;2,9;2;1;1
258103093157;258103097724;4567;2,9;2;1;1
258103237576;258103237666;90;2,9;2;1;1
258103237666;258103237695;29;2,9;2;1;1
258103237695;258103237708;13;2,9;2;1;1
258103237708;258103237821;113;2,9;2;1;1
258103237821;258103237841;20;2,9;2;1;1
258103237841;258103238190;349;2,9;2;1;1
258103238190;258103238339;149;2,9;2;1;1
258103238339;258103238404;65;2,9;2;1;1
258103238404;258103238869;465;2,9;2;1;1
258103238869;258103239158;289;2,9;2;1;1
258103239158;258103256868;17710;2,9;2;1;1
258103259186;258103259221;35;2,9;2;1;1
258103259221;258103259414;193;2,9;2;1;1
258103259414;258103259451;37;2,9;2;1;1
258103259451;258103259599;148;2,9;2;1;1
258103259599;258103259636;37;2,9;2;1;1
258103302851;258103303046;195;2,9;2;1;1
258103317635;258103317741;106;2,9;2;1;1
258103317741;258103317781;40;2,9;2;1;1
258103317781;258103317824;43;2,9;2;1;1
258103317824;258103317905;81;2,9;2;1;1
258103317905;258103318081;176;2,9;2;1;1
258103318175;258103318270;95;2,9;2;1;1
258103318270;258103318333;63;2,9;2;1;1
258103318333;258103318365;32;2,9;2;1;1
258103318365;258103318440;75;2,9;2;1;1
258103405906;258103405960;54;2,9;2;1;1
258103405960;258103405972;12;2,9;2;1;1
258103405972;258103406003;31;2,9;2;1;1
258103406003;258103406086;83;2,9;2;1;1
258103408509;258103408712;203;2,9;2;1;1
258103413869;258103413900;31;2,9;2;1;1
258103413900;258103414082;182;2,9;2;1;1
258103414082;258103414269;187;2,9;2;1;1
258103414269;258103414308;39;2,9;2;1;1
258103414308;258103414438;130;2,9;2;1;1
258103414438;258103414581;143;2,9;2;1;1
258103450588;258103450731;143;2,9;2;1;1
258103450731;258103450803;72;2,9;2;1;1
258103450803;258103450871;68;2,9;2;1;1
258103450871;258103450947;76;2,9;2;1;1
258103520043;258103520217;174;2,9;2;1;1
258103522265;258103522474;209;2,9;2;1;1
258103540795;258103541019;224;2,9;2;1;1
258103541019;258103541062;43;2,9;2;1;1
258103541062;258103541097;35;2,9;2;1;1
258103541097;258103541164;67;2,9;2;1;1
258103541164;258103541223;59;2,9;2;1;1
258103639156;258103639297;141;2,9;2;1;1
258103700483;258103700498;15;2,9;2;1;1
258103700498;258103700635;137;2,9;2;1;1
258103705460;258103705517;57;2,9;2;1;1
258103705517;258103705606;89;2,9;2;1;1
258103705606;258103705759;153;2,9;2;1;1
258103705759;258103706126;367;2,9;2;1;1
258103706126;258103706246;120;2,9;2;1;1
258103706246;258103706294;48;2,9;2;1;1
258103706294;258103706574;280;2,9;2;1;1
258103706574;258103708475;1901;2,9;2;1;1
258103708475;258103708587;112;2,9;2;1;1
258103708587;258103708622;35;2,9;2;1;1
258103708622;258103717170;8548;2,9;2;1;1
258103717170;258103717481;311;2,9;2;1;1
258103717481;258103717762;281;2,9;2;1;1
258103717762;258103718827;1065;2,9;2;1;1
258103718827;258103719520;693;2,9;2;1;1
258103719520;258103720668;1148;2,9;2;1;1
258103720668;258103727357;6689;2,9;2;1;1
258103728940;258103728943;3;2,9;2;1;1
258103728943;258103729111;168;2,9;2;1;1
258103732875;258103732929;54;2,9;2;1;1
258103732929;258103732992;63;2,9;2;1;1
258103732992;258103733139;147;2,9;2;1;1
258103733139;258103733246;107;2,9;2;1;1
258103776823;258103776848;25;2,9;2;1;1
258103776848;258103776963;115;2,9;2;1;1
258103814899;258103814928;29;9;1;1;1
258103814928;258103814944;16;9;1;1;1
258103814944;258103814970;26;9;1;1;1
258103814970;258103815018;48;9;1;1;1
258103815018;258103815063;45;9;1;1;1
258103815063;258103815182;119;9;1;1;1
258103815773;258103815942;169;9;1;1;1
258104031007;258104031124;117;9;1;1;1
258104031124;258104031259;135;9;1;1;1
258104031259;258104031408;149;9;1;1;1
258104031408;258104031527;119;9;1;1;1
258104377065;258104377188;123;9;1;1;1
258104377188;258104377256;68;9;1;1;1
258104377256;258104377330;74;9;1;1;1
258104377330;258104377496;166;9;1;1;1
258104381008;258104381012;4;9;1;1;1
258104381012;258104381107;95;9;1;1;1
258104381107;258104381151;44;9;1;1;1
258104381151;258104381289;138;9;1;1;1
258104381289;258104381316;27;9;1;1;1
258104384348;258104384485;137;9;1;1;1
258104384485;258104384548;63;9;1;1;1
258104384548;258104384647;99;9;1;1;1
258104508589;258104508664;75;9;1;1;1
258104508664;258104508760;96;9;1;1;1
258104508760;258104508797;37;9;1;1;1
258104515953;258104515996;43;9;1;1;1
258104515996;258104516064;68;9;1;1;1
258104516064;258104516092;28;9;1;1;1
258104516092;258104516142;50;9;1;1;1
258104518470;258104518675;205;9;1;1;1
258104607899;258104607934;35;9;1;1;1
258104607934;258104608013;79;9;1;1;1
258104608013;258104608059;46;9;1;1;1
258104608059;258104610635;2576;9;1;1;1
258104610635;258104610791;156;9;1;1;1
258104610791;258104611327;536;9;1;1;1
258104611327;258104612483;1156;9;1;1;1
258104612483;258104613298;815;9;1;1;1
258104613298;258104613497;199;9;1;1;1
258104613497;258104613538;41;9;1;1;1
258104613538;258104613583;45;9;1;1;1
258104613583;258104613727;144;9;1;1;1
258104613727;258104613787;60;9;1;1;1
258104613787;258104613817;30;9;1;1;1
258104613817;258104613982;165;9;1;1;1
258104613982;258104614008;26;9;1;1;1
258104614008;258104614089;81;9;1;1;1
258104614089;258104614106;17;9;1;1;1
258104614106;258104624056;9950;9;1;1;1
258104704581;258104704878;297;2,9;2;1;1
258104704878;258104705073;195;2,9;2;1;1
258104705073;258104705125;52;2,9;2;1;1
258104705125;258104705397;272;2,9;2;1;1
258104705397;258104705635;238;2,9;2;1;1
258104705635;258104705676;41;2,9;2;1;1
258104710747;258104710919;172;2,9;2;1;1
258104723127;258104723323;196;2,9;2;1;1
258104773444;258104773625;181;9;1;1;1
258104775954;258104776060;106;9;1;1;1
258104776060;258104776176;116;9;1;1;1
258104780532;258104780735;203;9;1;1;1
258104819727;258104819935;208;2,9;2;1;1
258104819935;258104819959;24;2,9;2;1;1
258104819959;258104820062;103;2,9;2;1;1
258104820062;258104820106;44;2,9;2;1;1
258104820106;258104820292;186;2,9;2;1;1
258104820292;258104820409;117;2,9;2;1;1
258104820409;258104820451;42;2,9;2;1;1
258104857795;258104857862;67;2,9;2;1;1
258104857862;258104857938;76;2,9;2;1;1
258104857938;258104858146;208;2,9;2;1;1
258104957124;258104957354;230;9;1;1;1
258104957354;258104957397;43;9;1;1;1
258104957397;258104957494;97;9;1;1;1
258104957494;258104957585;91;9;1;1;1
258104957585;258104957818;233;9;1;1;1
258104957818;258104958011;193;9;1;1;1
258104958011;258104958054;43;9;1;1;1
258104962981;258104963299;318;9;1;1;1
258105049918;258105049954;36;2,9;2;1;1
258105049954;258105050081;127;2,9;2;1;1
258105050081;258105050173;92;2,9;2;1;1
258105050173;258105050217;44;2,9;2;1;1
258105050217;258105050280;63;2,9;2;1;1
258105050280;258105050332;52;2,9;2;1;1
258105071650;258105071793;143;2,9;2;1;1
258105087533;258105087621;88;2,9;2;1;1
258105087621;258105087636;15;2,9;2;1;1
258105087636;258105087733;97;2,9;2;1;1
258105092254;258105092406;152;9;1;1;1
258105092406;258105092505;99;9;1;1;1
258105092883;258105092937;54;9;1;1;1
258105092937;258105092967;30;9;1;1;1
258105092967;258105093037;70;9;1;1;1
258105093037;258105093065;28;9;1;1;1
258105093065;258105093264;199;9;1;1;1
258105093264;258105093298;34;9;1;1;1
258105093298;258105093480;182;9;1;1;1
258105093480;258105093630;150;9;1;1;1
258105093630;258105093668;38;9;1;1;1
258105159881;258105160179;298;2,9;2;1;1
258105173089;258105173090;1;2,9;2;1;1
258105173090;258105173266;176;2,9;2;1;1
258105173266;258105173427;161;2,9;2;1;1
258105173427;258105173460;33;2,9;2;1;1
258105205384;258105205778;394;9;1;1;1
258105218206;258105218243;37;9;1;1;1
258105218243;258105218349;106;9;1;1;1
258105218349;258105218487;138;9;1;1;1
258105218487;258105218532;45;9;1;1;1
258105218532;258105218572;40;9;1;1;1
258105218572;258105218577;5;9;1;1;1
258105278462;258105278672;210;2,9;2;1;1
258105278672;258105278708;36;2,9;2;1;1
258105377250;258105377416;166;2,9;2;1;1
258105418041;258105418112;71;9;1;1;1
258105418112;258105418133;21;9;1;1;1
258105418133;258105418147;14;9;1;1;1
258105418147;258105418228;81;9;1;1;1
258105418228;258105418288;60;9;1;1;1
258105429664;258105429749;85;9;1;1;1
258105429749;258105429779;30;9;1;1;1
258105429779;258105430022;243;9;1;1;1
258105458167;258105458221;54;2,9;2;1;1
258105458221;258105458305;84;2,9;2;1;1
258105458305;258105458472;167;2,9;2;1;1
258105458472;258105458520;48;2,9;2;1;1
258105542005;258105542049;44;9;1;1;1
258105542049;258105542126;77;9;1;1;1
258105542126;258105542153;27;9;1;1;1
258105542153;258105542309;156;9;1;1;1
258105604705;258105604723;18;9;1;1;1
258105604723;258105604748;25;9;1;1;1
258105604748;258105604822;74;9;1;1;1
258105604822;258105604889;67;9;1;1;1
258105604889;258105604914;25;9;1;1;1
258105604914;258105604967;53;9;1;1;1
258105604967;258105605085;118;9;1;1;1
258105605085;258105605111;26;9;1;1;1
258105605111;258105605178;67;9;1;1;1
258105798449;258105798616;167;2,9;2;1;1
258105798616;258105798641;25;2,9;2;1;1
258105798641;258105798743;102;2,9;2;1;1
258105798743;258105798788;45;2,9;2;1;1
258105871604;258105871767;163;2,9;2;1;1
258105871767;258105871783;16;2,9;2;1;1
258105871783;258105871836;53;2,9;2;1;1
258105871836;258105871895;59;2,9;2;1;1
258105871895;258105872019;124;2,9;2;1;1
258105872019;258105872025;6;2,9;2;1;1
258105872025;258105872065;40;2,9;2;1;1
258105920234;258105920328;94;9;1;1;1
258105920328;258105920338;10;9;1;1;1
258105920338;258105920498;160;9;1;1;1
258105920498;258105920534;36;9;1;1;1
258105920534;258105920604;70;9;1;1;1
258105920604;258105920759;155;9;1;1;1
258105961779;258105962060;281;9;1;1;1
258105962588;258105962614;26;9;1;1;1
258105962614;258105962700;86;9;1;1;1
258105962700;258105962726;26;9;1;1;1
258105962726;258105962789;63;9;1;1;1
258106028570;258106028718;148;9;1;1;1
258106101437;258106101634;197;9;1;1;1
258106105894;258106106056;162;9;1;1;1
258106146557;258106146741;184;2,9;2;1;1
258106146741;258106146770;29;2,9;2;1;1
258106146770;258106146837;67;2,9;2;1;1
258106146837;258106146889;52;2,9;2;1;1
258106146889;258106146908;19;2,9;2;1;1
258106146908;258106146977;69;2,9;2;1;1
258106146977;258106147114;137;2,9;2;1;1
258106205710;258106205858;148;9;1;1;1
258106205858;258106205928;70;9;1;1;1
258106205928;258106206000;72;9;1;1;1
258106266444;258106266553;109;9;1;1;1
258106266553;258106266609;56;9;1;1;1
258106266609;258106266619;10;9;1;1;1
258106266619;258106266764;145;9;1;1;1
258106266764;258106266776;12;9;1;1;1
258106269146;258106269322;176;9;1;1;1
258106269362;258106269501;139;9;1;1;1
258106270151;258106270347;196;9;1;1;1
258106270347;258106270405;58;9;1;1;1
258106270405;258106270412;7;9;1;1;1
258106270412;258106270445;33;9;1;1;1
258106303408;258106303509;101;2,9;2;1;1
258106303509;258106303517;8;2,9;2;1;1
258106303517;258106303559;42;2,9;2;1;1
258106303559;258106303679;120;2,9;2;1;1
258106303679;258106303723;44;2,9;2;1;1
258106431097;258106431148;51;2,9;2;1;1
258106431148;258106431161;13;2,9;2;1;1
258106431161;258106431192;31;2,9;2;1;1
258106431192;258106431252;60;2,9;2;1;1
258106431252;258106431420;168;2,9;2;1;1
258106431420;258106431424;4;2,9;2;1;1
258106431424;258106431541;117;2,9;2;1;1
258106529079;258106529165;86;2,9;2;1;1
258106529165;258106529171;6;2,9;2;1;1
258106529171;258106529238;67;2,9;2;1;1
258106618575;258106618643;68;2,9;2;1;1
258106618643;258106618714;71;2,9;2;1;1
258106618714;258106619012;298;2,9;2;1;1
258106619012;258106619049;37;2,9;2;1;1
258106628138;258106628397;259;2,9;2;1;1
258106628397;258106628509;112;2,9;2;1;1
258106628509;258106628554;45;2,9;2;1;1
258106628554;258106628588;34;2,9;2;1;1
258106628588;258106628725;137;2,9;2;1;1
258106628725;258106628755;30;2,9;2;1;1
258106628755;258106628854;99;2,9;2;1;1
258106628854;258106628871;17;2,9;2;1;1
258106730657;258106730927;270;2,9;2;1;1
258107097176;258107097405;229;9;1;1;1
258107097405;258107097654;249;9;1;1;1
258107097654;258107097700;46;9;1;1;1
258107141741;258107141845;104;2,9;2;1;1
258107141845;258107141846;1;2,9;2;1;1
258107141846;258107141877;31;2,9;2;1;1
258107141877;258107142031;154;2,9;2;1;1
258107596483;258107596720;237;2,9;2;1;1
258107596720;258107596844;124;2,9;2;1;1
258107598396;258107598728;332;2,9;2;1;1
258107598728;258107598992;264;2,9;2;1;1
258107598992;258107599046;54;2,9;2;1;1
258107602008;258107602043;35;2,9;2;1;1
258107602043;258107602347;304;2,9;2;1;1
258107602347;258107602552;205;2,9;2;1;1
258107602552;258107602809;257;2,9;2;1;1
258107602809;258107603003;194;2,9;2;1;1
258107603267;258107603494;227;2,9;2;1;1
258107603494;258107603617;123;2,9;2;1;1
258107603617;258107603627;10;2,9;2;1;1
258107603627;258107603672;45;2,9;2;1;1
258107603672;258107603690;18;2,9;2;1;1
258107603690;258107603833;143;2,9;2;1;1
258107603833;258107603840;7;2,9;2;1;1
258107603840;258107603870;30;2,9;2;1;1
258107603870;258107603886;16;2,9;2;1;1
258107603886;258107603896;10;2,9;2;1;1
258107603896;258107603964;68;2,9;2;1;1
258107603964;258107604066;102;2,9;2;1;1
258107604066;258107604214;148;2,9;2;1;1
258107604214;258107604286;72;2,9;2;1;1
258107604286;258107604309;23;2,9;2;1;1
258107604309;258107604348;39;2,9;2;1;1
258107604348;258107604355;7;2,9;2;1;1
258107604355;258107604404;49;2,9;2;1;1
258107604404;258107604417;13;2,9;2;1;1
258107605687;258107606059;372;2,9;2;1;1
258107606059;258107606073;14;2,9;2;1;1
258107606073;258107606198;125;2,9;2;1;1
258107606198;258107606432;234;2,9;2;1;1
258107606432;258107606447;15;2,9;2;1;1
258107606447;258107606450;3;2,9;2;1;1
258107606450;258107606493;43;2,9;2;1;1
258107606493;258107606691;198;2,9;2;1;1
258107606691;258107606772;81;2,9;2;1;1
258107606772;258107606833;61;2,9;2;1;1
258107606833;258107606932;99;2,9;2;1;1
258107606932;258107606989;57;2,9;2;1;1
258107606989;258107606993;4;2,9;2;1;1
258107606993;258107607002;9;2,9;2;1;1
258107607002;258107607041;39;2,9;2;1;1
258107607041;258107607067;26;2,9;2;1;1
258107607067;258107607127;60;2,9;2;1;1
258107607127;258107607143;16;2,9;2;1;1
258107607143;258107607155;12;2,9;2;1;1
258107607155;258107607300;145;2,9;2;1;1
258107607300;258107607338;38;2,9;2;1;1
258107607338;258107607355;17;2,9;2;1;1
258107607355;258107607405;50;2,9;2;1;1
258107607774;258107607813;39;2,9;2;1;1
258107607813;258107607982;169;2,9;2;1;1
258107607982;258107608071;89;2,9;2;1;1
258107608071;258107608091;20;2,9;2;1;1
258107608091;258107608241;150;2,9;2;1;1
258107608241;258107608455;214;2,9;2;1;1
258107608455;258107608536;81;2,9;2;1;1
258107608536;258107608692;156;2,9;2;1;1
258107608692;258107608721;29;2,9;2;1;1
258107608721;258107608873;152;2,9;2;1;1
258107608873;258107608938;65;2,9;2;1;1
258107608938;258107608967;29;2,9;2;1;1
258107608967;258107609018;51;2,9;2;1;1
258107609018;258107609165;147;2,9;2;1;1
258107609165;258107609191;26;2,9;2;1;1
258107609191;258107609344;153;2,9;2;1;1
258107609344;258107609358;14;2,9;2;1;1
258107609358;258107609417;59;2,9;2;1;1
258107609417;258107609482;65;2,9;2;1;1
258107609482;258107609546;64;2,9;2;1;1
258107609546;258107609581;35;2,9;2;1;1
258107609581;258107609608;27;2,9;2;1;1
258107609608;258107609845;237;2,9;2;1;1
258107609845;258107609848;3;2,9;2;1;1
258107609848;258107609918;70;2,9;2;1;1
258107609918;258107609942;24;2,9;2;1;1
258107609942;258107610042;100;2,9;2;1;1
258107610042;258107610151;109;2,9;2;1;1
258107610151;258107610205;54;2,9;2;1;1
258107610205;258107610282;77;2,9;2;1;1
258107610282;258107610389;107;2,9;2;1;1
258107610389;258107610441;52;2,9;2;1;1
258107610441;258107610455;14;2,9;2;1;1
258107610455;258107610564;109;2,9;2;1;1
258107610564;258107610584;20;2,9;2;1;1
258107610584;258107610823;239;2,9;2;1;1
258107610823;258107610923;100;2,9;2;1;1
258107610923;258107610932;9;2,9;2;1;1
258107610932;258107611024;92;2,9;2;1;1
258107611024;258107611065;41;2,9;2;1;1
258107611065;258107611095;30;2,9;2;1;1
258107611095;258107611119;24;2,9;2;1;1
258107611119;258107611151;32;2,9;2;1;1
258107611151;258107611372;221;2,9;2;1;1
258107611372;258107611432;60;2,9;2;1;1
258107611432;258107611456;24;2,9;2;1;1
258107611456;258107611493;37;2,9;2;1;1
258107611493;258107611581;88;2,9;2;1;1
258107611581;258107611782;201;2,9;2;1;1
258107611782;258107612004;222;2,9;2;1;1
258107612004;258107612049;45;2,9;2;1;1
258107612049;258107612060;11;2,9;2;1;1
258107612060;258107612241;181;2,9;2;1;1
258107612241;258107612331;90;2,9;2;1;1
258107612331;258107612401;70;2,9;2;1;1
258107612401;258107612667;266;2,9;2;1;1
258107612667;258107612999;332;2,9;2;1;1
258107613275;258107613696;421;2,9;2;1;1
258107613696;258107613739;43;2,9;2;1;1
258107613739;258107613927;188;2,9;2;1;1
258107613927;258107613966;39;2,9;2;1;1
258107613966;258107614155;189;2,9;2;1;1
258107614155;258107614174;19;2,9;2;1;1
258107614174;258107614218;44;2,9;2;1;1
258107614218;258107614342;124;2,9;2;1;1
258107614342;258107614358;16;2,9;2;1;1
258107614358;258107614420;62;2,9;2;1;1
258107614420;258107614589;169;2,9;2;1;1
258107614589;258107614655;66;2,9;2;1;1
258107614655;258107614716;61;2,9;2;1;1
258107614716;258107614865;149;2,9;2;1;1
258107614865;258107615196;331;2,9;2;1;1
258107615196;258107615227;31;2,9;2;1;1
258107615227;258107615295;68;2,9;2;1;1
258107615295;258107615316;21;2,9;2;1;1
258107615316;258107615632;316;2,9;2;1;1
258107615632;258107615674;42;2,9;2;1;1
258107615674;258107615728;54;2,9;2;1;1
258107615728;258107615787;59;2,9;2;1;1
258107615787;258107615835;48;2,9;2;1;1
258107615835;258107615998;163;2,9;2;1;1
258107615998;258107616059;61;2,9;2;1;1
258107616059;258107616060;1;2,9;2;1;1
258107616060;258107616090;30;2,9;2;1;1
258107616090;258107616171;81;2,9;2;1;1
258107616171;258107616183;12;2,9;2;1;1
258107616183;258107616211;28;2,9;2;1;1
258107616211;258107616292;81;2,9;2;1;1
258107616292;258107616339;47;2,9;2;1;1
258107616339;258107616357;18;2,9;2;1;1
258107616357;258107616631;274;2,9;2;1;1
258107616631;258107616673;42;2,9;2;1;1
258107616673;258107616718;45;2,9;2;1;1
258107616718;258107616746;28;2,9;2;1;1
258107616746;258107616759;13;2,9;2;1;1
258107616759;258107616802;43;2,9;2;1;1
258107616802;258107616873;71;2,9;2;1;1
258107616873;258107616877;4;2,9;2;1;1
258107616877;258107616929;52;2,9;2;1;1
258107616929;258107616952;23;2,9;2;1;1
258107616952;258107617074;122;2,9;2;1;1
258107617074;258107617147;73;2,9;2;1;1
258107617147;258107617216;69;2,9;2;1;1
258107617216;258107617426;210;2,9;2;1;1
258107617426;258107617757;331;2,9;2;1;1
258107617757;258107618067;310;2,9;2;1;1
258107618067;258107618460;393;2,9;2;1;1
258107618460;258107618515;55;2,9;2;1;1
258107618515;258107618566;51;2,9;2;1;1
258107618566;258107618626;60;2,9;2;1;1
258107618626;258107618788;162;2,9;2;1;1
258107618788;258107618818;30;2,9;2;1;1
258107618818;258107618935;117;2,9;2;1;1
258107618935;258107619012;77;2,9;2;1;1
258107619012;258107619111;99;2,9;2;1;1
258107619111;258107619127;16;2,9;2;1;1
258107619127;258107619188;61;2,9;2;1;1
258107619188;258107619240;52;2,9;2;1;1
258107619240;258107619345;105;2,9;2;1;1
258107619345;258107619444;99;2,9;2;1;1
258107619444;258107619594;150;2,9;2;1;1
258107619594;258107619789;195;2,9;2;1;1
258107619789;258107620003;214;2,9;2;1;1
258107620003;258107620532;529;2,9;2;1;1
258107620532;258107621357;825;2,9;2;1;1
258107621357;258107622631;1274;2,9;2;1;1
258107622631;258107624185;1554;2,9;2;1;1
258107624185;258107624438;253;2,9;2;1;1
258107624438;258107625048;610;2,9;2;1;1
258107625048;258107690728;65680;9;1;1;1
258107690728;258107690802;74;9;1;1;1
258107690802;258107690926;124;9;1;1;1
258107690926;258107691348;422;9;1;1;1
258107691348;258107691602;254;9;1;1;1
258107691602;258107691778;176;9;1;1;1
258107691778;258107696156;4378;9;1;1;1
258107696156;258107696447;291;9;1;1;1
258107696447;258107696496;49;9;1;1;1
258107696496;258107696906;410;9;1;1;1
258107696906;258107696952;46;2,9;2;1;1
258107696952;258107697025;73;2,9;2;1;1
258107697025;258107697178;153;2,9;2;1;1
258107697178;258107697330;152;2,9;2;1;1
258107697330;258107697372;42;2,9;2;1;1
258107697372;258107698415;1043;2,9;2;1;1
258107698415;258107698438;23;2,9;2;1;1
258107698438;258107700532;2094;2,9;2;1;1
258107700532;258107704612;4080;2,9;2;1;1
258107704612;258107705192;580;2,9;2;1;1
258107705192;258107705265;73;2,9;2;1;1
258107705265;258107705457;192;2,9;2;1;1
258107705457;258107705600;143;2,9;2;1;1
258107705600;258107705650;50;2,9;2;1;1
258107705650;258107706625;975;2,9;2;1;1
258107706625;258107706626;1;2,9;2;1;1
258107706626;258107706748;122;2,9;2;1;1
258107706748;258107706840;92;2,9;2;1;1
258107706840;258107707250;410;2,9;2;1;1
258107707250;258107707890;640;2,9;2;1;1
258107707890;258107708167;277;2,9;2;1;1
258107708167;258107708330;163;2,9;2;1;1
258107708330;258107708488;158;2,9;2;1;1
258107708488;258107708628;140;2,9;2;1;1
258107708628;258107709165;537;2,9;2;1;1
258107709165;258107709206;41;2,9;2;1;1
258107709206;258107710146;940;2,9;2;1;1
258107710146;258107710351;205;2,9;2;1;1
258107710351;258107710913;562;2,9;2;1;1
258107710913;258107711053;140;2,9;2;1;1
258107711053;258107711648;595;2,9;2;1;1
258107711648;258107711748;100;2,9;2;1;1
258107711748;258107711781;33;2,9;2;1;1
258107711781;258107711821;40;2,9;2;1;1
258107711821;258107712032;211;2,9;2;1;1
258107712032;258107712217;185;2,9;2;1;1
258107712217;258107712261;44;2,9;2;1;1
258107712261;258107712364;103;2,9;2;1;1
258107712364;258107712636;272;2,9;2;1;1
258107712636;258107712638;2;2,9;2;1;1
258107712638;258107712648;10;2,9;2;1;1
258107712648;258107712721;73;2,9;2;1;1
258107712721;258107712725;4;2,9;2;1;1
258107712725;258107712736;11;2,9;2;1;1
258107712736;258107712805;69;2,9;2;1;1
258107712805;258107712900;95;2,9;2;1;1
258107712900;258107712979;79;2,9;2;1;1
258107712979;258107713156;177;2,9;2;1;1
258107713156;258107713176;20;2,9;2;1;1
258107713176;258107713249;73;2,9;2;1;1
258107713249;258107713368;119;2,9;2;1;1
258107713368;258107713395;27;2,9;2;1;1
258107713395;258107713453;58;2,9;2;1;1
258107713453;258107713576;123;2,9;2;1;1
258107713576;258107713749;173;2,9;2;1;1
258107713749;258107713828;79;2,9;2;1;1
258107713828;258107713880;52;2,9;2;1;1
258107713880;258107713886;6;2,9;2;1;1
258107713886;258107713897;11;2,9;2;1;1
258107713897;258107713923;26;2,9;2;1;1
258107713923;258107714059;136;2,9;2;1;1
258107714059;258107714074;15;2,9;2;1;1
258107714074;258107714098;24;2,9;2;1;1
258107714098;258107714196;98;2,9;2;1;1
258107714196;258107714240;44;2,9;2;1;1
258107714240;258107714277;37;2,9;2;1;1
258107714277;258107714321;44;2,9;2;1;1
258107714321;258107714384;63;2,9;2;1;1
258107714384;258107714457;73;2,9;2;1;1
258107714457;258107714491;34;2,9;2;1;1
258107714491;258107714502;11;2,9;2;1;1
258107714502;258107714615;113;2,9;2;1;1
258107714615;258107714619;4;2,9;2;1;1
258107714619;258107714669;50;2,9;2;1;1
258107714669;258107714754;85;2,9;2;1;1
258107714754;258107714999;245;2,9;2;1;1
258107714999;258107715134;135;2,9;2;1;1
258107715134;258107715270;136;2,9;2;1;1
258107715270;258107715605;335;2,9;2;1;1
258107715605;258107715857;252;2,9;2;1;1
258107715857;258107715914;57;2,9;2;1;1
258107715914;258107716061;147;2,9;2;1;1
258107716061;258107716103;42;2,9;2;1;1
258107716103;258107716650;547;2,9;2;1;1
258107716650;258107716984;334;2,9;2;1;1
258107716984;258107717207;223;2,9;2;1;1
258107717207;258107717279;72;2,9;2;1;1
258107717279;258107717518;239;2,9;2;1;1
258107717518;258107717724;206;2,9;2;1;1
258107717724;258107717851;127;2,9;2;1;1
258107717851;258107717923;72;2,9;2;1;1
258107717923;258107718464;541;2,9;2;1;1
258107718464;258107720772;2308;2,9;2;1;1
258107720772;258107720877;105;2,9;2;1;1
258107720877;258107721238;361;2,9;2;1;1
258107721238;258107721380;142;2,9;2;1;1
258107721380;258107721444;64;2,9;2;1;1
258107721444;258107721861;417;2,9;2;1;1
258107721861;258107722066;205;2,9;2;1;1
258107722066;258107722546;480;2,9;2;1;1
258107722546;258107723242;696;2,9;2;1;1
258107723242;258107723347;105;2,9;2;1;1
258107723347;258107723441;94;2,9;2;1;1
258107723441;258107723653;212;2,9;2;1;1
258107723653;258107723920;267;2,9;2;1;1
258107723920;258107723997;77;2,9;2;1;1
258107723997;258107724255;258;2,9;2;1;1
258107724255;258107724289;34;2,9;2;1;1
258107724289;258107724399;110;2,9;2;1;1
258107724399;258107724509;110;2,9;2;1;1
258107724509;258107724645;136;2,9;2;1;1
258107724645;258107724692;47;2,9;2;1;1
258107724692;258107724745;53;2,9;2;1;1
258107724745;258107724951;206;2,9;2;1;1
258107724951;258107725229;278;2,9;2;1;1
258107725229;258107725488;259;2,9;2;1;1
258107725488;258107725948;460;2,9;2;1;1
258107725948;258107726098;150;2,9;2;1;1
258107726098;258107726242;144;2,9;2;1;1
258107726242;258107726251;9;2,9;2;1;1
258107726251;258107726408;157;2,9;2;1;1
258107726408;258107726423;15;9;1;1;1
258107726423;258107726567;144;9;1;1;1
258107726567;258107726607;40;9;1;1;1
258107726607;258107726648;41;9;1;1;1
258107726648;258107726666;18;9;1;1;1
258107726666;258107726670;4;9;1;1;1
258107726670;258107726728;58;9;1;1;1
258107726728;258107726813;85;9;1;1;1
258107726813;258107726855;42;9;1;1;1
258107726855;258107726863;8;9;1;1;1
258107726863;258107726906;43;9;1;1;1
258107726906;258107726968;62;9;1;1;1
258107726968;258107727004;36;9;1;1;1
258107727004;258107727042;38;9;1;1;1
258107727042;258107727090;48;9;1;1;1
258107727090;258107727137;47;9;1;1;1
258107727137;258107727202;65;9;1;1;1
258107727202;258107727219;17;9;1;1;1
258107727219;258107727292;73;9;1;1;1
258107727292;258107727333;41;9;1;1;1
258107727333;258107727454;121;9;1;1;1
258107727454;258107727568;114;9;1;1;1
258107727568;258107727595;27;9;1;1;1
258110766280;258110766287;7;2,9;2;1;1
258110766287;258110766341;54;2,9;2;1;1
258110766341;258110766360;19;2,9;2;1;1
258110766360;258110766362;2;2,9;2;1;1
258110766362;258110766373;11;2,9;2;1;1
258110766373;258110766382;9;2,9;2;1;1
258110766382;258110766400;18;2,9;2;1;1
258110766400;258110766409;9;2,9;2;1;1
258110766409;258110766411;2;2,9;2;1;1
258110766411;258110766413;2;2,9;2;1;1
258110766413;258110766416;3;2,9;2;1;1
258110766416;258110766419;3;2,9;2;1;1
258110766419;258110766435;16;2,9;2;1;1
258110766435;258110766441;6;2,9;2;1;1
258110766441;258110766465;24;2,9;2;1;1
258110766465;258110766467;2;2,9;2;1;1
258110766467;258110766470;3;2,9;2;1;1
258110766470;258110766494;24;2,9;2;1;1
258110766494;258110766499;5;2,9;2;1;1
258110766499;258110766501;2;2,9;2;1;1
258110766501;258110766504;3;2,9;2;1;1
258110766504;258110766506;2;2,9;2;1;1
258110766506;258110766511;5;2,9;2;1;1
258110766511;258110766514;3;2,9;2;1;1
258110766514;258110766532;18;2,9;2;1;1
258110766532;258110766543;11;2,9;2;1;1
258110766543;258110766568;25;2,9;2;1;1
258110766568;258110766570;2;2,9;2;1;1
258110766570;258110766578;8;2,9;2;1;1
258110766578;258110766584;6;2,9;2;1;1
258110766584;258110766595;11;2,9;2;1;1
258110766595;258110766610;15;2,9;2;1;1
258110766610;258110766616;6;2,9;2;1;1
258110766616;258110766626;10;2,9;2;1;1
258110766626;258110766631;5;2,9;2;1;1
258110766631;258110766636;5;2,9;2;1;1
258110766636;258110766645;9;2,9;2;1;1
258110766645;258110766657;12;2,9;2;1;1
258110766657;258110766659;2;2,9;2;1;1
258110766659;258110766668;9;2,9;2;1;1
258110766668;258110766676;8;2,9;2;1;1
258110766676;258110766683;7;2,9;2;1;1
258110766683;258110766690;7;2,9;2;1;1
258110766690;258110766699;9;2,9;2;1;1
258110766699;258110766710;11;2,9;2;1;1
258110766710;258110766730;20;2,9;2;1;1
258110766730;258110766749;19;2,9;2;1;1
258110766749;258110766761;12;2,9;2;1;1
258110766761;258110766802;41;2,9;2;1;1
258110766802;258110766818;16;2,9;2;1;1
258110766818;258110766826;8;2,9;2;1;1
258110766826;258110766841;15;2,9;2;1;1
258110766841;258110766855;14;2,9;2;1;1
258110766855;258110766882;27;2,9;2;1;1
258110766882;258110766892;10;2,9;2;1;1
258110766892;258110766901;9;2,9;2;1;1
258110766901;258110766929;28;2,9;2;1;1
258110766929;258110766966;37;2,9;2;1;1
258110766966;258110766968;2;2,9;2;1;1
258110766968;258110766994;26;2,9;2;1;1
258110766994;258110767019;25;2,9;2;1;1
258110767019;258110767020;1;2,9;2;1;1
258110767020;258110767048;28;2,9;2;1;1
258110767048;258110767051;3;2,9;2;1;1
258110767051;258110767067;16;2,9;2;1;1
258110767067;258110767090;23;2,9;2;1;1
258110767090;258110767100;10;2,9;2;1;1
258110767100;258110767104;4;2,9;2;1;1
258110767104;258110767108;4;2,9;2;1;1
258110767108;258110767115;7;2,9;2;1;1
258110767115;258110767140;25;2,9;2;1;1
258110767140;258110767179;39;2,9;2;1;1
258110767179;258110767197;18;2,9;2;1;1
258110767197;258110767250;53;2,9;2;1;1
258110767250;258110767251;1;2,9;2;1;1
258110767251;258110767299;48;2,9;2;1;1
258110767299;258110767303;4;2,9;2;1;1
258110767303;258110767310;7;2,9;2;1;1
258110767310;258110767343;33;2,9;2;1;1
258110767343;258110767346;3;2,9;2;1;1
258110767346;258110767355;9;2,9;2;1;1
258110767355;258110767366;11;2,9;2;1;1
258110767366;258110767375;9;2,9;2;1;1
258110767375;258110767480;105;2,9;2;1;1
258110767480;258110767540;60;2,9;2;1;1
258110767540;258110767707;167;2,9;2;1;1
258110767707;258110767728;21;2,9;2;1;1
258110767728;258110767873;145;2,9;2;1;1
258110767873;258110767894;21;2,9;2;1;1
258110767894;258110767896;2;2,9;2;1;1
258110767896;258110768019;123;2,9;2;1;1
258110768019;258110768107;88;2,9;2;1;1
258110768107;258110781411;13304;2,9;2;1;1
258110781411;258110842298;60887;9;1;1;1
258110842298;258110844194;1896;2,9;2;1;1
258110844194;258110847259;3065;2,9;2;1;1
258110847259;258110847805;546;2,9;2;1;1
258110847805;258110850204;2399;2,9;2;1;1
258110850204;258110855162;4958;2,9;2;1;1
258110855162;258110857207;2045;2,9;2;1;1
258110857207;258110858394;1187;2,9;2;1;1
258110858394;258110860925;2531;2,9;2;1;1
258110860925;258110862610;1685;2,9;2;1;1
258110862610;258110864651;2041;2,9;2;1;1
258110864651;258110866376;1725;2,9;2;1;1
258110866376;258110867465;1089;2,9;2;1;1
258110867465;258110868052;587;2,9;2;1;1
258110868052;258110872545;4493;2,9;2;1;1
258110872545;258110874721;2176;2,9;2;1;1
258110874721;258110875937;1216;2,9;2;1;1
258110875937;258110876122;185;2,9;2;1;1
258110876122;258110881749;5627;2,9;2;1;1
258110881749;258110881780;31;2,9;2;1;1
258110881780;258110882096;316;2,9;2;1;1
258110882096;258110885354;3258;2,9;2;1;1
258110885354;258110885481;127;2,9;2;1;1
258110885481;258110885968;487;2,9;2;1;1
258110885968;258110889369;3401;2,9;2;1;1
258110889369;258110891484;2115;2,9;2;1;1
258110891484;258110892014;530;2,9;2;1;1
258110892014;258110893108;1094;2,9;2;1;1
258110893108;258110894151;1043;2,9;2;1;1
258110894151;258110894610;459;2,9;2;1;1
258110894610;258110894706;96;2,9;2;1;1
258110894706;258110894874;168;2,9;2;1;1
258110894874;258110895556;682;2,9;2;1;1
258110895556;258110896585;1029;2,9;2;1;1
258110896585;258110897128;543;2,9;2;1;1
258110897128;258110897290;162;2,9;2;1;1
258110897290;258110897782;492;2,9;2;1;1
258110897782;258110897803;21;9;1;1;1
258110897803;258110899914;2111;9;1;1;1
258110899914;258110900955;1041;9;1;1;1
258110900955;258110906675;5720;9;1;1;1
258110906675;258110906892;217;9;1;1;1
258110906892;258110907673;781;9;1;1;1
258110907673;258110909415;1742;9;1;1;1
258110909415;258110920667;11252;9;1;1;1
258110920667;258110920996;329;9;1;1;1
258110920996;258110921086;90;9;1;1;1
258110921086;258110923895;2809;9;1;1;1
258110923895;258110926799;2904;9;1;1;1
258110926799;258110932680;5881;9;1;1;1
258110932680;258110933733;1053;9;1;1;1
258110933733;258110936905;3172;9;1;1;1
258110936905;258110938177;1272;9;1;1;1
258110938177;258110939187;1010;9;1;1;1
258110939187;258110939900;713;9;1;1;1
258110939900;258110940026;126;9;1;1;1
258110940026;258110943430;3404;9;1;1;1
258110943430;258110944638;1208;9;1;1;1
258110944638;258110944713;75;9;1;1;1
258110944713;258110944853;140;9;1;1;1
258110944853;258110945131;278;9;1;1;1
258110945131;258110945226;95;9;1;1;1
258110945226;258110945576;350;9;1;1;1
258110945576;258110945764;188;9;1;1;1
258110945764;258110945831;67;9;1;1;1
258110945831;258110945846;15;9;1;1;1
258110945846;258110946099;253;9;1;1;1
258110946099;258110946334;235;9;1;1;1
258110946334;258110946545;211;9;1;1;1
258110946545;258110946583;38;9;1;1;1
258110946583;258110947001;418;9;1;1;1
258110947001;258110947406;405;9;1;1;1
258110947406;258110949791;2385;9;1;1;1
258110949791;258110949965;174;9;1;1;1
258110949965;258110949978;13;9;1;1;1
258110949978;258110950537;559;9;1;1;1
258110950537;258110950911;374;9;1;1;1
258110950911;258110951451;540;9;1;1;1
258110951451;258110952408;957;9;1;1;1
258110952408;258110957442;5034;2,9;2;1;1
258110957442;258110960179;2737;2,9;2;1;1
258110960179;258110963365;3186;2,9;2;1;1
258110963365;258110963802;437;2,9;2;1;1
258110963802;258110965046;1244;2,9;2;1;1
258110965046;258110969408;4362;2,9;2;1;1
258110969408;258110970333;925;2,9;2;1;1
258110970333;258110970653;320;2,9;2;1;1
258110970653;258110977714;7061;2,9;2;1;1
258110977714;258110980614;2900;2,9;2;1;1
258110980614;258110987097;6483;2,9;2;1;1
258110987097;258110990625;3528;2,9;2;1;1
258110990625;258110991816;1191;2,9;2;1;1
258110991816;258110994384;2568;2,9;2;1;1
258110994384;258110995315;931;2,9;2;1;1
258110995315;258110998794;3479;2,9;2;1;1
258110998794;258110999731;937;2,9;2;1;1
258110999731;258111002349;2618;2,9;2;1;1
258111002349;258111002634;285;2,9;2;1;1
258111002634;258111004848;2214;2,9;2;1;1
258111004848;258111006384;1536;2,9;2;1;1
258111006384;258111006618;234;2,9;2;1;1
258111006618;258111006680;62;2,9;2;1;1
258111006680;258111006691;11;2,9;2;1;1
258111006691;258111006715;24;2,9;2;1;1
258111006715;258111006744;29;2,9;2;1;1
258111006744;258111006935;191;2,9;2;1;1
258111006935;258111007032;97;2,9;2;1;1
258111007032;258111007083;51;2,9;2;1;1
258111007083;258111007107;24;2,9;2;1;1
258111007107;258111007211;104;2,9;2;1;1
258111007211;258111007252;41;2,9;2;1;1
258111007252;258111007280;28;2,9;2;1;1
258111007280;258111007524;244;2,9;2;1;1
258111007524;258111007791;267;2,9;2;1;1
258111007791;258111008011;220;2,9;2;1;1
258111008011;258111008439;428;2,9;2;1;1
258111008439;258111008955;516;2,9;2;1;1
258111008955;258111008990;35;2,9;2;1;1
258111008990;258111009294;304;2,9;2;1;1
258111009294;258111009877;583;2,9;2;1;1
258111009877;258111009899;22;2,9;2;1;1
258111009899;258111009936;37;2,9;2;1;1
258111009936;258111010088;152;2,9;2;1;1
258111010088;258111010126;38;2,9;2;1;1
258111010126;258111010135;9;2,9;2;1;1
258111010135;258111011896;1761;2,9;2;1;1
258111011896;258111012567;671;2,9;2;1;1
258111012567;258111012919;352;2,9;2;1;1
258111012919;258111013080;161;2,9;2;1;1
258111013080;258111013904;824;9;1;1;1
258111013904;258111014200;296;9;1;1;1
258111014200;258111014327;127;9;1;1;1
258111014327;258111014328;1;2,9;2;1;1
258111014328;258111014534;206;2,9;2;1;1
258111014534;258111015342;808;2,9;2;1;1
258111015342;258111021197;5855;9;1;1;1
258111021197;258111022473;1276;2,9;2;1;1
258111022473;258111026753;4280;9;1;1;1
258111026753;258111027370;617;9;1;1;1
258111027370;258111028067;697;2,9;2;1;1
258111028067;258111029194;1127;2,9;2;1;1
258111029194;258111029713;519;2,9;2;1;1
258111029713;258111029816;103;9;1;1;1
258111029816;258111030567;751;2,9;2;1;1
258111030567;258111030993;426;9;1;1;1
258111030993;258111031599;606;2,9;2;1;1
258111031599;258111033101;1502;9;1;1;1
258111033101;258111040047;6946;9;1;1;1
