start;end;duration;phases;nphases;jobs;njobs;days;ndays
220152;220152;0;2;1;11;1;1;1
220152;220153;1;-1;0;-1;0
220153;220165;12;7;1;11;1;1;1
220165;223076;2911;-1;0;-1;0
223076;223076;0;1,4,8;3;11;1;1;1
223076;223100;24;8;1;11;1;1;1
223100;226930;3830;-1;0;-1;0
226930;226930;0;1,4,8;3;11;1;1;1
226930;226955;25;8;1;11;1;1;1
226955;230406;3451;-1;0;-1;0
230406;230406;0;1,4;2;11;1;1;1
230406;230407;1;-1;0;-1;0
230407;230441;34;8;1;11;1;1;1
230441;233873;3432;-1;0;-1;0
233873;233873;0;1,4;2;11;1;1;1
233873;233874;1;-1;0;-1;0
233874;233900;26;8;1;11;1;1;1
233900;237728;3828;-1;0;-1;0
237728;237728;0;1,4,8;3;11;1;1;1
237728;237753;25;8;1;11;1;1;1
237753;241761;4008;-1;0;-1;0
241761;241761;0;1,4,8;3;11;1;1;1
241761;241786;25;8;1;11;1;1;1
241786;245945;4159;-1;0;-1;0
245945;245945;0;1,4,8;3;11;1;1;1
245945;245971;26;8;1;11;1;1;1
245971;249710;3739;-1;0;-1;0
249710;249710;0;1,4;2;11;1;1;1
249710;249711;1;-1;0;-1;0
249711;249738;27;8;1;11;1;1;1
249738;250566;828;-1;0;-1;0
250566;250580;14;2;1;9;1;1;1
250580;250580;0;0,1,2,4;4;9;1;1;1
250580;251013;433;2;1;9;1;1;1
250581;250581;0;2,4;2;9;1;1;1
250581;250582;1;-1;0;-1;0
250582;250582;0;0,1,2;3;9;1;1;1
250582;250583;1;0;1;9;1;1;1
250583;250583;0;0;1;9;1;1;1
250583;250584;1;0;1;9;1;1;1
250584;250584;0;0,2;2;9;1;1;1
250584;250585;1;0;1;9;1;1;1
250585;250621;36;-1;0;-1;0
250621;250621;0;0;1;9;1;1;1
250621;250622;1;0;1;9;1;1;1
250622;250622;0;0,2;2;9;1;1;1
250622;257538;6916;2;1;9;1;1;1
250630;250631;1;2;1;9;1;1;1
250631;250631;0;2;1;9;1;1;1
250631;257538;6907;2;1;9;1;1;1
250686;250687;1;2;1;9;1;1;1
250687;250688;1;2;1;9;1;1;1
250688;250689;1;2;1;9;1;1;1
250689;257538;6849;2;1;9;1;1;1
250724;250759;35;2;1;9;1;1;1
250759;250794;35;2;1;9;1;1;1
250794;250828;34;2;1;9;1;1;1
250828;250828;0;0,2;2;9;1;1;1
250828;257538;6710;2;1;9;1;1;1
250829;250829;0;0,2;2;9;1;1;1
250829;250830;1;0,2;2;9;1;1;1
250830;250830;0;0,2;2;9;1;1;1
250830;250915;85;2;1;9;1;1;1
250830;250836;6;2;1;9;1;1;1
250830;250831;1;2;1;9;1;1;1
250831;250834;3;2;1;9;1;1;1
250834;250835;1;2;1;9;1;1;1
250835;250835;0;0,2;2;9;1;1;1
250835;250914;79;2;1;9;1;1;1
250836;250836;0;0,2;2;9;1;1;1
250836;250851;15;2;1;9;1;1;1
250837;250837;0;0;1;9;1;1;1
250837;250838;1;0;1;9;1;1;1
250838;250838;0;0;1;9;1;1;1
250838;250839;1;0;1;9;1;1;1
250839;250839;0;0;1;9;1;1;1
250839;250840;1;0;1;9;1;1;1
250840;250840;0;0;1;9;1;1;1
250840;250841;1;-1;0;-1;0
250841;250841;0;0;1;9;1;1;1
250841;250843;2;-1;0;-1;0
250843;250868;25;2;1;9;1;1;1
250868;250868;0;0,2;2;9;1;1;1
250868;250884;16;2;1;9;1;1;1
250869;250869;0;0;1;9;1;1;1
250869;250870;1;0;1;9;1;1;1
250870;250870;0;0;1;9;1;1;1
250870;250871;1;0;1;9;1;1;1
250871;250871;0;0;1;9;1;1;1
250871;250872;1;0;1;9;1;1;1
250872;250872;0;0;1;9;1;1;1
250872;250873;1;-1;0;-1;0
250873;250873;0;0;1;9;1;1;1
250873;250876;3;-1;0;-1;0
250876;250876;0;0;1;9;1;1;1
250876;250893;17;0;1;9;1;1;1
250876;250892;16;0;1;9;1;1;1
250876;250891;15;0;1;9;1;1;1
250876;250880;4;0;1;9;1;1;1
250876;250879;3;0;1;9;1;1;1
250877;250877;0;0;1;9;1;1;1
250877;250893;16;0;1;9;1;1;1
250877;250892;15;0;1;9;1;1;1
250877;250891;14;0;1;9;1;1;1
250877;250880;3;0;1;9;1;1;1
250877;250879;2;0;1;9;1;1;1
250878;250878;0;0;1;9;1;1;1
250878;250893;15;0;1;9;1;1;1
250878;250892;14;0;1;9;1;1;1
250878;250880;2;0;1;9;1;1;1
250878;250879;1;0;1;9;1;1;1
250879;250879;0;0;1;9;1;1;1
250879;250893;14;0;1;9;1;1;1
250879;250892;13;0;1;9;1;1;1
250879;250891;12;0;1;9;1;1;1
250879;250880;1;0;1;9;1;1;1
250880;250880;0;0;1;9;1;1;1
250880;250893;13;0;1;9;1;1;1
250880;250892;12;0;1;9;1;1;1
250880;250881;1;0;1;9;1;1;1
250881;250881;0;0;1;9;1;1;1
250881;250882;1;0;1;9;1;1;1
250882;250882;0;0;1;9;1;1;1
250882;250883;1;0;1;9;1;1;1
250883;250883;0;0;1;9;1;1;1
250883;250884;1;0;1;9;1;1;1
250884;250884;0;0;1;9;1;1;1
250884;250885;1;-1;0;-1;0
250885;250885;0;0;1;9;1;1;1
250885;250889;4;-1;0;-1;0
250889;250889;0;0;1;9;1;1;1
250889;250893;4;0;1;9;1;1;1
250889;250892;3;0;1;9;1;1;1
250889;250890;1;0;1;9;1;1;1
250890;250890;0;0;1;9;1;1;1
250890;250893;3;0;1;9;1;1;1
250890;250892;2;0;1;9;1;1;1
250890;250891;1;0;1;9;1;1;1
250891;250891;0;0;1;9;1;1;1
250891;250893;2;0;1;9;1;1;1
250891;250892;1;0;1;9;1;1;1
250892;250892;0;0;1;9;1;1;1
250892;250893;1;0;1;9;1;1;1
250893;250893;0;0;1;9;1;1;1
250893;250894;1;-1;0;-1;0
250894;250894;0;2;1;9;1;1;1
250894;250909;15;2;1;9;1;1;1
250894;250896;2;2;1;9;1;1;1
250895;250895;0;0,2;2;9;1;1;1
250895;250896;1;-1;0;-1;0
250896;250911;15;2;1;9;1;1;1
250911;250912;1;2;1;9;1;1;1
250912;250913;1;2;1;9;1;1;1
250913;250913;0;2;1;9;1;1;1
250913;250916;3;2;1;9;1;1;1
250914;250915;1;2;1;9;1;1;1
250915;250916;1;-1;0;-1;0
250916;250916;0;2;1;9;1;1;1
250916;257505;6589;2;1;9;1;1;1
250945;250946;1;2;1;9;1;1;1
250946;250954;8;2;1;9;1;1;1
250954;250955;1;2;1;9;1;1;1
250955;250963;8;2;1;9;1;1;1
250963;250969;6;2;1;9;1;1;1
250969;250975;6;2;1;9;1;1;1
250975;250983;8;2;1;9;1;1;1
250983;250988;5;2;1;9;1;1;1
250988;250989;1;2;1;9;1;1;1
250989;250994;5;2;1;9;1;1;1
250994;250995;1;2;1;9;1;1;1
250995;251000;5;2;1;9;1;1;1
251000;251016;16;2;1;9;1;1;1
251016;251017;1;1,2;2;9;1;1;1
251017;251018;1;1,2;2;9;1;1;1
251018;251019;1;1,2;2;9;1;1;1
251019;251023;4;1,2;2;9;1;1;1
251023;251024;1;1,2;2;9;1;1;1
251024;251025;1;1,2;2;9;1;1;1
251025;251034;9;1,2;2;9;1;1;1
251034;251065;31;1,2;2;9;1;1;1
251065;251066;1;1,2,5;3;9;1;1;1
251066;251067;1;1,2,5;3;9;1;1;1
251067;251082;15;1,2,5;3;9;1;1;1
251082;252169;1087;1,2,5;3;9;1;1;1
252169;252170;1;1,2,5;3;9;1;1;1
252170;252171;1;1,2,5;3;9;1;1;1
252171;252236;65;1,2,5;3;9;1;1;1
252236;252255;19;1,2,3,5;4;9;1;1;1
252255;252256;1;1,2,3,5;4;9;1;1;1
252256;252257;1;1,2,3,5;4;9;1;1;1
252257;252258;1;1,2,3,5;4;9;1;1;1
252258;252259;1;1,2,3,5;4;9;1;1;1
252259;252260;1;1,2,3,5;4;9;1;1;1
252260;252261;1;1,2,3,5;4;9;1;1;1
252261;252262;1;1,2,3,5;4;9;1;1;1
252262;252263;1;1,2,3,5;4;9;1;1;1
252263;252264;1;1,2,3,5;4;9;1;1;1
252264;252265;1;1,2,3,5;4;9;1;1;1
252265;252266;1;1,2,3,5;4;9;1;1;1
252266;252267;1;1,2,3,5;4;9;1;1;1
252267;252268;1;1,2,3,5;4;9;1;1;1
252268;252269;1;1,2,3,5;4;9;1;1;1
252269;252854;585;1,2,3,5;4;9;1;1;1
252854;252854;0;0,1,2,3,5;5;2,9;2;1;1
252854;256894;4040;1,2,3,5;4;9;1;1;1
252855;252855;0;0;1;2;1;1;1
252855;254131;1276;0;1;2;1;1;1
252856;252856;0;0,1;2;2;1;1;1
252856;258103;5247;1;1;2;1;1;1
252856;252862;6;0;1;2;1;1;1
252856;252857;1;0;1;2;1;1;1
252857;252857;0;0;1;2;1;1;1
252857;252938;81;0;1;2;1;1;1
252902;252938;36;0;1;2;1;1;1
252938;252938;0;0;1;2;1;1;1
252938;252939;1;0;1;2;1;1;1
252939;252939;0;0;1;2;1;1;1
252939;254069;1130;0;1;2;1;1;1
252939;254066;1127;0;1;2;1;1;1
252940;252947;7;0;1;2;1;1;1
252947;252947;0;0,1;2;2;1;1;1
252947;254069;1122;0;1;2;1;1;1
252948;252952;4;0;1;2;1;1;1
252952;252959;7;0;1;2;1;1;1
252956;252956;0;0;1;2;1;1;1
252956;252959;3;-1;0;-1;0
252959;252959;0;0;1;2;1;1;1
252959;252960;1;0;1;2;1;1;1
252960;252960;0;0;1;2;1;1;1
252960;253017;57;0;1;2;1;1;1
252980;253017;37;0;1;2;1;1;1
253017;253017;0;0,1;2;2;1;1;1
253017;257852;4835;1;1;2;1;1;1
253017;253720;703;0;1;2;1;1;1
253017;253033;16;0;1;2;1;1;1
253023;253024;1;0;1;2;1;1;1
253024;253034;10;-1;0;-1;0
253034;253034;0;0;1;2;1;1;1
253034;253035;1;0;1;2;1;1;1
253035;253035;0;0;1;2;1;1;1
253035;253301;266;0;1;2;1;1;1
253301;253309;8;0;1;2;1;1;1
253309;253458;149;-1;0;-1;0
253458;253458;0;1,4;2;11;1;1;1
253458;253459;1;-1;0;-1;0
253459;253486;27;8;1;11;1;1;1
253486;253540;54;-1;0;-1;0
253540;253540;0;0,3,4;3;2;1;1;1
253540;257849;4309;3;1;2;1;1;1
253540;253720;180;0;1;2;1;1;1
253720;253720;0;0;1;2;1;1;1
253720;253898;178;0;1;2;1;1;1
253720;253742;22;0;1;2;1;1;1
253721;253731;10;0;1;2;1;1;1
253731;253750;19;-1;0;-1;0
253750;253750;0;0;1;2;1;1;1
253750;253898;148;0;1;2;1;1;1
253898;253936;38;-1;0;-1;0
253936;253959;23;0;1;2;1;1;1
253959;254056;97;0;1;2;1;1;1
253962;253971;9;0;1;2;1;1;1
253971;253973;2;-1;0;-1;0
253973;253995;22;0;1;2;1;1;1
253995;253996;1;0;1;2;1;1;1
253996;254021;25;0;1;2;1;1;1
254021;254024;3;-1;0;-1;0
254024;254047;23;0;1;2;1;1;1
254047;254056;9;-1;0;-1;0
254056;254056;0;0;1;2;1;1;1
254056;254060;4;-1;0;-1;0
254060;254065;5;0;1;2;1;1;1
254065;254393;328;-1;0;-1;0
254393;254865;472;1;1;2;1;1;1
254865;255246;381;1,5;2;2;1;1;1
255246;255281;35;0,1,5;3;2,10;2;1;1
255281;255310;29;1,5;2;2;1;1;1
255310;255336;26;0,1,5;3;2,6;2;1;1
255336;255834;498;1,5;2;2;1;1;1
255834;255881;47;0,1,5;3;2,3;2;1;1
255881;256525;644;1,5;2;2;1;1;1
256525;256575;50;1,5;2;2,3;2;1;1
256575;256801;226;1,5;2;2;1;1;1
256801;256849;48;0,1,5;3;2,5;2;1;1
256849;256894;45;1,5;2;2;1;1;1
256894;256895;1;1,2,3,5;4;2,9;2;1;1
256895;257273;378;1,5;2;2;1;1;1
257273;257273;0;1,4,5;3;2,11;2;1;1
257273;257748;475;1,5;2;2;1;1;1
257274;257303;29;8;1;11;1;1;1
257303;257316;13;-1;0;-1;0
257316;257359;43;1;1;6;1;1;1
257359;257499;140;-1;0;-1;0
257499;257538;39;1;1;5;1;1;1
257538;257538;0;1,2;2;5,9;2;1;1
257538;257549;11;1;1;5;1;1;1
257549;257748;199;-1;0;-1;0
257748;257763;15;1,5;2;2;1;1;1
257763;257810;47;0,1,5;3;0,2;2;1;1
257810;257852;42;1,5;2;2;1;1;1
257852;258076;224;1,5;2;2;1;1;1
258076;258076;0;1,3,5;3;2,9;2;1;1
258076;258103;27;1,5;2;2;1;1;1
258077;258077;0;1,5;2;9;1;1;1
258077;258078;1;1,5;2;9;1;1;1
258078;258078;0;1,5;2;9;1;1;1
258078;258079;1;1,5;2;9;1;1;1
258079;258079;0;1,3,5;3;9;1;1;1
258079;258080;1;1;1;9;1;1;1
258080;258080;0;1,3,5;3;9;1;1;1
258080;258081;1;-1;0;-1;0
258081;258081;0;1,3,5;3;9;1;1;1
258081;258082;1;3;1;9;1;1;1
258082;258082;0;1,3,5;3;9;1;1;1
258082;258083;1;3;1;9;1;1;1
258083;258083;0;1,3,5;3;9;1;1;1
258083;258084;1;1,5;2;9;1;1;1
258084;258084;0;1,5;2;9;1;1;1
258084;258085;1;1,5;2;9;1;1;1
258085;258085;0;1,3,5;3;9;1;1;1
258085;258086;1;-1;0;-1;0
258086;258086;0;1,3,5;3;9;1;1;1
258086;258087;1;1;1;9;1;1;1
258087;258087;0;1,3,5;3;9;1;1;1
258087;258088;1;3;1;9;1;1;1
258088;258088;0;1,3,5;3;9;1;1;1
258088;258089;1;1;1;9;1;1;1
258089;258089;0;1,3,5;3;9;1;1;1
258089;258090;1;-1;0;-1;0
258090;258090;0;1,3,5;3;9;1;1;1
258090;258091;1;1;1;9;1;1;1
258091;258091;0;1,3,5;3;9;1;1;1
258091;258092;1;-1;0;-1;0
258092;258092;0;1,3,5;3;9;1;1;1
258092;258093;1;-1;0;-1;0
258093;258093;0;1,3,5;3;9;1;1;1
258093;258097;4;3;1;9;1;1;1
258093;258096;3;3;1;9;1;1;1
258094;258095;1;3;1;9;1;1;1
258095;258095;0;0,3;2;9;1;1;1
258095;258096;1;3;1;9;1;1;1
258096;258096;0;0,1,3,4,6;5;9;1;1;1
258096;258098;2;0,1,3;3;9;1;1;1
258096;258097;1;0,3;2;9;1;1;1
258097;258097;0;0,3,6;3;9;1;1;1
258097;258099;2;0,3;2;9;1;1;1
258097;258098;1;0,3;2;9;1;1;1
258098;258098;0;0,3,5,6;4;9;1;1;1
258098;258100;2;0,3;2;9;1;1;1
258098;258099;1;0,3;2;9;1;1;1
258099;258099;0;0,1,3,6;4;9;1;1;1
258099;258101;2;0,1,3;3;9;1;1;1
258099;258100;1;0,3;2;9;1;1;1
258100;258100;0;0,1,3,5,6;5;9;1;1;1
258100;258102;2;0,1,3;3;9;1;1;1
258100;258101;1;0,1,3;3;9;1;1;1
258101;258101;0;0,1,3,5,6;5;9;1;1;1
258101;258103;2;0,3;2;9;1;1;1
258101;258102;1;0,1,3;3;9;1;1;1
258102;258102;0;0,1,3,5,6;5;9;1;1;1
258102;258104;2;0,1,3;3;9;1;1;1
258102;258103;1;0,1,3;3;9;1;1;1
258103;258103;0;0,3,5,6;4;9;1;1;1
258103;258107;4;0,3;2;9;1;1;1
258103;258105;2;0,3;2;9;1;1;1
258103;258104;1;0,3;2;9;1;1;1
258104;258104;0;0,1,3,4,5,6;6;2,9;2;1;1
258104;258108;4;3;1;9;1;1;1
258104;258107;3;0,3;2;9;1;1;1
258104;258106;2;0,3;2;9;1;1;1
258104;258105;1;0,1,3,4;4;2,9;2;1;1
258105;258105;0;0,3,4,5,6;5;2,9;2;1;1
258105;258108;3;0,3;2;9;1;1;1
258105;258107;2;0,3;2;9;1;1;1
258105;258106;1;0,3;2;9;1;1;1
258106;258106;0;0,3,4,6;4;2,9;2;1;1
258106;258108;2;0,3;2;9;1;1;1
258106;258107;1;0,3,4;3;2,9;2;1;1
258107;258107;0;0,3,4,6;4;2,9;2;1;1
258107;258111;4;3;1;9;1;1;1
258107;258110;3;0,3;2;9;1;1;1
258107;258108;1;0,3;2;9;1;1;1
258108;258108;0;0,3,4;3;2,9;2;1;1
258108;258111;3;3;1;9;1;1;1
258108;258110;2;0,3;2;9;1;1;1
258108;258109;1;4;1;2;1;1;1
258109;258109;0;0,3,4;3;2,9;2;1;1
258109;258111;2;3;1;9;1;1;1
258109;258110;1;0,3,4;3;2,9;2;1;1
258110;258110;0;0,3,4,6;4;2,9;2;1;1
258110;258111;1;3,4,6;3;2,9;2;1;1
258111;258111;0;0,3,4;3;2,9;2;1;1
258111;258113;2;3;1;9;1;1;1
258111;258112;1;3,4;2;2,9;2;1;1
258112;258112;0;0,3,4;3;2,9;2;1;1
258112;258113;1;0,3,4;3;2,9;2;1;1
258113;258113;0;0,3,4;3;2,9;2;1;1
258113;258114;1;4;1;2;1;1;1
258114;258114;0;3,4;2;2,9;2;1;1
258114;258115;1;-1;0;-1;0
258115;258115;0;3,4;2;2,9;2;1;1
258115;258116;1;4;1;2;1;1;1
258116;258116;0;3,4;2;2,9;2;1;1
258116;258117;1;3,4;2;2,9;2;1;1
258117;258117;0;3,4;2;2,9;2;1;1
258117;258118;1;-1;0;-1;0
258118;258118;0;3;1;9;1;1;1
258118;258119;1;3;1;9;1;1;1
258119;258119;0;3;1;9;1;1;1
258119;258120;1;-1;0;-1;0
258120;258120;0;3,4;2;2,9;2;1;1
258120;258121;1;-1;0;-1;0
258121;258121;0;3,4;2;2,9;2;1;1
258121;258122;1;-1;0;-1;0
258122;258122;0;3,4;2;2,9;2;1;1
258122;258123;1;-1;0;-1;0
258123;258123;0;3,4;2;2,9;2;1;1
258123;258124;1;-1;0;-1;0
258124;258124;0;3,4;2;2,9;2;1;1
258124;258125;1;-1;0;-1;0
258125;258125;0;3,4;2;2,9;2;1;1
258125;258126;1;-1;0;-1;0
258126;258126;0;3,4;2;2,9;2;1;1
258126;258127;1;3;1;9;1;1;1
258127;258127;0;3,4;2;2,9;2;1;1
258127;258128;1;-1;0;-1;0
258128;258128;0;3,4;2;2,9;2;1;1
258128;258129;1;-1;0;-1;0
258129;258129;0;3,4;2;2,9;2;1;1
258129;258130;1;-1;0;-1;0
258130;258130;0;3,4;2;2,9;2;1;1
258130;258131;1;3;1;9;1;1;1
258131;258131;0;3,4;2;2,9;2;1;1
258131;258132;1;3;1;9;1;1;1
258132;258132;0;3,4;2;2,9;2;1;1
258132;258133;1;-1;0;-1;0
258133;258133;0;3,4;2;2,9;2;1;1
258133;258134;1;-1;0;-1;0
258134;258134;0;4;1;2;1;1;1
258134;258135;1;-1;0;-1;0
258135;258135;0;4;1;2;1;1;1
258135;258136;1;-1;0;-1;0
258136;258136;0;4;1;2;1;1;1
258136;258137;1;-1;0;-1;0
258137;258137;0;4;1;2;1;1;1
258137;258138;1;-1;0;-1;0
258138;258138;0;4;1;2;1;1;1
258138;258139;1;-1;0;-1;0
258139;258139;0;4;1;2;1;1;1
258139;258140;1;-1;0;-1;0
258140;258140;0;4;1;2;1;1;1
258140;258141;1;-1;0;-1;0
258141;258141;0;4;1;2;1;1;1
258141;258142;1;-1;0;-1;0
258142;258142;0;4;1;2;1;1;1
258142;258143;1;-1;0;-1;0
258143;258143;0;4;1;2;1;1;1
258143;258144;1;-1;0;-1;0
258144;258144;0;4;1;2;1;1;1
258144;258145;1;-1;0;-1;0
258145;258145;0;4;1;2;1;1;1
258145;258146;1;-1;0;-1;0
258146;258146;0;4;1;2;1;1;1
258146;258147;1;-1;0;-1;0
258147;258147;0;4;1;2;1;1;1
258147;258148;1;-1;0;-1;0
258148;258148;0;4;1;2;1;1;1
258148;258149;1;-1;0;-1;0
258149;258149;0;4;1;2;1;1;1
258149;258150;1;-1;0;-1;0
258150;258150;0;4;1;2;1;1;1
258150;258151;1;-1;0;-1;0
258151;258151;0;4;1;2;1;1;1
258151;258152;1;-1;0;-1;0
258152;258152;0;4;1;2;1;1;1
258152;258153;1;-1;0;-1;0
258153;258153;0;4;1;2;1;1;1
258153;258154;1;-1;0;-1;0
258154;258154;0;4;1;2;1;1;1
258154;258155;1;-1;0;-1;0
258155;258155;0;4;1;2;1;1;1
258155;258156;1;-1;0;-1;0
258156;258156;0;4;1;2;1;1;1
258156;258157;1;-1;0;-1;0
258157;258157;0;4;1;2;1;1;1
258157;258158;1;-1;0;-1;0
258158;258158;0;4;1;2;1;1;1
258158;258159;1;-1;0;-1;0
258159;258159;0;4;1;2;1;1;1
258159;258160;1;-1;0;-1;0
258160;258160;0;4;1;2;1;1;1
258160;258161;1;-1;0;-1;0
258161;258161;0;4;1;2;1;1;1
258161;258162;1;-1;0;-1;0
258162;258162;0;4;1;2;1;1;1
258162;258163;1;-1;0;-1;0
258163;258163;0;4;1;2;1;1;1
258163;258164;1;-1;0;-1;0
258164;258164;0;4;1;2;1;1;1
258164;258165;1;-1;0;-1;0
258165;258165;0;4;1;2;1;1;1
258165;258166;1;-1;0;-1;0
258166;258166;0;4;1;2;1;1;1
258166;258167;1;-1;0;-1;0
258167;258167;0;4;1;2;1;1;1
258167;258168;1;-1;0;-1;0
258168;258168;0;4;1;2;1;1;1
258168;258169;1;4;1;2;1;1;1
258169;258169;0;4;1;2;1;1;1
258169;258170;1;-1;0;-1;0
258170;258170;0;4;1;2;1;1;1
258170;258171;1;-1;0;-1;0
258171;258171;0;4;1;2;1;1;1
258171;258172;1;-1;0;-1;0
258172;258172;0;4;1;2;1;1;1
258172;258173;1;-1;0;-1;0
258173;258173;0;4;1;2;1;1;1
258173;258174;1;-1;0;-1;0
258174;258174;0;4;1;2;1;1;1
258174;258175;1;-1;0;-1;0
258175;258175;0;4;1;2;1;1;1
258175;258176;1;-1;0;-1;0
258176;258176;0;4;1;2;1;1;1
258176;258177;1;-1;0;-1;0
258177;258177;0;4;1;2;1;1;1
258177;258178;1;-1;0;-1;0
258178;258178;0;4;1;2;1;1;1
258178;258179;1;-1;0;-1;0
258179;258179;0;4;1;2;1;1;1
258179;258180;1;-1;0;-1;0
258180;258180;0;4;1;2;1;1;1
258180;258181;1;-1;0;-1;0
258181;258181;0;4;1;2;1;1;1
258181;258182;1;-1;0;-1;0
258182;258182;0;4;1;2;1;1;1
258182;258183;1;-1;0;-1;0
258183;258183;0;4;1;2;1;1;1
258183;258184;1;-1;0;-1;0
258184;258184;0;4;1;2;1;1;1
258184;258185;1;-1;0;-1;0
258185;258185;0;4;1;2;1;1;1
258185;258186;1;-1;0;-1;0
258186;258186;0;4;1;2;1;1;1
258186;258187;1;-1;0;-1;0
258187;258187;0;4;1;2;1;1;1
258187;258188;1;-1;0;-1;0
258188;258188;0;4;1;2;1;1;1
258188;258189;1;-1;0;-1;0
258189;258189;0;4;1;2;1;1;1
258189;258190;1;-1;0;-1;0
258190;258190;0;4;1;2;1;1;1
258190;258191;1;-1;0;-1;0
258191;258191;0;4;1;2;1;1;1
258191;258192;1;-1;0;-1;0
258192;258192;0;4;1;2;1;1;1
258192;258193;1;-1;0;-1;0
258193;258193;0;4;1;2;1;1;1
258193;258194;1;-1;0;-1;0
258194;258194;0;4;1;2;1;1;1
258194;258195;1;-1;0;-1;0
258195;258195;0;4;1;2;1;1;1
258195;258196;1;-1;0;-1;0
258196;258196;0;4;1;2;1;1;1
258196;258197;1;-1;0;-1;0
258197;258197;0;4;1;2;1;1;1
258197;258198;1;-1;0;-1;0
258198;258198;0;4;1;2;1;1;1
258198;258199;1;-1;0;-1;0
258199;258199;0;4;1;2;1;1;1
258199;258200;1;-1;0;-1;0
258200;258200;0;4;1;2;1;1;1
258200;258201;1;-1;0;-1;0
258201;258201;0;4;1;2;1;1;1
258201;258202;1;-1;0;-1;0
258202;258202;0;4;1;2;1;1;1
258202;258203;1;-1;0;-1;0
258203;258203;0;4;1;2;1;1;1
258203;258204;1;-1;0;-1;0
258204;258204;0;4;1;2;1;1;1
258204;258205;1;-1;0;-1;0
258205;258205;0;4;1;2;1;1;1
258205;258206;1;-1;0;-1;0
258206;258206;0;4;1;2;1;1;1
258206;258207;1;-1;0;-1;0
258207;258207;0;4;1;2;1;1;1
258207;258208;1;-1;0;-1;0
258208;258208;0;4;1;2;1;1;1
258208;258209;1;-1;0;-1;0
258209;258209;0;4;1;2;1;1;1
258209;258210;1;-1;0;-1;0
258210;258210;0;4;1;2;1;1;1
258210;258211;1;-1;0;-1;0
258211;258211;0;4;1;2;1;1;1
258211;258212;1;-1;0;-1;0
258212;258212;0;4;1;2;1;1;1
258212;258213;1;-1;0;-1;0
258213;258213;0;4;1;2;1;1;1
258213;258214;1;-1;0;-1;0
258214;258214;0;4;1;2;1;1;1
258214;258215;1;-1;0;-1;0
258215;258215;0;4;1;2;1;1;1
258215;258216;1;-1;0;-1;0
258216;258216;0;4;1;2;1;1;1
258216;258217;1;-1;0;-1;0
258217;258217;0;4;1;2;1;1;1
258217;258218;1;-1;0;-1;0
258218;258218;0;4;1;2;1;1;1
258218;258219;1;-1;0;-1;0
258219;258219;0;4;1;2;1;1;1
258219;258220;1;-1;0;-1;0
258220;258220;0;4;1;2;1;1;1
258220;258221;1;-1;0;-1;0
258221;258221;0;4;1;2;1;1;1
258221;258222;1;-1;0;-1;0
258222;258222;0;4;1;2;1;1;1
258222;258223;1;-1;0;-1;0
258223;258223;0;4;1;2;1;1;1
258223;258224;1;-1;0;-1;0
258224;258224;0;4;1;2;1;1;1
258224;258225;1;-1;0;-1;0
258225;258225;0;4;1;2;1;1;1
258225;258226;1;-1;0;-1;0
258226;258226;0;4;1;2;1;1;1
258226;258227;1;-1;0;-1;0
258227;258227;0;4;1;2;1;1;1
258227;258228;1;-1;0;-1;0
258228;258228;0;4;1;2;1;1;1
258228;258229;1;-1;0;-1;0
258229;258229;0;4;1;2;1;1;1
258229;258230;1;-1;0;-1;0
258230;258230;0;4;1;2;1;1;1
258230;258231;1;-1;0;-1;0
258231;258231;0;4;1;2;1;1;1
258231;258232;1;-1;0;-1;0
258232;258232;0;4;1;2;1;1;1
258232;258233;1;-1;0;-1;0
258233;258233;0;4;1;2;1;1;1
258233;258234;1;-1;0;-1;0
258234;258234;0;4;1;2;1;1;1
258234;258235;1;-1;0;-1;0
258235;258235;0;4;1;2;1;1;1
258235;258236;1;-1;0;-1;0
258236;258236;0;4;1;2;1;1;1
258236;258237;1;-1;0;-1;0
258237;258237;0;4;1;2;1;1;1
258237;258238;1;-1;0;-1;0
258238;258238;0;4;1;2;1;1;1
258238;258239;1;-1;0;-1;0
258239;258239;0;4;1;2;1;1;1
258239;258240;1;-1;0;-1;0
258240;258240;0;4;1;2;1;1;1
258240;258241;1;-1;0;-1;0
258241;258241;0;4;1;2;1;1;1
258241;258242;1;-1;0;-1;0
258242;258242;0;4;1;2;1;1;1
258242;258243;1;-1;0;-1;0
258243;258243;0;4;1;2;1;1;1
258243;258244;1;-1;0;-1;0
258244;258244;0;4;1;2;1;1;1
258244;258245;1;-1;0;-1;0
258245;258245;0;4;1;2;1;1;1
258245;258246;1;-1;0;-1;0
258246;258246;0;4;1;2;1;1;1
258246;258247;1;-1;0;-1;0
258247;258247;0;4;1;2;1;1;1
258247;258248;1;-1;0;-1;0
258248;258248;0;4;1;2;1;1;1
258248;258249;1;-1;0;-1;0
258249;258249;0;4;1;2;1;1;1
258249;258250;1;-1;0;-1;0
258250;258250;0;4;1;2;1;1;1
258250;258251;1;-1;0;-1;0
258251;258251;0;4;1;2;1;1;1
258251;258252;1;-1;0;-1;0
258252;258252;0;4;1;2;1;1;1
258252;258253;1;-1;0;-1;0
258253;258253;0;4;1;2;1;1;1
258253;258254;1;-1;0;-1;0
258254;258254;0;4;1;2;1;1;1
258254;258255;1;-1;0;-1;0
258255;258255;0;4;1;2;1;1;1
258255;258256;1;-1;0;-1;0
258256;258256;0;4;1;2;1;1;1
258256;258257;1;-1;0;-1;0
258257;258257;0;4;1;2;1;1;1
258257;258258;1;-1;0;-1;0
258258;258258;0;4;1;2;1;1;1
258258;258259;1;-1;0;-1;0
258259;258259;0;4;1;2;1;1;1
258259;258260;1;-1;0;-1;0
258260;258260;0;4;1;2;1;1;1
258260;258261;1;-1;0;-1;0
258261;258261;0;4;1;2;1;1;1
258261;258262;1;-1;0;-1;0
258262;258262;0;4;1;2;1;1;1
258262;258263;1;-1;0;-1;0
258263;258263;0;4;1;2;1;1;1
258263;258264;1;-1;0;-1;0
258264;258264;0;4;1;2;1;1;1
258264;258265;1;-1;0;-1;0
258265;258265;0;4;1;2;1;1;1
258265;258266;1;-1;0;-1;0
258266;258266;0;4;1;2;1;1;1
258266;258267;1;-1;0;-1;0
258267;258267;0;4;1;2;1;1;1
258267;258268;1;-1;0;-1;0
258268;258268;0;4;1;2;1;1;1
258268;258269;1;-1;0;-1;0
258269;258269;0;4;1;2;1;1;1
258269;258270;1;-1;0;-1;0
258270;258270;0;4;1;2;1;1;1
258270;258271;1;-1;0;-1;0
258271;258271;0;4;1;2;1;1;1
258271;258272;1;4;1;2;1;1;1
258272;258272;0;4;1;2;1;1;1
258272;258273;1;-1;0;-1;0
258273;258273;0;4;1;2;1;1;1
258273;258274;1;-1;0;-1;0
258274;258274;0;4;1;2;1;1;1
258274;258275;1;-1;0;-1;0
258275;258275;0;4;1;2;1;1;1
258275;258276;1;-1;0;-1;0
258276;258276;0;4;1;2;1;1;1
258276;258277;1;-1;0;-1;0
258277;258277;0;4;1;2;1;1;1
258277;258278;1;-1;0;-1;0
258278;258278;0;4;1;2;1;1;1
258278;258279;1;-1;0;-1;0
258279;258279;0;4;1;2;1;1;1
258279;258280;1;-1;0;-1;0
258280;258280;0;4;1;2;1;1;1
258280;258281;1;-1;0;-1;0
258281;258281;0;4;1;2;1;1;1
258281;258282;1;-1;0;-1;0
258282;258282;0;4;1;2;1;1;1
258282;258283;1;-1;0;-1;0
258283;258283;0;4;1;2;1;1;1
258283;258284;1;-1;0;-1;0
258284;258284;0;4;1;2;1;1;1
258284;258285;1;-1;0;-1;0
258285;258285;0;4;1;2;1;1;1
258285;258286;1;-1;0;-1;0
258286;258286;0;4;1;2;1;1;1
258286;258287;1;-1;0;-1;0
258287;258287;0;4;1;2;1;1;1
258287;258288;1;-1;0;-1;0
258288;258288;0;4;1;2;1;1;1
258288;258289;1;-1;0;-1;0
258289;258289;0;4;1;2;1;1;1
258289;258290;1;-1;0;-1;0
258290;258290;0;4;1;2;1;1;1
258290;258291;1;-1;0;-1;0
258291;258291;0;4;1;2;1;1;1
258291;258292;1;-1;0;-1;0
258292;258292;0;4;1;2;1;1;1
258292;258293;1;-1;0;-1;0
258293;258293;0;4;1;2;1;1;1
258293;258294;1;-1;0;-1;0
258294;258294;0;4;1;2;1;1;1
258294;258295;1;-1;0;-1;0
258295;258295;0;4;1;2;1;1;1
258295;258296;1;-1;0;-1;0
258296;258296;0;4;1;2;1;1;1
258296;258297;1;-1;0;-1;0
258297;258297;0;4;1;2;1;1;1
258297;258298;1;-1;0;-1;0
258298;258298;0;4;1;2;1;1;1
258298;258299;1;-1;0;-1;0
258299;258299;0;4;1;2;1;1;1
258299;258300;1;-1;0;-1;0
258300;258300;0;4;1;2;1;1;1
258300;258301;1;-1;0;-1;0
258301;258301;0;4;1;2;1;1;1
258301;258304;3;4;1;2;1;1;1
258302;258302;0;4;1;2;1;1;1
258302;258303;1;-1;0;-1;0
258303;258303;0;4;1;2;1;1;1
258303;258304;1;-1;0;-1;0
258304;258304;0;4;1;2;1;1;1
258304;258305;1;-1;0;-1;0
258305;258305;0;4;1;2;1;1;1
258305;258306;1;-1;0;-1;0
258306;258306;0;4;1;2;1;1;1
258306;258307;1;-1;0;-1;0
258307;258307;0;4;1;2;1;1;1
258307;258308;1;-1;0;-1;0
258308;258308;0;4;1;2;1;1;1
258308;258309;1;-1;0;-1;0
258309;258309;0;4;1;2;1;1;1
258309;258310;1;-1;0;-1;0
258310;258310;0;4;1;2;1;1;1
258310;258311;1;-1;0;-1;0
258311;258311;0;4;1;2;1;1;1
258311;258312;1;-1;0;-1;0
258312;258312;0;4;1;2;1;1;1
258312;258313;1;-1;0;-1;0
258313;258313;0;4;1;2;1;1;1
258313;258314;1;-1;0;-1;0
258314;258314;0;4;1;2;1;1;1
258314;258315;1;-1;0;-1;0
258315;258315;0;4;1;2;1;1;1
258315;258316;1;-1;0;-1;0
258316;258316;0;4;1;2;1;1;1
258316;258317;1;-1;0;-1;0
258317;258317;0;4;1;2;1;1;1
258317;258318;1;-1;0;-1;0
258318;258318;0;4;1;2;1;1;1
258318;258319;1;-1;0;-1;0
258319;258319;0;4;1;2;1;1;1
258319;258320;1;-1;0;-1;0
258320;258320;0;4;1;2;1;1;1
258320;258321;1;-1;0;-1;0
258321;258321;0;4;1;2;1;1;1
258321;258322;1;-1;0;-1;0
258322;258322;0;4;1;2;1;1;1
258322;258323;1;-1;0;-1;0
258323;258323;0;4;1;2;1;1;1
258323;258324;1;-1;0;-1;0
258324;258324;0;4;1;2;1;1;1
258324;258325;1;-1;0;-1;0
258325;258325;0;4;1;2;1;1;1
258325;258326;1;-1;0;-1;0
258326;258326;0;4;1;2;1;1;1
258326;258327;1;-1;0;-1;0
258327;258327;0;4;1;2;1;1;1
258327;258328;1;-1;0;-1;0
258328;258328;0;4;1;2;1;1;1
258328;258329;1;-1;0;-1;0
258329;258329;0;4;1;2;1;1;1
258329;258330;1;-1;0;-1;0
258330;258330;0;4;1;2;1;1;1
258330;258331;1;-1;0;-1;0
258331;258331;0;4;1;2;1;1;1
258331;258332;1;-1;0;-1;0
258332;258332;0;4;1;2;1;1;1
258332;258333;1;-1;0;-1;0
258333;258333;0;4;1;2;1;1;1
258333;258334;1;-1;0;-1;0
258334;258334;0;4;1;2;1;1;1
258334;258335;1;-1;0;-1;0
258335;258335;0;4;1;2;1;1;1
258335;258336;1;-1;0;-1;0
258336;258336;0;4;1;2;1;1;1
258336;258337;1;-1;0;-1;0
258337;258337;0;4;1;2;1;1;1
258337;258338;1;-1;0;-1;0
258338;258338;0;4;1;2;1;1;1
258338;258339;1;-1;0;-1;0
258339;258339;0;4;1;2;1;1;1
258339;258457;118;-1;0;-1;0
258457;258508;51;1;1;0;1;1;1
258508;258538;30;-1;0;-1;0
258538;258615;77;0;1;7;1;1;1
258615;258779;164;-1;0;-1;0
258779;258788;9;0;1;1;1;1;1
258788;258812;24;0;1;1,8;2;1;1
258812;258814;2;0;1;1,4,8;3;1;1
258814;258814;0;0;1;1,4;2;1;1
258814;258859;45;0;1;4;1;1;1
258859;259114;255;-1;0;-1;0
259114;259176;62;1;1;10;1;1;1
259176;259506;330;-1;0;-1;0
259506;259546;40;1;1;4;1;1;1
259546;259556;10;0,1;2;4,7;2;1;1
259556;259624;68;0;1;7;1;1;1
259624;260556;932;-1;0;-1;0
260556;260634;78;0;1;7;1;1;1
260634;260735;101;-1;0;-1;0
260735;260778;43;1;1;8;1;1;1
260778;261202;424;-1;0;-1;0
261202;261202;0;1,4,8;3;11;1;1;1
261202;261230;28;8;1;11;1;1;1
261230;261564;334;-1;0;-1;0
261564;261641;77;0;1;7;1;1;1
261641;262296;655;-1;0;-1;0
262296;262354;58;1;1;1;1;1;1
262354;262773;419;-1;0;-1;0
262773;262773;0;1,4,8;3;11;1;1;1
262773;262802;29;8;1;11;1;1;1
