start;end;duration;phases;nphases;jobs;njobs
3763;3779;16;0;1;0;1
3779;3810;31;0,3;2;0,1;2
3810;3814;4;3;1;1;1
3814;3897;83;-1;0;-1;0
3897;4001;104;4;1;1;1
4001;4100;99;4,5;2;1,2;2
4100;4300;200;4;1;1;1
4300;4320;20;4,5;2;1,2;2
4320;4445;125;4;1;1;1
4445;4457;12;4,5;2;1,2;2
4457;4490;33;1,2,4,5;4;0,1,2;3
4490;4508;18;1,2,4;3;0,1;2
4508;4524;16;4;1;1;1
4524;4701;177;-1;0;-1;0
4701;4720;19;6;1;3;1
