start;end;duration;phases;nphases;jobs;njobs;days;ndays
220152308402;220152707824;399422;2;1;11;1;1;1
220152707824;220153139869;432045;-1;0;-1;0;1;1
220153139869;220165067403;11927534;7;1;11;1;1;1
220165067403;223076378280;2911310877;-1;0;-1;0;1;1
223076378280;223076379378;1098;4;1;11;1;1;1
223076379378;223076382203;2825;-1;0;-1;0;1;1
223076382203;223076385509;3306;1;1;11;1;1;1
223076385509;223076641119;255610;-1;0;-1;0;1;1
223076641119;223100614723;23973604;8;1;11;1;1;1
223100614723;226930023403;3829408680;-1;0;-1;0;1;1
226930023403;226930024634;1231;4;1;11;1;1;1
226930024634;226930029764;5130;-1;0;-1;0;1;1
226930029764;226930033217;3453;1;1;11;1;1;1
226930033217;226930297896;264679;-1;0;-1;0;1;1
226930297896;226955643345;25345449;8;1;11;1;1;1
226955643345;230406953277;3451309932;-1;0;-1;0;1;1
230406953277;230406954409;1132;4;1;11;1;1;1
230406954409;230406957335;2926;-1;0;-1;0;1;1
230406957335;230406960613;3278;1;1;11;1;1;1
230406960613;230407194940;234327;-1;0;-1;0;1;1
230407194940;230441129801;33934861;8;1;11;1;1;1
230441129801;233873854347;3432724546;-1;0;-1;0;1;1
233873854347;233873855559;1212;4;1;11;1;1;1
233873855559;233873858752;3193;-1;0;-1;0;1;1
233873858752;233873862104;3352;1;1;11;1;1;1
233873862104;233874150132;288028;-1;0;-1;0;1;1
233874150132;233900138538;25988406;8;1;11;1;1;1
233900138538;237728213169;3828074631;-1;0;-1;0;1;1
237728213169;237728214316;1147;4;1;11;1;1;1
237728214316;237728219166;4850;-1;0;-1;0;1;1
237728219166;237728222525;3359;1;1;11;1;1;1
237728222525;237728493697;271172;-1;0;-1;0;1;1
237728493697;237753311887;24818190;8;1;11;1;1;1
237753311887;241761626811;4008314924;-1;0;-1;0;1;1
241761626811;241761627870;1059;4;1;11;1;1;1
241761627870;241761630179;2309;-1;0;-1;0;1;1
241761630179;241761633456;3277;1;1;11;1;1;1
241761633456;241761863312;229856;-1;0;-1;0;1;1
241761863312;241786758255;24894943;8;1;11;1;1;1
241786758255;245945404652;4158646397;-1;0;-1;0;1;1
245945404652;245945405896;1244;4;1;11;1;1;1
245945405896;245945410519;4623;-1;0;-1;0;1;1
245945410519;245945413974;3455;1;1;11;1;1;1
245945413974;245945708056;294082;-1;0;-1;0;1;1
245945708056;245971919059;26211003;8;1;11;1;1;1
245971919059;249710951784;3739032725;-1;0;-1;0;1;1
249710951784;249710952895;1111;4;1;11;1;1;1
249710952895;249710955171;2276;-1;0;-1;0;1;1
249710955171;249710958486;3315;1;1;11;1;1;1
249710958486;249711197405;238919;-1;0;-1;0;1;1
249711197405;249738547825;27350420;8;1;11;1;1;1
249738547825;250566127127;827579302;-1;0;-1;0;1;1
250566127127;250580042232;13915105;2;1;9;1;1;1
250580042232;250580132903;90671;1,2;2;9;1;1;1
250580132903;250580133283;380;1,2;2;9;1;1;1
250580133283;250580133424;141;1,2;2;9;1;1;1
250580133424;250580133517;93;1,2;2;9;1;1;1
250580133517;250580133543;26;1,2;2;9;1;1;1
250580133543;250580133550;7;1,2;2;9;1;1;1
250580133550;250580133580;30;1,2;2;9;1;1;1
250580133580;250580133683;103;1,2;2;9;1;1;1
250580133683;250580133705;22;1,2;2;9;1;1;1
250580133705;250580133783;78;1,2;2;9;1;1;1
250580133783;250580133806;23;1,2;2;9;1;1;1
250580133806;250580133855;49;1,2;2;9;1;1;1
250580133855;250580134682;827;1,2;2;9;1;1;1
250580134682;250580134849;167;1,2;2;9;1;1;1
250580134849;250580134894;45;1,2;2;9;1;1;1
250580134894;250580135114;220;1,2;2;9;1;1;1
250580135114;250580135135;21;1,2;2;9;1;1;1
250580135135;250580135505;370;1,2;2;9;1;1;1
250580135505;250580135552;47;1,2;2;9;1;1;1
250580135552;250580135590;38;1,2;2;9;1;1;1
250580135590;250580135595;5;1,2;2;9;1;1;1
250580135595;250580135610;15;1,2;2;9;1;1;1
250580135610;250580135666;56;1,2;2;9;1;1;1
250580135666;250580135814;148;1,2;2;9;1;1;1
250580135814;250580135877;63;1,2;2;9;1;1;1
250580135877;250580136431;554;1,2;2;9;1;1;1
250580136431;250580136457;26;1,2;2;9;1;1;1
250580136457;250580136526;69;1,2;2;9;1;1;1
250580136526;250580136753;227;1,2;2;9;1;1;1
250580136753;250580136792;39;1,2;2;9;1;1;1
250580136792;250580136819;27;1,2;2;9;1;1;1
250580136819;250580136841;22;1,2;2;9;1;1;1
250580136841;250580136904;63;1,2;2;9;1;1;1
250580136904;250580137045;141;1,2;2;9;1;1;1
250580137045;250580137093;48;1,2;2;9;1;1;1
250580137093;250580137132;39;1,2;2;9;1;1;1
250580137132;250580137177;45;1,2;2;9;1;1;1
250580137177;250580137189;12;1,2;2;9;1;1;1
250580137189;250580137244;55;1,2;2;9;1;1;1
250580137244;250580137283;39;1,2;2;9;1;1;1
250580137283;250580137299;16;1,2;2;9;1;1;1
250580137299;250580137330;31;1,2;2;9;1;1;1
250580137330;250580137368;38;1,2;2;9;1;1;1
250580137368;250580137389;21;1,2;2;9;1;1;1
250580137389;250580137521;132;1,2;2;9;1;1;1
250580137521;250580137581;60;1,2;2;9;1;1;1
250580137581;250580137602;21;1,2;2;9;1;1;1
250580137602;250580137604;2;1,2;2;9;1;1;1
250580137604;250580137639;35;1,2;2;9;1;1;1
250580137639;250580137648;9;1,2;2;9;1;1;1
250580137648;250580137683;35;1,2;2;9;1;1;1
250580137683;250580137688;5;1,2;2;9;1;1;1
250580137688;250580137725;37;1,2;2;9;1;1;1
250580137725;250580137748;23;1,2;2;9;1;1;1
250580137748;250580137970;222;1,2;2;9;1;1;1
250580137970;250580138017;47;1,2;2;9;1;1;1
250580138017;250580138025;8;1,2;2;9;1;1;1
250580138025;250580138043;18;1,2;2;9;1;1;1
250580138043;250580138044;1;1,2;2;9;1;1;1
250580138044;250580138078;34;1,2;2;9;1;1;1
250580138078;250580138110;32;1,2;2;9;1;1;1
250580138110;250580138196;86;1,2;2;9;1;1;1
250580138196;250580138251;55;1,2;2;9;1;1;1
250580138251;250580138275;24;1,2;2;9;1;1;1
250580138275;250580138280;5;1,2;2;9;1;1;1
250580138280;250580138317;37;1,2;2;9;1;1;1
250580138317;250580138342;25;1,2;2;9;1;1;1
250580138342;250580138354;12;1,2;2;9;1;1;1
250580138354;250580138404;50;1,2;2;9;1;1;1
250580138404;250580138418;14;1,2;2;9;1;1;1
250580138418;250580138487;69;1,2;2;9;1;1;1
250580138487;250580138519;32;1,2;2;9;1;1;1
250580138519;250580138559;40;1,2;2;9;1;1;1
250580138559;250580138572;13;1,2;2;9;1;1;1
250580138572;250580138581;9;1,2;2;9;1;1;1
250580138581;250580138605;24;1,2;2;9;1;1;1
250580138605;250580138618;13;1,2;2;9;1;1;1
250580138618;250580138626;8;1,2;2;9;1;1;1
250580138626;250580138636;10;1,2;2;9;1;1;1
250580138636;250580138657;21;1,2;2;9;1;1;1
250580138657;250580138679;22;1,2;2;9;1;1;1
250580138679;250580138713;34;1,2;2;9;1;1;1
250580138713;250580138743;30;1,2;2;9;1;1;1
250580138743;250580138763;20;1,2;2;9;1;1;1
250580138763;250580138791;28;1,2;2;9;1;1;1
250580138791;250580138819;28;1,2;2;9;1;1;1
250580138819;250580138840;21;1,2;2;9;1;1;1
250580138840;250580138843;3;1,2;2;9;1;1;1
250580138843;250580138864;21;1,2;2;9;1;1;1
250580138864;250580138882;18;1,2;2;9;1;1;1
250580138882;250580138909;27;1,2;2;9;1;1;1
250580138909;250580138913;4;1,2;2;9;1;1;1
250580138913;250580138935;22;1,2;2;9;1;1;1
250580138935;250580138954;19;1,2;2;9;1;1;1
250580138954;250580138991;37;1,2;2;9;1;1;1
250580138991;250580139168;177;1,2;2;9;1;1;1
250580139168;250580139319;151;1,2;2;9;1;1;1
250580139319;250580139341;22;1,2;2;9;1;1;1
250580139341;250580139359;18;1,2;2;9;1;1;1
250580139359;250580139708;349;1,2;2;9;1;1;1
250580139708;250580139910;202;1,2;2;9;1;1;1
250580139910;250580139943;33;1,2;2;9;1;1;1
250580139943;250580140031;88;1,2;2;9;1;1;1
250580140031;250580140061;30;1,2;2;9;1;1;1
250580140061;250580140128;67;1,2;2;9;1;1;1
250580140128;250580140310;182;1,2;2;9;1;1;1
250580140310;250580140394;84;1,2;2;9;1;1;1
250580140394;250580140419;25;1,2;2;9;1;1;1
250580140419;250580140471;52;1,2;2;9;1;1;1
250580140471;250580140498;27;1,2;2;9;1;1;1
250580140498;250580140572;74;1,2;2;9;1;1;1
250580140572;250580140599;27;1,2;2;9;1;1;1
250580140599;250580140681;82;1,2;2;9;1;1;1
250580140681;250580140798;117;1,2;2;9;1;1;1
250580140798;250580140860;62;1,2;2;9;1;1;1
250580140860;250580140889;29;1,2;2;9;1;1;1
250580140889;250580140916;27;1,2;2;9;1;1;1
250580140916;250580140976;60;1,2;2;9;1;1;1
250580140976;250580141000;24;1,2;2;9;1;1;1
250580141000;250580141013;13;1,2;2;9;1;1;1
250580141013;250580141035;22;1,2;2;9;1;1;1
250580141035;250580141049;14;1,2;2;9;1;1;1
250580141049;250580141071;22;1,2;2;9;1;1;1
250580141071;250580141110;39;1,2;2;9;1;1;1
250580141110;250580141112;2;1,2;2;9;1;1;1
250580141112;250580141132;20;1,2;2;9;1;1;1
250580141132;250580141154;22;1,2;2;9;1;1;1
250580141154;250580141177;23;1,2;2;9;1;1;1
250580141177;250580141179;2;1,2;2;9;1;1;1
250580141179;250580141211;32;1,2;2;9;1;1;1
250580141211;250580141265;54;1,2;2;9;1;1;1
250580141265;250580141341;76;1,2;2;9;1;1;1
250580141341;250580141522;181;1,2;2;9;1;1;1
250580141522;250580141761;239;1,2;2;9;1;1;1
250580141761;250580141773;12;1,2;2;9;1;1;1
250580141773;250580141815;42;1,2;2;9;1;1;1
250580141815;250580141890;75;1,2;2;9;1;1;1
250580141890;250580141914;24;1,2;2;9;1;1;1
250580141914;250580142214;300;1,2;2;9;1;1;1
250580142214;250580142391;177;1,2;2;9;1;1;1
250580142391;250580142414;23;1,2;2;9;1;1;1
250580142414;250580142598;184;1,2;2;9;1;1;1
250580142598;250580142631;33;1,2;2;9;1;1;1
250580142631;250580142652;21;1,2;2;9;1;1;1
250580142652;250580142682;30;1,2;2;9;1;1;1
250580142682;250580142702;20;1,2;2;9;1;1;1
250580142702;250580142734;32;1,2;2;9;1;1;1
250580142734;250580142755;21;1,2;2;9;1;1;1
250580142755;250580142794;39;1,2;2;9;1;1;1
250580142794;250580142812;18;1,2;2;9;1;1;1
250580142812;250580142815;3;1,2;2;9;1;1;1
250580142815;250580142837;22;1,2;2;9;1;1;1
250580142837;250580142846;9;1,2;2;9;1;1;1
250580142846;250580142870;24;1,2;2;9;1;1;1
250580142870;250580142899;29;1,2;2;9;1;1;1
250580142899;250580142921;22;1,2;2;9;1;1;1
250580142921;250580142965;44;1,2;2;9;1;1;1
250580142965;250580142980;15;1,2;2;9;1;1;1
250580142980;250580143003;23;1,2;2;9;1;1;1
250580143003;250580143019;16;1,2;2;9;1;1;1
250580143019;250580143033;14;1,2;2;9;1;1;1
250580143033;250580143068;35;1,2;2;9;1;1;1
250580143068;250580143069;1;1,2;2;9;1;1;1
250580143069;250580143115;46;1,2;2;9;1;1;1
250580143115;250580143124;9;1,2;2;9;1;1;1
250580143124;250580143148;24;1,2;2;9;1;1;1
250580143148;250580143173;25;1,2;2;9;1;1;1
250580143173;250580143183;10;1,2;2;9;1;1;1
250580143183;250580143186;3;1,2;2;9;1;1;1
250580143186;250580143205;19;1,2;2;9;1;1;1
250580143205;250580143207;2;1,2;2;9;1;1;1
250580143207;250580143212;5;1,2;2;9;1;1;1
250580143212;250580143235;23;1,2;2;9;1;1;1
250580143235;250580143238;3;1,2;2;9;1;1;1
250580143238;250580143259;21;1,2;2;9;1;1;1
250580143259;250580143264;5;1,2;2;9;1;1;1
250580143264;250580143274;10;1,2;2;9;1;1;1
250580143274;250580143296;22;1,2;2;9;1;1;1
250580143296;250580143318;22;1,2;2;9;1;1;1
250580143318;250580143364;46;1,2;2;9;1;1;1
250580143364;250580143384;20;1,2;2;9;1;1;1
250580143384;250580143468;84;1,2;2;9;1;1;1
250580143468;250580143485;17;1,2;2;9;1;1;1
250580143485;250580143505;20;1,2;2;9;1;1;1
250580143505;250580143521;16;1,2;2;9;1;1;1
250580143521;250580143539;18;1,2;2;9;1;1;1
250580143539;250580143572;33;1,2;2;9;1;1;1
250580143572;250580143577;5;1,2;2;9;1;1;1
250580143577;250580143604;27;1,2;2;9;1;1;1
250580143604;250580143627;23;1,2;2;9;1;1;1
250580143627;250580143660;33;1,2;2;9;1;1;1
250580143660;250580143697;37;1,2;2;9;1;1;1
250580143697;250580143728;31;1,2;2;9;1;1;1
250580143728;250580143729;1;1,2;2;9;1;1;1
250580143729;250580143763;34;1,2;2;9;1;1;1
250580143763;250580143789;26;1,2;2;9;1;1;1
250580143789;250580143791;2;1,2;2;9;1;1;1
250580143791;250580143803;12;1,2;2;9;1;1;1
250580143803;250580143817;14;1,2;2;9;1;1;1
250580143817;250580143831;14;1,2;2;9;1;1;1
250580143831;250580143896;65;1,2;2;9;1;1;1
250580143896;250580143904;8;1,2;2;9;1;1;1
250580143904;250580143923;19;1,2;2;9;1;1;1
250580143923;250580143937;14;1,2;2;9;1;1;1
250580143937;250580143941;4;1,2;2;9;1;1;1
250580143941;250580143959;18;1,2;2;9;1;1;1
250580143959;250580143962;3;1,2;2;9;1;1;1
250580143962;250580143964;2;1,2;2;9;1;1;1
250580143964;250580143966;2;1,2;2;9;1;1;1
250580143966;250580143989;23;1,2;2;9;1;1;1
250580143989;250580144000;11;1,2;2;9;1;1;1
250580144000;250580144012;12;1,2;2;9;1;1;1
250580144012;250580144018;6;1,2;2;9;1;1;1
250580144018;250580144022;4;1,2;2;9;1;1;1
250580144022;250580144026;4;1,2;2;9;1;1;1
250580144026;250580144034;8;1,2;2;9;1;1;1
250580144034;250580144054;20;1,2;2;9;1;1;1
250580144054;250580144059;5;1,2;2;9;1;1;1
250580144059;250580144069;10;1,2;2;9;1;1;1
250580144069;250580144072;3;1,2;2;9;1;1;1
250580144072;250580144088;16;1,2;2;9;1;1;1
250580144088;250580144111;23;1,2;2;9;1;1;1
250580144111;250580144119;8;1,2;2;9;1;1;1
250580144119;250580144121;2;1,2;2;9;1;1;1
250580144121;250580144159;38;1,2;2;9;1;1;1
250580144159;250580144184;25;1,2;2;9;1;1;1
250580144184;250580144195;11;1,2;2;9;1;1;1
250580144195;250580144226;31;1,2;2;9;1;1;1
250580144226;250580144249;23;1,2;2;9;1;1;1
250580144249;250580144269;20;1,2;2;9;1;1;1
250580144269;250580144278;9;1,2;2;9;1;1;1
250580144278;250580144317;39;1,2;2;9;1;1;1
250580144317;250580144509;192;1,2;2;9;1;1;1
250580144509;250580144556;47;1,2;2;9;1;1;1
250580144556;250580144795;239;1,2;2;9;1;1;1
250580144795;250580144803;8;1,2;2;9;1;1;1
250580144803;250580144825;22;1,2;2;9;1;1;1
250580144825;250580144866;41;1,2;2;9;1;1;1
250580144866;250580144900;34;1,2;2;9;1;1;1
250580144900;250580144908;8;1,2;2;9;1;1;1
250580144908;250580144927;19;1,2;2;9;1;1;1
250580144927;250580144931;4;1,2;2;9;1;1;1
250580144931;250580145037;106;1,2;2;9;1;1;1
250580145037;250580145183;146;1,2;2;9;1;1;1
250580145183;250580145220;37;1,2;2;9;1;1;1
250580145220;250580145235;15;1,2;2;9;1;1;1
250580145235;250580145291;56;1,2;2;9;1;1;1
250580145291;250580145394;103;1,2;2;9;1;1;1
250580145394;250580145472;78;1,2;2;9;1;1;1
250580145472;250580145499;27;1,2;2;9;1;1;1
250580145499;250580145539;40;1,2;2;9;1;1;1
250580145539;250580145545;6;1,2;2;9;1;1;1
250580145545;250580145601;56;1,2;2;9;1;1;1
250580145601;250580145675;74;1,2;2;9;1;1;1
250580145675;250580145717;42;1,2;2;9;1;1;1
250580145717;250580145773;56;1,2;2;9;1;1;1
250580145773;250580145796;23;1,2;2;9;1;1;1
250580145796;250580145845;49;1,2;2;9;1;1;1
250580145845;250580145849;4;1,2;2;9;1;1;1
250580145849;250580145887;38;1,2;2;9;1;1;1
250580145887;250580145900;13;1,2;2;9;1;1;1
250580145900;250580145955;55;1,2;2;9;1;1;1
250580145955;250580145976;21;1,2;2;9;1;1;1
250580145976;250580145994;18;1,2;2;9;1;1;1
250580145994;250580146006;12;1,2;2;9;1;1;1
250580146006;250580146009;3;1,2;2;9;1;1;1
250580146009;250580146035;26;1,2;2;9;1;1;1
250580146035;250580146044;9;1,2;2;9;1;1;1
250580146044;250580146065;21;1,2;2;9;1;1;1
250580146065;250580146085;20;1,2;2;9;1;1;1
250580146085;250580146089;4;1,2;2;9;1;1;1
250580146089;250580146103;14;1,2;2;9;1;1;1
250580146103;250580146178;75;1,2;2;9;1;1;1
250580146178;250580146297;119;1,2;2;9;1;1;1
250580146297;250580146307;10;1,2;2;9;1;1;1
250580146307;250580146343;36;1,2;2;9;1;1;1
250580146343;250580146372;29;1,2;2;9;1;1;1
250580146372;250580146391;19;1,2;2;9;1;1;1
250580146391;250580146410;19;1,2;2;9;1;1;1
250580146410;250580146444;34;1,2;2;9;1;1;1
250580146444;250580146473;29;1,2;2;9;1;1;1
250580146473;250580146475;2;1,2;2;9;1;1;1
250580146475;250580146520;45;1,2;2;9;1;1;1
250580146520;250580146546;26;1,2;2;9;1;1;1
250580146546;250580146561;15;1,2;2;9;1;1;1
250580146561;250580146592;31;1,2;2;9;1;1;1
250580146592;250580146596;4;1,2;2;9;1;1;1
250580146596;250580146615;19;1,2;2;9;1;1;1
250580146615;250580146634;19;1,2;2;9;1;1;1
250580146634;250580146635;1;1,2;2;9;1;1;1
250580146635;250580146643;8;1,2;2;9;1;1;1
250580146643;250580146655;12;1,2;2;9;1;1;1
250580146655;250580146682;27;1,2;2;9;1;1;1
250580146682;250580146701;19;1,2;2;9;1;1;1
250580146701;250580146753;52;1,2;2;9;1;1;1
250580146753;250580146756;3;1,2;2;9;1;1;1
250580146756;250580146795;39;1,2;2;9;1;1;1
250580146795;250580146810;15;1,2;2;9;1;1;1
250580146810;250580146826;16;1,2;2;9;1;1;1
250580146826;250580146836;10;1,2;2;9;1;1;1
250580146836;250580146885;49;1,2;2;9;1;1;1
250580146885;250580146903;18;1,2;2;9;1;1;1
250580146903;250580146948;45;1,2;2;9;1;1;1
250580146948;250580146955;7;1,2;2;9;1;1;1
250580146955;250580146957;2;1,2;2;9;1;1;1
250580146957;250580146969;12;1,2;2;9;1;1;1
250580146969;250580146990;21;1,2;2;9;1;1;1
250580146990;250580146991;1;1,2;2;9;1;1;1
250580146991;250580147014;23;1,2;2;9;1;1;1
250580147014;250580147018;4;1,2;2;9;1;1;1
250580147018;250580147037;19;1,2;2;9;1;1;1
250580147037;250580147087;50;1,2;2;9;1;1;1
250580147087;250580147108;21;1,2;2;9;1;1;1
250580147108;250580147147;39;1,2;2;9;1;1;1
250580147147;250580147149;2;1,2;2;9;1;1;1
250580147149;250580147179;30;1,2;2;9;1;1;1
250580147179;250580147184;5;1,2;2;9;1;1;1
250580147184;250580147202;18;1,2;2;9;1;1;1
250580147202;250580147209;7;1,2;2;9;1;1;1
250580147209;250580147216;7;1,2;2;9;1;1;1
250580147216;250580147240;24;1,2;2;9;1;1;1
250580147240;250580147254;14;1,2;2;9;1;1;1
250580147254;250580147261;7;1,2;2;9;1;1;1
250580147261;250580147269;8;1,2;2;9;1;1;1
250580147269;250580147289;20;1,2;2;9;1;1;1
250580147289;250580147323;34;1,2;2;9;1;1;1
250580147323;250580147344;21;1,2;2;9;1;1;1
250580147344;250580147357;13;1,2;2;9;1;1;1
250580147357;250580147376;19;1,2;2;9;1;1;1
250580147376;250580147396;20;1,2;2;9;1;1;1
250580147396;250580147410;14;1,2;2;9;1;1;1
250580147410;250580147430;20;1,2;2;9;1;1;1
250580147430;250580147458;28;1,2;2;9;1;1;1
250580147458;250580147469;11;1,2;2;9;1;1;1
250580147469;250580147485;16;1,2;2;9;1;1;1
250580147485;250580147504;19;1,2;2;9;1;1;1
250580147504;250580147523;19;1,2;2;9;1;1;1
250580147523;250580147528;5;1,2;2;9;1;1;1
250580147528;250580147544;16;1,2;2;9;1;1;1
250580147544;250580147555;11;1,2;2;9;1;1;1
250580147555;250580147586;31;1,2;2;9;1;1;1
250580147586;250580147628;42;1,2;2;9;1;1;1
250580147628;250580147663;35;1,2;2;9;1;1;1
250580147663;250580147695;32;1,2;2;9;1;1;1
250580147695;250580147704;9;1,2;2;9;1;1;1
250580147704;250580147709;5;1,2;2;9;1;1;1
250580147709;250580147732;23;1,2;2;9;1;1;1
250580147732;250580147779;47;1,2;2;9;1;1;1
250580147779;250580147801;22;1,2;2;9;1;1;1
250580147801;250580147838;37;1,2;2;9;1;1;1
250580147838;250580147916;78;1,2;2;9;1;1;1
250580147916;250580147966;50;1,2;2;9;1;1;1
250580147966;250580147996;30;1,2;2;9;1;1;1
250580147996;250580148016;20;1,2;2;9;1;1;1
250580148016;250580148386;370;1,2;2;9;1;1;1
250580148386;250580148518;132;1,2;2;9;1;1;1
250580148518;250580148556;38;1,2;2;9;1;1;1
250580148556;250580148648;92;1,2;2;9;1;1;1
250580148648;250580148661;13;1,2;2;9;1;1;1
250580148661;250580148706;45;1,2;2;9;1;1;1
250580148706;250580148754;48;1,2;2;9;1;1;1
250580148754;250580148763;9;1,2;2;9;1;1;1
250580148763;250580148778;15;1,2;2;9;1;1;1
250580148778;250580148791;13;1,2;2;9;1;1;1
250580148791;250580148819;28;1,2;2;9;1;1;1
250580148819;250580148826;7;1,2;2;9;1;1;1
250580148826;250580148847;21;1,2;2;9;1;1;1
250580148847;250580148867;20;1,2;2;9;1;1;1
250580148867;250580148875;8;1,2;2;9;1;1;1
250580148875;250580148877;2;1,2;2;9;1;1;1
250580148877;250580148900;23;1,2;2;9;1;1;1
250580148900;250580148902;2;1,2;2;9;1;1;1
250580148902;250580148929;27;1,2;2;9;1;1;1
250580148929;250580148951;22;1,2;2;9;1;1;1
250580148951;250580148981;30;1,2;2;9;1;1;1
250580148981;250580149017;36;1,2;2;9;1;1;1
250580149017;250580149026;9;1,2;2;9;1;1;1
250580149026;250580149049;23;1,2;2;9;1;1;1
250580149049;250580149059;10;1,2;2;9;1;1;1
250580149059;250580149074;15;1,2;2;9;1;1;1
250580149074;250580149078;4;1,2;2;9;1;1;1
250580149078;250580149105;27;1,2;2;9;1;1;1
250580149105;250580149106;1;1,2;2;9;1;1;1
250580149106;250580149107;1;1,2;2;9;1;1;1
250580149107;250580149139;32;1,2;2;9;1;1;1
250580149139;250580149219;80;1,2;2;9;1;1;1
250580149219;250580149241;22;1,2;2;9;1;1;1
250580149241;250580149296;55;1,2;2;9;1;1;1
250580149296;250580149410;114;1,2;2;9;1;1;1
250580149410;250580149437;27;1,2;2;9;1;1;1
250580149437;250580149456;19;1,2;2;9;1;1;1
250580149456;250580149480;24;1,2;2;9;1;1;1
250580149480;250580149511;31;1,2;2;9;1;1;1
250580149511;250580149533;22;1,2;2;9;1;1;1
250580149533;250580149639;106;1,2;2;9;1;1;1
250580149639;250580149722;83;1,2;2;9;1;1;1
250580149722;250580149752;30;1,2;2;9;1;1;1
250580149752;250580149783;31;1,2;2;9;1;1;1
250580149783;250580149873;90;1,2;2;9;1;1;1
250580149873;250580149903;30;1,2;2;9;1;1;1
250580149903;250580149944;41;1,2;2;9;1;1;1
250580149944;250580149978;34;1,2;2;9;1;1;1
250580149978;250580150021;43;1,2;2;9;1;1;1
250580150021;250580150051;30;1,2;2;9;1;1;1
250580150051;250580150077;26;1,2;2;9;1;1;1
250580150077;250580150106;29;1,2;2;9;1;1;1
250580150106;250580150136;30;1,2;2;9;1;1;1
250580150136;250580150171;35;1,2;2;9;1;1;1
250580150171;250580150199;28;1,2;2;9;1;1;1
250580150199;250580150226;27;1,2;2;9;1;1;1
250580150226;250580150255;29;1,2;2;9;1;1;1
250580150255;250580150284;29;1,2;2;9;1;1;1
250580150284;250580150313;29;1,2;2;9;1;1;1
250580150313;250580150350;37;1,2;2;9;1;1;1
250580150350;250580150382;32;1,2;2;9;1;1;1
250580150382;250580150449;67;1,2;2;9;1;1;1
250580150449;250580150583;134;1,2;2;9;1;1;1
250580150583;250580150625;42;1,2;2;9;1;1;1
250580150625;250580150662;37;1,2;2;9;1;1;1
250580150662;250580150722;60;1,2;2;9;1;1;1
250580150722;250580150773;51;1,2;2;9;1;1;1
250580150773;250580150820;47;1,2;2;9;1;1;1
250580150820;250580150890;70;1,2;2;9;1;1;1
250580150890;250580150911;21;1,2;2;9;1;1;1
250580150911;250580150949;38;1,2;2;9;1;1;1
250580150949;250580151565;616;1,2;2;9;1;1;1
250580151565;250580151604;39;1,2;2;9;1;1;1
250580151604;250580151614;10;1,2;2;9;1;1;1
250580151614;250580151673;59;1,2;2;9;1;1;1
250580151673;250580151679;6;1,2;2;9;1;1;1
250580151679;250580151712;33;1,2;2;9;1;1;1
250580151712;250580151724;12;1,2;2;9;1;1;1
250580151724;250580151777;53;1,2;2;9;1;1;1
250580151777;250580151837;60;1,2;2;9;1;1;1
250580151837;250580151847;10;1,2;2;9;1;1;1
250580151847;250580151951;104;1,2;2;9;1;1;1
250580151951;250580151977;26;1,2;2;9;1;1;1
250580151977;250580152205;228;1,2;2;9;1;1;1
250580152205;250580152240;35;1,2;2;9;1;1;1
250580152240;250580152258;18;1,2;2;9;1;1;1
250580152258;250580152297;39;1,2;2;9;1;1;1
250580152297;250580152353;56;1,2;2;9;1;1;1
250580152353;250580152360;7;1,2;2;9;1;1;1
250580152360;250580152400;40;1,2;2;9;1;1;1
250580152400;250580152416;16;1,2;2;9;1;1;1
250580152416;250580152436;20;1,2;2;9;1;1;1
250580152436;250580152468;32;1,2;2;9;1;1;1
250580152468;250580152593;125;1,2;2;9;1;1;1
250580152593;250580152666;73;1,2;2;9;1;1;1
250580152666;250580152706;40;1,2;2;9;1;1;1
250580152706;250580152813;107;1,2;2;9;1;1;1
250580152813;250580152848;35;1,2;2;9;1;1;1
250580152848;250580152934;86;1,2;2;9;1;1;1
250580152934;250580152974;40;1,2;2;9;1;1;1
250580152974;250580153068;94;1,2;2;9;1;1;1
250580153068;250580153536;468;1,2;2;9;1;1;1
250580153536;250580153573;37;1,2;2;9;1;1;1
250580153573;250580153614;41;1,2;2;9;1;1;1
250580153614;250580153660;46;1,2;2;9;1;1;1
250580153660;250580153696;36;1,2;2;9;1;1;1
250580153696;250580153737;41;1,2;2;9;1;1;1
250580153737;250580153770;33;1,2;2;9;1;1;1
250580153770;250580153804;34;1,2;2;9;1;1;1
250580153804;250580153846;42;1,2;2;9;1;1;1
250580153846;250580154390;544;1,2;2;9;1;1;1
250580154390;250580155149;759;1,2;2;9;1;1;1
250580155149;250580155398;249;1,2;2;9;1;1;1
250580155398;250580155446;48;1,2;2;9;1;1;1
250580155446;250580155503;57;1,2;2;9;1;1;1
250580155503;250580155538;35;1,2;2;9;1;1;1
250580155538;250580155940;402;1,2;2;9;1;1;1
250580155940;250580156441;501;1,2;2;9;1;1;1
250580156441;250580156506;65;1,2;2;9;1;1;1
250580156506;250580166198;9692;1,2;2;9;1;1;1
250580166198;250580177208;11010;1,2;2;9;1;1;1
250580177208;250580177532;324;1,2;2;9;1;1;1
250580177532;250580201261;23729;1,2;2;9;1;1;1
250580201261;250580201786;525;1,2,4;3;9;1;1;1
250580201786;250580203997;2211;1,2;2;9;1;1;1
250580203997;250580204222;225;0,1,2;3;9;1;1;1
250580204222;250580303246;99024;1,2;2;9;1;1;1
250580303246;250580368594;65348;1,2;2;9;1;1;1
250580368594;250580624231;255637;1,2;2;9;1;1;1
250580624231;250580667431;43200;1,2;2;9;1;1;1
250580667431;250581006383;338952;1,2;2;9;1;1;1
250581006383;250581063093;56710;1,2;2;9;1;1;1
250581063093;250581148423;85330;1,2;2;9;1;1;1
250581148423;250581152290;3867;1,2,4;3;9;1;1;1
250581152290;250581215164;62874;1,2;2;9;1;1;1
250581215164;250582226488;1011324;1,2;2;9;1;1;1
250582226488;250582233645;7157;1,2;2;9;1;1;1
250582233645;250582265989;32344;1,2;2;9;1;1;1
250582265989;250582298613;32624;1,2;2;9;1;1;1
250582298613;250582302982;4369;0,1,2;3;9;1;1;1
250582302982;250582318174;15192;0,1,2;3;9;1;1;1
250582318174;250582323584;5410;0,1,2;3;9;1;1;1
250582323584;250582328817;5233;0,1,2;3;9;1;1;1
250582328817;250582329600;783;0,1,2;3;9;1;1;1
250582329600;250582333649;4049;0,1,2;3;9;1;1;1
250582333649;250582333731;82;0,1,2;3;9;1;1;1
250582333731;250582333918;187;0,1,2;3;9;1;1;1
250582333918;250582334150;232;0,1,2;3;9;1;1;1
250582334150;250582340841;6691;0,1,2;3;9;1;1;1
250582340841;250582341088;247;0,1,2;3;9;1;1;1
250582341088;250582345417;4329;0,1,2;3;9;1;1;1
250582345417;250582347003;1586;0,1,2;3;9;1;1;1
250582347003;250582349378;2375;0,1,2;3;9;1;1;1
250582349378;250582349395;17;0,1,2;3;9;1;1;1
250582349395;250582349450;55;0,1,2;3;9;1;1;1
250582349450;250582350224;774;0,1,2;3;9;1;1;1
250582350224;250582350437;213;0,1,2;3;9;1;1;1
250582350437;250582350514;77;0,1,2;3;9;1;1;1
250582350514;250582352322;1808;0,1,2;3;9;1;1;1
250582352322;250582353320;998;0,1,2;3;9;1;1;1
250582353320;250582353394;74;0,1,2;3;9;1;1;1
250582353394;250582353857;463;0,1,2;3;9;1;1;1
250582353857;250582353998;141;0,1,2;3;9;1;1;1
250582353998;250582354053;55;0,1,2;3;9;1;1;1
250582354053;250582354408;355;0,1,2;3;9;1;1;1
250582354408;250582354555;147;0,1,2;3;9;1;1;1
250582354555;250582355901;1346;0,1,2;3;9;1;1;1
250582355901;250582356929;1028;0,1,2;3;9;1;1;1
250582356929;250582356995;66;0,1,2;3;9;1;1;1
250582356995;250582357084;89;0,1,2;3;9;1;1;1
250582357084;250582357650;566;0,1,2;3;9;1;1;1
250582357650;250582358450;800;0,1,2;3;9;1;1;1
250582358450;250582358778;328;0,1,2;3;9;1;1;1
250582358778;250582358816;38;0,1,2;3;9;1;1;1
250582358816;250582359124;308;0,1,2;3;9;1;1;1
250582359124;250582359691;567;0,1,2;3;9;1;1;1
250582359691;250582361816;2125;0,1,2;3;9;1;1;1
250582361816;250582362873;1057;0,1,2;3;9;1;1;1
250582362873;250582364367;1494;0,1,2;3;9;1;1;1
250582364367;250582372800;8433;0,1,2;3;9;1;1;1
250582372800;250582380241;7441;0,1,2;3;9;1;1;1
250582380241;250582381495;1254;0,1,2;3;9;1;1;1
250582381495;250582385268;3773;0,1,2;3;9;1;1;1
250582385268;250582385971;703;0,1,2;3;9;1;1;1
250582385971;250582386040;69;0,1,2;3;9;1;1;1
250582386040;250582386906;866;0,1,2;3;9;1;1;1
250582386906;250582389026;2120;0,1,2;3;9;1;1;1
250582389026;250582390301;1275;0,1,2;3;9;1;1;1
250582390301;250582390494;193;0,1,2;3;9;1;1;1
250582390494;250582390569;75;0,1,2;3;9;1;1;1
250582390569;250582391131;562;0,1,2;3;9;1;1;1
250582391131;250582391732;601;0,1,2;3;9;1;1;1
250582391732;250582393120;1388;0,1,2;3;9;1;1;1
250582393120;250582393923;803;0,1,2;3;9;1;1;1
250582393923;250582393985;62;0,1,2;3;9;1;1;1
250582393985;250582394013;28;0,1,2;3;9;1;1;1
250582394013;250582394062;49;0,1,2;3;9;1;1;1
250582394062;250582394116;54;0,1,2;3;9;1;1;1
250582394116;250582394292;176;0,1,2;3;9;1;1;1
250582394292;250582396117;1825;0,1,2;3;9;1;1;1
250582396117;250582398663;2546;0,1,2;3;9;1;1;1
250582398663;250582400768;2105;0,1,2;3;9;1;1;1
250582400768;250582400990;222;0,1,2;3;9;1;1;1
250582400990;250582402642;1652;0,1,2;3;9;1;1;1
250582402642;250582412144;9502;0,1,2;3;9;1;1;1
250582412144;250582412206;62;0,1,2;3;9;1;1;1
250582412206;250582413370;1164;0,1,2;3;9;1;1;1
250582413370;250582413719;349;0,1,2;3;9;1;1;1
250582413719;250582413784;65;0,1,2;3;9;1;1;1
250582413784;250582414218;434;0,1,2;3;9;1;1;1
250582414218;250582414428;210;0,1,2;3;9;1;1;1
250582414428;250582414885;457;0,1,2;3;9;1;1;1
250582414885;250582415762;877;0,1,2;3;9;1;1;1
250582415762;250582416637;875;0,1,2;3;9;1;1;1
250582416637;250582418804;2167;0,1,2;3;9;1;1;1
250582418804;250582418896;92;0,1,2;3;9;1;1;1
250582418896;250582425083;6187;0,1,2;3;9;1;1;1
250582425083;250582426215;1132;0,1,2;3;9;1;1;1
250582426215;250582428536;2321;0,1,2;3;9;1;1;1
250582428536;250582433022;4486;0,1,2;3;9;1;1;1
250582433022;250582436077;3055;0,1,2;3;9;1;1;1
250582436077;250582437353;1276;0,1,2;3;9;1;1;1
250582437353;250582437567;214;0,1,2;3;9;1;1;1
250582437567;250582438213;646;0,1,2;3;9;1;1;1
250582438213;250582439173;960;0,1,2;3;9;1;1;1
250582439173;250582439505;332;0,1,2;3;9;1;1;1
250582439505;250582439691;186;0,1,2;3;9;1;1;1
250582439691;250582439786;95;0,1,2;3;9;1;1;1
250582439786;250582441669;1883;0,1,2;3;9;1;1;1
250582441669;250582442812;1143;0,1,2;3;9;1;1;1
250582442812;250582446774;3962;0,1,2;3;9;1;1;1
250582446774;250582448429;1655;0,1,2;3;9;1;1;1
250582448429;250582449466;1037;0,1,2;3;9;1;1;1
250582449466;250582454096;4630;0,1,2;3;9;1;1;1
250582454096;250582454744;648;0,1,2;3;9;1;1;1
250582454744;250582456112;1368;0,1,2;3;9;1;1;1
250582456112;250582463572;7460;0,1,2;3;9;1;1;1
250582463572;250582479282;15710;0,1,2;3;9;1;1;1
250582479282;250582481849;2567;0,1,2;3;9;1;1;1
250582481849;250582497065;15216;0,1,2;3;9;1;1;1
250582497065;250582501757;4692;0,1,2;3;9;1;1;1
250582501757;250582502218;461;0,1,2;3;9;1;1;1
250582502218;250582502417;199;0,1,2;3;9;1;1;1
250582502417;250582503142;725;0,1,2;3;9;1;1;1
250582503142;250582505294;2152;0,1,2;3;9;1;1;1
250582505294;250582505883;589;0,1,2;3;9;1;1;1
250582505883;250582506442;559;0,1,2;3;9;1;1;1
250582506442;250582506971;529;0,1,2;3;9;1;1;1
250582506971;250582507269;298;0,1,2;3;9;1;1;1
250582507269;250582508046;777;0,1,2;3;9;1;1;1
250582508046;250582508161;115;0,1,2;3;9;1;1;1
250582508161;250582508374;213;0,1,2;3;9;1;1;1
250582508374;250582508590;216;0,1,2;3;9;1;1;1
250582508590;250582508724;134;0,1,2;3;9;1;1;1
250582508724;250582534496;25772;0,1,2;3;9;1;1;1
250582534496;250582534510;14;0,1,2;3;9;1;1;1
250582534510;250582534725;215;0,1,2;3;9;1;1;1
250582534725;250582535319;594;0,1,2;3;9;1;1;1
250582535319;250582537765;2446;0,1,2;3;9;1;1;1
250582537765;250582538221;456;0,1,2;3;9;1;1;1
250582538221;250582539539;1318;0,1,2;3;9;1;1;1
250582539539;250582546123;6584;0,1,2;3;9;1;1;1
250582546123;250582548901;2778;0,1,2;3;9;1;1;1
250582548901;250582549499;598;0,1,2;3;9;1;1;1
250582549499;250582549810;311;0,1,2;3;9;1;1;1
250582549810;250582550656;846;0,1,2;3;9;1;1;1
250582550656;250582552166;1510;0,1,2;3;9;1;1;1
250582552166;250582552983;817;0,1,2;3;9;1;1;1
250582552983;250582555934;2951;0,1,2;3;9;1;1;1
250582555934;250582559203;3269;0,1,2;3;9;1;1;1
250582559203;250582562069;2866;0,1,2;3;9;1;1;1
250582562069;250582564884;2815;0,1,2;3;9;1;1;1
250582564884;250582565552;668;0,1,2;3;9;1;1;1
250582565552;250582566681;1129;0,1,2;3;9;1;1;1
250582566681;250582567499;818;0,1,2;3;9;1;1;1
250582567499;250582568370;871;0,1,2;3;9;1;1;1
250582568370;250582568539;169;0,1,2;3;9;1;1;1
250582568539;250582571800;3261;0,1,2;3;9;1;1;1
250582571800;250582571874;74;0,1,2;3;9;1;1;1
250582571874;250582572841;967;0,1,2;3;9;1;1;1
250582572841;250582573032;191;0,1,2;3;9;1;1;1
250582573032;250582573070;38;0,1,2;3;9;1;1;1
250582573070;250582573867;797;0,1,2;3;9;1;1;1
250582573867;250582574197;330;0,1,2;3;9;1;1;1
250582574197;250582574652;455;0,1,2;3;9;1;1;1
250582574652;250582574728;76;0,1,2;3;9;1;1;1
250582574728;250582574935;207;0,1,2;3;9;1;1;1
250582574935;250582576054;1119;0,1,2;3;9;1;1;1
250582576054;250582576654;600;0,1,2;3;9;1;1;1
250582576654;250582576768;114;0,1,2;3;9;1;1;1
250582576768;250582577341;573;0,1,2;3;9;1;1;1
250582577341;250582580894;3553;0,1,2;3;9;1;1;1
250582580894;250582582429;1535;0,1,2;3;9;1;1;1
250582582429;250582582473;44;0,1,2;3;9;1;1;1
250582582473;250582582958;485;0,1,2;3;9;1;1;1
250582582958;250582582982;24;0,1,2;3;9;1;1;1
250582582982;250582583165;183;0,1,2;3;9;1;1;1
250582583165;250582583761;596;0,1,2;3;9;1;1;1
250582583761;250582587375;3614;0,1,2;3;9;1;1;1
250582587375;250582587657;282;0,1,2;3;9;1;1;1
250582587657;250582587727;70;0,1,2;3;9;1;1;1
250582587727;250582588569;842;0,1,2;3;9;1;1;1
250582588569;250582590603;2034;0,1,2;3;9;1;1;1
250582590603;250582591127;524;0,1,2;3;9;1;1;1
250582591127;250582593354;2227;0,1,2;3;9;1;1;1
250582593354;250582593716;362;0,1,2;3;9;1;1;1
250582593716;250582603901;10185;0,1,2;3;9;1;1;1
250582603901;250582610555;6654;0,1,2;3;9;1;1;1
250582610555;250582617038;6483;0,1,2;3;9;1;1;1
250582617038;250582619833;2795;0,1,2;3;9;1;1;1
250582619833;250582619876;43;0,1,2;3;9;1;1;1
250582619876;250582622934;3058;0,1,2;3;9;1;1;1
250582622934;250582623190;256;0,1,2;3;9;1;1;1
250582623190;250582623225;35;0,1,2;3;9;1;1;1
250582623225;250582623287;62;0,1,2;3;9;1;1;1
250582623287;250582623475;188;0,1,2;3;9;1;1;1
250582623475;250582623477;2;0,1,2;3;9;1;1;1
250582623477;250582623542;65;0,1,2;3;9;1;1;1
250582623542;250582623577;35;0,1,2;3;9;1;1;1
250582623577;250582623709;132;0,1,2;3;9;1;1;1
250582623709;250582623747;38;0,1,2;3;9;1;1;1
250582623747;250582624030;283;0,1,2;3;9;1;1;1
250582624030;250582624060;30;0,1,2;3;9;1;1;1
250582624060;250582630279;6219;0,1,2;3;9;1;1;1
250582630279;250582630840;561;0,1,2;3;9;1;1;1
250582630840;250582630925;85;0,1,2;3;9;1;1;1
250582630925;250582631139;214;0,1,2;3;9;1;1;1
250582631139;250582632221;1082;0,1,2;3;9;1;1;1
250582632221;250582632765;544;0,1,2;3;9;1;1;1
250582632765;250582633211;446;0,1,2;3;9;1;1;1
250582633211;250582634393;1182;0,1,2;3;9;1;1;1
250582634393;250582635753;1360;0,1,2;3;9;1;1;1
250582635753;250582636429;676;0,1,2;3;9;1;1;1
250582636429;250582637094;665;0,1,2;3;9;1;1;1
250582637094;250582637296;202;0,1,2;3;9;1;1;1
250582637296;250582638159;863;0,1,2;3;9;1;1;1
250582638159;250582638321;162;0,1,2;3;9;1;1;1
250582638321;250582638389;68;0,1,2;3;9;1;1;1
250582638389;250582640587;2198;0,1,2;3;9;1;1;1
250582640587;250582642980;2393;0,1,2;3;9;1;1;1
250582642980;250582643034;54;0,1,2;3;9;1;1;1
250582643034;250582644133;1099;0,1,2;3;9;1;1;1
250582644133;250582645237;1104;0,1,2;3;9;1;1;1
250582645237;250582645278;41;0,1,2;3;9;1;1;1
250582645278;250582646467;1189;0,1,2;3;9;1;1;1
250582646467;250582648114;1647;0,1,2;3;9;1;1;1
250582648114;250582648371;257;0,1,2;3;9;1;1;1
250582648371;250582652541;4170;0,1,2;3;9;1;1;1
250582652541;250582654430;1889;0,1,2;3;9;1;1;1
250582654430;250582654505;75;0,1,2;3;9;1;1;1
250582654505;250582654909;404;0,1,2;3;9;1;1;1
250582654909;250582655344;435;0,1,2;3;9;1;1;1
250582655344;250582655460;116;0,1,2;3;9;1;1;1
250582655460;250582655607;147;0,1,2;3;9;1;1;1
250582655607;250582663829;8222;0,1,2;3;9;1;1;1
250582663829;250582664411;582;0,1,2;3;9;1;1;1
250582664411;250582665932;1521;0,1,2;3;9;1;1;1
250582665932;250582666013;81;0,1,2;3;9;1;1;1
250582666013;250582667836;1823;0,1,2;3;9;1;1;1
250582667836;250582668358;522;0,1,2;3;9;1;1;1
250582668358;250582671457;3099;0,1,2;3;9;1;1;1
250582671457;250582671523;66;0,1,2;3;9;1;1;1
250582671523;250582671557;34;0,1,2;3;9;1;1;1
250582671557;250582672958;1401;0,1,2;3;9;1;1;1
250582672958;250582673901;943;0,1,2;3;9;1;1;1
250582673901;250582674173;272;0,1,2;3;9;1;1;1
250582674173;250582675324;1151;0,1,2;3;9;1;1;1
250582675324;250582675766;442;0,1,2;3;9;1;1;1
250582675766;250582680736;4970;0,1,2;3;9;1;1;1
250582680736;250582680843;107;0,1,2;3;9;1;1;1
250582680843;250582681206;363;0,1,2;3;9;1;1;1
250582681206;250582681460;254;0,1,2;3;9;1;1;1
250582681460;250582682987;1527;0,1,2;3;9;1;1;1
250582682987;250582683781;794;0,1,2;3;9;1;1;1
250582683781;250582684441;660;0,1,2;3;9;1;1;1
250582684441;250582684916;475;0,1,2;3;9;1;1;1
250582684916;250582686606;1690;0,1,2;3;9;1;1;1
250582686606;250582688459;1853;0,1,2;3;9;1;1;1
250582688459;250582688630;171;0,1,2;3;9;1;1;1
250582688630;250582689304;674;0,1,2;3;9;1;1;1
250582689304;250582689539;235;0,1,2;3;9;1;1;1
250582689539;250582690331;792;0,1,2;3;9;1;1;1
250582690331;250582690513;182;0,1,2;3;9;1;1;1
250582690513;250582692041;1528;0,1,2;3;9;1;1;1
250582692041;250582692825;784;0,1,2;3;9;1;1;1
250582692825;250582693497;672;0,1,2;3;9;1;1;1
250582693497;250582693710;213;0,1,2;3;9;1;1;1
250582693710;250582693760;50;0,1,2;3;9;1;1;1
250582693760;250582693802;42;0,1,2;3;9;1;1;1
250582693802;250582693974;172;0,1,2;3;9;1;1;1
250582693974;250582694006;32;0,1,2;3;9;1;1;1
250582694006;250582694154;148;0,1,2;3;9;1;1;1
250582694154;250582694250;96;0,1,2;3;9;1;1;1
250582694250;250582694382;132;0,1,2;3;9;1;1;1
250582694382;250582694538;156;0,1,2;3;9;1;1;1
250582694538;250582696639;2101;0,1,2;3;9;1;1;1
250582696639;250582697228;589;0,1,2;3;9;1;1;1
250582697228;250582698746;1518;0,1,2;3;9;1;1;1
250582698746;250582698806;60;0,1,2;3;9;1;1;1
250582698806;250582700303;1497;0,1,2;3;9;1;1;1
250582700303;250582700906;603;0,1,2;3;9;1;1;1
250582700906;250582702699;1793;0,1,2;3;9;1;1;1
250582702699;250582702986;287;0,1,2;3;9;1;1;1
250582702986;250582703396;410;0,1,2;3;9;1;1;1
250582703396;250582703619;223;0,1,2;3;9;1;1;1
250582703619;250582703658;39;0,1,2;3;9;1;1;1
250582703658;250582703764;106;0,1,2;3;9;1;1;1
250582703764;250582703814;50;0,1,2;3;9;1;1;1
250582703814;250582705407;1593;0,1,2;3;9;1;1;1
250582705407;250582707155;1748;0,1,2;3;9;1;1;1
250582707155;250582707262;107;0,1,2;3;9;1;1;1
250582707262;250582707508;246;0,1,2;3;9;1;1;1
250582707508;250582710187;2679;0,1,2;3;9;1;1;1
250582710187;250582710259;72;0,1,2;3;9;1;1;1
250582710259;250582711240;981;0,1,2;3;9;1;1;1
250582711240;250582711290;50;0,1,2;3;9;1;1;1
250582711290;250582711908;618;0,1,2;3;9;1;1;1
250582711908;250582711948;40;0,1,2;3;9;1;1;1
250582711948;250582712444;496;0,1,2;3;9;1;1;1
250582712444;250582713825;1381;0,1,2;3;9;1;1;1
250582713825;250582714198;373;0,1,2;3;9;1;1;1
250582714198;250582714241;43;0,1,2;3;9;1;1;1
250582714241;250582716662;2421;0,1,2;3;9;1;1;1
250582716662;250582716870;208;0,1,2;3;9;1;1;1
250582716870;250582716944;74;0,1,2;3;9;1;1;1
250582716944;250582716987;43;0,1,2;3;9;1;1;1
250582716987;250582717443;456;0,1,2;3;9;1;1;1
250582717443;250582718176;733;0,1,2;3;9;1;1;1
250582718176;250582719057;881;0,1,2;3;9;1;1;1
250582719057;250582721530;2473;0,1,2;3;9;1;1;1
250582721530;250582722822;1292;0,1,2;3;9;1;1;1
250582722822;250582722864;42;0,1,2;3;9;1;1;1
250582722864;250582724118;1254;0,1,2;3;9;1;1;1
250582724118;250582725859;1741;0,1,2;3;9;1;1;1
250582725859;250582726265;406;0,1,2;3;9;1;1;1
250582726265;250582726305;40;0,1,2;3;9;1;1;1
250582726305;250582726848;543;0,1,2;3;9;1;1;1
250582726848;250582727736;888;0,1,2;3;9;1;1;1
250582727736;250582731300;3564;0,1,2;3;9;1;1;1
250582731300;250582731323;23;0,1,2;3;9;1;1;1
250582731323;250582732147;824;0,1,2;3;9;1;1;1
250582732147;250582732572;425;0,1,2;3;9;1;1;1
250582732572;250582733008;436;0,1,2;3;9;1;1;1
250582733008;250582733049;41;0,1,2;3;9;1;1;1
250582733049;250582735019;1970;0,1,2;3;9;1;1;1
250582735019;250582735895;876;0,1,2;3;9;1;1;1
250582735895;250582736063;168;0,1,2;3;9;1;1;1
250582736063;250582739684;3621;0,1,2;3;9;1;1;1
250582739684;250582740756;1072;0,1,2;3;9;1;1;1
250582740756;250582742422;1666;0,1,2;3;9;1;1;1
250582742422;250582742511;89;0,1,2;3;9;1;1;1
250582742511;250582742694;183;0,1,2;3;9;1;1;1
250582742694;250582742818;124;0,1,2;3;9;1;1;1
250582742818;250582742891;73;0,1,2;3;9;1;1;1
250582742891;250582743065;174;0,1,2;3;9;1;1;1
250582743065;250582743424;359;0,1,2;3;9;1;1;1
250582743424;250582743513;89;0,1,2;3;9;1;1;1
250582743513;250582743576;63;0,1,2;3;9;1;1;1
250582743576;250582744107;531;0,1,2;3;9;1;1;1
250582744107;250582744139;32;0,1,2;3;9;1;1;1
250582744139;250582744302;163;0,1,2;3;9;1;1;1
250582744302;250582746389;2087;0,1,2;3;9;1;1;1
250582746389;250582747613;1224;0,1,2;3;9;1;1;1
250582747613;250582747661;48;0,1,2;3;9;1;1;1
250582747661;250582747864;203;0,1,2;3;9;1;1;1
250582747864;250582748169;305;0,1,2;3;9;1;1;1
250582748169;250582748484;315;0,1,2;3;9;1;1;1
250582748484;250582749468;984;0,1,2;3;9;1;1;1
250582749468;250582749517;49;0,1,2;3;9;1;1;1
250582749517;250582749616;99;0,1,2;3;9;1;1;1
250582749616;250582749669;53;0,1,2;3;9;1;1;1
250582749669;250582750028;359;0,1,2;3;9;1;1;1
250582750028;250582753041;3013;0,1,2;3;9;1;1;1
250582753041;250582753128;87;0,1,2;3;9;1;1;1
250582753128;250582753246;118;0,1,2;3;9;1;1;1
250582753246;250582753316;70;0,1,2;3;9;1;1;1
250582753316;250582753380;64;0,1,2;3;9;1;1;1
250582753380;250582753422;42;0,1,2;3;9;1;1;1
250582753422;250582753449;27;0,1,2;3;9;1;1;1
250582753449;250582753512;63;0,1,2;3;9;1;1;1
250582753512;250582753563;51;0,1,2;3;9;1;1;1
250582753563;250582753581;18;0,1,2;3;9;1;1;1
250582753581;250582753687;106;0,1,2;3;9;1;1;1
250582753687;250582753770;83;0,1,2;3;9;1;1;1
250582753770;250582753779;9;0,1,2;3;9;1;1;1
250582753779;250582754953;1174;0,1,2;3;9;1;1;1
250582754953;250582755505;552;0,1,2;3;9;1;1;1
250582755505;250582755569;64;0,1,2;3;9;1;1;1
250582755569;250582756101;532;0,1,2;3;9;1;1;1
250582756101;250582757238;1137;0,1,2;3;9;1;1;1
250582757238;250582757590;352;0,1,2;3;9;1;1;1
250582757590;250582757673;83;0,1,2;3;9;1;1;1
250582757673;250582757756;83;0,1,2;3;9;1;1;1
250582757756;250582757981;225;0,1,2;3;9;1;1;1
250582757981;250582758267;286;0,1,2;3;9;1;1;1
250582758267;250582759060;793;0,1,2;3;9;1;1;1
250582759060;250582760330;1270;0,1,2;3;9;1;1;1
250582760330;250582760494;164;0,1,2;3;9;1;1;1
250582760494;250582760627;133;0,1,2;3;9;1;1;1
250582760627;250582761956;1329;0,1,2;3;9;1;1;1
250582761956;250582762338;382;0,1,2;3;9;1;1;1
250582762338;250582763175;837;0,1,2;3;9;1;1;1
250582763175;250582768241;5066;0,1,2;3;9;1;1;1
250582768241;250582769884;1643;0,1,2;3;9;1;1;1
250582769884;250582772950;3066;0,1,2;3;9;1;1;1
250582772950;250582773702;752;0,1,2;3;9;1;1;1
250582773702;250582775725;2023;0,1,2;3;9;1;1;1
250582775725;250582778478;2753;0,1,2;3;9;1;1;1
250582778478;250582778595;117;0,1,2;3;9;1;1;1
250582778595;250582779060;465;0,1,2;3;9;1;1;1
250582779060;250582779109;49;0,1,2;3;9;1;1;1
250582779109;250582779130;21;0,1,2;3;9;1;1;1
250582779130;250582779266;136;0,1,2;3;9;1;1;1
250582779266;250582779432;166;0,1,2;3;9;1;1;1
250582779432;250582779506;74;0,1,2;3;9;1;1;1
250582779506;250582779535;29;0,1,2;3;9;1;1;1
250582779535;250582779595;60;0,1,2;3;9;1;1;1
250582779595;250582779799;204;0,1,2;3;9;1;1;1
250582779799;250582779801;2;0,1,2;3;9;1;1;1
250582779801;250582779856;55;0,1,2;3;9;1;1;1
250582779856;250582779877;21;0,1,2;3;9;1;1;1
250582779877;250582779921;44;0,1,2;3;9;1;1;1
250582779921;250582783334;3413;0,1,2;3;9;1;1;1
250582783334;250582783511;177;0,1,2;3;9;1;1;1
250582783511;250582783542;31;0,1,2;3;9;1;1;1
250582783542;250582784255;713;0,1,2;3;9;1;1;1
250582784255;250582787671;3416;0,1,2;3;9;1;1;1
250582787671;250582787695;24;0,1,2;3;9;1;1;1
250582787695;250582787720;25;0,1,2;3;9;1;1;1
250582787720;250582787728;8;0,1,2;3;9;1;1;1
250582787728;250582787750;22;0,1,2;3;9;1;1;1
250582787750;250582787798;48;0,1,2;3;9;1;1;1
250582787798;250582787834;36;0,1,2;3;9;1;1;1
250582787834;250582787989;155;0,1,2;3;9;1;1;1
250582787989;250582789780;1791;0,1,2;3;9;1;1;1
250582789780;250582790872;1092;0,1,2;3;9;1;1;1
250582790872;250582791808;936;0,1,2;3;9;1;1;1
250582791808;250582791945;137;0,1,2;3;9;1;1;1
250582791945;250582792275;330;0,1,2;3;9;1;1;1
250582792275;250582792513;238;0,1,2;3;9;1;1;1
250582792513;250582792842;329;0,1,2;3;9;1;1;1
250582792842;250582793044;202;0,1,2;3;9;1;1;1
250582793044;250582793223;179;0,1,2;3;9;1;1;1
250582793223;250582793244;21;0,1,2;3;9;1;1;1
250582793244;250582793400;156;0,1,2;3;9;1;1;1
250582793400;250582793428;28;0,1,2;3;9;1;1;1
250582793428;250582794115;687;0,1,2;3;9;1;1;1
250582794115;250582794408;293;0,1,2;3;9;1;1;1
250582794408;250582794468;60;0,1,2;3;9;1;1;1
250582794468;250582794482;14;0,1,2;3;9;1;1;1
250582794482;250582794498;16;0,1,2;3;9;1;1;1
250582794498;250582794601;103;0,1,2;3;9;1;1;1
250582794601;250582795176;575;0,1,2;3;9;1;1;1
250582795176;250582795402;226;0,1,2;3;9;1;1;1
250582795402;250582795422;20;0,1,2;3;9;1;1;1
250582795422;250582795518;96;0,1,2;3;9;1;1;1
250582795518;250582795646;128;0,1,2;3;9;1;1;1
250582795646;250582795706;60;0,1,2;3;9;1;1;1
250582795706;250582796234;528;0,1,2;3;9;1;1;1
250582796234;250582797528;1294;0,1,2;3;9;1;1;1
250582797528;250582798551;1023;0,1,2;3;9;1;1;1
250582798551;250582798819;268;0,1,2;3;9;1;1;1
250582798819;250582798829;10;0,1,2;3;9;1;1;1
250582798829;250582798915;86;0,1,2;3;9;1;1;1
250582798915;250582798935;20;0,1,2;3;9;1;1;1
250582798935;250582799042;107;0,1,2;3;9;1;1;1
250582799042;250582800793;1751;0,1,2;3;9;1;1;1
250582800793;250582801258;465;0,1,2;3;9;1;1;1
250582801258;250582801339;81;0,1,2;3;9;1;1;1
250582801339;250582802295;956;0,1,2;3;9;1;1;1
250582802295;250582802828;533;0,1,2;3;9;1;1;1
250582802828;250582802966;138;0,1,2;3;9;1;1;1
250582802966;250582803038;72;0,1,2;3;9;1;1;1
250582803038;250582803724;686;0,1,2;3;9;1;1;1
250582803724;250582805460;1736;0,1,2;3;9;1;1;1
250582805460;250582805505;45;0,1,2;3;9;1;1;1
250582805505;250582805885;380;0,1,2;3;9;1;1;1
250582805885;250582805894;9;0,1,2;3;9;1;1;1
250582805894;250582806048;154;0,1,2;3;9;1;1;1
250582806048;250582806530;482;0,1,2;3;9;1;1;1
250582806530;250582806560;30;0,1,2;3;9;1;1;1
250582806560;250582806605;45;0,1,2;3;9;1;1;1
250582806605;250582807545;940;0,1,2;3;9;1;1;1
250582807545;250582807643;98;0,1,2;3;9;1;1;1
250582807643;250582807963;320;0,1,2;3;9;1;1;1
250582807963;250582808479;516;0,1,2;3;9;1;1;1
250582808479;250582809052;573;0,1,2;3;9;1;1;1
250582809052;250582809277;225;0,1,2;3;9;1;1;1
250582809277;250582809643;366;0,1,2;3;9;1;1;1
250582809643;250582809891;248;0,1,2;3;9;1;1;1
250582809891;250582809917;26;0,1,2;3;9;1;1;1
250582809917;250582809966;49;0,1,2;3;9;1;1;1
250582809966;250582809978;12;0,1,2;3;9;1;1;1
250582809978;250582810250;272;0,1,2;3;9;1;1;1
250582810250;250582811160;910;0,1,2;3;9;1;1;1
250582811160;250582811638;478;0,1,2;3;9;1;1;1
250582811638;250582811830;192;0,1,2;3;9;1;1;1
250582811830;250582812438;608;0,1,2;3;9;1;1;1
250582812438;250582812748;310;0,1,2;3;9;1;1;1
250582812748;250582813104;356;0,1,2;3;9;1;1;1
250582813104;250582815820;2716;0,1,2;3;9;1;1;1
250582815820;250582817056;1236;0,1,2;3;9;1;1;1
250582817056;250582817260;204;0,1,2;3;9;1;1;1
250582817260;250582818602;1342;0,1,2;3;9;1;1;1
250582818602;250582818658;56;0,1,2;3;9;1;1;1
250582818658;250582818713;55;0,1,2;3;9;1;1;1
250582818713;250582819165;452;0,1,2;3;9;1;1;1
250582819165;250582819202;37;0,1,2;3;9;1;1;1
250582819202;250582819598;396;0,1,2;3;9;1;1;1
250582819598;250582819638;40;0,1,2;3;9;1;1;1
250582819638;250582819831;193;0,1,2;3;9;1;1;1
250582819831;250582819904;73;0,1,2;3;9;1;1;1
250582819904;250582820032;128;0,1,2;3;9;1;1;1
250582820032;250582820132;100;0,1,2;3;9;1;1;1
250582820132;250582820160;28;0,1,2;3;9;1;1;1
250582820160;250582820197;37;0,1,2;3;9;1;1;1
250582820197;250582820288;91;0,1,2;3;9;1;1;1
250582820288;250582820449;161;0,1,2;3;9;1;1;1
250582820449;250582820997;548;0,1,2;3;9;1;1;1
250582820997;250582821059;62;0,1,2;3;9;1;1;1
250582821059;250582822533;1474;0,1,2;3;9;1;1;1
250582822533;250582822614;81;0,1,2;3;9;1;1;1
250582822614;250582823845;1231;0,1,2;3;9;1;1;1
250582823845;250582824073;228;0,1,2;3;9;1;1;1
250582824073;250582825041;968;0,1,2;3;9;1;1;1
250582825041;250582825391;350;0,1,2;3;9;1;1;1
250582825391;250582825636;245;0,1,2;3;9;1;1;1
250582825636;250582825936;300;0,1,2;3;9;1;1;1
250582825936;250582826157;221;0,1,2;3;9;1;1;1
250582826157;250582826498;341;0,1,2;3;9;1;1;1
250582826498;250582827104;606;0,1,2;3;9;1;1;1
250582827104;250582831153;4049;0,1,2;3;9;1;1;1
250582831153;250582831856;703;0,1,2;3;9;1;1;1
250582831856;250582832704;848;0,1,2;3;9;1;1;1
250582832704;250582833099;395;0,1,2;3;9;1;1;1
250582833099;250582833770;671;0,1,2;3;9;1;1;1
250582833770;250582834196;426;0,1,2;3;9;1;1;1
250582834196;250582834269;73;0,1,2;3;9;1;1;1
250582834269;250582835677;1408;0,1,2;3;9;1;1;1
250582835677;250582837906;2229;0,1,2;3;9;1;1;1
250582837906;250582838071;165;0,1,2;3;9;1;1;1
250582838071;250582838113;42;0,1,2;3;9;1;1;1
250582838113;250582839224;1111;0,1,2;3;9;1;1;1
250582839224;250582839302;78;0,1,2;3;9;1;1;1
250582839302;250582839366;64;0,1,2;3;9;1;1;1
250582839366;250582839662;296;0,1,2;3;9;1;1;1
250582839662;250582841947;2285;0,1,2;3;9;1;1;1
250582841947;250582842549;602;0,1,2;3;9;1;1;1
250582842549;250582842926;377;0,1,2;3;9;1;1;1
250582842926;250582843030;104;0,1,2;3;9;1;1;1
250582843030;250582843190;160;0,1,2;3;9;1;1;1
250582843190;250582843220;30;0,1,2;3;9;1;1;1
250582843220;250582843292;72;0,1,2;3;9;1;1;1
250582843292;250582843321;29;0,1,2;3;9;1;1;1
250582843321;250582843427;106;0,1,2;3;9;1;1;1
250582843427;250582843609;182;0,1,2;3;9;1;1;1
250582843609;250582844241;632;0,1,2;3;9;1;1;1
250582844241;250582845239;998;0,1,2;3;9;1;1;1
250582845239;250582845344;105;0,1,2;3;9;1;1;1
250582845344;250582845428;84;0,1,2;3;9;1;1;1
250582845428;250582845468;40;0,1,2;3;9;1;1;1
250582845468;250582845553;85;0,1,2;3;9;1;1;1
250582845553;250582845913;360;0,1,2;3;9;1;1;1
250582845913;250582846279;366;0,1,2;3;9;1;1;1
250582846279;250582846317;38;0,1,2;3;9;1;1;1
250582846317;250582846440;123;0,1,2;3;9;1;1;1
250582846440;250582846538;98;0,1,2;3;9;1;1;1
250582846538;250582847246;708;0,1,2;3;9;1;1;1
250582847246;250582848335;1089;0,1,2;3;9;1;1;1
250582848335;250582848385;50;0,1,2;3;9;1;1;1
250582848385;250582848602;217;0,1,2;3;9;1;1;1
250582848602;250582850379;1777;0,1,2;3;9;1;1;1
250582850379;250582850434;55;0,1,2;3;9;1;1;1
250582850434;250582850508;74;0,1,2;3;9;1;1;1
250582850508;250582850575;67;0,1,2;3;9;1;1;1
250582850575;250582850805;230;0,1,2;3;9;1;1;1
250582850805;250582850847;42;0,1,2;3;9;1;1;1
250582850847;250582850911;64;0,1,2;3;9;1;1;1
250582850911;250582851060;149;0,1,2;3;9;1;1;1
250582851060;250582851104;44;0,1,2;3;9;1;1;1
250582851104;250582851838;734;0,1,2;3;9;1;1;1
250582851838;250582853186;1348;0,1,2;3;9;1;1;1
250582853186;250582853237;51;0,1,2;3;9;1;1;1
250582853237;250582853857;620;0,1,2;3;9;1;1;1
250582853857;250582855001;1144;0,1,2;3;9;1;1;1
250582855001;250582855381;380;0,1,2;3;9;1;1;1
250582855381;250582855492;111;0,1,2;3;9;1;1;1
250582855492;250582855824;332;0,1,2;3;9;1;1;1
250582855824;250582856538;714;0,1,2;3;9;1;1;1
250582856538;250582856670;132;0,1,2;3;9;1;1;1
250582856670;250582857722;1052;0,1,2;3;9;1;1;1
250582857722;250582858626;904;0,1,2;3;9;1;1;1
250582858626;250582858748;122;0,1,2;3;9;1;1;1
250582858748;250582858927;179;0,1,2;3;9;1;1;1
250582858927;250582859384;457;0,1,2;3;9;1;1;1
250582859384;250582859425;41;0,1,2;3;9;1;1;1
250582859425;250582859648;223;0,1,2;3;9;1;1;1
250582859648;250582859862;214;0,1,2;3;9;1;1;1
250582859862;250582860889;1027;0,1,2;3;9;1;1;1
250582860889;250582862066;1177;0,1,2;3;9;1;1;1
250582862066;250582862105;39;0,1,2;3;9;1;1;1
250582862105;250582862544;439;0,1,2;3;9;1;1;1
250582862544;250582863975;1431;0,1,2;3;9;1;1;1
250582863975;250582865933;1958;0,1,2;3;9;1;1;1
250582865933;250582866544;611;0,1,2;3;9;1;1;1
250582866544;250582868193;1649;0,1,2;3;9;1;1;1
250582868193;250582869293;1100;0,1,2;3;9;1;1;1
250582869293;250582871289;1996;0,1,2;3;9;1;1;1
250582871289;250582871981;692;0,1,2;3;9;1;1;1
250582871981;250582875683;3702;0,1,2;3;9;1;1;1
250582875683;250582875781;98;0,1,2;3;9;1;1;1
250582875781;250582876065;284;0,1,2;3;9;1;1;1
250582876065;250582881315;5250;0,1,2;3;9;1;1;1
250582881315;250582883118;1803;0,1,2;3;9;1;1;1
250582883118;250582885916;2798;0,1,2;3;9;1;1;1
250582885916;250582886742;826;0,1,2;3;9;1;1;1
250582886742;250582887494;752;0,1,2;3;9;1;1;1
250582887494;250582887539;45;0,1,2;3;9;1;1;1
250582887539;250582887776;237;0,1,2;3;9;1;1;1
250582887776;250582888522;746;0,1,2;3;9;1;1;1
250582888522;250582888605;83;0,1,2;3;9;1;1;1
250582888605;250582893399;4794;0,1,2;3;9;1;1;1
250582893399;250582894032;633;0,1,2;3;9;1;1;1
250582894032;250582896055;2023;0,1,2;3;9;1;1;1
250582896055;250582896689;634;0,1,2;3;9;1;1;1
250582896689;250582897168;479;0,1,2;3;9;1;1;1
250582897168;250582897236;68;0,1,2;3;9;1;1;1
250582897236;250582897859;623;0,1,2;3;9;1;1;1
250582897859;250582898735;876;0,1,2;3;9;1;1;1
250582898735;250582899340;605;0,1,2;3;9;1;1;1
250582899340;250582899585;245;0,1,2;3;9;1;1;1
250582899585;250582899941;356;0,1,2;3;9;1;1;1
250582899941;250582900301;360;0,1,2;3;9;1;1;1
250582900301;250582900589;288;0,1,2;3;9;1;1;1
250582900589;250582900986;397;0,1,2;3;9;1;1;1
250582900986;250582901763;777;0,1,2;3;9;1;1;1
250582901763;250582902106;343;0,1,2;3;9;1;1;1
250582902106;250582903521;1415;0,1,2;3;9;1;1;1
250582903521;250582904411;890;0,1,2;3;9;1;1;1
250582904411;250582904447;36;0,1,2;3;9;1;1;1
250582904447;250582904832;385;0,1,2;3;9;1;1;1
250582904832;250582904951;119;0,1,2;3;9;1;1;1
250582904951;250582904993;42;0,1,2;3;9;1;1;1
250582904993;250582905301;308;0,1,2;3;9;1;1;1
250582905301;250582905374;73;0,1,2;3;9;1;1;1
250582905374;250582905419;45;0,1,2;3;9;1;1;1
250582905419;250582905441;22;0,1,2;3;9;1;1;1
250582905441;250582905501;60;0,1,2;3;9;1;1;1
250582905501;250582905534;33;0,1,2;3;9;1;1;1
250582905534;250582906358;824;0,1,2;3;9;1;1;1
250582906358;250582906442;84;0,1,2;3;9;1;1;1
250582906442;250582906758;316;0,1,2;3;9;1;1;1
250582906758;250582907022;264;0,1,2;3;9;1;1;1
250582907022;250582907299;277;0,1,2;3;9;1;1;1
250582907299;250582907454;155;0,1,2;3;9;1;1;1
250582907454;250582907463;9;0,1,2;3;9;1;1;1
250582907463;250582907592;129;0,1,2;3;9;1;1;1
250582907592;250582907625;33;0,1,2;3;9;1;1;1
250582907625;250582907708;83;0,1,2;3;9;1;1;1
250582907708;250582907837;129;0,1,2;3;9;1;1;1
250582907837;250582908129;292;0,1,2;3;9;1;1;1
250582908129;250582908183;54;0,1,2;3;9;1;1;1
250582908183;250582908227;44;0,1,2;3;9;1;1;1
250582908227;250582908429;202;0,1,2;3;9;1;1;1
250582908429;250582908696;267;0,1,2;3;9;1;1;1
250582908696;250582908793;97;0,1,2;3;9;1;1;1
250582908793;250582910419;1626;0,1,2;3;9;1;1;1
250582910419;250582910487;68;0,1,2;3;9;1;1;1
250582910487;250582911599;1112;0,1,2;3;9;1;1;1
250582911599;250582912286;687;0,1,2;3;9;1;1;1
250582912286;250582912362;76;0,1,2;3;9;1;1;1
250582912362;250582912514;152;0,1,2;3;9;1;1;1
250582912514;250582912598;84;0,1,2;3;9;1;1;1
250582912598;250582912734;136;0,1,2;3;9;1;1;1
250582912734;250582913125;391;0,1,2;3;9;1;1;1
250582913125;250582913202;77;0,1,2;3;9;1;1;1
250582913202;250582913706;504;0,1,2;3;9;1;1;1
250582913706;250582914347;641;0,1,2;3;9;1;1;1
250582914347;250582914368;21;0,1,2;3;9;1;1;1
250582914368;250582916337;1969;0,1,2;3;9;1;1;1
250582916337;250582917723;1386;0,1,2;3;9;1;1;1
250582917723;250582919426;1703;0,1,2;3;9;1;1;1
250582919426;250582919474;48;0,1,2;3;9;1;1;1
250582919474;250582919773;299;0,1,2;3;9;1;1;1
250582919773;250582919924;151;0,1,2;3;9;1;1;1
250582919924;250582919952;28;0,1,2;3;9;1;1;1
250582919952;250582919989;37;0,1,2;3;9;1;1;1
250582919989;250582920186;197;0,1,2;3;9;1;1;1
250582920186;250582920223;37;0,1,2;3;9;1;1;1
250582920223;250582920234;11;0,1,2;3;9;1;1;1
250582920234;250582920276;42;0,1,2;3;9;1;1;1
250582920276;250582920360;84;0,1,2;3;9;1;1;1
250582920360;250582920370;10;0,1,2;3;9;1;1;1
250582920370;250582920391;21;0,1,2;3;9;1;1;1
250582920391;250582920675;284;0,1,2;3;9;1;1;1
250582920675;250582920702;27;0,1,2;3;9;1;1;1
250582920702;250582920947;245;0,1,2;3;9;1;1;1
250582920947;250582921273;326;0,1,2;3;9;1;1;1
250582921273;250582921316;43;0,1,2;3;9;1;1;1
250582921316;250582921380;64;0,1,2;3;9;1;1;1
250582921380;250582921519;139;0,1,2;3;9;1;1;1
250582921519;250582921590;71;0,1,2;3;9;1;1;1
250582921590;250582921786;196;0,1,2;3;9;1;1;1
250582921786;250582922293;507;0,1,2;3;9;1;1;1
250582922293;250582922333;40;0,1,2;3;9;1;1;1
250582922333;250582922346;13;0,1,2;3;9;1;1;1
250582922346;250582922504;158;0,1,2;3;9;1;1;1
250582922504;250582922539;35;0,1,2;3;9;1;1;1
250582922539;250582923073;534;0,1,2;3;9;1;1;1
250582923073;250582923920;847;0,1,2;3;9;1;1;1
250582923920;250582924258;338;0,1,2;3;9;1;1;1
250582924258;250582924370;112;0,1,2;3;9;1;1;1
250582924370;250582924411;41;0,1,2;3;9;1;1;1
250582924411;250582924470;59;0,1,2;3;9;1;1;1
250582924470;250582924839;369;0,1,2;3;9;1;1;1
250582924839;250582924853;14;0,1,2;3;9;1;1;1
250582924853;250582924883;30;0,1,2;3;9;1;1;1
250582924883;250582924887;4;0,1,2;3;9;1;1;1
250582924887;250582926258;1371;0,1,2;3;9;1;1;1
250582926258;250582926322;64;0,1,2;3;9;1;1;1
250582926322;250582926353;31;0,1,2;3;9;1;1;1
250582926353;250582926696;343;0,1,2;3;9;1;1;1
250582926696;250582927061;365;0,1,2;3;9;1;1;1
250582927061;250582927690;629;0,1,2;3;9;1;1;1
250582927690;250582927737;47;0,1,2;3;9;1;1;1
250582927737;250582927911;174;0,1,2;3;9;1;1;1
250582927911;250582927932;21;0,1,2;3;9;1;1;1
250582927932;250582928054;122;0,1,2;3;9;1;1;1
250582928054;250582928381;327;0,1,2;3;9;1;1;1
250582928381;250582928446;65;0,1,2;3;9;1;1;1
250582928446;250582928643;197;0,1,2;3;9;1;1;1
250582928643;250582929189;546;0,1,2;3;9;1;1;1
250582929189;250582929477;288;0,1,2;3;9;1;1;1
250582929477;250582929647;170;0,1,2;3;9;1;1;1
250582929647;250582930153;506;0,1,2;3;9;1;1;1
250582930153;250582930712;559;0,1,2;3;9;1;1;1
250582930712;250582930741;29;0,1,2;3;9;1;1;1
250582930741;250582930771;30;0,1,2;3;9;1;1;1
250582930771;250582930805;34;0,1,2;3;9;1;1;1
250582930805;250582930828;23;0,1,2;3;9;1;1;1
250582930828;250582931083;255;0,1,2;3;9;1;1;1
250582931083;250582931098;15;0,1,2;3;9;1;1;1
250582931098;250582931127;29;0,1,2;3;9;1;1;1
250582931127;250582931367;240;0,1,2;3;9;1;1;1
250582931367;250582932029;662;0,1,2;3;9;1;1;1
250582932029;250582932500;471;0,1,2;3;9;1;1;1
250582932500;250582932622;122;0,1,2;3;9;1;1;1
250582932622;250582932806;184;0,1,2;3;9;1;1;1
250582932806;250582933179;373;0,1,2;3;9;1;1;1
250582933179;250582933597;418;0,1,2;3;9;1;1;1
250582933597;250582934258;661;0,1,2;3;9;1;1;1
250582934258;250582934506;248;0,1,2;3;9;1;1;1
250582934506;250582935235;729;0,1,2;3;9;1;1;1
250582935235;250582935367;132;0,1,2;3;9;1;1;1
250582935367;250582935987;620;0,1,2;3;9;1;1;1
250582935987;250582936027;40;0,1,2;3;9;1;1;1
250582936027;250582936492;465;0,1,2;3;9;1;1;1
250582936492;250582936522;30;0,1,2;3;9;1;1;1
250582936522;250582936771;249;0,1,2;3;9;1;1;1
250582936771;250582938158;1387;0,1,2;3;9;1;1;1
250582938158;250582938597;439;0,1,2;3;9;1;1;1
250582938597;250582938944;347;0,1,2;3;9;1;1;1
250582938944;250582939509;565;0,1,2;3;9;1;1;1
250582939509;250582939772;263;0,1,2;3;9;1;1;1
250582939772;250582940464;692;0,1,2;3;9;1;1;1
250582940464;250582940670;206;0,1,2;3;9;1;1;1
250582940670;250582942350;1680;0,1,2;3;9;1;1;1
250582942350;250582942594;244;0,1,2;3;9;1;1;1
250582942594;250582942753;159;0,1,2;3;9;1;1;1
250582942753;250582943359;606;0,1,2;3;9;1;1;1
250582943359;250582943476;117;0,1,2;3;9;1;1;1
250582943476;250582943574;98;0,1,2;3;9;1;1;1
250582943574;250582943943;369;0,1,2;3;9;1;1;1
250582943943;250582945190;1247;0,1,2;3;9;1;1;1
250582945190;250582945407;217;0,1,2;3;9;1;1;1
250582945407;250582945956;549;0,1,2;3;9;1;1;1
250582945956;250582946113;157;0,1,2;3;9;1;1;1
250582946113;250582946119;6;0,1,2;3;9;1;1;1
250582946119;250582946528;409;0,1,2;3;9;1;1;1
250582946528;250582946568;40;0,1,2;3;9;1;1;1
250582946568;250582946760;192;0,1,2;3;9;1;1;1
250582946760;250582946849;89;0,1,2;3;9;1;1;1
250582946849;250582947185;336;0,1,2;3;9;1;1;1
250582947185;250582947410;225;0,1,2;3;9;1;1;1
250582947410;250582947432;22;0,1,2;3;9;1;1;1
250582947432;250582949878;2446;0,1,2;3;9;1;1;1
250582949878;250582951478;1600;0,1,2;3;9;1;1;1
250582951478;250582951942;464;0,1,2;3;9;1;1;1
250582951942;250582952395;453;0,1,2;3;9;1;1;1
250582952395;250582952450;55;0,1,2;3;9;1;1;1
250582952450;250582952611;161;0,1,2;3;9;1;1;1
250582952611;250582952650;39;0,1,2;3;9;1;1;1
250582952650;250582953133;483;0,1,2;3;9;1;1;1
250582953133;250582953228;95;0,1,2;3;9;1;1;1
250582953228;250582953556;328;0,1,2;3;9;1;1;1
250582953556;250582953561;5;0,1,2;3;9;1;1;1
250582953561;250582953578;17;0,1,2;3;9;1;1;1
250582953578;250582953868;290;0,1,2;3;9;1;1;1
250582953868;250582954100;232;0,1,2;3;9;1;1;1
250582954100;250582955304;1204;0,1,2;3;9;1;1;1
250582955304;250582955414;110;0,1,2;3;9;1;1;1
250582955414;250582955784;370;0,1,2;3;9;1;1;1
250582955784;250582957221;1437;0,1,2;3;9;1;1;1
250582957221;250582957281;60;0,1,2;3;9;1;1;1
250582957281;250582957841;560;0,1,2;3;9;1;1;1
250582957841;250582959300;1459;0,1,2;3;9;1;1;1
250582959300;250582959642;342;0,1,2;3;9;1;1;1
250582959642;250582959813;171;0,1,2;3;9;1;1;1
250582959813;250582959963;150;0,1,2;3;9;1;1;1
250582959963;250582959989;26;0,1,2;3;9;1;1;1
250582959989;250582960418;429;0,1,2;3;9;1;1;1
250582960418;250582960966;548;0,1,2;3;9;1;1;1
250582960966;250582961254;288;0,1,2;3;9;1;1;1
250582961254;250582961711;457;0,1,2;3;9;1;1;1
250582961711;250582962318;607;0,1,2;3;9;1;1;1
250582962318;250582962445;127;0,1,2;3;9;1;1;1
250582962445;250582963307;862;0,1,2;3;9;1;1;1
250582963307;250582963567;260;0,1,2;3;9;1;1;1
250582963567;250582964240;673;0,1,2;3;9;1;1;1
250582964240;250582964397;157;0,1,2;3;9;1;1;1
250582964397;250582964713;316;0,1,2;3;9;1;1;1
250582964713;250582964948;235;0,1,2;3;9;1;1;1
250582964948;250582965194;246;0,1,2;3;9;1;1;1
250582965194;250582965558;364;0,1,2;3;9;1;1;1
250582965558;250582965582;24;0,1,2;3;9;1;1;1
250582965582;250582965611;29;0,1,2;3;9;1;1;1
250582965611;250582965775;164;0,1,2;3;9;1;1;1
250582965775;250582965976;201;0,1,2;3;9;1;1;1
250582965976;250582966269;293;0,1,2;3;9;1;1;1
250582966269;250582966916;647;0,1,2;3;9;1;1;1
250582966916;250582967187;271;0,1,2;3;9;1;1;1
250582967187;250582967292;105;0,1,2;3;9;1;1;1
250582967292;250582967348;56;0,1,2;3;9;1;1;1
250582967348;250582968185;837;0,1,2;3;9;1;1;1
250582968185;250582969460;1275;0,1,2;3;9;1;1;1
250582969460;250582970407;947;0,1,2;3;9;1;1;1
250582970407;250582970536;129;0,1,2;3;9;1;1;1
250582970536;250582971496;960;0,1,2;3;9;1;1;1
250582971496;250582971824;328;0,1,2;3;9;1;1;1
250582971824;250582971863;39;0,1,2;3;9;1;1;1
250582971863;250582971903;40;0,1,2;3;9;1;1;1
250582971903;250582972191;288;0,1,2;3;9;1;1;1
250582972191;250582972524;333;0,1,2;3;9;1;1;1
250582972524;250582973417;893;0,1,2;3;9;1;1;1
250582973417;250582973468;51;0,1,2;3;9;1;1;1
250582973468;250582973600;132;0,1,2;3;9;1;1;1
250582973600;250582973976;376;0,1,2;3;9;1;1;1
250582973976;250582974135;159;0,1,2;3;9;1;1;1
250582974135;250582974496;361;0,1,2;3;9;1;1;1
250582974496;250582974589;93;0,1,2;3;9;1;1;1
250582974589;250582974667;78;0,1,2;3;9;1;1;1
250582974667;250582974752;85;0,1,2;3;9;1;1;1
250582974752;250582974891;139;0,1,2;3;9;1;1;1
250582974891;250582975010;119;0,1,2;3;9;1;1;1
250582975010;250582975159;149;0,1,2;3;9;1;1;1
250582975159;250582975271;112;0,1,2;3;9;1;1;1
250582975271;250582975502;231;0,1,2;3;9;1;1;1
250582975502;250582975666;164;0,1,2;3;9;1;1;1
250582975666;250582975879;213;0,1,2;3;9;1;1;1
250582975879;250582976003;124;0,1,2;3;9;1;1;1
250582976003;250582976262;259;0,1,2;3;9;1;1;1
250582976262;250582976418;156;0,1,2;3;9;1;1;1
250582976418;250582976568;150;0,1,2;3;9;1;1;1
250582976568;250582977090;522;0,1,2;3;9;1;1;1
250582977090;250582977259;169;0,1,2;3;9;1;1;1
250582977259;250582977340;81;0,1,2;3;9;1;1;1
250582977340;250582977500;160;0,1,2;3;9;1;1;1
250582977500;250582977924;424;0,1,2;3;9;1;1;1
250582977924;250582977995;71;0,1,2;3;9;1;1;1
250582977995;250582978093;98;0,1,2;3;9;1;1;1
250582978093;250582978255;162;0,1,2;3;9;1;1;1
250582978255;250582979032;777;0,1,2;3;9;1;1;1
250582979032;250582980025;993;0,1,2;3;9;1;1;1
250582980025;250582981770;1745;0,1,2;3;9;1;1;1
250582981770;250582981805;35;0,1,2;3;9;1;1;1
250582981805;250582981909;104;0,1,2;3;9;1;1;1
250582981909;250582982617;708;0,1,2;3;9;1;1;1
250582982617;250582982887;270;0,1,2;3;9;1;1;1
250582982887;250582983061;174;0,1,2;3;9;1;1;1
250582983061;250582983238;177;0,1,2;3;9;1;1;1
250582983238;250582983649;411;0,1,2;3;9;1;1;1
250582983649;250582984076;427;0,1,2;3;9;1;1;1
250582984076;250582984238;162;0,1,2;3;9;1;1;1
250582984238;250582984401;163;0,1,2;3;9;1;1;1
250582984401;250582985021;620;0,1,2;3;9;1;1;1
250582985021;250582985425;404;0,1,2;3;9;1;1;1
250582985425;250582986016;591;0,1,2;3;9;1;1;1
250582986016;250582986061;45;0,1,2;3;9;1;1;1
250582986061;250582986719;658;0,1,2;3;9;1;1;1
250582986719;250582986825;106;0,1,2;3;9;1;1;1
250582986825;250582986828;3;0,1,2;3;9;1;1;1
250582986828;250582986982;154;0,1,2;3;9;1;1;1
250582986982;250582987004;22;0,1,2;3;9;1;1;1
250582987004;250582987070;66;0,1,2;3;9;1;1;1
250582987070;250582987238;168;0,1,2;3;9;1;1;1
250582987238;250582987344;106;0,1,2;3;9;1;1;1
250582987344;250582987975;631;0,1,2;3;9;1;1;1
250582987975;250582990134;2159;0,1,2;3;9;1;1;1
250582990134;250582990488;354;0,1,2;3;9;1;1;1
250582990488;250582990540;52;0,1,2;3;9;1;1;1
250582990540;250582990733;193;0,1,2;3;9;1;1;1
250582990733;250582991425;692;0,1,2;3;9;1;1;1
250582991425;250582992350;925;0,1,2;3;9;1;1;1
250582992350;250582993427;1077;0,1,2;3;9;1;1;1
250582993427;250582993470;43;0,1,2;3;9;1;1;1
250582993470;250582993647;177;0,1,2;3;9;1;1;1
250582993647;250582993789;142;0,1,2;3;9;1;1;1
250582993789;250582994034;245;0,1,2;3;9;1;1;1
250582994034;250582994230;196;0,1,2;3;9;1;1;1
250582994230;250582994308;78;0,1,2;3;9;1;1;1
250582994308;250582994398;90;0,1,2;3;9;1;1;1
250582994398;250582994549;151;0,1,2;3;9;1;1;1
250582994549;250582995227;678;0,1,2;3;9;1;1;1
250582995227;250582995425;198;0,1,2;3;9;1;1;1
250582995425;250582995521;96;0,1,2;3;9;1;1;1
250582995521;250582995812;291;0,1,2;3;9;1;1;1
250582995812;250582995882;70;0,1,2;3;9;1;1;1
250582995882;250582996264;382;0,1,2;3;9;1;1;1
250582996264;250582996314;50;0,1,2;3;9;1;1;1
250582996314;250582996353;39;0,1,2;3;9;1;1;1
250582996353;250582996849;496;0,1,2;3;9;1;1;1
250582996849;250582996898;49;0,1,2;3;9;1;1;1
250582996898;250582997055;157;0,1,2;3;9;1;1;1
250582997055;250582997185;130;0,1,2;3;9;1;1;1
250582997185;250582997869;684;0,1,2;3;9;1;1;1
250582997869;250582997942;73;0,1,2;3;9;1;1;1
250582997942;250582998033;91;0,1,2;3;9;1;1;1
250582998033;250582998244;211;0,1,2;3;9;1;1;1
250582998244;250582998542;298;0,1,2;3;9;1;1;1
250582998542;250582999020;478;0,1,2;3;9;1;1;1
250582999020;250582999145;125;0,1,2;3;9;1;1;1
250582999145;250582999188;43;0,1,2;3;9;1;1;1
250582999188;250582999425;237;0,1,2;3;9;1;1;1
250582999425;250582999534;109;0,1,2;3;9;1;1;1
250582999534;250582999733;199;0,1,2;3;9;1;1;1
250582999733;250582999755;22;0,1,2;3;9;1;1;1
250582999755;250583000108;353;0,1,2;3;9;1;1;1
250583000108;250583000138;30;0,1,2;3;9;1;1;1
250583000138;250583000425;287;0,1,2;3;9;1;1;1
250583000425;250583000430;5;0,1,2;3;9;1;1;1
250583000430;250583000758;328;0,1,2;3;9;1;1;1
250583000758;250583001113;355;0,1,2;3;9;1;1;1
250583001113;250583001182;69;0,1,2;3;9;1;1;1
250583001182;250583001967;785;0,1,2;3;9;1;1;1
250583001967;250583002296;329;0,1,2;3;9;1;1;1
250583002296;250583002563;267;0,1,2;3;9;1;1;1
250583002563;250583002883;320;0,1,2;3;9;1;1;1
250583002883;250583002899;16;0,1,2;3;9;1;1;1
250583002899;250583003018;119;0,1,2;3;9;1;1;1
250583003018;250583003152;134;0,1,2;3;9;1;1;1
250583003152;250583003304;152;0,1,2;3;9;1;1;1
250583003304;250583003332;28;0,1,2;3;9;1;1;1
250583003332;250583003619;287;0,1,2;3;9;1;1;1
250583003619;250583003686;67;0,1,2;3;9;1;1;1
250583003686;250583003990;304;0,1,2;3;9;1;1;1
250583003990;250583004268;278;0,1,2;3;9;1;1;1
250583004268;250583004740;472;0,1,2;3;9;1;1;1
250583004740;250583004829;89;0,1,2;3;9;1;1;1
250583004829;250583006503;1674;0,1,2;3;9;1;1;1
250583006503;250583006679;176;0,1,2;3;9;1;1;1
250583006679;250583007560;881;0,1,2;3;9;1;1;1
250583007560;250583007584;24;0,1,2;3;9;1;1;1
250583007584;250583007599;15;0,1,2;3;9;1;1;1
250583007599;250583007969;370;0,1,2;3;9;1;1;1
250583007969;250583008037;68;0,1,2;3;9;1;1;1
250583008037;250583008070;33;0,1,2;3;9;1;1;1
250583008070;250583008126;56;0,1,2;3;9;1;1;1
250583008126;250583009566;1440;0,1,2;3;9;1;1;1
250583009566;250583009863;297;0,1,2;3;9;1;1;1
250583009863;250583010179;316;0,1,2;3;9;1;1;1
250583010179;250583010219;40;0,1,2;3;9;1;1;1
250583010219;250583010383;164;0,1,2;3;9;1;1;1
250583010383;250583010872;489;0,1,2;3;9;1;1;1
250583010872;250583011517;645;0,1,2;3;9;1;1;1
250583011517;250583011599;82;0,1,2;3;9;1;1;1
250583011599;250583011812;213;0,1,2;3;9;1;1;1
250583011812;250583011891;79;0,1,2;3;9;1;1;1
250583011891;250583012130;239;0,1,2;3;9;1;1;1
250583012130;250583012230;100;0,1,2;3;9;1;1;1
250583012230;250583012390;160;0,1,2;3;9;1;1;1
250583012390;250583012674;284;0,1,2;3;9;1;1;1
250583012674;250583013012;338;0,1,2;3;9;1;1;1
250583013012;250583013076;64;0,1,2;3;9;1;1;1
250583013076;250583013170;94;0,1,2;3;9;1;1;1
250583013170;250583013371;201;0,1,2;3;9;1;1;1
250583013371;250583013810;439;0,1,2;3;9;1;1;1
250583013810;250583013971;161;0,1,2;3;9;1;1;1
250583013971;250583014011;40;0,1,2;3;9;1;1;1
250583014011;250583014173;162;0,1,2;3;9;1;1;1
250583014173;250583015180;1007;0,1,2;3;9;1;1;1
250583015180;250583015957;777;0,1,2;3;9;1;1;1
250583015957;250583016062;105;0,1,2;3;9;1;1;1
250583016062;250583016508;446;0,1,2;3;9;1;1;1
250583016508;250583016526;18;0,1,2;3;9;1;1;1
250583016526;250583017047;521;0,1,2;3;9;1;1;1
250583017047;250583017186;139;0,1,2;3;9;1;1;1
250583017186;250583017294;108;0,1,2;3;9;1;1;1
250583017294;250583017528;234;0,1,2;3;9;1;1;1
250583017528;250583019266;1738;0,1,2;3;9;1;1;1
250583019266;250583019410;144;0,1,2;3;9;1;1;1
250583019410;250583019563;153;0,1,2;3;9;1;1;1
250583019563;250583019615;52;0,1,2;3;9;1;1;1
250583019615;250583019681;66;0,1,2;3;9;1;1;1
250583019681;250583020795;1114;0,1,2;3;9;1;1;1
250583020795;250583021274;479;0,1,2;3;9;1;1;1
250583021274;250583022131;857;0,1,2;3;9;1;1;1
250583022131;250583022283;152;0,1,2;3;9;1;1;1
250583022283;250583022312;29;0,1,2;3;9;1;1;1
250583022312;250583022460;148;0,1,2;3;9;1;1;1
250583022460;250583022480;20;0,1,2;3;9;1;1;1
250583022480;250583022826;346;0,1,2;3;9;1;1;1
250583022826;250583022830;4;0,1,2;3;9;1;1;1
250583022830;250583022848;18;0,1,2;3;9;1;1;1
250583022848;250583023034;186;0,1,2;3;9;1;1;1
250583023034;250583023129;95;0,1,2;3;9;1;1;1
250583023129;250583023525;396;0,1,2;3;9;1;1;1
250583023525;250583023568;43;0,1,2;3;9;1;1;1
250583023568;250583024367;799;0,1,2;3;9;1;1;1
250583024367;250583024436;69;0,1,2;3;9;1;1;1
250583024436;250583024463;27;0,1,2;3;9;1;1;1
250583024463;250583024527;64;0,1,2;3;9;1;1;1
250583024527;250583024671;144;0,1,2;3;9;1;1;1
250583024671;250583024781;110;0,1,2;3;9;1;1;1
250583024781;250583026060;1279;0,1,2;3;9;1;1;1
250583026060;250583026291;231;0,1,2;3;9;1;1;1
250583026291;250583026430;139;0,1,2;3;9;1;1;1
250583026430;250583026457;27;0,1,2;3;9;1;1;1
250583026457;250583027018;561;0,1,2;3;9;1;1;1
250583027018;250583027226;208;0,1,2;3;9;1;1;1
250583027226;250583027499;273;0,1,2;3;9;1;1;1
250583027499;250583027609;110;0,1,2;3;9;1;1;1
250583027609;250583027700;91;0,1,2;3;9;1;1;1
250583027700;250583028326;626;0,1,2;3;9;1;1;1
250583028326;250583028460;134;0,1,2;3;9;1;1;1
250583028460;250583029574;1114;0,1,2;3;9;1;1;1
250583029574;250583029676;102;0,1,2;3;9;1;1;1
250583029676;250583031106;1430;0,1,2;3;9;1;1;1
250583031106;250583031332;226;0,1,2;3;9;1;1;1
250583031332;250583032011;679;0,1,2;3;9;1;1;1
250583032011;250583032292;281;0,1,2;3;9;1;1;1
250583032292;250583032457;165;0,1,2;3;9;1;1;1
250583032457;250583032475;18;0,1,2;3;9;1;1;1
250583032475;250583032490;15;0,1,2;3;9;1;1;1
250583032490;250583032999;509;0,1,2;3;9;1;1;1
250583032999;250583033751;752;0,1,2;3;9;1;1;1
250583033751;250583034975;1224;0,1,2;3;9;1;1;1
250583034975;250583035063;88;0,1,2;3;9;1;1;1
250583035063;250583035076;13;0,1,2;3;9;1;1;1
250583035076;250583035085;9;0,1,2;3;9;1;1;1
250583035085;250583035107;22;0,1,2;3;9;1;1;1
250583035107;250583035250;143;0,1,2;3;9;1;1;1
250583035250;250583035437;187;0,1,2;3;9;1;1;1
250583035437;250583035513;76;0,1,2;3;9;1;1;1
250583035513;250583035669;156;0,1,2;3;9;1;1;1
250583035669;250583035914;245;0,1,2;3;9;1;1;1
250583035914;250583035950;36;0,1,2;3;9;1;1;1
250583035950;250583036067;117;0,1,2;3;9;1;1;1
250583036067;250583036206;139;0,1,2;3;9;1;1;1
250583036206;250583036220;14;0,1,2;3;9;1;1;1
250583036220;250583036250;30;0,1,2;3;9;1;1;1
250583036250;250583036275;25;0,1,2;3;9;1;1;1
250583036275;250583036300;25;0,1,2;3;9;1;1;1
250583036300;250583036311;11;0,1,2;3;9;1;1;1
250583036311;250583036375;64;0,1,2;3;9;1;1;1
250583036375;250583036740;365;0,1,2;3;9;1;1;1
250583036740;250583036956;216;0,1,2;3;9;1;1;1
250583036956;250583037756;800;0,1,2;3;9;1;1;1
250583037756;250583037757;1;0,1,2;3;9;1;1;1
250583037757;250583038017;260;0,1,2;3;9;1;1;1
250583038017;250583038189;172;0,1,2;3;9;1;1;1
250583038189;250583038581;392;0,1,2;3;9;1;1;1
250583038581;250583038607;26;0,1,2;3;9;1;1;1
250583038607;250583038923;316;0,1,2;3;9;1;1;1
250583038923;250583039006;83;0,1,2;3;9;1;1;1
250583039006;250583039011;5;0,1,2;3;9;1;1;1
250583039011;250583039215;204;0,1,2;3;9;1;1;1
250583039215;250583039242;27;0,1,2;3;9;1;1;1
250583039242;250583039353;111;0,1,2;3;9;1;1;1
250583039353;250583039656;303;0,1,2;3;9;1;1;1
250583039656;250583039693;37;0,1,2;3;9;1;1;1
250583039693;250583039775;82;0,1,2;3;9;1;1;1
250583039775;250583039885;110;0,1,2;3;9;1;1;1
250583039885;250583039915;30;0,1,2;3;9;1;1;1
250583039915;250583039935;20;0,1,2;3;9;1;1;1
250583039935;250583040065;130;0,1,2;3;9;1;1;1
250583040065;250583041035;970;0,1,2;3;9;1;1;1
250583041035;250583041173;138;0,1,2;3;9;1;1;1
250583041173;250583041821;648;0,1,2;3;9;1;1;1
250583041821;250583041973;152;0,1,2;3;9;1;1;1
250583041973;250583042125;152;0,1,2;3;9;1;1;1
250583042125;250583042189;64;0,1,2;3;9;1;1;1
250583042189;250583042360;171;0,1,2;3;9;1;1;1
250583042360;250583042743;383;0,1,2;3;9;1;1;1
250583042743;250583043009;266;0,1,2;3;9;1;1;1
250583043009;250583043571;562;0,1,2;3;9;1;1;1
250583043571;250583045430;1859;0,1,2;3;9;1;1;1
250583045430;250583045765;335;0,1,2;3;9;1;1;1
250583045765;250583045997;232;0,1,2;3;9;1;1;1
250583045997;250583046308;311;0,1,2;3;9;1;1;1
250583046308;250583046672;364;0,1,2;3;9;1;1;1
250583046672;250583046919;247;0,1,2;3;9;1;1;1
250583046919;250583047643;724;0,1,2;3;9;1;1;1
250583047643;250583047754;111;0,1,2;3;9;1;1;1
250583047754;250583047985;231;0,1,2;3;9;1;1;1
250583047985;250583048024;39;0,1,2;3;9;1;1;1
250583048024;250583048071;47;0,1,2;3;9;1;1;1
250583048071;250583048110;39;0,1,2;3;9;1;1;1
250583048110;250583048146;36;0,1,2;3;9;1;1;1
250583048146;250583048190;44;0,1,2;3;9;1;1;1
250583048190;250583048473;283;0,1,2;3;9;1;1;1
250583048473;250583048615;142;0,1,2;3;9;1;1;1
250583048615;250583048904;289;0,1,2;3;9;1;1;1
250583048904;250583049536;632;0,1,2;3;9;1;1;1
250583049536;250583050167;631;0,1,2;3;9;1;1;1
250583050167;250583050423;256;0,1,2;3;9;1;1;1
250583050423;250583050702;279;0,1,2;3;9;1;1;1
250583050702;250583051140;438;0,1,2;3;9;1;1;1
250583051140;250583051228;88;0,1,2;3;9;1;1;1
250583051228;250583051372;144;0,1,2;3;9;1;1;1
250583051372;250583051721;349;0,1,2;3;9;1;1;1
250583051721;250583051867;146;0,1,2;3;9;1;1;1
250583051867;250583051941;74;0,1,2;3;9;1;1;1
250583051941;250583051952;11;0,1,2;3;9;1;1;1
250583051952;250583052242;290;0,1,2;3;9;1;1;1
250583052242;250583052318;76;0,1,2;3;9;1;1;1
250583052318;250583052604;286;0,1,2;3;9;1;1;1
250583052604;250583052791;187;0,1,2;3;9;1;1;1
250583052791;250583052866;75;0,1,2;3;9;1;1;1
250583052866;250583052871;5;0,1,2;3;9;1;1;1
250583052871;250583052918;47;0,1,2;3;9;1;1;1
250583052918;250583053010;92;0,1,2;3;9;1;1;1
250583053010;250583053018;8;0,1,2;3;9;1;1;1
250583053018;250583053128;110;0,1,2;3;9;1;1;1
250583053128;250583053276;148;0,1,2;3;9;1;1;1
250583053276;250583053514;238;0,1,2;3;9;1;1;1
250583053514;250583053768;254;0,1,2;3;9;1;1;1
250583053768;250583053916;148;0,1,2;3;9;1;1;1
250583053916;250583054006;90;0,1,2;3;9;1;1;1
250583054006;250583054339;333;0,1,2;3;9;1;1;1
250583054339;250583054873;534;0,1,2;3;9;1;1;1
250583054873;250583054997;124;0,1,2;3;9;1;1;1
250583054997;250583055435;438;0,1,2;3;9;1;1;1
250583055435;250583055892;457;0,1,2;3;9;1;1;1
250583055892;250583055985;93;0,1,2;3;9;1;1;1
250583055985;250583056008;23;0,1,2;3;9;1;1;1
250583056008;250583056074;66;0,1,2;3;9;1;1;1
250583056074;250583056236;162;0,1,2;3;9;1;1;1
250583056236;250583056334;98;0,1,2;3;9;1;1;1
250583056334;250583056389;55;0,1,2;3;9;1;1;1
250583056389;250583056534;145;0,1,2;3;9;1;1;1
250583056534;250583056558;24;0,1,2;3;9;1;1;1
250583056558;250583057163;605;0,1,2;3;9;1;1;1
250583057163;250583057340;177;0,1,2;3;9;1;1;1
250583057340;250583057565;225;0,1,2;3;9;1;1;1
250583057565;250583057728;163;0,1,2;3;9;1;1;1
250583057728;250583057761;33;0,1,2;3;9;1;1;1
250583057761;250583057854;93;0,1,2;3;9;1;1;1
250583057854;250583058433;579;0,1,2;3;9;1;1;1
250583058433;250583059119;686;0,1,2;3;9;1;1;1
250583059119;250583059218;99;0,1,2;3;9;1;1;1
250583059218;250583059324;106;0,1,2;3;9;1;1;1
250583059324;250583059358;34;0,1,2;3;9;1;1;1
250583059358;250583059451;93;0,1,2;3;9;1;1;1
250583059451;250583059604;153;0,1,2;3;9;1;1;1
250583059604;250583059931;327;0,1,2;3;9;1;1;1
250583059931;250583060123;192;0,1,2;3;9;1;1;1
250583060123;250583060127;4;0,1,2;3;9;1;1;1
250583060127;250583060219;92;0,1,2;3;9;1;1;1
250583060219;250583060597;378;0,1,2;3;9;1;1;1
250583060597;250583060959;362;0,1,2;3;9;1;1;1
250583060959;250583061326;367;0,1,2;3;9;1;1;1
250583061326;250583061608;282;0,1,2;3;9;1;1;1
250583061608;250583062005;397;0,1,2;3;9;1;1;1
250583062005;250583063051;1046;0,1,2;3;9;1;1;1
250583063051;250583063208;157;0,1,2;3;9;1;1;1
250583063208;250583063243;35;0,1,2;3;9;1;1;1
250583063243;250583063759;516;0,1,2;3;9;1;1;1
250583063759;250583063768;9;0,1,2;3;9;1;1;1
250583063768;250583064266;498;0,1,2;3;9;1;1;1
250583064266;250583065130;864;0,1,2;3;9;1;1;1
250583065130;250583065177;47;0,1,2;3;9;1;1;1
250583065177;250583065276;99;0,1,2;3;9;1;1;1
250583065276;250583065345;69;0,1,2;3;9;1;1;1
250583065345;250583065356;11;0,1,2;3;9;1;1;1
250583065356;250583065372;16;0,1,2;3;9;1;1;1
250583065372;250583065451;79;0,1,2;3;9;1;1;1
250583065451;250583065702;251;0,1,2;3;9;1;1;1
250583065702;250583065767;65;0,1,2;3;9;1;1;1
250583065767;250583066161;394;0,1,2;3;9;1;1;1
250583066161;250583066207;46;0,1,2;3;9;1;1;1
250583066207;250583066345;138;0,1,2;3;9;1;1;1
250583066345;250583066479;134;0,1,2;3;9;1;1;1
250583066479;250583066497;18;0,1,2;3;9;1;1;1
250583066497;250583067318;821;0,1,2;3;9;1;1;1
250583067318;250583067354;36;0,1,2;3;9;1;1;1
250583067354;250583068406;1052;0,1,2;3;9;1;1;1
250583068406;250583068649;243;0,1,2;3;9;1;1;1
250583068649;250583068960;311;0,1,2;3;9;1;1;1
250583068960;250583069215;255;0,1,2;3;9;1;1;1
250583069215;250583069532;317;0,1,2;3;9;1;1;1
250583069532;250583069617;85;0,1,2;3;9;1;1;1
250583069617;250583069980;363;0,1,2;3;9;1;1;1
250583069980;250583070252;272;0,1,2;3;9;1;1;1
250583070252;250583070710;458;0,1,2;3;9;1;1;1
250583070710;250583070809;99;0,1,2;3;9;1;1;1
250583070809;250583072273;1464;0,1,2;3;9;1;1;1
250583072273;250583072503;230;0,1,2;3;9;1;1;1
250583072503;250583072724;221;0,1,2;3;9;1;1;1
250583072724;250583072773;49;0,1,2;3;9;1;1;1
250583072773;250583073831;1058;0,1,2;3;9;1;1;1
250583073831;250583073857;26;0,1,2;3;9;1;1;1
250583073857;250583075010;1153;0,1,2;3;9;1;1;1
250583075010;250583075536;526;0,1,2;3;9;1;1;1
250583075536;250583075598;62;0,1,2;3;9;1;1;1
250583075598;250583075892;294;0,1,2;3;9;1;1;1
250583075892;250583076599;707;0,1,2;3;9;1;1;1
250583076599;250583076879;280;0,1,2;3;9;1;1;1
250583076879;250583077413;534;0,1,2;3;9;1;1;1
250583077413;250583077575;162;0,1,2;3;9;1;1;1
250583077575;250583077616;41;0,1,2;3;9;1;1;1
250583077616;250583077820;204;0,1,2;3;9;1;1;1
250583077820;250583077825;5;0,1,2;3;9;1;1;1
250583077825;250583078831;1006;0,1,2;3;9;1;1;1
250583078831;250583079051;220;0,1,2;3;9;1;1;1
250583079051;250583079422;371;0,1,2;3;9;1;1;1
250583079422;250583079870;448;0,1,2;3;9;1;1;1
250583079870;250583079871;1;0,1,2;3;9;1;1;1
250583079871;250583080051;180;0,1,2;3;9;1;1;1
250583080051;250583080176;125;0,1,2;3;9;1;1;1
250583080176;250583080342;166;0,1,2;3;9;1;1;1
250583080342;250583080631;289;0,1,2;3;9;1;1;1
250583080631;250583080724;93;0,1,2;3;9;1;1;1
250583080724;250583080826;102;0,1,2;3;9;1;1;1
250583080826;250583080898;72;0,1,2;3;9;1;1;1
250583080898;250583081292;394;0,1,2;3;9;1;1;1
250583081292;250583081317;25;0,1,2;3;9;1;1;1
250583081317;250583082494;1177;0,1,2;3;9;1;1;1
250583082494;250583082672;178;0,1,2;3;9;1;1;1
250583082672;250583082986;314;0,1,2;3;9;1;1;1
250583082986;250583083151;165;0,1,2;3;9;1;1;1
250583083151;250583083457;306;0,1,2;3;9;1;1;1
250583083457;250583084410;953;0,1,2;3;9;1;1;1
250583084410;250583084796;386;0,1,2;3;9;1;1;1
250583084796;250583085401;605;0,1,2;3;9;1;1;1
250583085401;250583085688;287;0,1,2;3;9;1;1;1
250583085688;250583085710;22;0,1,2;3;9;1;1;1
250583085710;250583085997;287;0,1,2;3;9;1;1;1
250583085997;250583086051;54;0,1,2;3;9;1;1;1
250583086051;250583086389;338;0,1,2;3;9;1;1;1
250583086389;250583086444;55;0,1,2;3;9;1;1;1
250583086444;250583086665;221;0,1,2;3;9;1;1;1
250583086665;250583086750;85;0,1,2;3;9;1;1;1
250583086750;250583086977;227;0,1,2;3;9;1;1;1
250583086977;250583087486;509;0,1,2;3;9;1;1;1
250583087486;250583087766;280;0,1,2;3;9;1;1;1
250583087766;250583087977;211;0,1,2;3;9;1;1;1
250583087977;250583088341;364;0,1,2;3;9;1;1;1
250583088341;250583088477;136;0,1,2;3;9;1;1;1
250583088477;250583088483;6;0,1,2;3;9;1;1;1
250583088483;250583088517;34;0,1,2;3;9;1;1;1
250583088517;250583088525;8;0,1,2;3;9;1;1;1
250583088525;250583088570;45;0,1,2;3;9;1;1;1
250583088570;250583088677;107;0,1,2;3;9;1;1;1
250583088677;250583088691;14;0,1,2;3;9;1;1;1
250583088691;250583088932;241;0,1,2;3;9;1;1;1
250583088932;250583089461;529;0,1,2;3;9;1;1;1
250583089461;250583089599;138;0,1,2;3;9;1;1;1
250583089599;250583089679;80;0,1,2;3;9;1;1;1
250583089679;250583089791;112;0,1,2;3;9;1;1;1
250583089791;250583089855;64;0,1,2;3;9;1;1;1
250583089855;250583090040;185;0,1,2;3;9;1;1;1
250583090040;250583090160;120;0,1,2;3;9;1;1;1
250583090160;250583090202;42;0,1,2;3;9;1;1;1
250583090202;250583090291;89;0,1,2;3;9;1;1;1
250583090291;250583090382;91;0,1,2;3;9;1;1;1
250583090382;250583090919;537;0,1,2;3;9;1;1;1
250583090919;250583091032;113;0,1,2;3;9;1;1;1
250583091032;250583091396;364;0,1,2;3;9;1;1;1
250583091396;250583091415;19;0,1,2;3;9;1;1;1
250583091415;250583091439;24;0,1,2;3;9;1;1;1
250583091439;250583091631;192;0,1,2;3;9;1;1;1
250583091631;250583091711;80;0,1,2;3;9;1;1;1
250583091711;250583091838;127;0,1,2;3;9;1;1;1
250583091838;250583092105;267;0,1,2;3;9;1;1;1
250583092105;250583092395;290;0,1,2;3;9;1;1;1
250583092395;250583092595;200;0,1,2;3;9;1;1;1
250583092595;250583092616;21;0,1,2;3;9;1;1;1
250583092616;250583092690;74;0,1,2;3;9;1;1;1
250583092690;250583092785;95;0,1,2;3;9;1;1;1
250583092785;250583092898;113;0,1,2;3;9;1;1;1
250583092898;250583092971;73;0,1,2;3;9;1;1;1
250583092971;250583093219;248;0,1,2;3;9;1;1;1
250583093219;250583094082;863;0,1,2;3;9;1;1;1
250583094082;250583094541;459;0,1,2;3;9;1;1;1
250583094541;250583095770;1229;0,1,2;3;9;1;1;1
250583095770;250583096197;427;0,1,2;3;9;1;1;1
250583096197;250583096285;88;0,1,2;3;9;1;1;1
250583096285;250583096346;61;0,1,2;3;9;1;1;1
250583096346;250583096805;459;0,1,2;3;9;1;1;1
250583096805;250583097305;500;0,1,2;3;9;1;1;1
250583097305;250583097483;178;0,1,2;3;9;1;1;1
250583097483;250583098003;520;0,1,2;3;9;1;1;1
250583098003;250583098185;182;0,1,2;3;9;1;1;1
250583098185;250583098189;4;0,1,2;3;9;1;1;1
250583098189;250583098265;76;0,1,2;3;9;1;1;1
250583098265;250583098329;64;0,1,2;3;9;1;1;1
250583098329;250583098399;70;0,1,2;3;9;1;1;1
250583098399;250583098461;62;0,1,2;3;9;1;1;1
250583098461;250583098614;153;0,1,2;3;9;1;1;1
250583098614;250583098641;27;0,1,2;3;9;1;1;1
250583098641;250583098736;95;0,1,2;3;9;1;1;1
250583098736;250583098966;230;0,1,2;3;9;1;1;1
250583098966;250583099027;61;0,1,2;3;9;1;1;1
250583099027;250583099071;44;0,1,2;3;9;1;1;1
250583099071;250583099220;149;0,1,2;3;9;1;1;1
250583099220;250583099646;426;0,1,2;3;9;1;1;1
250583099646;250583099713;67;0,1,2;3;9;1;1;1
250583099713;250583100001;288;0,1,2;3;9;1;1;1
250583100001;250583100082;81;0,1,2;3;9;1;1;1
250583100082;250583100792;710;0,1,2;3;9;1;1;1
250583100792;250583100837;45;0,1,2;3;9;1;1;1
250583100837;250583100891;54;0,1,2;3;9;1;1;1
250583100891;250583100936;45;0,1,2;3;9;1;1;1
250583100936;250583101010;74;0,1,2;3;9;1;1;1
250583101010;250583101154;144;0,1,2;3;9;1;1;1
250583101154;250583101215;61;0,1,2;3;9;1;1;1
250583101215;250583101365;150;0,1,2;3;9;1;1;1
250583101365;250583101430;65;0,1,2;3;9;1;1;1
250583101430;250583101744;314;0,1,2;3;9;1;1;1
250583101744;250583101951;207;0,1,2;3;9;1;1;1
250583101951;250583102299;348;0,1,2;3;9;1;1;1
250583102299;250583102384;85;0,1,2;3;9;1;1;1
250583102384;250583102702;318;0,1,2;3;9;1;1;1
250583102702;250583102747;45;0,1,2;3;9;1;1;1
250583102747;250583103076;329;0,1,2;3;9;1;1;1
250583103076;250583103123;47;0,1,2;3;9;1;1;1
250583103123;250583103217;94;0,1,2;3;9;1;1;1
250583103217;250583103376;159;0,1,2;3;9;1;1;1
250583103376;250583103413;37;0,1,2;3;9;1;1;1
250583103413;250583103491;78;0,1,2;3;9;1;1;1
250583103491;250583103569;78;0,1,2;3;9;1;1;1
250583103569;250583103698;129;0,1,2;3;9;1;1;1
250583103698;250583104127;429;0,1,2;3;9;1;1;1
250583104127;250583104376;249;0,1,2;3;9;1;1;1
250583104376;250583104381;5;0,1,2;3;9;1;1;1
250583104381;250583104504;123;0,1,2;3;9;1;1;1
250583104504;250583104695;191;0,1,2;3;9;1;1;1
250583104695;250583104776;81;0,1,2;3;9;1;1;1
250583104776;250583104963;187;0,1,2;3;9;1;1;1
250583104963;250583105325;362;0,1,2;3;9;1;1;1
250583105325;250583105405;80;0,1,2;3;9;1;1;1
250583105405;250583105459;54;0,1,2;3;9;1;1;1
250583105459;250583105760;301;0,1,2;3;9;1;1;1
250583105760;250583105848;88;0,1,2;3;9;1;1;1
250583105848;250583106120;272;0,1,2;3;9;1;1;1
250583106120;250583106361;241;0,1,2;3;9;1;1;1
250583106361;250583106535;174;0,1,2;3;9;1;1;1
250583106535;250583106795;260;0,1,2;3;9;1;1;1
250583106795;250583107070;275;0,1,2;3;9;1;1;1
250583107070;250583107148;78;0,1,2;3;9;1;1;1
250583107148;250583107222;74;0,1,2;3;9;1;1;1
250583107222;250583107386;164;0,1,2;3;9;1;1;1
250583107386;250583107387;1;0,1,2;3;9;1;1;1
250583107387;250583107421;34;0,1,2;3;9;1;1;1
250583107421;250583107482;61;0,1,2;3;9;1;1;1
250583107482;250583107491;9;0,1,2;3;9;1;1;1
250583107491;250583107584;93;0,1,2;3;9;1;1;1
250583107584;250583108433;849;0,1,2;3;9;1;1;1
250583108433;250583108505;72;0,1,2;3;9;1;1;1
250583108505;250583108644;139;0,1,2;3;9;1;1;1
250583108644;250583108708;64;0,1,2;3;9;1;1;1
250583108708;250583108786;78;0,1,2;3;9;1;1;1
250583108786;250583108901;115;0,1,2;3;9;1;1;1
250583108901;250583109459;558;0,1,2;3;9;1;1;1
250583109459;250583109665;206;0,1,2;3;9;1;1;1
250583109665;250583109761;96;0,1,2;3;9;1;1;1
250583109761;250583109861;100;0,1,2;3;9;1;1;1
250583109861;250583109906;45;0,1,2;3;9;1;1;1
250583109906;250583110573;667;0,1,2;3;9;1;1;1
250583110573;250583110623;50;0,1,2;3;9;1;1;1
250583110623;250583110639;16;0,1,2;3;9;1;1;1
250583110639;250583110862;223;0,1,2;3;9;1;1;1
250583110862;250583110951;89;0,1,2;3;9;1;1;1
250583110951;250583111172;221;0,1,2;3;9;1;1;1
250583111172;250583111187;15;0,1,2;3;9;1;1;1
250583111187;250583111526;339;0,1,2;3;9;1;1;1
250583111526;250583111940;414;0,1,2;3;9;1;1;1
250583111940;250583112002;62;0,1,2;3;9;1;1;1
250583112002;250583112297;295;0,1,2;3;9;1;1;1
250583112297;250583112925;628;0,1,2;3;9;1;1;1
250583112925;250583113128;203;0,1,2;3;9;1;1;1
250583113128;250583113177;49;0,1,2;3;9;1;1;1
250583113177;250583113482;305;0,1,2;3;9;1;1;1
250583113482;250583113766;284;0,1,2;3;9;1;1;1
250583113766;250583113823;57;0,1,2;3;9;1;1;1
250583113823;250583114089;266;0,1,2;3;9;1;1;1
250583114089;250583114164;75;0,1,2;3;9;1;1;1
250583114164;250583114395;231;0,1,2;3;9;1;1;1
250583114395;250583114405;10;0,1,2;3;9;1;1;1
250583114405;250583114867;462;0,1,2;3;9;1;1;1
250583114867;250583115130;263;0,1,2;3;9;1;1;1
250583115130;250583115433;303;0,1,2;3;9;1;1;1
250583115433;250583115445;12;0,1,2;3;9;1;1;1
250583115445;250583115471;26;0,1,2;3;9;1;1;1
250583115471;250583115548;77;0,1,2;3;9;1;1;1
250583115548;250583115716;168;0,1,2;3;9;1;1;1
250583115716;250583116139;423;0,1,2;3;9;1;1;1
250583116139;250583116508;369;0,1,2;3;9;1;1;1
250583116508;250583116731;223;0,1,2;3;9;1;1;1
250583116731;250583117042;311;0,1,2;3;9;1;1;1
250583117042;250583119603;2561;0,1,2;3;9;1;1;1
250583119603;250583119821;218;0,1,2;3;9;1;1;1
250583119821;250583121444;1623;0,1,2;3;9;1;1;1
250583121444;250583122473;1029;0,1,2;3;9;1;1;1
250583122473;250583123346;873;0,1,2;3;9;1;1;1
250583123346;250583123431;85;0,1,2;3;9;1;1;1
250583123431;250583123435;4;0,1,2;3;9;1;1;1
250583123435;250583123543;108;0,1,2;3;9;1;1;1
250583123543;250583123560;17;0,1,2;3;9;1;1;1
250583123560;250583123598;38;0,1,2;3;9;1;1;1
250583123598;250583123721;123;0,1,2;3;9;1;1;1
250583123721;250583123967;246;0,1,2;3;9;1;1;1
250583123967;250583124009;42;0,1,2;3;9;1;1;1
250583124009;250583124067;58;0,1,2;3;9;1;1;1
250583124067;250583124109;42;0,1,2;3;9;1;1;1
250583124109;250583124868;759;0,1,2;3;9;1;1;1
250583124868;250583125003;135;0,1,2;3;9;1;1;1
250583125003;250583125132;129;0,1,2;3;9;1;1;1
250583125132;250583125289;157;0,1,2;3;9;1;1;1
250583125289;250583125365;76;0,1,2;3;9;1;1;1
250583125365;250583125506;141;0,1,2;3;9;1;1;1
250583125506;250583126025;519;0,1,2;3;9;1;1;1
250583126025;250583126374;349;0,1,2;3;9;1;1;1
250583126374;250583126460;86;0,1,2;3;9;1;1;1
250583126460;250583126466;6;0,1,2;3;9;1;1;1
250583126466;250583127462;996;0,1,2;3;9;1;1;1
250583127462;250583127551;89;0,1,2;3;9;1;1;1
250583127551;250583127805;254;0,1,2;3;9;1;1;1
250583127805;250583128388;583;0,1,2;3;9;1;1;1
250583128388;250583128455;67;0,1,2;3;9;1;1;1
250583128455;250583128485;30;0,1,2;3;9;1;1;1
250583128485;250583129445;960;0,1,2;3;9;1;1;1
250583129445;250583130199;754;0,1,2;3;9;1;1;1
250583130199;250583130417;218;0,1,2;3;9;1;1;1
250583130417;250583130495;78;0,1,2;3;9;1;1;1
250583130495;250583130800;305;0,1,2;3;9;1;1;1
250583130800;250583130921;121;0,1,2;3;9;1;1;1
250583130921;250583131784;863;0,1,2;3;9;1;1;1
250583131784;250583131847;63;0,1,2;3;9;1;1;1
250583131847;250583132020;173;0,1,2;3;9;1;1;1
250583132020;250583132431;411;0,1,2;3;9;1;1;1
250583132431;250583132530;99;0,1,2;3;9;1;1;1
250583132530;250583132717;187;0,1,2;3;9;1;1;1
250583132717;250583132776;59;0,1,2;3;9;1;1;1
250583132776;250583132789;13;0,1,2;3;9;1;1;1
250583132789;250583133111;322;0,1,2;3;9;1;1;1
250583133111;250583133160;49;0,1,2;3;9;1;1;1
250583133160;250583133722;562;0,1,2;3;9;1;1;1
250583133722;250583134179;457;0,1,2;3;9;1;1;1
250583134179;250583134222;43;0,1,2;3;9;1;1;1
250583134222;250583134238;16;0,1,2;3;9;1;1;1
250583134238;250583134361;123;0,1,2;3;9;1;1;1
250583134361;250583134426;65;0,1,2;3;9;1;1;1
250583134426;250583134464;38;0,1,2;3;9;1;1;1
250583134464;250583134787;323;0,1,2;3;9;1;1;1
250583134787;250583135026;239;0,1,2;3;9;1;1;1
250583135026;250583135199;173;0,1,2;3;9;1;1;1
250583135199;250583135380;181;0,1,2;3;9;1;1;1
250583135380;250583135560;180;0,1,2;3;9;1;1;1
250583135560;250583135893;333;0,1,2;3;9;1;1;1
250583135893;250583136159;266;0,1,2;3;9;1;1;1
250583136159;250583136792;633;0,1,2;3;9;1;1;1
250583136792;250583137025;233;0,1,2;3;9;1;1;1
250583137025;250583137056;31;0,1,2;3;9;1;1;1
250583137056;250583137217;161;0,1,2;3;9;1;1;1
250583137217;250583137395;178;0,1,2;3;9;1;1;1
250583137395;250583137578;183;0,1,2;3;9;1;1;1
250583137578;250583137680;102;0,1,2;3;9;1;1;1
250583137680;250583137692;12;0,1,2;3;9;1;1;1
250583137692;250583137754;62;0,1,2;3;9;1;1;1
250583137754;250583137781;27;0,1,2;3;9;1;1;1
250583137781;250583138031;250;0,1,2;3;9;1;1;1
250583138031;250583138210;179;0,1,2;3;9;1;1;1
250583138210;250583138563;353;0,1,2;3;9;1;1;1
250583138563;250583138935;372;0,1,2;3;9;1;1;1
250583138935;250583139021;86;0,1,2;3;9;1;1;1
250583139021;250583139093;72;0,1,2;3;9;1;1;1
250583139093;250583139322;229;0,1,2;3;9;1;1;1
250583139322;250583139332;10;0,1,2;3;9;1;1;1
250583139332;250583139422;90;0,1,2;3;9;1;1;1
250583139422;250583139557;135;0,1,2;3;9;1;1;1
250583139557;250583140017;460;0,1,2;3;9;1;1;1
250583140017;250583140709;692;0,1,2;3;9;1;1;1
250583140709;250583140719;10;0,1,2;3;9;1;1;1
250583140719;250583140728;9;0,1,2;3;9;1;1;1
250583140728;250583140948;220;0,1,2;3;9;1;1;1
250583140948;250583140972;24;0,1,2;3;9;1;1;1
250583140972;250583141338;366;0,1,2;3;9;1;1;1
250583141338;250583142186;848;0,1,2;3;9;1;1;1
250583142186;250583142259;73;0,1,2;3;9;1;1;1
250583142259;250583142270;11;0,1,2;3;9;1;1;1
250583142270;250583142286;16;0,1,2;3;9;1;1;1
250583142286;250583142313;27;0,1,2;3;9;1;1;1
250583142313;250583142580;267;0,1,2;3;9;1;1;1
250583142580;250583142686;106;0,1,2;3;9;1;1;1
250583142686;250583142853;167;0,1,2;3;9;1;1;1
250583142853;250583142971;118;0,1,2;3;9;1;1;1
250583142971;250583143003;32;0,1,2;3;9;1;1;1
250583143003;250583143099;96;0,1,2;3;9;1;1;1
250583143099;250583143271;172;0,1,2;3;9;1;1;1
250583143271;250583143345;74;0,1,2;3;9;1;1;1
250583143345;250583143348;3;0,1,2;3;9;1;1;1
250583143348;250583143439;91;0,1,2;3;9;1;1;1
250583143439;250583143628;189;0,1,2;3;9;1;1;1
250583143628;250583144041;413;0,1,2;3;9;1;1;1
250583144041;250583144256;215;0,1,2;3;9;1;1;1
250583144256;250583144286;30;0,1,2;3;9;1;1;1
250583144286;250583144338;52;0,1,2;3;9;1;1;1
250583144338;250583144430;92;0,1,2;3;9;1;1;1
250583144430;250583144544;114;0,1,2;3;9;1;1;1
250583144544;250583144655;111;0,1,2;3;9;1;1;1
250583144655;250583144857;202;0,1,2;3;9;1;1;1
250583144857;250583145011;154;0,1,2;3;9;1;1;1
250583145011;250583145275;264;0,1,2;3;9;1;1;1
250583145275;250583145376;101;0,1,2;3;9;1;1;1
250583145376;250583145469;93;0,1,2;3;9;1;1;1
250583145469;250583145487;18;0,1,2;3;9;1;1;1
250583145487;250583145862;375;0,1,2;3;9;1;1;1
250583145862;250583146728;866;0,1,2;3;9;1;1;1
250583146728;250583146810;82;0,1,2;3;9;1;1;1
250583146810;250583146986;176;0,1,2;3;9;1;1;1
250583146986;250583147037;51;0,1,2;3;9;1;1;1
250583147037;250583147505;468;0,1,2;3;9;1;1;1
250583147505;250583148090;585;0,1,2;3;9;1;1;1
250583148090;250583148189;99;0,1,2;3;9;1;1;1
250583148189;250583148247;58;0,1,2;3;9;1;1;1
250583148247;250583148722;475;0,1,2;3;9;1;1;1
250583148722;250583148809;87;0,1,2;3;9;1;1;1
250583148809;250583149009;200;0,1,2;3;9;1;1;1
250583149009;250583149824;815;0,1,2;3;9;1;1;1
250583149824;250583150037;213;0,1,2;3;9;1;1;1
250583150037;250583150250;213;0,1,2;3;9;1;1;1
250583150250;250583150356;106;0,1,2;3;9;1;1;1
250583150356;250583150597;241;0,1,2;3;9;1;1;1
250583150597;250583151248;651;0,1,2;3;9;1;1;1
250583151248;250583151330;82;0,1,2;3;9;1;1;1
250583151330;250583151781;451;0,1,2;3;9;1;1;1
250583151781;250583152907;1126;0,1,2;3;9;1;1;1
250583152907;250583153953;1046;0,1,2;3;9;1;1;1
250583153953;250583154873;920;0,1,2;3;9;1;1;1
250583154873;250583154993;120;0,1,2;3;9;1;1;1
250583154993;250583155639;646;0,1,2;3;9;1;1;1
250583155639;250583155674;35;0,1,2;3;9;1;1;1
250583155674;250583155682;8;0,1,2;3;9;1;1;1
250583155682;250583155701;19;0,1,2;3;9;1;1;1
250583155701;250583155779;78;0,1,2;3;9;1;1;1
250583155779;250583156123;344;0,1,2;3;9;1;1;1
250583156123;250583156144;21;0,1,2;3;9;1;1;1
250583156144;250583156214;70;0,1,2;3;9;1;1;1
250583156214;250583156421;207;0,1,2;3;9;1;1;1
250583156421;250583156493;72;0,1,2;3;9;1;1;1
250583156493;250583156800;307;0,1,2;3;9;1;1;1
250583156800;250583156902;102;0,1,2;3;9;1;1;1
250583156902;250583156952;50;0,1,2;3;9;1;1;1
250583156952;250583157064;112;0,1,2;3;9;1;1;1
250583157064;250583157303;239;0,1,2;3;9;1;1;1
250583157303;250583157677;374;0,1,2;3;9;1;1;1
250583157677;250583157921;244;0,1,2;3;9;1;1;1
250583157921;250583158151;230;0,1,2;3;9;1;1;1
250583158151;250583158400;249;0,1,2;3;9;1;1;1
250583158400;250583158723;323;0,1,2;3;9;1;1;1
250583158723;250583158781;58;0,1,2;3;9;1;1;1
250583158781;250583158962;181;0,1,2;3;9;1;1;1
250583158962;250583159029;67;0,1,2;3;9;1;1;1
250583159029;250583159124;95;0,1,2;3;9;1;1;1
250583159124;250583159668;544;0,1,2;3;9;1;1;1
250583159668;250583159695;27;0,1,2;3;9;1;1;1
250583159695;250583160511;816;0,1,2;3;9;1;1;1
250583160511;250583160643;132;0,1,2;3;9;1;1;1
250583160643;250583160810;167;0,1,2;3;9;1;1;1
250583160810;250583161201;391;0,1,2;3;9;1;1;1
250583161201;250583161565;364;0,1,2;3;9;1;1;1
250583161565;250583161617;52;0,1,2;3;9;1;1;1
250583161617;250583162047;430;0,1,2;3;9;1;1;1
250583162047;250583163650;1603;0,1,2;3;9;1;1;1
250583163650;250583163861;211;0,1,2;3;9;1;1;1
250583163861;250583163912;51;0,1,2;3;9;1;1;1
250583163912;250583164899;987;0,1,2;3;9;1;1;1
250583164899;250583165024;125;0,1,2;3;9;1;1;1
250583165024;250583165446;422;0,1,2;3;9;1;1;1
250583165446;250583165537;91;0,1,2;3;9;1;1;1
250583165537;250583165990;453;0,1,2;3;9;1;1;1
250583165990;250583166067;77;0,1,2;3;9;1;1;1
250583166067;250583166319;252;0,1,2;3;9;1;1;1
250583166319;250583166560;241;0,1,2;3;9;1;1;1
250583166560;250583166632;72;0,1,2;3;9;1;1;1
250583166632;250583166754;122;0,1,2;3;9;1;1;1
250583166754;250583167407;653;0,1,2;3;9;1;1;1
250583167407;250583167420;13;0,1,2;3;9;1;1;1
250583167420;250583167548;128;0,1,2;3;9;1;1;1
250583167548;250583167584;36;0,1,2;3;9;1;1;1
250583167584;250583167680;96;0,1,2;3;9;1;1;1
250583167680;250583167701;21;0,1,2;3;9;1;1;1
250583167701;250583167825;124;0,1,2;3;9;1;1;1
250583167825;250583168203;378;0,1,2;3;9;1;1;1
250583168203;250583168581;378;0,1,2;3;9;1;1;1
250583168581;250583168741;160;0,1,2;3;9;1;1;1
250583168741;250583169205;464;0,1,2;3;9;1;1;1
250583169205;250583169217;12;0,1,2;3;9;1;1;1
250583169217;250583169276;59;0,1,2;3;9;1;1;1
250583169276;250583169549;273;0,1,2;3;9;1;1;1
250583169549;250583170059;510;0,1,2;3;9;1;1;1
250583170059;250583170151;92;0,1,2;3;9;1;1;1
250583170151;250583170381;230;0,1,2;3;9;1;1;1
250583170381;250583170548;167;0,1,2;3;9;1;1;1
250583170548;250583171440;892;0,1,2;3;9;1;1;1
250583171440;250583171619;179;0,1,2;3;9;1;1;1
250583171619;250583172133;514;0,1,2;3;9;1;1;1
250583172133;250583172221;88;0,1,2;3;9;1;1;1
250583172221;250583173447;1226;0,1,2;3;9;1;1;1
250583173447;250583173983;536;0,1,2;3;9;1;1;1
250583173983;250583174039;56;0,1,2;3;9;1;1;1
250583174039;250583174042;3;0,1,2;3;9;1;1;1
250583174042;250583174190;148;0,1,2;3;9;1;1;1
250583174190;250583174523;333;0,1,2;3;9;1;1;1
250583174523;250583174665;142;0,1,2;3;9;1;1;1
250583174665;250583175111;446;0,1,2;3;9;1;1;1
250583175111;250583175531;420;0,1,2;3;9;1;1;1
250583175531;250583175532;1;0,1,2;3;9;1;1;1
250583175532;250583176226;694;0,1,2;3;9;1;1;1
250583176226;250583176327;101;0,1,2;3;9;1;1;1
250583176327;250583176819;492;0,1,2;3;9;1;1;1
250583176819;250583176894;75;0,1,2;3;9;1;1;1
250583176894;250583177030;136;0,1,2;3;9;1;1;1
250583177030;250583177121;91;0,1,2;3;9;1;1;1
250583177121;250583177640;519;0,1,2;3;9;1;1;1
250583177640;250583177731;91;0,1,2;3;9;1;1;1
250583177731;250583177852;121;0,1,2;3;9;1;1;1
250583177852;250583178292;440;0,1,2;3;9;1;1;1
250583178292;250583178878;586;0,1,2;3;9;1;1;1
250583178878;250583179688;810;0,1,2;3;9;1;1;1
250583179688;250583179790;102;0,1,2;3;9;1;1;1
250583179790;250583179834;44;0,1,2;3;9;1;1;1
250583179834;250583180123;289;0,1,2;3;9;1;1;1
250583180123;250583180368;245;0,1,2;3;9;1;1;1
250583180368;250583180725;357;0,1,2;3;9;1;1;1
250583180725;250583181747;1022;0,1,2;3;9;1;1;1
250583181747;250583182098;351;0,1,2;3;9;1;1;1
250583182098;250583182499;401;0,1,2;3;9;1;1;1
250583182499;250583182720;221;0,1,2;3;9;1;1;1
250583182720;250583182787;67;0,1,2;3;9;1;1;1
250583182787;250583182912;125;0,1,2;3;9;1;1;1
250583182912;250583182970;58;0,1,2;3;9;1;1;1
250583182970;250583183008;38;0,1,2;3;9;1;1;1
250583183008;250583183021;13;0,1,2;3;9;1;1;1
250583183021;250583183086;65;0,1,2;3;9;1;1;1
250583183086;250583183090;4;0,1,2;3;9;1;1;1
250583183090;250583183306;216;0,1,2;3;9;1;1;1
250583183306;250583183345;39;0,1,2;3;9;1;1;1
250583183345;250583183587;242;0,1,2;3;9;1;1;1
250583183587;250583183619;32;0,1,2;3;9;1;1;1
250583183619;250583183798;179;0,1,2;3;9;1;1;1
250583183798;250583183852;54;0,1,2;3;9;1;1;1
250583183852;250583184000;148;0,1,2;3;9;1;1;1
250583184000;250583184115;115;0,1,2;3;9;1;1;1
250583184115;250583184296;181;0,1,2;3;9;1;1;1
250583184296;250583184368;72;0,1,2;3;9;1;1;1
250583184368;250583185128;760;0,1,2;3;9;1;1;1
250583185128;250583185418;290;0,1,2;3;9;1;1;1
250583185418;250583185710;292;0,1,2;3;9;1;1;1
250583185710;250583185794;84;0,1,2;3;9;1;1;1
250583185794;250583185997;203;0,1,2;3;9;1;1;1
250583185997;250583186077;80;0,1,2;3;9;1;1;1
250583186077;250583186299;222;0,1,2;3;9;1;1;1
250583186299;250583186409;110;0,1,2;3;9;1;1;1
250583186409;250583186508;99;0,1,2;3;9;1;1;1
250583186508;250583186530;22;0,1,2;3;9;1;1;1
250583186530;250583186646;116;0,1,2;3;9;1;1;1
250583186646;250583187011;365;0,1,2;3;9;1;1;1
250583187011;250583187336;325;0,1,2;3;9;1;1;1
250583187336;250583187636;300;0,1,2;3;9;1;1;1
250583187636;250583189411;1775;0,1,2;3;9;1;1;1
250583189411;250583190002;591;0,1,2;3;9;1;1;1
250583190002;250583190104;102;0,1,2;3;9;1;1;1
250583190104;250583190633;529;0,1,2;3;9;1;1;1
250583190633;250583190711;78;0,1,2;3;9;1;1;1
250583190711;250583190752;41;0,1,2;3;9;1;1;1
250583190752;250583190930;178;0,1,2;3;9;1;1;1
250583190930;250583191036;106;0,1,2;3;9;1;1;1
250583191036;250583191640;604;0,1,2;3;9;1;1;1
250583191640;250583191710;70;0,1,2;3;9;1;1;1
250583191710;250583191848;138;0,1,2;3;9;1;1;1
250583191848;250583192067;219;0,1,2;3;9;1;1;1
250583192067;250583192426;359;0,1,2;3;9;1;1;1
250583192426;250583192474;48;0,1,2;3;9;1;1;1
250583192474;250583192585;111;0,1,2;3;9;1;1;1
250583192585;250583192630;45;0,1,2;3;9;1;1;1
250583192630;250583192688;58;0,1,2;3;9;1;1;1
250583192688;250583192701;13;0,1,2;3;9;1;1;1
250583192701;250583193314;613;0,1,2;3;9;1;1;1
250583193314;250583194176;862;0,1,2;3;9;1;1;1
250583194176;250583195288;1112;0,1,2;3;9;1;1;1
250583195288;250583195450;162;0,1,2;3;9;1;1;1
250583195450;250583195526;76;0,1,2;3;9;1;1;1
250583195526;250583195635;109;0,1,2;3;9;1;1;1
250583195635;250583195689;54;0,1,2;3;9;1;1;1
250583195689;250583195821;132;0,1,2;3;9;1;1;1
250583195821;250583195875;54;0,1,2;3;9;1;1;1
250583195875;250583195884;9;0,1,2;3;9;1;1;1
250583195884;250583196490;606;0,1,2;3;9;1;1;1
250583196490;250583196814;324;0,1,2;3;9;1;1;1
250583196814;250583197044;230;0,1,2;3;9;1;1;1
250583197044;250583197238;194;0,1,2;3;9;1;1;1
250583197238;250583197293;55;0,1,2;3;9;1;1;1
250583197293;250583197296;3;0,1,2;3;9;1;1;1
250583197296;250583197428;132;0,1,2;3;9;1;1;1
250583197428;250583197656;228;0,1,2;3;9;1;1;1
250583197656;250583197768;112;0,1,2;3;9;1;1;1
250583197768;250583198029;261;0,1,2;3;9;1;1;1
250583198029;250583198144;115;0,1,2;3;9;1;1;1
250583198144;250583198167;23;0,1,2;3;9;1;1;1
250583198167;250583198259;92;0,1,2;3;9;1;1;1
250583198259;250583198440;181;0,1,2;3;9;1;1;1
250583198440;250583198524;84;0,1,2;3;9;1;1;1
250583198524;250583199022;498;0,1,2;3;9;1;1;1
250583199022;250583199101;79;0,1,2;3;9;1;1;1
250583199101;250583199212;111;0,1,2;3;9;1;1;1
250583199212;250583199259;47;0,1,2;3;9;1;1;1
250583199259;250583199268;9;0,1,2;3;9;1;1;1
250583199268;250583199316;48;0,1,2;3;9;1;1;1
250583199316;250583199568;252;0,1,2;3;9;1;1;1
250583199568;250583199576;8;0,1,2;3;9;1;1;1
250583199576;250583199848;272;0,1,2;3;9;1;1;1
250583199848;250583200544;696;0,1,2;3;9;1;1;1
250583200544;250583200738;194;0,1,2;3;9;1;1;1
250583200738;250583201040;302;0,1,2;3;9;1;1;1
250583201040;250583201480;440;0,1,2;3;9;1;1;1
250583201480;250583201929;449;0,1,2;3;9;1;1;1
250583201929;250583202354;425;0,1,2;3;9;1;1;1
250583202354;250583202768;414;0,1,2;3;9;1;1;1
250583202768;250583203789;1021;0,1,2;3;9;1;1;1
250583203789;250583204179;390;0,1,2;3;9;1;1;1
250583204179;250583204303;124;0,1,2;3;9;1;1;1
250583204303;250583204442;139;0,1,2;3;9;1;1;1
250583204442;250583205610;1168;0,1,2;3;9;1;1;1
250583205610;250583205885;275;0,1,2;3;9;1;1;1
250583205885;250583206466;581;0,1,2;3;9;1;1;1
250583206466;250583206967;501;0,1,2;3;9;1;1;1
250583206967;250583207006;39;0,1,2;3;9;1;1;1
250583207006;250583207124;118;0,1,2;3;9;1;1;1
250583207124;250583208142;1018;0,1,2;3;9;1;1;1
250583208142;250583208740;598;0,1,2;3;9;1;1;1
250583208740;250583208746;6;0,1,2;3;9;1;1;1
250583208746;250583209243;497;0,1,2;3;9;1;1;1
250583209243;250583209249;6;0,1,2;3;9;1;1;1
250583209249;250583209434;185;0,1,2;3;9;1;1;1
250583209434;250583210023;589;0,1,2;3;9;1;1;1
250583210023;250583210036;13;0,1,2;3;9;1;1;1
250583210036;250583210063;27;0,1,2;3;9;1;1;1
250583210063;250583210873;810;0,1,2;3;9;1;1;1
250583210873;250583211048;175;0,1,2;3;9;1;1;1
250583211048;250583211059;11;0,1,2;3;9;1;1;1
250583211059;250583211251;192;0,1,2;3;9;1;1;1
250583211251;250583211285;34;0,1,2;3;9;1;1;1
250583211285;250583211351;66;0,1,2;3;9;1;1;1
250583211351;250583211824;473;0,1,2;3;9;1;1;1
250583211824;250583212254;430;0,1,2;3;9;1;1;1
250583212254;250583212298;44;0,1,2;3;9;1;1;1
250583212298;250583212475;177;0,1,2;3;9;1;1;1
250583212475;250583212895;420;0,1,2;3;9;1;1;1
250583212895;250583212930;35;0,1,2;3;9;1;1;1
250583212930;250583213068;138;0,1,2;3;9;1;1;1
250583213068;250583213100;32;0,1,2;3;9;1;1;1
250583213100;250583213113;13;0,1,2;3;9;1;1;1
250583213113;250583213254;141;0,1,2;3;9;1;1;1
250583213254;250583213449;195;0,1,2;3;9;1;1;1
250583213449;250583213462;13;0,1,2;3;9;1;1;1
250583213462;250583213524;62;0,1,2;3;9;1;1;1
250583213524;250583213676;152;0,1,2;3;9;1;1;1
250583213676;250583214387;711;0,1,2;3;9;1;1;1
250583214387;250583214699;312;0,1,2;3;9;1;1;1
250583214699;250583215185;486;0,1,2;3;9;1;1;1
250583215185;250583215386;201;0,1,2;3;9;1;1;1
250583215386;250583215433;47;0,1,2;3;9;1;1;1
250583215433;250583215759;326;0,1,2;3;9;1;1;1
250583215759;250583215995;236;0,1,2;3;9;1;1;1
250583215995;250583216148;153;0,1,2;3;9;1;1;1
250583216148;250583216306;158;0,1,2;3;9;1;1;1
250583216306;250583216387;81;0,1,2;3;9;1;1;1
250583216387;250583216862;475;0,1,2;3;9;1;1;1
250583216862;250583216908;46;0,1,2;3;9;1;1;1
250583216908;250583216952;44;0,1,2;3;9;1;1;1
250583216952;250583216990;38;0,1,2;3;9;1;1;1
250583216990;250583217757;767;0,1,2;3;9;1;1;1
250583217757;250583218199;442;0,1,2;3;9;1;1;1
250583218199;250583218259;60;0,1,2;3;9;1;1;1
250583218259;250583218759;500;0,1,2;3;9;1;1;1
250583218759;250583219205;446;0,1,2;3;9;1;1;1
250583219205;250583219710;505;0,1,2;3;9;1;1;1
250583219710;250583221069;1359;0,1,2;3;9;1;1;1
250583221069;250583221463;394;0,1,2;3;9;1;1;1
250583221463;250583221858;395;0,1,2;3;9;1;1;1
250583221858;250583222379;521;0,1,2;3;9;1;1;1
250583222379;250583222607;228;0,1,2;3;9;1;1;1
250583222607;250583222615;8;0,1,2;3;9;1;1;1
250583222615;250583222686;71;0,1,2;3;9;1;1;1
250583222686;250583222871;185;0,1,2;3;9;1;1;1
250583222871;250583223132;261;0,1,2;3;9;1;1;1
250583223132;250583223291;159;0,1,2;3;9;1;1;1
250583223291;250583223535;244;0,1,2;3;9;1;1;1
250583223535;250583223684;149;0,1,2;3;9;1;1;1
250583223684;250583223784;100;0,1,2;3;9;1;1;1
250583223784;250583224401;617;0,1,2;3;9;1;1;1
250583224401;250583224432;31;0,1,2;3;9;1;1;1
250583224432;250583224436;4;0,1,2;3;9;1;1;1
250583224436;250583224523;87;0,1,2;3;9;1;1;1
250583224523;250583224543;20;0,1,2;3;9;1;1;1
250583224543;250583224815;272;0,1,2;3;9;1;1;1
250583224815;250583224821;6;0,1,2;3;9;1;1;1
250583224821;250583225020;199;0,1,2;3;9;1;1;1
250583225020;250583225624;604;0,1,2;3;9;1;1;1
250583225624;250583225790;166;0,1,2;3;9;1;1;1
250583225790;250583225974;184;0,1,2;3;9;1;1;1
250583225974;250583226045;71;0,1,2;3;9;1;1;1
250583226045;250583226185;140;0,1,2;3;9;1;1;1
250583226185;250583226208;23;0,1,2;3;9;1;1;1
250583226208;250583226494;286;0,1,2;3;9;1;1;1
250583226494;250583227216;722;0,1,2;3;9;1;1;1
250583227216;250583227321;105;0,1,2;3;9;1;1;1
250583227321;250583227399;78;0,1,2;3;9;1;1;1
250583227399;250583227635;236;0,1,2;3;9;1;1;1
250583227635;250583227840;205;0,1,2;3;9;1;1;1
250583227840;250583228291;451;0,1,2;3;9;1;1;1
250583228291;250583228547;256;0,1,2;3;9;1;1;1
250583228547;250583229118;571;0,1,2;3;9;1;1;1
250583229118;250583229427;309;0,1,2;3;9;1;1;1
250583229427;250583229542;115;0,1,2;3;9;1;1;1
250583229542;250583229834;292;0,1,2;3;9;1;1;1
250583229834;250583230592;758;0,1,2;3;9;1;1;1
250583230592;250583230858;266;0,1,2;3;9;1;1;1
250583230858;250583230932;74;0,1,2;3;9;1;1;1
250583230932;250583231146;214;0,1,2;3;9;1;1;1
250583231146;250583232801;1655;0,1,2;3;9;1;1;1
250583232801;250583233714;913;0,1,2;3;9;1;1;1
250583233714;250583234910;1196;0,1,2;3;9;1;1;1
250583234910;250583235274;364;0,1,2;3;9;1;1;1
250583235274;250583235464;190;0,1,2;3;9;1;1;1
250583235464;250583235685;221;0,1,2;3;9;1;1;1
250583235685;250583235743;58;0,1,2;3;9;1;1;1
250583235743;250583236007;264;0,1,2;3;9;1;1;1
250583236007;250583236092;85;0,1,2;3;9;1;1;1
250583236092;250583236114;22;0,1,2;3;9;1;1;1
250583236114;250583236767;653;0,1,2;3;9;1;1;1
250583236767;250583237961;1194;0,1,2;3;9;1;1;1
250583237961;250583239436;1475;0,1,2;3;9;1;1;1
250583239436;250583239500;64;0,1,2;3;9;1;1;1
250583239500;250583242244;2744;0,1,2;3;9;1;1;1
250583242244;250583244414;2170;0,1,2;3;9;1;1;1
250583244414;250583244624;210;0,1,2;3;9;1;1;1
250583244624;250583245257;633;0,1,2;3;9;1;1;1
250583245257;250583245374;117;0,1,2;3;9;1;1;1
250583245374;250583245565;191;0,1,2;3;9;1;1;1
250583245565;250583245721;156;0,1,2;3;9;1;1;1
250583245721;250583249105;3384;0,1,2;3;9;1;1;1
250583249105;250583250142;1037;0,1,2;3;9;1;1;1
250583250142;250583252363;2221;0,1,2;3;9;1;1;1
250583252363;250583254034;1671;0,1,2;3;9;1;1;1
250583254034;250583254112;78;0,1,2;3;9;1;1;1
250583254112;250583255488;1376;0,1,2;3;9;1;1;1
250583255488;250583255883;395;0,1,2;3;9;1;1;1
250583255883;250583256129;246;0,1,2;3;9;1;1;1
250583256129;250583256605;476;0,1,2;3;9;1;1;1
250583256605;250583256634;29;0,1,2;3;9;1;1;1
250583256634;250583256663;29;0,1,2;3;9;1;1;1
250583256663;250583256830;167;0,1,2;3;9;1;1;1
250583256830;250583257490;660;0,1,2;3;9;1;1;1
250583257490;250583258492;1002;0,1,2;3;9;1;1;1
250583258492;250583258529;37;0,1,2;3;9;1;1;1
250583258529;250583258717;188;0,1,2;3;9;1;1;1
250583258717;250583259552;835;0,1,2;3;9;1;1;1
250583259552;250583260123;571;0,1,2;3;9;1;1;1
250583260123;250583260162;39;0,1,2;3;9;1;1;1
250583260162;250583261025;863;0,1,2;3;9;1;1;1
250583261025;250583261361;336;0,1,2;3;9;1;1;1
250583261361;250583261415;54;0,1,2;3;9;1;1;1
250583261415;250583261533;118;0,1,2;3;9;1;1;1
250583261533;250583261917;384;0,1,2;3;9;1;1;1
250583261917;250583262800;883;0,1,2;3;9;1;1;1
250583262800;250583264324;1524;0,1,2;3;9;1;1;1
250583264324;250583264573;249;0,1,2;3;9;1;1;1
250583264573;250583264719;146;0,1,2;3;9;1;1;1
250583264719;250583264780;61;0,1,2;3;9;1;1;1
250583264780;250583265461;681;0,1,2;3;9;1;1;1
250583265461;250583265748;287;0,1,2;3;9;1;1;1
250583265748;250583265829;81;0,1,2;3;9;1;1;1
250583265829;250583266471;642;0,1,2;3;9;1;1;1
250583266471;250583266844;373;0,1,2;3;9;1;1;1
250583266844;250583267384;540;0,1,2;3;9;1;1;1
250583267384;250583267519;135;0,1,2;3;9;1;1;1
250583267519;250583267774;255;0,1,2;3;9;1;1;1
250583267774;250583268935;1161;0,1,2;3;9;1;1;1
250583268935;250583269148;213;0,1,2;3;9;1;1;1
250583269148;250583269299;151;0,1,2;3;9;1;1;1
250583269299;250583269404;105;0,1,2;3;9;1;1;1
250583269404;250583269498;94;0,1,2;3;9;1;1;1
250583269498;250583270073;575;0,1,2;3;9;1;1;1
250583270073;250583270646;573;0,1,2;3;9;1;1;1
250583270646;250583271816;1170;0,1,2;3;9;1;1;1
250583271816;250583272882;1066;0,1,2;3;9;1;1;1
250583272882;250583272954;72;0,1,2;3;9;1;1;1
250583272954;250583273505;551;0,1,2;3;9;1;1;1
250583273505;250583273535;30;0,1,2;3;9;1;1;1
250583273535;250583274172;637;0,1,2;3;9;1;1;1
250583274172;250583274726;554;0,1,2;3;9;1;1;1
250583274726;250583274794;68;0,1,2;3;9;1;1;1
250583274794;250583274975;181;0,1,2;3;9;1;1;1
250583274975;250583276444;1469;0,1,2;3;9;1;1;1
250583276444;250583276683;239;0,1,2;3;9;1;1;1
250583276683;250583276770;87;0,1,2;3;9;1;1;1
250583276770;250583276826;56;0,1,2;3;9;1;1;1
250583276826;250583277188;362;0,1,2;3;9;1;1;1
250583277188;250583277376;188;0,1,2;3;9;1;1;1
250583277376;250583277534;158;0,1,2;3;9;1;1;1
250583277534;250583277646;112;0,1,2;3;9;1;1;1
250583277646;250583278112;466;0,1,2;3;9;1;1;1
250583278112;250583278792;680;0,1,2;3;9;1;1;1
250583278792;250583279532;740;0,1,2;3;9;1;1;1
250583279532;250583280561;1029;0,1,2;3;9;1;1;1
250583280561;250583280572;11;0,1,2;3;9;1;1;1
250583280572;250583280689;117;0,1,2;3;9;1;1;1
250583280689;250583281589;900;0,1,2;3;9;1;1;1
250583281589;250583281600;11;0,1,2;3;9;1;1;1
250583281600;250583281854;254;0,1,2;3;9;1;1;1
250583281854;250583283235;1381;0,1,2;3;9;1;1;1
250583283235;250583283283;48;0,1,2;3;9;1;1;1
250583283283;250583283526;243;0,1,2;3;9;1;1;1
250583283526;250583283537;11;0,1,2;3;9;1;1;1
250583283537;250583283613;76;0,1,2;3;9;1;1;1
250583283613;250583285357;1744;0,1,2;3;9;1;1;1
250583285357;250583286303;946;0,1,2;3;9;1;1;1
250583286303;250583286304;1;0,1,2;3;9;1;1;1
250583286304;250583286629;325;0,1,2;3;9;1;1;1
250583286629;250583286709;80;0,1,2;3;9;1;1;1
250583286709;250583286933;224;0,1,2;3;9;1;1;1
250583286933;250583287313;380;0,1,2;3;9;1;1;1
250583287313;250583288139;826;0,1,2;3;9;1;1;1
250583288139;250583288478;339;0,1,2;3;9;1;1;1
250583288478;250583288508;30;0,1,2;3;9;1;1;1
250583288508;250583288587;79;0,1,2;3;9;1;1;1
250583288587;250583288694;107;0,1,2;3;9;1;1;1
250583288694;250583289212;518;0,1,2;3;9;1;1;1
250583289212;250583289266;54;0,1,2;3;9;1;1;1
250583289266;250583290276;1010;0,1,2;3;9;1;1;1
250583290276;250583290930;654;0,1,2;3;9;1;1;1
250583290930;250583291292;362;0,1,2;3;9;1;1;1
250583291292;250583291569;277;0,1,2;3;9;1;1;1
250583291569;250583291646;77;0,1,2;3;9;1;1;1
250583291646;250583291763;117;0,1,2;3;9;1;1;1
250583291763;250583292129;366;0,1,2;3;9;1;1;1
250583292129;250583292600;471;0,1,2;3;9;1;1;1
250583292600;250583293273;673;0,1,2;3;9;1;1;1
250583293273;250583294223;950;0,1,2;3;9;1;1;1
250583294223;250583296848;2625;0,1,2;3;9;1;1;1
250583296848;250583296867;19;0,1,2;3;9;1;1;1
250583296867;250583297626;759;0,1,2;3;9;1;1;1
250583297626;250583297679;53;0,1,2;3;9;1;1;1
250583297679;250583297709;30;0,1,2;3;9;1;1;1
250583297709;250583297945;236;0,1,2;3;9;1;1;1
250583297945;250583299356;1411;0,1,2;3;9;1;1;1
250583299356;250583299519;163;0,1,2;3;9;1;1;1
250583299519;250583299526;7;0,1,2;3;9;1;1;1
250583299526;250583299548;22;0,1,2;3;9;1;1;1
250583299548;250583299557;9;0,1,2;3;9;1;1;1
250583299557;250583299601;44;0,1,2;3;9;1;1;1
250583299601;250583299672;71;0,1,2;3;9;1;1;1
250583299672;250583299694;22;0,1,2;3;9;1;1;1
250583299694;250583299713;19;0,1,2;3;9;1;1;1
250583299713;250583299886;173;0,1,2;3;9;1;1;1
250583299886;250583299922;36;0,1,2;3;9;1;1;1
250583299922;250583299981;59;0,1,2;3;9;1;1;1
250583299981;250583300300;319;0,1,2;3;9;1;1;1
250583300300;250583302668;2368;0,1,2;3;9;1;1;1
250583302668;250583302741;73;0,1,2;3;9;1;1;1
250583302741;250583303008;267;0,1,2;3;9;1;1;1
250583303008;250583303812;804;0,1,2;3;9;1;1;1
250583303812;250583303882;70;0,1,2;3;9;1;1;1
250583303882;250583304355;473;0,1,2;3;9;1;1;1
250583304355;250583304912;557;0,1,2;3;9;1;1;1
250583304912;250583306264;1352;0,1,2;3;9;1;1;1
250583306264;250583306733;469;0,1,2;3;9;1;1;1
250583306733;250583306820;87;0,1,2;3;9;1;1;1
250583306820;250583306987;167;0,1,2;3;9;1;1;1
250583306987;250583307189;202;0,1,2;3;9;1;1;1
250583307189;250583307568;379;0,1,2;3;9;1;1;1
250583307568;250583309097;1529;0,1,2;3;9;1;1;1
250583309097;250583309111;14;0,1,2;3;9;1;1;1
250583309111;250583309600;489;0,1,2;3;9;1;1;1
250583309600;250583310189;589;0,1,2;3;9;1;1;1
250583310189;250583310510;321;0,1,2;3;9;1;1;1
250583310510;250583313904;3394;0,1,2;3;9;1;1;1
250583313904;250583318025;4121;0,1,2;3;9;1;1;1
250583318025;250583319463;1438;0,1,2;3;9;1;1;1
250583319463;250583319468;5;0,1,2;3;9;1;1;1
250583319468;250583319524;56;0,1,2;3;9;1;1;1
250583319524;250583319613;89;0,1,2;3;9;1;1;1
250583319613;250583320356;743;0,1,2;3;9;1;1;1
250583320356;250583321838;1482;0,1,2;3;9;1;1;1
250583321838;250583322880;1042;0,1,2;3;9;1;1;1
250583322880;250583322891;11;0,1,2;3;9;1;1;1
250583322891;250583323696;805;0,1,2;3;9;1;1;1
250583323696;250583323847;151;0,1,2;3;9;1;1;1
250583323847;250583323893;46;0,1,2;3;9;1;1;1
250583323893;250583324453;560;0,1,2;3;9;1;1;1
250583324453;250583324501;48;0,1,2;3;9;1;1;1
250583324501;250583325204;703;0,1,2;3;9;1;1;1
250583325204;250583325295;91;0,1,2;3;9;1;1;1
250583325295;250583325304;9;0,1,2;3;9;1;1;1
250583325304;250583325489;185;0,1,2;3;9;1;1;1
250583325489;250583325691;202;0,1,2;3;9;1;1;1
250583325691;250583325734;43;0,1,2;3;9;1;1;1
250583325734;250583325900;166;0,1,2;3;9;1;1;1
250583325900;250583325929;29;0,1,2;3;9;1;1;1
250583325929;250583326194;265;0,1,2;3;9;1;1;1
250583326194;250583326222;28;0,1,2;3;9;1;1;1
250583326222;250583326244;22;0,1,2;3;9;1;1;1
250583326244;250583326549;305;0,1,2;3;9;1;1;1
250583326549;250583327012;463;0,1,2;3;9;1;1;1
250583327012;250583327161;149;0,1,2;3;9;1;1;1
250583327161;250583327172;11;0,1,2;3;9;1;1;1
250583327172;250583327229;57;0,1,2;3;9;1;1;1
250583327229;250583329318;2089;0,1,2;3;9;1;1;1
250583329318;250583329391;73;0,1,2;3;9;1;1;1
250583329391;250583329398;7;0,1,2;3;9;1;1;1
250583329398;250583330189;791;0,1,2;3;9;1;1;1
250583330189;250583330325;136;0,1,2;3;9;1;1;1
250583330325;250583330454;129;0,1,2;3;9;1;1;1
250583330454;250583330638;184;0,1,2;3;9;1;1;1
250583330638;250583331036;398;0,1,2;3;9;1;1;1
250583331036;250583331140;104;0,1,2;3;9;1;1;1
250583331140;250583331972;832;0,1,2;3;9;1;1;1
250583331972;250583332010;38;0,1,2;3;9;1;1;1
250583332010;250583332525;515;0,1,2;3;9;1;1;1
250583332525;250583332569;44;0,1,2;3;9;1;1;1
250583332569;250583332825;256;0,1,2;3;9;1;1;1
250583332825;250583334692;1867;0,1,2;3;9;1;1;1
250583334692;250583334804;112;0,1,2;3;9;1;1;1
250583334804;250583334979;175;0,1,2;3;9;1;1;1
250583334979;250583335462;483;0,1,2;3;9;1;1;1
250583335462;250583335497;35;0,1,2;3;9;1;1;1
250583335497;250583336043;546;0,1,2;3;9;1;1;1
250583336043;250583336117;74;0,1,2;3;9;1;1;1
250583336117;250583336686;569;0,1,2;3;9;1;1;1
250583336686;250583336728;42;0,1,2;3;9;1;1;1
250583336728;250583337911;1183;0,1,2;3;9;1;1;1
250583337911;250583338929;1018;0,1,2;3;9;1;1;1
250583338929;250583339351;422;0,1,2;3;9;1;1;1
250583339351;250583340031;680;0,1,2;3;9;1;1;1
250583340031;250583340062;31;0,1,2;3;9;1;1;1
250583340062;250583342118;2056;0,1,2;3;9;1;1;1
250583342118;250583342606;488;0,1,2;3;9;1;1;1
250583342606;250583343930;1324;0,1,2;3;9;1;1;1
250583343930;250583345226;1296;0,1,2;3;9;1;1;1
250583345226;250583345294;68;0,1,2;3;9;1;1;1
250583345294;250583345662;368;0,1,2;3;9;1;1;1
250583345662;250583345758;96;0,1,2;3;9;1;1;1
250583345758;250583347538;1780;0,1,2;3;9;1;1;1
250583347538;250583347624;86;0,1,2;3;9;1;1;1
250583347624;250583347664;40;0,1,2;3;9;1;1;1
250583347664;250583347697;33;0,1,2;3;9;1;1;1
250583347697;250583349115;1418;0,1,2;3;9;1;1;1
250583349115;250583349324;209;0,1,2;3;9;1;1;1
250583349324;250583349752;428;0,1,2;3;9;1;1;1
250583349752;250583350959;1207;0,1,2;3;9;1;1;1
250583350959;250583351066;107;0,1,2;3;9;1;1;1
250583351066;250583352833;1767;0,1,2;3;9;1;1;1
250583352833;250583353747;914;0,1,2;3;9;1;1;1
250583353747;250583353829;82;0,1,2;3;9;1;1;1
250583353829;250583354762;933;0,1,2;3;9;1;1;1
250583354762;250583354993;231;0,1,2;3;9;1;1;1
250583354993;250583356001;1008;0,1,2;3;9;1;1;1
250583356001;250583356331;330;0,1,2;3;9;1;1;1
250583356331;250583356628;297;0,1,2;3;9;1;1;1
250583356628;250583357278;650;0,1,2;3;9;1;1;1
250583357278;250583358417;1139;0,1,2;3;9;1;1;1
250583358417;250583358841;424;0,1,2;3;9;1;1;1
250583358841;250583359580;739;0,1,2;3;9;1;1;1
250583359580;250583359781;201;0,1,2;3;9;1;1;1
250583359781;250583360444;663;0,1,2;3;9;1;1;1
250583360444;250583360529;85;0,1,2;3;9;1;1;1
250583360529;250583360905;376;0,1,2;3;9;1;1;1
250583360905;250583361809;904;0,1,2;3;9;1;1;1
250583361809;250583362929;1120;0,1,2;3;9;1;1;1
250583362929;250583363136;207;0,1,2;3;9;1;1;1
250583363136;250583364728;1592;0,1,2;3;9;1;1;1
250583364728;250583366639;1911;0,1,2;3;9;1;1;1
250583366639;250583368084;1445;0,1,2;3;9;1;1;1
250583368084;250583368127;43;0,1,2;3;9;1;1;1
250583368127;250583368440;313;0,1,2;3;9;1;1;1
250583368440;250583368732;292;0,1,2;3;9;1;1;1
250583368732;250583369090;358;0,1,2;3;9;1;1;1
250583369090;250583369854;764;0,1,2;3;9;1;1;1
250583369854;250583370629;775;0,1,2;3;9;1;1;1
250583370629;250583372068;1439;0,1,2;3;9;1;1;1
250583372068;250583373176;1108;0,1,2;3;9;1;1;1
250583373176;250583373411;235;0,1,2;3;9;1;1;1
250583373411;250583373860;449;0,1,2;3;9;1;1;1
250583373860;250583374589;729;0,1,2;3;9;1;1;1
250583374589;250583374788;199;0,1,2;3;9;1;1;1
250583374788;250583374862;74;0,1,2;3;9;1;1;1
250583374862;250583375544;682;0,1,2;3;9;1;1;1
250583375544;250583378283;2739;0,1,2;3;9;1;1;1
250583378283;250583378553;270;0,1,2;3;9;1;1;1
250583378553;250583380282;1729;0,1,2;3;9;1;1;1
250583380282;250583380408;126;0,1,2;3;9;1;1;1
250583380408;250583381809;1401;0,1,2;3;9;1;1;1
250583381809;250583381885;76;0,1,2;3;9;1;1;1
250583381885;250583382287;402;0,1,2;3;9;1;1;1
250583382287;250583382719;432;0,1,2;3;9;1;1;1
250583382719;250583383825;1106;0,1,2;3;9;1;1;1
250583383825;250583385430;1605;0,1,2;3;9;1;1;1
250583385430;250583387161;1731;0,1,2;3;9;1;1;1
250583387161;250583387322;161;0,1,2;3;9;1;1;1
250583387322;250583388435;1113;0,1,2;3;9;1;1;1
250583388435;250583389217;782;0,1,2;3;9;1;1;1
250583389217;250583389537;320;0,1,2;3;9;1;1;1
250583389537;250583389553;16;0,1,2;3;9;1;1;1
250583389553;250583390017;464;0,1,2;3;9;1;1;1
250583390017;250583390069;52;0,1,2;3;9;1;1;1
250583390069;250583390270;201;0,1,2;3;9;1;1;1
250583390270;250583392264;1994;0,1,2;3;9;1;1;1
250583392264;250583393522;1258;0,1,2;3;9;1;1;1
250583393522;250583394903;1381;0,1,2;3;9;1;1;1
250583394903;250583395487;584;0,1,2;3;9;1;1;1
250583395487;250583396070;583;0,1,2;3;9;1;1;1
250583396070;250583397422;1352;0,1,2;3;9;1;1;1
250583397422;250583398138;716;0,1,2;3;9;1;1;1
250583398138;250583398424;286;0,1,2;3;9;1;1;1
250583398424;250583399395;971;0,1,2;3;9;1;1;1
250583399395;250583399398;3;0,1,2;3;9;1;1;1
250583399398;250583399533;135;0,1,2;3;9;1;1;1
250583399533;250583400252;719;0,1,2;3;9;1;1;1
250583400252;250583400679;427;0,1,2;3;9;1;1;1
250583400679;250583401067;388;0,1,2;3;9;1;1;1
250583401067;250583401617;550;0,1,2;3;9;1;1;1
250583401617;250583402080;463;0,1,2;3;9;1;1;1
250583402080;250583403216;1136;0,1,2;3;9;1;1;1
250583403216;250583403294;78;0,1,2;3;9;1;1;1
250583403294;250583403303;9;0,1,2;3;9;1;1;1
250583403303;250583403398;95;0,1,2;3;9;1;1;1
250583403398;250583403540;142;0,1,2;3;9;1;1;1
250583403540;250583403779;239;0,1,2;3;9;1;1;1
250583403779;250583404273;494;0,1,2;3;9;1;1;1
250583404273;250583404810;537;0,1,2;3;9;1;1;1
250583404810;250583405511;701;0,1,2;3;9;1;1;1
250583405511;250583405870;359;0,1,2;3;9;1;1;1
250583405870;250583405888;18;0,1,2;3;9;1;1;1
250583405888;250583406476;588;0,1,2;3;9;1;1;1
250583406476;250583406506;30;0,1,2;3;9;1;1;1
250583406506;250583406785;279;0,1,2;3;9;1;1;1
250583406785;250583407226;441;0,1,2;3;9;1;1;1
250583407226;250583407686;460;0,1,2;3;9;1;1;1
250583407686;250583409390;1704;0,1,2;3;9;1;1;1
250583409390;250583409422;32;0,1,2;3;9;1;1;1
250583409422;250583409442;20;0,1,2;3;9;1;1;1
250583409442;250583409616;174;0,1,2;3;9;1;1;1
250583409616;250583409786;170;0,1,2;3;9;1;1;1
250583409786;250583410485;699;0,1,2;3;9;1;1;1
250583410485;250583411256;771;0,1,2;3;9;1;1;1
250583411256;250583411321;65;0,1,2;3;9;1;1;1
250583411321;250583412099;778;0,1,2;3;9;1;1;1
250583412099;250583412445;346;0,1,2;3;9;1;1;1
250583412445;250583412559;114;0,1,2;3;9;1;1;1
250583412559;250583413331;772;0,1,2;3;9;1;1;1
250583413331;250583413667;336;0,1,2;3;9;1;1;1
250583413667;250583414018;351;0,1,2;3;9;1;1;1
250583414018;250583414669;651;0,1,2;3;9;1;1;1
250583414669;250583415386;717;0,1,2;3;9;1;1;1
250583415386;250583415895;509;0,1,2;3;9;1;1;1
250583415895;250583416045;150;0,1,2;3;9;1;1;1
250583416045;250583416349;304;0,1,2;3;9;1;1;1
250583416349;250583416415;66;0,1,2;3;9;1;1;1
250583416415;250583416600;185;0,1,2;3;9;1;1;1
250583416600;250583416703;103;0,1,2;3;9;1;1;1
250583416703;250583416895;192;0,1,2;3;9;1;1;1
250583416895;250583417307;412;0,1,2;3;9;1;1;1
250583417307;250583417308;1;0,1,2;3;9;1;1;1
250583417308;250583417444;136;0,1,2;3;9;1;1;1
250583417444;250583418487;1043;0,1,2;3;9;1;1;1
250583418487;250583418695;208;0,1,2;3;9;1;1;1
250583418695;250583419378;683;0,1,2;3;9;1;1;1
250583419378;250583419714;336;0,1,2;3;9;1;1;1
250583419714;250583420274;560;0,1,2;3;9;1;1;1
250583420274;250583420334;60;0,1,2;3;9;1;1;1
250583420334;250583420402;68;0,1,2;3;9;1;1;1
250583420402;250583420433;31;0,1,2;3;9;1;1;1
250583420433;250583420464;31;0,1,2;3;9;1;1;1
250583420464;250583420504;40;0,1,2;3;9;1;1;1
250583420504;250583421337;833;0,1,2;3;9;1;1;1
250583421337;250583421605;268;0,1,2;3;9;1;1;1
250583421605;250583421626;21;0,1,2;3;9;1;1;1
250583421626;250583421663;37;0,1,2;3;9;1;1;1
250583421663;250583421696;33;0,1,2;3;9;1;1;1
250583421696;250583421718;22;0,1,2;3;9;1;1;1
250583421718;250583421751;33;0,1,2;3;9;1;1;1
250583421751;250583421854;103;0,1,2;3;9;1;1;1
250583421854;250583422015;161;0,1,2;3;9;1;1;1
250583422015;250583422150;135;0,1,2;3;9;1;1;1
250583422150;250583422835;685;0,1,2;3;9;1;1;1
250583422835;250583422995;160;0,1,2;3;9;1;1;1
250583422995;250583423264;269;0,1,2;3;9;1;1;1
250583423264;250583423286;22;0,1,2;3;9;1;1;1
250583423286;250583423399;113;0,1,2;3;9;1;1;1
250583423399;250583423816;417;0,1,2;3;9;1;1;1
250583423816;250583425027;1211;0,1,2;3;9;1;1;1
250583425027;250583425510;483;0,1,2;3;9;1;1;1
250583425510;250583427295;1785;0,1,2;3;9;1;1;1
250583427295;250583427348;53;0,1,2;3;9;1;1;1
250583427348;250583427406;58;0,1,2;3;9;1;1;1
250583427406;250583427797;391;0,1,2;3;9;1;1;1
250583427797;250583428528;731;0,1,2;3;9;1;1;1
250583428528;250583429006;478;0,1,2;3;9;1;1;1
250583429006;250583429414;408;0,1,2;3;9;1;1;1
250583429414;250583429848;434;0,1,2;3;9;1;1;1
250583429848;250583431970;2122;0,1,2;3;9;1;1;1
250583431970;250583433097;1127;0,1,2;3;9;1;1;1
250583433097;250583433279;182;0,1,2;3;9;1;1;1
250583433279;250583433455;176;0,1,2;3;9;1;1;1
250583433455;250583433697;242;0,1,2;3;9;1;1;1
250583433697;250583433791;94;0,1,2;3;9;1;1;1
250583433791;250583434043;252;0,1,2;3;9;1;1;1
250583434043;250583434057;14;0,1,2;3;9;1;1;1
250583434057;250583434276;219;0,1,2;3;9;1;1;1
250583434276;250583434624;348;0,1,2;3;9;1;1;1
250583434624;250583434682;58;0,1,2;3;9;1;1;1
250583434682;250583436094;1412;0,1,2;3;9;1;1;1
250583436094;250583436236;142;0,1,2;3;9;1;1;1
250583436236;250583436467;231;0,1,2;3;9;1;1;1
250583436467;250583436568;101;0,1,2;3;9;1;1;1
250583436568;250583436618;50;0,1,2;3;9;1;1;1
250583436618;250583436688;70;0,1,2;3;9;1;1;1
250583436688;250583437717;1029;0,1,2;3;9;1;1;1
250583437717;250583437781;64;0,1,2;3;9;1;1;1
250583437781;250583438316;535;0,1,2;3;9;1;1;1
250583438316;250583438475;159;0,1,2;3;9;1;1;1
250583438475;250583438476;1;0,1,2;3;9;1;1;1
250583438476;250583438531;55;0,1,2;3;9;1;1;1
250583438531;250583438633;102;0,1,2;3;9;1;1;1
250583438633;250583438782;149;0,1,2;3;9;1;1;1
250583438782;250583439010;228;0,1,2;3;9;1;1;1
250583439010;250583439256;246;0,1,2;3;9;1;1;1
250583439256;250583439478;222;0,1,2;3;9;1;1;1
250583439478;250583440726;1248;0,1,2;3;9;1;1;1
250583440726;250583440749;23;0,1,2;3;9;1;1;1
250583440749;250583440864;115;0,1,2;3;9;1;1;1
250583440864;250583440990;126;0,1,2;3;9;1;1;1
250583440990;250583441521;531;0,1,2;3;9;1;1;1
250583441521;250583441653;132;0,1,2;3;9;1;1;1
250583441653;250583442091;438;0,1,2;3;9;1;1;1
250583442091;250583442183;92;0,1,2;3;9;1;1;1
250583442183;250583443565;1382;0,1,2;3;9;1;1;1
250583443565;250583444432;867;0,1,2;3;9;1;1;1
250583444432;250583444956;524;0,1,2;3;9;1;1;1
250583444956;250583445222;266;0,1,2;3;9;1;1;1
250583445222;250583445571;349;0,1,2;3;9;1;1;1
250583445571;250583445891;320;0,1,2;3;9;1;1;1
250583445891;250583446685;794;0,1,2;3;9;1;1;1
250583446685;250583447125;440;0,1,2;3;9;1;1;1
250583447125;250583447264;139;0,1,2;3;9;1;1;1
250583447264;250583448583;1319;0,1,2;3;9;1;1;1
250583448583;250583448590;7;0,1,2;3;9;1;1;1
250583448590;250583452395;3805;0,1,2;3;9;1;1;1
250583452395;250583452567;172;0,1,2;3;9;1;1;1
250583452567;250583453948;1381;0,1,2;3;9;1;1;1
250583453948;250583455310;1362;0,1,2;3;9;1;1;1
250583455310;250583456125;815;0,1,2;3;9;1;1;1
250583456125;250583456787;662;0,1,2;3;9;1;1;1
250583456787;250583457359;572;0,1,2;3;9;1;1;1
250583457359;250583458104;745;0,1,2;3;9;1;1;1
250583458104;250583458958;854;0,1,2;3;9;1;1;1
250583458958;250583460503;1545;0,1,2;3;9;1;1;1
250583460503;250583461112;609;0,1,2;3;9;1;1;1
250583461112;250583461161;49;0,1,2;3;9;1;1;1
250583461161;250583461570;409;0,1,2;3;9;1;1;1
250583461570;250583462529;959;0,1,2;3;9;1;1;1
250583462529;250583463988;1459;0,1,2;3;9;1;1;1
250583463988;250583464076;88;0,1,2;3;9;1;1;1
250583464076;250583464975;899;0,1,2;3;9;1;1;1
250583464975;250583465048;73;0,1,2;3;9;1;1;1
250583465048;250583465758;710;0,1,2;3;9;1;1;1
250583465758;250583465864;106;0,1,2;3;9;1;1;1
250583465864;250583466380;516;0,1,2;3;9;1;1;1
250583466380;250583466441;61;0,1,2;3;9;1;1;1
250583466441;250583466446;5;0,1,2;3;9;1;1;1
250583466446;250583466962;516;0,1,2;3;9;1;1;1
250583466962;250583468352;1390;0,1,2;3;9;1;1;1
250583468352;250583469109;757;0,1,2;3;9;1;1;1
250583469109;250583469649;540;0,1,2;3;9;1;1;1
250583469649;250583470792;1143;0,1,2;3;9;1;1;1
250583470792;250583471775;983;0,1,2;3;9;1;1;1
250583471775;250583471801;26;0,1,2;3;9;1;1;1
250583471801;250583473190;1389;0,1,2;3;9;1;1;1
250583473190;250583473253;63;0,1,2;3;9;1;1;1
250583473253;250583474068;815;0,1,2;3;9;1;1;1
250583474068;250583474411;343;0,1,2;3;9;1;1;1
250583474411;250583474998;587;0,1,2;3;9;1;1;1
250583474998;250583477864;2866;0,1,2;3;9;1;1;1
250583477864;250583477905;41;0,1,2;3;9;1;1;1
250583477905;250583477962;57;0,1,2;3;9;1;1;1
250583477962;250583479095;1133;0,1,2;3;9;1;1;1
250583479095;250583479647;552;0,1,2;3;9;1;1;1
250583479647;250583479696;49;0,1,2;3;9;1;1;1
250583479696;250583480641;945;0,1,2;3;9;1;1;1
250583480641;250583481118;477;0,1,2;3;9;1;1;1
250583481118;250583483135;2017;0,1,2;3;9;1;1;1
250583483135;250583483351;216;0,1,2;3;9;1;1;1
250583483351;250583484186;835;0,1,2;3;9;1;1;1
250583484186;250583485103;917;0,1,2;3;9;1;1;1
250583485103;250583487403;2300;0,1,2;3;9;1;1;1
250583487403;250583487799;396;0,1,2;3;9;1;1;1
250583487799;250583487854;55;0,1,2;3;9;1;1;1
250583487854;250583488042;188;0,1,2;3;9;1;1;1
250583488042;250583488120;78;0,1,2;3;9;1;1;1
250583488120;250583489362;1242;0,1,2;3;9;1;1;1
250583489362;250583489964;602;0,1,2;3;9;1;1;1
250583489964;250583490247;283;0,1,2;3;9;1;1;1
250583490247;250583491289;1042;0,1,2;3;9;1;1;1
250583491289;250583491548;259;0,1,2;3;9;1;1;1
250583491548;250583491682;134;0,1,2;3;9;1;1;1
250583491682;250583492286;604;0,1,2;3;9;1;1;1
250583492286;250583492432;146;0,1,2;3;9;1;1;1
250583492432;250583496475;4043;0,1,2;3;9;1;1;1
250583496475;250583497519;1044;0,1,2;3;9;1;1;1
250583497519;250583498119;600;0,1,2;3;9;1;1;1
250583498119;250583498299;180;0,1,2;3;9;1;1;1
250583498299;250583499871;1572;0,1,2;3;9;1;1;1
250583499871;250583501325;1454;0,1,2;3;9;1;1;1
250583501325;250583501761;436;0,1,2;3;9;1;1;1
250583501761;250583502709;948;0,1,2;3;9;1;1;1
250583502709;250583504028;1319;0,1,2;3;9;1;1;1
250583504028;250583504311;283;0,1,2;3;9;1;1;1
250583504311;250583504846;535;0,1,2;3;9;1;1;1
250583504846;250583505087;241;0,1,2;3;9;1;1;1
250583505087;250583505369;282;0,1,2;3;9;1;1;1
250583505369;250583506797;1428;0,1,2;3;9;1;1;1
250583506797;250583507094;297;0,1,2;3;9;1;1;1
250583507094;250583507270;176;0,1,2;3;9;1;1;1
250583507270;250583508987;1717;0,1,2;3;9;1;1;1
250583508987;250583509001;14;0,1,2;3;9;1;1;1
250583509001;250583510410;1409;0,1,2;3;9;1;1;1
250583510410;250583510596;186;0,1,2;3;9;1;1;1
250583510596;250583511205;609;0,1,2;3;9;1;1;1
250583511205;250583512042;837;0,1,2;3;9;1;1;1
250583512042;250583513599;1557;0,1,2;3;9;1;1;1
250583513599;250583514600;1001;0,1,2;3;9;1;1;1
250583514600;250583514768;168;0,1,2;3;9;1;1;1
250583514768;250583514840;72;0,1,2;3;9;1;1;1
250583514840;250583514884;44;0,1,2;3;9;1;1;1
250583514884;250583514959;75;0,1,2;3;9;1;1;1
250583514959;250583515805;846;0,1,2;3;9;1;1;1
250583515805;250583516053;248;0,1,2;3;9;1;1;1
250583516053;250583517144;1091;0,1,2;3;9;1;1;1
250583517144;250583518318;1174;0,1,2;3;9;1;1;1
250583518318;250583518462;144;0,1,2;3;9;1;1;1
250583518462;250583518543;81;0,1,2;3;9;1;1;1
250583518543;250583519033;490;0,1,2;3;9;1;1;1
250583519033;250583519131;98;0,1,2;3;9;1;1;1
250583519131;250583519336;205;0,1,2;3;9;1;1;1
250583519336;250583519482;146;0,1,2;3;9;1;1;1
250583519482;250583519649;167;0,1,2;3;9;1;1;1
250583519649;250583519912;263;0,1,2;3;9;1;1;1
250583519912;250583520155;243;0,1,2;3;9;1;1;1
250583520155;250583520666;511;0,1,2;3;9;1;1;1
250583520666;250583520750;84;0,1,2;3;9;1;1;1
250583520750;250583520814;64;0,1,2;3;9;1;1;1
250583520814;250583520944;130;0,1,2;3;9;1;1;1
250583520944;250583521038;94;0,1,2;3;9;1;1;1
250583521038;250583521125;87;0,1,2;3;9;1;1;1
250583521125;250583521538;413;0,1,2;3;9;1;1;1
250583521538;250583521795;257;0,1,2;3;9;1;1;1
250583521795;250583521810;15;0,1,2;3;9;1;1;1
250583521810;250583521861;51;0,1,2;3;9;1;1;1
250583521861;250583522339;478;0,1,2;3;9;1;1;1
250583522339;250583522395;56;0,1,2;3;9;1;1;1
250583522395;250583522595;200;0,1,2;3;9;1;1;1
250583522595;250583522721;126;0,1,2;3;9;1;1;1
250583522721;250583524244;1523;0,1,2;3;9;1;1;1
250583524244;250583524285;41;0,1,2;3;9;1;1;1
250583524285;250583524372;87;0,1,2;3;9;1;1;1
250583524372;250583524508;136;0,1,2;3;9;1;1;1
250583524508;250583524682;174;0,1,2;3;9;1;1;1
250583524682;250583524708;26;0,1,2;3;9;1;1;1
250583524708;250583524995;287;0,1,2;3;9;1;1;1
250583524995;250583525398;403;0,1,2;3;9;1;1;1
250583525398;250583525402;4;0,1,2;3;9;1;1;1
250583525402;250583525490;88;0,1,2;3;9;1;1;1
250583525490;250583525604;114;0,1,2;3;9;1;1;1
250583525604;250583525743;139;0,1,2;3;9;1;1;1
250583525743;250583525806;63;0,1,2;3;9;1;1;1
250583525806;250583526300;494;0,1,2;3;9;1;1;1
250583526300;250583526334;34;0,1,2;3;9;1;1;1
250583526334;250583526715;381;0,1,2;3;9;1;1;1
250583526715;250583526800;85;0,1,2;3;9;1;1;1
250583526800;250583526995;195;0,1,2;3;9;1;1;1
250583526995;250583527280;285;0,1,2;3;9;1;1;1
250583527280;250583527563;283;0,1,2;3;9;1;1;1
250583527563;250583527800;237;0,1,2;3;9;1;1;1
250583527800;250583527817;17;0,1,2;3;9;1;1;1
250583527817;250583528627;810;0,1,2;3;9;1;1;1
250583528627;250583528742;115;0,1,2;3;9;1;1;1
250583528742;250583529207;465;0,1,2;3;9;1;1;1
250583529207;250583529562;355;0,1,2;3;9;1;1;1
250583529562;250583529909;347;0,1,2;3;9;1;1;1
250583529909;250583529938;29;0,1,2;3;9;1;1;1
250583529938;250583530124;186;0,1,2;3;9;1;1;1
250583530124;250583530151;27;0,1,2;3;9;1;1;1
250583530151;250583530291;140;0,1,2;3;9;1;1;1
250583530291;250583530560;269;0,1,2;3;9;1;1;1
250583530560;250583530779;219;0,1,2;3;9;1;1;1
250583530779;250583530881;102;0,1,2;3;9;1;1;1
250583530881;250583530962;81;0,1,2;3;9;1;1;1
250583530962;250583531038;76;0,1,2;3;9;1;1;1
250583531038;250583531095;57;0,1,2;3;9;1;1;1
250583531095;250583531147;52;0,1,2;3;9;1;1;1
250583531147;250583531513;366;0,1,2;3;9;1;1;1
250583531513;250583531535;22;0,1,2;3;9;1;1;1
250583531535;250583531807;272;0,1,2;3;9;1;1;1
250583531807;250583531905;98;0,1,2;3;9;1;1;1
250583531905;250583533188;1283;0,1,2;3;9;1;1;1
250583533188;250583533438;250;0,1,2;3;9;1;1;1
250583533438;250583533612;174;0,1,2;3;9;1;1;1
250583533612;250583534443;831;0,1,2;3;9;1;1;1
250583534443;250583534489;46;0,1,2;3;9;1;1;1
250583534489;250583535108;619;0,1,2;3;9;1;1;1
250583535108;250583535374;266;0,1,2;3;9;1;1;1
250583535374;250583535377;3;0,1,2;3;9;1;1;1
250583535377;250583535413;36;0,1,2;3;9;1;1;1
250583535413;250583535454;41;0,1,2;3;9;1;1;1
250583535454;250583535606;152;0,1,2;3;9;1;1;1
250583535606;250583535609;3;0,1,2;3;9;1;1;1
250583535609;250583537114;1505;0,1,2;3;9;1;1;1
250583537114;250583537165;51;0,1,2;3;9;1;1;1
250583537165;250583537382;217;0,1,2;3;9;1;1;1
250583537382;250583537594;212;0,1,2;3;9;1;1;1
250583537594;250583537960;366;0,1,2;3;9;1;1;1
250583537960;250583538989;1029;0,1,2;3;9;1;1;1
250583538989;250583539299;310;0,1,2;3;9;1;1;1
250583539299;250583539471;172;0,1,2;3;9;1;1;1
250583539471;250583539622;151;0,1,2;3;9;1;1;1
250583539622;250583539934;312;0,1,2;3;9;1;1;1
250583539934;250583540709;775;0,1,2;3;9;1;1;1
250583540709;250583541449;740;0,1,2;3;9;1;1;1
250583541449;250583541501;52;0,1,2;3;9;1;1;1
250583541501;250583541855;354;0,1,2;3;9;1;1;1
250583541855;250583541906;51;0,1,2;3;9;1;1;1
250583541906;250583541935;29;0,1,2;3;9;1;1;1
250583541935;250583542149;214;0,1,2;3;9;1;1;1
250583542149;250583542292;143;0,1,2;3;9;1;1;1
250583542292;250583542384;92;0,1,2;3;9;1;1;1
250583542384;250583542581;197;0,1,2;3;9;1;1;1
250583542581;250583543101;520;0,1,2;3;9;1;1;1
250583543101;250583543188;87;0,1,2;3;9;1;1;1
250583543188;250583543257;69;0,1,2;3;9;1;1;1
250583543257;250583543481;224;0,1,2;3;9;1;1;1
250583543481;250583544216;735;0,1,2;3;9;1;1;1
250583544216;250583544760;544;0,1,2;3;9;1;1;1
250583544760;250583544863;103;0,1,2;3;9;1;1;1
250583544863;250583545876;1013;0,1,2;3;9;1;1;1
250583545876;250583545957;81;0,1,2;3;9;1;1;1
250583545957;250583548309;2352;0,1,2;3;9;1;1;1
250583548309;250583549387;1078;0,1,2;3;9;1;1;1
250583549387;250583551567;2180;0,1,2;3;9;1;1;1
250583551567;250583552092;525;0,1,2;3;9;1;1;1
250583552092;250583553053;961;0,1,2;3;9;1;1;1
250583553053;250583553688;635;0,1,2;3;9;1;1;1
250583553688;250583554160;472;0,1,2;3;9;1;1;1
250583554160;250583554529;369;0,1,2;3;9;1;1;1
250583554529;250583555017;488;0,1,2;3;9;1;1;1
250583555017;250583555661;644;0,1,2;3;9;1;1;1
250583555661;250583556866;1205;0,1,2;3;9;1;1;1
250583556866;250583557593;727;0,1,2;3;9;1;1;1
250583557593;250583557777;184;0,1,2;3;9;1;1;1
250583557777;250583561798;4021;0,1,2;3;9;1;1;1
250583561798;250583562901;1103;0,1,2;3;9;1;1;1
250583562901;250583563641;740;0,1,2;3;9;1;1;1
250583563641;250583565097;1456;0,1,2;3;9;1;1;1
250583565097;250583565138;41;0,1,2;3;9;1;1;1
250583565138;250583565352;214;0,1,2;3;9;1;1;1
250583565352;250583565433;81;0,1,2;3;9;1;1;1
250583565433;250583566877;1444;0,1,2;3;9;1;1;1
250583566877;250583567384;507;0,1,2;3;9;1;1;1
250583567384;250583567713;329;0,1,2;3;9;1;1;1
250583567713;250583568051;338;0,1,2;3;9;1;1;1
250583568051;250583568084;33;0,1,2;3;9;1;1;1
250583568084;250583568275;191;0,1,2;3;9;1;1;1
250583568275;250583568407;132;0,1,2;3;9;1;1;1
250583568407;250583568958;551;0,1,2;3;9;1;1;1
250583568958;250583569913;955;0,1,2;3;9;1;1;1
250583569913;250583571665;1752;0,1,2;3;9;1;1;1
250583571665;250583571956;291;0,1,2;3;9;1;1;1
250583571956;250583571993;37;0,1,2;3;9;1;1;1
250583571993;250583572116;123;0,1,2;3;9;1;1;1
250583572116;250583572312;196;0,1,2;3;9;1;1;1
250583572312;250583572500;188;0,1,2;3;9;1;1;1
250583572500;250583572569;69;0,1,2;3;9;1;1;1
250583572569;250583572936;367;0,1,2;3;9;1;1;1
250583572936;250583573379;443;0,1,2;3;9;1;1;1
250583573379;250583573635;256;0,1,2;3;9;1;1;1
250583573635;250583574245;610;0,1,2;3;9;1;1;1
250583574245;250583575056;811;0,1,2;3;9;1;1;1
250583575056;250583575224;168;0,1,2;3;9;1;1;1
250583575224;250583575334;110;0,1,2;3;9;1;1;1
250583575334;250583575593;259;0,1,2;3;9;1;1;1
250583575593;250583576109;516;0,1,2;3;9;1;1;1
250583576109;250583576337;228;0,1,2;3;9;1;1;1
250583576337;250583576595;258;0,1,2;3;9;1;1;1
250583576595;250583576878;283;0,1,2;3;9;1;1;1
250583576878;250583576970;92;0,1,2;3;9;1;1;1
250583576970;250583577198;228;0,1,2;3;9;1;1;1
250583577198;250583577323;125;0,1,2;3;9;1;1;1
250583577323;250583577580;257;0,1,2;3;9;1;1;1
250583577580;250583577685;105;0,1,2;3;9;1;1;1
250583577685;250583577874;189;0,1,2;3;9;1;1;1
250583577874;250583578348;474;0,1,2;3;9;1;1;1
250583578348;250583578491;143;0,1,2;3;9;1;1;1
250583578491;250583578841;350;0,1,2;3;9;1;1;1
250583578841;250583579368;527;0,1,2;3;9;1;1;1
250583579368;250583579613;245;0,1,2;3;9;1;1;1
250583579613;250583580059;446;0,1,2;3;9;1;1;1
250583580059;250583580174;115;0,1,2;3;9;1;1;1
250583580174;250583582001;1827;0,1,2;3;9;1;1;1
250583582001;250583582304;303;0,1,2;3;9;1;1;1
250583582304;250583582369;65;0,1,2;3;9;1;1;1
250583582369;250583584830;2461;0,1,2;3;9;1;1;1
250583584830;250583584924;94;0,1,2;3;9;1;1;1
250583584924;250583585224;300;0,1,2;3;9;1;1;1
250583585224;250583585760;536;0,1,2;3;9;1;1;1
250583585760;250583585997;237;0,1,2;3;9;1;1;1
250583585997;250583586001;4;0,1,2;3;9;1;1;1
250583586001;250583591537;5536;0,1,2;3;9;1;1;1
250583591537;250583593230;1693;0,1,2;3;9;1;1;1
250583593230;250583593743;513;0,1,2;3;9;1;1;1
250583593743;250583594352;609;0,1,2;3;9;1;1;1
250583594352;250583598157;3805;0,1,2;3;9;1;1;1
250583598157;250583603572;5415;0,1,2;3;9;1;1;1
250583603572;250583606901;3329;0,1,2;3;9;1;1;1
250583606901;250583610421;3520;0,1,2;3;9;1;1;1
250583610421;250583610461;40;0,1,2;3;9;1;1;1
250583610461;250583612738;2277;0,1,2;3;9;1;1;1
250583612738;250583614095;1357;0,1,2;3;9;1;1;1
250583614095;250583614662;567;0,1,2;3;9;1;1;1
250583614662;250583614952;290;0,1,2;3;9;1;1;1
250583614952;250583616124;1172;0,1,2;3;9;1;1;1
250583616124;250583617773;1649;0,1,2;3;9;1;1;1
250583617773;250583619331;1558;0,1,2;3;9;1;1;1
250583619331;250583619670;339;0,1,2;3;9;1;1;1
250583619670;250583625197;5527;0,1,2;3;9;1;1;1
250583625197;250583625734;537;0,1,2;3;9;1;1;1
250583625734;250583628112;2378;0,1,2;3;9;1;1;1
250583628112;250583630148;2036;0,1,2;3;9;1;1;1
250583630148;250583630240;92;0,1,2;3;9;1;1;1
250583630240;250583630643;403;0,1,2;3;9;1;1;1
250583630643;250583630745;102;0,1,2;3;9;1;1;1
250583630745;250583635068;4323;0,1,2;3;9;1;1;1
250583635068;250583635772;704;0,1,2;3;9;1;1;1
250583635772;250583639316;3544;0,1,2;3;9;1;1;1
250583639316;250583642234;2918;0,1,2;3;9;1;1;1
250583642234;250583642855;621;0,1,2;3;9;1;1;1
250583642855;250583643050;195;0,1,2;3;9;1;1;1
250583643050;250583645698;2648;0,1,2;3;9;1;1;1
250583645698;250583647561;1863;0,1,2;3;9;1;1;1
250583647561;250583649855;2294;0,1,2;3;9;1;1;1
250583649855;250583649957;102;0,1,2;3;9;1;1;1
250583649957;250583651447;1490;0,1,2;3;9;1;1;1
250583651447;250583651983;536;0,1,2;3;9;1;1;1
250583651983;250583657473;5490;0,1,2;3;9;1;1;1
250583657473;250583659385;1912;0,1,2;3;9;1;1;1
250583659385;250583659839;454;0,1,2;3;9;1;1;1
250583659839;250583660028;189;0,1,2;3;9;1;1;1
250583660028;250583661102;1074;0,1,2;3;9;1;1;1
250583661102;250583661197;95;0,1,2;3;9;1;1;1
250583661197;250583661271;74;0,1,2;3;9;1;1;1
250583661271;250583662602;1331;0,1,2;3;9;1;1;1
250583662602;250583662633;31;0,1,2;3;9;1;1;1
250583662633;250583662643;10;0,1,2;3;9;1;1;1
250583662643;250583662714;71;0,1,2;3;9;1;1;1
250583662714;250583662773;59;0,1,2;3;9;1;1;1
250583662773;250583663279;506;0,1,2;3;9;1;1;1
250583663279;250583663300;21;0,1,2;3;9;1;1;1
250583663300;250583663536;236;0,1,2;3;9;1;1;1
250583663536;250583666352;2816;0,1,2;3;9;1;1;1
250583666352;250583666483;131;0,1,2;3;9;1;1;1
250583666483;250583666610;127;0,1,2;3;9;1;1;1
250583666610;250583666771;161;0,1,2;3;9;1;1;1
250583666771;250583667497;726;0,1,2;3;9;1;1;1
250583667497;250583668014;517;0,1,2;3;9;1;1;1
250583668014;250583668466;452;0,1,2;3;9;1;1;1
250583668466;250583668709;243;0,1,2;3;9;1;1;1
250583668709;250583668760;51;0,1,2;3;9;1;1;1
250583668760;250583669341;581;0,1,2;3;9;1;1;1
250583669341;250583669913;572;0,1,2;3;9;1;1;1
250583669913;250583670241;328;0,1,2;3;9;1;1;1
250583670241;250583670466;225;0,1,2;3;9;1;1;1
250583670466;250583671923;1457;0,1,2;3;9;1;1;1
250583671923;250583672395;472;0,1,2;3;9;1;1;1
250583672395;250583672695;300;0,1,2;3;9;1;1;1
250583672695;250583672824;129;0,1,2;3;9;1;1;1
250583672824;250583672939;115;0,1,2;3;9;1;1;1
250583672939;250583674690;1751;0,1,2;3;9;1;1;1
250583674690;250583676424;1734;0,1,2;3;9;1;1;1
250583676424;250583676594;170;0,1,2;3;9;1;1;1
250583676594;250583676678;84;0,1,2;3;9;1;1;1
250583676678;250583678040;1362;0,1,2;3;9;1;1;1
250583678040;250583678267;227;0,1,2;3;9;1;1;1
250583678267;250583680104;1837;0,1,2;3;9;1;1;1
250583680104;250583680160;56;0,1,2;3;9;1;1;1
250583680160;250583680312;152;0,1,2;3;9;1;1;1
250583680312;250583680779;467;0,1,2;3;9;1;1;1
250583680779;250583680980;201;0,1,2;3;9;1;1;1
250583680980;250583681086;106;0,1,2;3;9;1;1;1
250583681086;250583681405;319;0,1,2;3;9;1;1;1
250583681405;250583682152;747;0,1,2;3;9;1;1;1
250583682152;250583683656;1504;0,1,2;3;9;1;1;1
250583683656;250583683873;217;0,1,2;3;9;1;1;1
250583683873;250583684252;379;0,1,2;3;9;1;1;1
250583684252;250583684338;86;0,1,2;3;9;1;1;1
250583684338;250583684360;22;0,1,2;3;9;1;1;1
250583684360;250583685661;1301;0,1,2;3;9;1;1;1
250583685661;250583686197;536;0,1,2;3;9;1;1;1
250583686197;250583689191;2994;0,1,2;3;9;1;1;1
250583689191;250583690186;995;0,1,2;3;9;1;1;1
250583690186;250583690279;93;0,1,2;3;9;1;1;1
250583690279;250583691664;1385;0,1,2;3;9;1;1;1
250583691664;250583692413;749;0,1,2;3;9;1;1;1
250583692413;250583692871;458;0,1,2;3;9;1;1;1
250583692871;250583693243;372;0,1,2;3;9;1;1;1
250583693243;250583693614;371;0,1,2;3;9;1;1;1
250583693614;250583693755;141;0,1,2;3;9;1;1;1
250583693755;250583694104;349;0,1,2;3;9;1;1;1
250583694104;250583694574;470;0,1,2;3;9;1;1;1
250583694574;250583694714;140;0,1,2;3;9;1;1;1
250583694714;250583697314;2600;0,1,2;3;9;1;1;1
250583697314;250583698224;910;0,1,2;3;9;1;1;1
250583698224;250583699543;1319;0,1,2;3;9;1;1;1
250583699543;250583699976;433;0,1,2;3;9;1;1;1
250583699976;250583701534;1558;0,1,2;3;9;1;1;1
250583701534;250583701596;62;0,1,2;3;9;1;1;1
250583701596;250583701618;22;0,1,2;3;9;1;1;1
250583701618;250583702491;873;0,1,2;3;9;1;1;1
250583702491;250583703013;522;0,1,2;3;9;1;1;1
250583703013;250583703071;58;0,1,2;3;9;1;1;1
250583703071;250583703519;448;0,1,2;3;9;1;1;1
250583703519;250583703685;166;0,1,2;3;9;1;1;1
250583703685;250583705205;1520;0,1,2;3;9;1;1;1
250583705205;250583705309;104;0,1,2;3;9;1;1;1
250583705309;250583705795;486;0,1,2;3;9;1;1;1
250583705795;250583705821;26;0,1,2;3;9;1;1;1
250583705821;250583706761;940;0,1,2;3;9;1;1;1
250583706761;250583707977;1216;0,1,2;3;9;1;1;1
250583707977;250583708673;696;0,1,2;3;9;1;1;1
250583708673;250583709731;1058;0,1,2;3;9;1;1;1
250583709731;250583710431;700;0,1,2;3;9;1;1;1
250583710431;250583710819;388;0,1,2;3;9;1;1;1
250583710819;250583711550;731;0,1,2;3;9;1;1;1
250583711550;250583716187;4637;0,1,2;3;9;1;1;1
250583716187;250583716231;44;0,1,2;3;9;1;1;1
250583716231;250583716385;154;0,1,2;3;9;1;1;1
250583716385;250583716453;68;0,1,2;3;9;1;1;1
250583716453;250583716672;219;0,1,2;3;9;1;1;1
250583716672;250583716727;55;0,1,2;3;9;1;1;1
250583716727;250583716950;223;0,1,2;3;9;1;1;1
250583716950;250583716997;47;0,1,2;3;9;1;1;1
250583716997;250583719305;2308;0,1,2;3;9;1;1;1
250583719305;250583720236;931;0,1,2;3;9;1;1;1
250583720236;250583722461;2225;0,1,2;3;9;1;1;1
250583722461;250583722551;90;0,1,2;3;9;1;1;1
250583722551;250583723096;545;0,1,2;3;9;1;1;1
250583723096;250583725840;2744;0,1,2;3;9;1;1;1
250583725840;250583726169;329;0,1,2;3;9;1;1;1
250583726169;250583726278;109;0,1,2;3;9;1;1;1
250583726278;250583726301;23;0,1,2;3;9;1;1;1
250583726301;250583726879;578;0,1,2;3;9;1;1;1
250583726879;250583728114;1235;0,1,2;3;9;1;1;1
250583728114;250583728253;139;0,1,2;3;9;1;1;1
250583728253;250583728265;12;0,1,2;3;9;1;1;1
250583728265;250583728615;350;0,1,2;3;9;1;1;1
250583728615;250583729000;385;0,1,2;3;9;1;1;1
250583729000;250583729204;204;0,1,2;3;9;1;1;1
250583729204;250583729321;117;0,1,2;3;9;1;1;1
250583729321;250583731068;1747;0,1,2;3;9;1;1;1
250583731068;250583731556;488;0,1,2;3;9;1;1;1
250583731556;250583731801;245;0,1,2;3;9;1;1;1
250583731801;250583731840;39;0,1,2;3;9;1;1;1
250583731840;250583731946;106;0,1,2;3;9;1;1;1
250583731946;250583732212;266;0,1,2;3;9;1;1;1
250583732212;250583732307;95;0,1,2;3;9;1;1;1
250583732307;250583732529;222;0,1,2;3;9;1;1;1
250583732529;250583732779;250;0,1,2;3;9;1;1;1
250583732779;250583734117;1338;0,1,2;3;9;1;1;1
250583734117;250583734162;45;0,1,2;3;9;1;1;1
250583734162;250583734721;559;0,1,2;3;9;1;1;1
250583734721;250583734820;99;0,1,2;3;9;1;1;1
250583734820;250583735349;529;0,1,2;3;9;1;1;1
250583735349;250583735998;649;0,1,2;3;9;1;1;1
250583735998;250583736083;85;0,1,2;3;9;1;1;1
250583736083;250583737054;971;0,1,2;3;9;1;1;1
250583737054;250583738342;1288;0,1,2;3;9;1;1;1
250583738342;250583739181;839;0,1,2;3;9;1;1;1
250583739181;250583740080;899;0,1,2;3;9;1;1;1
250583740080;250583740148;68;0,1,2;3;9;1;1;1
250583740148;250583740155;7;0,1,2;3;9;1;1;1
250583740155;250583740813;658;0,1,2;3;9;1;1;1
250583740813;250583741034;221;0,1,2;3;9;1;1;1
250583741034;250583741279;245;0,1,2;3;9;1;1;1
250583741279;250583742178;899;0,1,2;3;9;1;1;1
250583742178;250583742631;453;0,1,2;3;9;1;1;1
250583742631;250583742663;32;0,1,2;3;9;1;1;1
250583742663;250583743430;767;0,1,2;3;9;1;1;1
250583743430;250583743801;371;0,1,2;3;9;1;1;1
250583743801;250583746410;2609;0,1,2;3;9;1;1;1
250583746410;250583748124;1714;0,1,2;3;9;1;1;1
250583748124;250583748996;872;0,1,2;3;9;1;1;1
250583748996;250583750081;1085;0,1,2;3;9;1;1;1
250583750081;250583750597;516;0,1,2;3;9;1;1;1
250583750597;250583751037;440;0,1,2;3;9;1;1;1
250583751037;250583751059;22;0,1,2;3;9;1;1;1
250583751059;250583751153;94;0,1,2;3;9;1;1;1
250583751153;250583754485;3332;0,1,2;3;9;1;1;1
250583754485;250583754664;179;0,1,2;3;9;1;1;1
250583754664;250583755472;808;0,1,2;3;9;1;1;1
250583755472;250583756870;1398;0,1,2;3;9;1;1;1
250583756870;250583756948;78;0,1,2;3;9;1;1;1
250583756948;250583758522;1574;0,1,2;3;9;1;1;1
250583758522;250583758655;133;0,1,2;3;9;1;1;1
250583758655;250583759852;1197;0,1,2;3;9;1;1;1
250583759852;250583761314;1462;0,1,2;3;9;1;1;1
250583761314;250583762381;1067;0,1,2;3;9;1;1;1
250583762381;250583762446;65;0,1,2;3;9;1;1;1
250583762446;250583762543;97;0,1,2;3;9;1;1;1
250583762543;250583762945;402;0,1,2;3;9;1;1;1
250583762945;250583763974;1029;0,1,2;3;9;1;1;1
250583763974;250583771880;7906;0,1,2;3;9;1;1;1
250583771880;250583772502;622;0,1,2;3;9;1;1;1
250583772502;250583774018;1516;0,1,2;3;9;1;1;1
250583774018;250583774613;595;0,1,2;3;9;1;1;1
250583774613;250583776775;2162;0,1,2;3;9;1;1;1
250583776775;250583776981;206;0,1,2;3;9;1;1;1
250583776981;250583777986;1005;0,1,2;3;9;1;1;1
250583777986;250583780698;2712;0,1,2;3;9;1;1;1
250583780698;250583781186;488;0,1,2;3;9;1;1;1
250583781186;250583784300;3114;0,1,2;3;9;1;1;1
250583784300;250583784565;265;0,1,2;3;9;1;1;1
250583784565;250583786104;1539;0,1,2;3;9;1;1;1
250583786104;250583788816;2712;0,1,2;3;9;1;1;1
250583788816;250583789292;476;0,1,2;3;9;1;1;1
250583789292;250583789625;333;0,1,2;3;9;1;1;1
250583789625;250583789657;32;0,1,2;3;9;1;1;1
250583789657;250583789747;90;0,1,2;3;9;1;1;1
250583789747;250583789872;125;0,1,2;3;9;1;1;1
250583789872;250583790479;607;0,1,2;3;9;1;1;1
250583790479;250583791069;590;0,1,2;3;9;1;1;1
250583791069;250583791095;26;0,1,2;3;9;1;1;1
250583791095;250583791196;101;0,1,2;3;9;1;1;1
250583791196;250583792232;1036;0,1,2;3;9;1;1;1
250583792232;250583792432;200;0,1,2;3;9;1;1;1
250583792432;250583792578;146;0,1,2;3;9;1;1;1
250583792578;250583793128;550;0,1,2;3;9;1;1;1
250583793128;250583793755;627;0,1,2;3;9;1;1;1
250583793755;250583793817;62;0,1,2;3;9;1;1;1
250583793817;250583794566;749;0,1,2;3;9;1;1;1
250583794566;250583796610;2044;0,1,2;3;9;1;1;1
250583796610;250583798111;1501;0,1,2;3;9;1;1;1
250583798111;250583798230;119;0,1,2;3;9;1;1;1
250583798230;250583798378;148;0,1,2;3;9;1;1;1
250583798378;250583799692;1314;0,1,2;3;9;1;1;1
250583799692;250583800022;330;0,1,2;3;9;1;1;1
250583800022;250583800093;71;0,1,2;3;9;1;1;1
250583800093;250583800186;93;0,1,2;3;9;1;1;1
250583800186;250583801289;1103;0,1,2;3;9;1;1;1
250583801289;250583801572;283;0,1,2;3;9;1;1;1
250583801572;250583801841;269;0,1,2;3;9;1;1;1
250583801841;250583803134;1293;0,1,2;3;9;1;1;1
250583803134;250583805256;2122;0,1,2;3;9;1;1;1
250583805256;250583805405;149;0,1,2;3;9;1;1;1
250583805405;250583805448;43;0,1,2;3;9;1;1;1
250583805448;250583807013;1565;0,1,2;3;9;1;1;1
250583807013;250583808663;1650;0,1,2;3;9;1;1;1
250583808663;250583809562;899;0,1,2;3;9;1;1;1
250583809562;250583809981;419;0,1,2;3;9;1;1;1
250583809981;250583810431;450;0,1,2;3;9;1;1;1
250583810431;250583811472;1041;0,1,2;3;9;1;1;1
250583811472;250583812171;699;0,1,2;3;9;1;1;1
250583812171;250583813090;919;0,1,2;3;9;1;1;1
250583813090;250583813813;723;0,1,2;3;9;1;1;1
250583813813;250583814505;692;0,1,2;3;9;1;1;1
250583814505;250583814528;23;0,1,2;3;9;1;1;1
250583814528;250583819391;4863;0,1,2;3;9;1;1;1
250583819391;250583823551;4160;0,1,2;3;9;1;1;1
250583823551;250583823590;39;0,1,2;3;9;1;1;1
250583823590;250583824006;416;0,1,2;3;9;1;1;1
250583824006;250583824039;33;0,1,2;3;9;1;1;1
250583824039;250583824094;55;0,1,2;3;9;1;1;1
250583824094;250583829306;5212;0,1,2;3;9;1;1;1
250583829306;250583829793;487;0,1,2;3;9;1;1;1
250583829793;250583835727;5934;0,1,2;3;9;1;1;1
250583835727;250583845589;9862;0,1,2;3;9;1;1;1
250583845589;250583847865;2276;0,1,2;3;9;1;1;1
250583847865;250583848174;309;0,1,2;3;9;1;1;1
250583848174;250583848866;692;0,1,2;3;9;1;1;1
250583848866;250583849396;530;0,1,2;3;9;1;1;1
250583849396;250583849766;370;0,1,2;3;9;1;1;1
250583849766;250583850133;367;0,1,2;3;9;1;1;1
250583850133;250583850378;245;0,1,2;3;9;1;1;1
250583850378;250583852741;2363;0,1,2;3;9;1;1;1
250583852741;250583852789;48;0,1,2;3;9;1;1;1
250583852789;250583859971;7182;0,1,2;3;9;1;1;1
250583859971;250583862455;2484;0,1,2;3;9;1;1;1
250583862455;250583862921;466;0,1,2;3;9;1;1;1
250583862921;250583863424;503;0,1,2;3;9;1;1;1
250583863424;250583864477;1053;0,1,2;3;9;1;1;1
250583864477;250583868228;3751;0,1,2;3;9;1;1;1
250583868228;250583868475;247;0,1,2;3;9;1;1;1
250583868475;250583868719;244;0,1,2;3;9;1;1;1
250583868719;250583870739;2020;0,1,2;3;9;1;1;1
250583870739;250583870821;82;0,1,2;3;9;1;1;1
250583870821;250583872536;1715;0,1,2;3;9;1;1;1
250583872536;250583872625;89;0,1,2;3;9;1;1;1
250583872625;250583872815;190;0,1,2;3;9;1;1;1
250583872815;250583879364;6549;0,1,2;3;9;1;1;1
250583879364;250583880210;846;0,1,2;3;9;1;1;1
250583880210;250583880650;440;0,1,2;3;9;1;1;1
250583880650;250583882456;1806;0,1,2;3;9;1;1;1
250583882456;250583882519;63;0,1,2;3;9;1;1;1
250583882519;250583886769;4250;0,1,2;3;9;1;1;1
250583886769;250583888114;1345;0,1,2;3;9;1;1;1
250583888114;250583889042;928;0,1,2;3;9;1;1;1
250583889042;250583891191;2149;0,1,2;3;9;1;1;1
250583891191;250583891225;34;0,1,2;3;9;1;1;1
250583891225;250583893326;2101;0,1,2;3;9;1;1;1
250583893326;250583893388;62;0,1,2;3;9;1;1;1
250583893388;250583895154;1766;0,1,2;3;9;1;1;1
250583895154;250583896669;1515;0,1,2;3;9;1;1;1
250583896669;250583896796;127;0,1,2;3;9;1;1;1
250583896796;250583898024;1228;0,1,2;3;9;1;1;1
250583898024;250583898074;50;0,1,2;3;9;1;1;1
250583898074;250583898146;72;0,1,2;3;9;1;1;1
250583898146;250583898586;440;0,1,2;3;9;1;1;1
250583898586;250583900077;1491;0,1,2;3;9;1;1;1
250583900077;250583900880;803;0,1,2;3;9;1;1;1
250583900880;250583903340;2460;0,1,2;3;9;1;1;1
250583903340;250583903620;280;0,1,2;3;9;1;1;1
250583903620;250583904176;556;0,1,2;3;9;1;1;1
250583904176;250583904980;804;0,1,2;3;9;1;1;1
250583904980;250583905040;60;0,1,2;3;9;1;1;1
250583905040;250583905098;58;0,1,2;3;9;1;1;1
250583905098;250583905359;261;0,1,2;3;9;1;1;1
250583905359;250583907501;2142;0,1,2;3;9;1;1;1
250583907501;250583908124;623;0,1,2;3;9;1;1;1
250583908124;250583909156;1032;0,1,2;3;9;1;1;1
250583909156;250583911117;1961;0,1,2;3;9;1;1;1
250583911117;250583911195;78;0,1,2;3;9;1;1;1
250583911195;250583911915;720;0,1,2;3;9;1;1;1
250583911915;250583913276;1361;0,1,2;3;9;1;1;1
250583913276;250583916102;2826;0,1,2;3;9;1;1;1
250583916102;250583916195;93;0,1,2;3;9;1;1;1
250583916195;250583916246;51;0,1,2;3;9;1;1;1
250583916246;250583916837;591;0,1,2;3;9;1;1;1
250583916837;250583917801;964;0,1,2;3;9;1;1;1
250583917801;250583919222;1421;0,1,2;3;9;1;1;1
250583919222;250583919795;573;0,1,2;3;9;1;1;1
250583919795;250583920101;306;0,1,2;3;9;1;1;1
250583920101;250583920611;510;0,1,2;3;9;1;1;1
250583920611;250583921932;1321;0,1,2;3;9;1;1;1
250583921932;250583921964;32;0,1,2;3;9;1;1;1
250583921964;250583921985;21;0,1,2;3;9;1;1;1
250583921985;250583922285;300;0,1,2;3;9;1;1;1
250583922285;250583922444;159;0,1,2;3;9;1;1;1
250583922444;250583923011;567;0,1,2;3;9;1;1;1
250583923011;250583924818;1807;0,1,2;3;9;1;1;1
250583924818;250583924984;166;0,1,2;3;9;1;1;1
250583924984;250583925124;140;0,1,2;3;9;1;1;1
250583925124;250583929040;3916;0,1,2;3;9;1;1;1
250583929040;250583934887;5847;0,1,2;3;9;1;1;1
250583934887;250583941213;6326;0,1,2;3;9;1;1;1
250583941213;250583941254;41;0,1,2;3;9;1;1;1
250583941254;250583945082;3828;0,1,2;3;9;1;1;1
250583945082;250583945150;68;0,1,2;3;9;1;1;1
250583945150;250583955286;10136;0,1,2;3;9;1;1;1
250583955286;250583983051;27765;0,1,2;3;9;1;1;1
250583983051;250584015672;32621;0,1,2;3;9;1;1;1
250584015672;250584021330;5658;0,1,2;3;9;1;1;1
250584021330;250584030884;9554;0,1,2;3;9;1;1;1
250584030884;250584035953;5069;0,1,2;3;9;1;1;1
250584035953;250584048632;12679;0,1,2;3;9;1;1;1
250584048632;250584050222;1590;0,1,2;3;9;1;1;1
250584050222;250584059136;8914;0,1,2;3;9;1;1;1
250584059136;250584060808;1672;0,1,2;3;9;1;1;1
250584060808;250584060960;152;0,1,2;3;9;1;1;1
250584060960;250584061011;51;0,1,2;3;9;1;1;1
250584061011;250584062465;1454;0,1,2;3;9;1;1;1
250584062465;250584064851;2386;0,1,2;3;9;1;1;1
250584064851;250584067429;2578;0,1,2;3;9;1;1;1
250584067429;250584068798;1369;0,1,2;3;9;1;1;1
250584068798;250584070833;2035;0,1,2;3;9;1;1;1
250584070833;250584075563;4730;0,1,2;3;9;1;1;1
250584075563;250584075695;132;0,1,2;3;9;1;1;1
250584075695;250584077479;1784;0,1,2;3;9;1;1;1
250584077479;250584078017;538;0,1,2;3;9;1;1;1
250584078017;250584078170;153;0,1,2;3;9;1;1;1
250584078170;250584078519;349;0,1,2;3;9;1;1;1
250584078519;250584078910;391;0,1,2;3;9;1;1;1
250584078910;250584079003;93;0,1,2;3;9;1;1;1
250584079003;250584079084;81;0,1,2;3;9;1;1;1
250584079084;250584089143;10059;0,1,2;3;9;1;1;1
250584089143;250584090777;1634;0,1,2;3;9;1;1;1
250584090777;250584099842;9065;0,1,2;3;9;1;1;1
250584099842;250584101830;1988;0,1,2;3;9;1;1;1
250584101830;250584102186;356;0,1,2;3;9;1;1;1
250584102186;250584105681;3495;0,1,2;3;9;1;1;1
250584105681;250584106384;703;0,1,2;3;9;1;1;1
250584106384;250584108138;1754;0,1,2;3;9;1;1;1
250584108138;250584108716;578;0,1,2;3;9;1;1;1
250584108716;250584108922;206;0,1,2;3;9;1;1;1
250584108922;250584111485;2563;0,1,2;3;9;1;1;1
250584111485;250584112872;1387;0,1,2;3;9;1;1;1
250584112872;250584113271;399;0,1,2;3;9;1;1;1
250584113271;250584113492;221;0,1,2;3;9;1;1;1
250584113492;250584117242;3750;0,1,2;3;9;1;1;1
250584117242;250584125735;8493;0,1,2;3;9;1;1;1
250584125735;250584125868;133;0,1,2;3;9;1;1;1
250584125868;250584127443;1575;0,1,2;3;9;1;1;1
250584127443;250584127494;51;0,1,2;3;9;1;1;1
250584127494;250584127626;132;0,1,2;3;9;1;1;1
250584127626;250584128740;1114;0,1,2;3;9;1;1;1
250584128740;250584129088;348;0,1,2;3;9;1;1;1
250584129088;250584130540;1452;0,1,2;3;9;1;1;1
250584130540;250584131946;1406;0,1,2;3;9;1;1;1
250584131946;250584134561;2615;0,1,2;3;9;1;1;1
250584134561;250584135063;502;0,1,2;3;9;1;1;1
250584135063;250584140528;5465;0,1,2;3;9;1;1;1
250584140528;250584141960;1432;0,1,2;3;9;1;1;1
250584141960;250584142655;695;0,1,2;3;9;1;1;1
250584142655;250584143019;364;0,1,2;3;9;1;1;1
250584143019;250584143132;113;0,1,2;3;9;1;1;1
250584143132;250584143812;680;0,1,2;3;9;1;1;1
250584143812;250584144848;1036;0,1,2;3;9;1;1;1
250584144848;250584147559;2711;0,1,2;3;9;1;1;1
250584147559;250584147798;239;0,1,2;3;9;1;1;1
250584147798;250584147850;52;0,1,2;3;9;1;1;1
250584147850;250584148098;248;0,1,2;3;9;1;1;1
250584148098;250584149054;956;0,1,2;3;9;1;1;1
250584149054;250584421579;272525;1,2;2;9;1;1;1
250584421579;250584596965;175386;1,2;2;9;1;1;1
250584596965;250584638689;41724;1,2;2;9;1;1;1
250584638689;250584663793;25104;1,2;2;9;1;1;1
250584663793;250584677673;13880;0,1,2;3;9;1;1;1
250584677673;250584685207;7534;0,1,2;3;9;1;1;1
250584685207;250584685292;85;0,1,2;3;9;1;1;1
250584685292;250584686016;724;0,1,2;3;9;1;1;1
250584686016;250584686094;78;0,1,2;3;9;1;1;1
250584686094;250584687724;1630;0,1,2;3;9;1;1;1
250584687724;250584688527;803;0,1,2;3;9;1;1;1
250584688527;250584688782;255;0,1,2;3;9;1;1;1
250584688782;250584688990;208;0,1,2;3;9;1;1;1
250584688990;250584690124;1134;0,1,2;3;9;1;1;1
250584690124;250584692042;1918;0,1,2;3;9;1;1;1
250584692042;250584692105;63;0,1,2;3;9;1;1;1
250584692105;250584692479;374;0,1,2;3;9;1;1;1
250584692479;250584692810;331;0,1,2;3;9;1;1;1
250584692810;250584692880;70;0,1,2;3;9;1;1;1
250584692880;250584692890;10;0,1,2;3;9;1;1;1
250584692890;250584692999;109;0,1,2;3;9;1;1;1
250584692999;250584693201;202;0,1,2;3;9;1;1;1
250584693201;250584693270;69;0,1,2;3;9;1;1;1
250584693270;250584693301;31;0,1,2;3;9;1;1;1
250584693301;250584693327;26;0,1,2;3;9;1;1;1
250584693327;250584693357;30;0,1,2;3;9;1;1;1
250584693357;250584693393;36;0,1,2;3;9;1;1;1
250584693393;250584693489;96;0,1,2;3;9;1;1;1
250584693489;250584693588;99;0,1,2;3;9;1;1;1
250584693588;250584693822;234;0,1,2;3;9;1;1;1
250584693822;250584693878;56;0,1,2;3;9;1;1;1
250584693878;250584693918;40;0,1,2;3;9;1;1;1
250584693918;250584693996;78;0,1,2;3;9;1;1;1
250584693996;250584694033;37;0,1,2;3;9;1;1;1
250584694033;250584694333;300;0,1,2;3;9;1;1;1
250584694333;250584694372;39;0,1,2;3;9;1;1;1
250584694372;250584694406;34;0,1,2;3;9;1;1;1
250584694406;250584694538;132;0,1,2;3;9;1;1;1
250584694538;250584694823;285;0,1,2;3;9;1;1;1
250584694823;250584695530;707;0,1,2;3;9;1;1;1
250584695530;250584696453;923;0,1,2;3;9;1;1;1
250584696453;250584697488;1035;0,1,2;3;9;1;1;1
250584697488;250584697812;324;0,1,2;3;9;1;1;1
250584697812;250584697822;10;0,1,2;3;9;1;1;1
250584697822;250584697992;170;0,1,2;3;9;1;1;1
250584697992;250584698086;94;0,1,2;3;9;1;1;1
250584698086;250584698488;402;0,1,2;3;9;1;1;1
250584698488;250584698803;315;0,1,2;3;9;1;1;1
250584698803;250584699070;267;0,1,2;3;9;1;1;1
250584699070;250584699092;22;0,1,2;3;9;1;1;1
250584699092;250584699125;33;0,1,2;3;9;1;1;1
250584699125;250584699219;94;0,1,2;3;9;1;1;1
250584699219;250584699390;171;0,1,2;3;9;1;1;1
250584699390;250584700244;854;0,1,2;3;9;1;1;1
250584700244;250584701406;1162;0,1,2;3;9;1;1;1
250584701406;250584702261;855;0,1,2;3;9;1;1;1
250584702261;250584702800;539;0,1,2;3;9;1;1;1
250584702800;250584702893;93;0,1,2;3;9;1;1;1
250584702893;250584702942;49;0,1,2;3;9;1;1;1
250584702942;250584703927;985;0,1,2;3;9;1;1;1
250584703927;250584704675;748;0,1,2;3;9;1;1;1
250584704675;250584704849;174;0,1,2;3;9;1;1;1
250584704849;250584705619;770;0,1,2;3;9;1;1;1
250584705619;250584705847;228;0,1,2;3;9;1;1;1
250584705847;250584706609;762;0,1,2;3;9;1;1;1
250584706609;250584706648;39;0,1,2;3;9;1;1;1
250584706648;250584706703;55;0,1,2;3;9;1;1;1
250584706703;250584706799;96;0,1,2;3;9;1;1;1
250584706799;250584707016;217;0,1,2;3;9;1;1;1
250584707016;250584707163;147;0,1,2;3;9;1;1;1
250584707163;250584707190;27;0,1,2;3;9;1;1;1
250584707190;250584707273;83;0,1,2;3;9;1;1;1
250584707273;250584707284;11;0,1,2;3;9;1;1;1
250584707284;250584707379;95;0,1,2;3;9;1;1;1
250584707379;250584707489;110;0,1,2;3;9;1;1;1
250584707489;250584707585;96;0,1,2;3;9;1;1;1
250584707585;250584707888;303;0,1,2;3;9;1;1;1
250584707888;250584708038;150;0,1,2;3;9;1;1;1
250584708038;250584708521;483;0,1,2;3;9;1;1;1
250584708521;250584708805;284;0,1,2;3;9;1;1;1
250584708805;250584709310;505;0,1,2;3;9;1;1;1
250584709310;250584709544;234;0,1,2;3;9;1;1;1
250584709544;250584709706;162;0,1,2;3;9;1;1;1
250584709706;250584710459;753;0,1,2;3;9;1;1;1
250584710459;250584710652;193;0,1,2;3;9;1;1;1
250584710652;250584710826;174;0,1,2;3;9;1;1;1
250584710826;250584711761;935;0,1,2;3;9;1;1;1
250584711761;250584712331;570;0,1,2;3;9;1;1;1
250584712331;250584712351;20;0,1,2;3;9;1;1;1
250584712351;250584712445;94;0,1,2;3;9;1;1;1
250584712445;250584712696;251;0,1,2;3;9;1;1;1
250584712696;250584712862;166;0,1,2;3;9;1;1;1
250584712862;250584713290;428;0,1,2;3;9;1;1;1
250584713290;250584713586;296;0,1,2;3;9;1;1;1
250584713586;250584713594;8;0,1,2;3;9;1;1;1
250584713594;250584713647;53;0,1,2;3;9;1;1;1
250584713647;250584713653;6;0,1,2;3;9;1;1;1
250584713653;250584713800;147;0,1,2;3;9;1;1;1
250584713800;250584713950;150;0,1,2;3;9;1;1;1
250584713950;250584714215;265;0,1,2;3;9;1;1;1
250584714215;250584714275;60;0,1,2;3;9;1;1;1
250584714275;250584714328;53;0,1,2;3;9;1;1;1
250584714328;250584714526;198;0,1,2;3;9;1;1;1
250584714526;250584714869;343;0,1,2;3;9;1;1;1
250584714869;250584714900;31;0,1,2;3;9;1;1;1
250584714900;250584714975;75;0,1,2;3;9;1;1;1
250584714975;250584715009;34;0,1,2;3;9;1;1;1
250584715009;250584715084;75;0,1,2;3;9;1;1;1
250584715084;250584716744;1660;0,1,2;3;9;1;1;1
250584716744;250584716795;51;0,1,2;3;9;1;1;1
250584716795;250584716836;41;0,1,2;3;9;1;1;1
250584716836;250584716945;109;0,1,2;3;9;1;1;1
250584716945;250584717002;57;0,1,2;3;9;1;1;1
250584717002;250584717101;99;0,1,2;3;9;1;1;1
250584717101;250584717339;238;0,1,2;3;9;1;1;1
250584717339;250584717412;73;0,1,2;3;9;1;1;1
250584717412;250584717780;368;0,1,2;3;9;1;1;1
250584717780;250584718138;358;0,1,2;3;9;1;1;1
250584718138;250584718563;425;0,1,2;3;9;1;1;1
250584718563;250584718862;299;0,1,2;3;9;1;1;1
250584718862;250584719419;557;0,1,2;3;9;1;1;1
250584719419;250584719531;112;0,1,2;3;9;1;1;1
250584719531;250584719663;132;0,1,2;3;9;1;1;1
250584719663;250584719783;120;0,1,2;3;9;1;1;1
250584719783;250584719876;93;0,1,2;3;9;1;1;1
250584719876;250584719984;108;0,1,2;3;9;1;1;1
250584719984;250584720107;123;0,1,2;3;9;1;1;1
250584720107;250584721301;1194;0,1,2;3;9;1;1;1
250584721301;250584721456;155;0,1,2;3;9;1;1;1
250584721456;250584722017;561;0,1,2;3;9;1;1;1
250584722017;250584722097;80;0,1,2;3;9;1;1;1
250584722097;250584722134;37;0,1,2;3;9;1;1;1
250584722134;250584722689;555;0,1,2;3;9;1;1;1
250584722689;250584722751;62;0,1,2;3;9;1;1;1
250584722751;250584722917;166;0,1,2;3;9;1;1;1
250584722917;250584722973;56;0,1,2;3;9;1;1;1
250584722973;250584723344;371;0,1,2;3;9;1;1;1
250584723344;250584723653;309;0,1,2;3;9;1;1;1
250584723653;250584723738;85;0,1,2;3;9;1;1;1
250584723738;250584723800;62;0,1,2;3;9;1;1;1
250584723800;250584723961;161;0,1,2;3;9;1;1;1
250584723961;250584724235;274;0,1,2;3;9;1;1;1
250584724235;250584724393;158;0,1,2;3;9;1;1;1
250584724393;250584724419;26;0,1,2;3;9;1;1;1
250584724419;250584724452;33;0,1,2;3;9;1;1;1
250584724452;250584724664;212;0,1,2;3;9;1;1;1
250584724664;250584725134;470;0,1,2;3;9;1;1;1
250584725134;250584725166;32;0,1,2;3;9;1;1;1
250584725166;250584725388;222;0,1,2;3;9;1;1;1
250584725388;250584725520;132;0,1,2;3;9;1;1;1
250584725520;250584725625;105;0,1,2;3;9;1;1;1
250584725625;250584725752;127;0,1,2;3;9;1;1;1
250584725752;250584725855;103;0,1,2;3;9;1;1;1
250584725855;250584725981;126;0,1,2;3;9;1;1;1
250584725981;250584726009;28;0,1,2;3;9;1;1;1
250584726009;250584726050;41;0,1,2;3;9;1;1;1
250584726050;250584726051;1;0,1,2;3;9;1;1;1
250584726051;250584726137;86;0,1,2;3;9;1;1;1
250584726137;250584726192;55;0,1,2;3;9;1;1;1
250584726192;250584726248;56;0,1,2;3;9;1;1;1
250584726248;250584726377;129;0,1,2;3;9;1;1;1
250584726377;250584726579;202;0,1,2;3;9;1;1;1
250584726579;250584726684;105;0,1,2;3;9;1;1;1
250584726684;250584726922;238;0,1,2;3;9;1;1;1
250584726922;250584727203;281;0,1,2;3;9;1;1;1
250584727203;250584727223;20;0,1,2;3;9;1;1;1
250584727223;250584727522;299;0,1,2;3;9;1;1;1
250584727522;250584727691;169;0,1,2;3;9;1;1;1
250584727691;250584727864;173;0,1,2;3;9;1;1;1
250584727864;250584727920;56;0,1,2;3;9;1;1;1
250584727920;250584728360;440;0,1,2;3;9;1;1;1
250584728360;250584728527;167;0,1,2;3;9;1;1;1
250584728527;250584728581;54;0,1,2;3;9;1;1;1
250584728581;250584728626;45;0,1,2;3;9;1;1;1
250584728626;250584728690;64;0,1,2;3;9;1;1;1
250584728690;250584728705;15;0,1,2;3;9;1;1;1
250584728705;250584728732;27;0,1,2;3;9;1;1;1
250584728732;250584728775;43;0,1,2;3;9;1;1;1
250584728775;250584728780;5;0,1,2;3;9;1;1;1
250584728780;250584728833;53;0,1,2;3;9;1;1;1
250584728833;250584728845;12;0,1,2;3;9;1;1;1
250584728845;250584728914;69;0,1,2;3;9;1;1;1
250584728914;250584728984;70;0,1,2;3;9;1;1;1
250584728984;250584729034;50;0,1,2;3;9;1;1;1
250584729034;250584729053;19;0,1,2;3;9;1;1;1
250584729053;250584729069;16;0,1,2;3;9;1;1;1
250584729069;250584729551;482;0,1,2;3;9;1;1;1
250584729551;250584729701;150;0,1,2;3;9;1;1;1
250584729701;250584729911;210;0,1,2;3;9;1;1;1
250584729911;250584730085;174;0,1,2;3;9;1;1;1
250584730085;250584730146;61;0,1,2;3;9;1;1;1
250584730146;250584730335;189;0,1,2;3;9;1;1;1
250584730335;250584730523;188;0,1,2;3;9;1;1;1
250584730523;250584730905;382;0,1,2;3;9;1;1;1
250584730905;250584731415;510;0,1,2;3;9;1;1;1
250584731415;250584731804;389;0,1,2;3;9;1;1;1
250584731804;250584731960;156;0,1,2;3;9;1;1;1
250584731960;250584732510;550;0,1,2;3;9;1;1;1
250584732510;250584732535;25;0,1,2;3;9;1;1;1
250584732535;250584732624;89;0,1,2;3;9;1;1;1
250584732624;250584733005;381;0,1,2;3;9;1;1;1
250584733005;250584733096;91;0,1,2;3;9;1;1;1
250584733096;250584733166;70;0,1,2;3;9;1;1;1
250584733166;250584733287;121;0,1,2;3;9;1;1;1
250584733287;250584734112;825;0,1,2;3;9;1;1;1
250584734112;250584734259;147;0,1,2;3;9;1;1;1
250584734259;250584734833;574;0,1,2;3;9;1;1;1
250584734833;250584735185;352;0,1,2;3;9;1;1;1
250584735185;250584735910;725;0,1,2;3;9;1;1;1
250584735910;250584737372;1462;0,1,2;3;9;1;1;1
250584737372;250584737396;24;0,1,2;3;9;1;1;1
250584737396;250584737932;536;0,1,2;3;9;1;1;1
250584737932;250584738167;235;0,1,2;3;9;1;1;1
250584738167;250584739898;1731;0,1,2;3;9;1;1;1
250584739898;250584739999;101;0,1,2;3;9;1;1;1
250584739999;250584740220;221;0,1,2;3;9;1;1;1
250584740220;250584740424;204;0,1,2;3;9;1;1;1
250584740424;250584740519;95;0,1,2;3;9;1;1;1
250584740519;250584741362;843;0,1,2;3;9;1;1;1
250584741362;250584742089;727;0,1,2;3;9;1;1;1
250584742089;250584742136;47;0,1,2;3;9;1;1;1
250584742136;250584742255;119;0,1,2;3;9;1;1;1
250584742255;250584742499;244;0,1,2;3;9;1;1;1
250584742499;250584742639;140;0,1,2;3;9;1;1;1
250584742639;250584742760;121;0,1,2;3;9;1;1;1
250584742760;250584742784;24;0,1,2;3;9;1;1;1
250584742784;250584742830;46;0,1,2;3;9;1;1;1
250584742830;250584743080;250;0,1,2;3;9;1;1;1
250584743080;250584743131;51;0,1,2;3;9;1;1;1
250584743131;250584743191;60;0,1,2;3;9;1;1;1
250584743191;250584743332;141;0,1,2;3;9;1;1;1
250584743332;250584743664;332;0,1,2;3;9;1;1;1
250584743664;250584743756;92;0,1,2;3;9;1;1;1
250584743756;250584743907;151;0,1,2;3;9;1;1;1
250584743907;250584744032;125;0,1,2;3;9;1;1;1
250584744032;250584744066;34;0,1,2;3;9;1;1;1
250584744066;250584744131;65;0,1,2;3;9;1;1;1
250584744131;250584746011;1880;0,1,2;3;9;1;1;1
250584746011;250584746093;82;0,1,2;3;9;1;1;1
250584746093;250584746502;409;0,1,2;3;9;1;1;1
250584746502;250584746616;114;0,1,2;3;9;1;1;1
250584746616;250584746658;42;0,1,2;3;9;1;1;1
250584746658;250584746867;209;0,1,2;3;9;1;1;1
250584746867;250584749444;2577;0,1,2;3;9;1;1;1
250584749444;250584749711;267;0,1,2;3;9;1;1;1
250584749711;250584750016;305;0,1,2;3;9;1;1;1
250584750016;250584750022;6;0,1,2;3;9;1;1;1
250584750022;250584750150;128;0,1,2;3;9;1;1;1
250584750150;250584750183;33;0,1,2;3;9;1;1;1
250584750183;250584750257;74;0,1,2;3;9;1;1;1
250584750257;250584750536;279;0,1,2;3;9;1;1;1
250584750536;250584750546;10;0,1,2;3;9;1;1;1
250584750546;250584750697;151;0,1,2;3;9;1;1;1
250584750697;250584750926;229;0,1,2;3;9;1;1;1
250584750926;250584750965;39;0,1,2;3;9;1;1;1
250584750965;250584752658;1693;0,1,2;3;9;1;1;1
250584752658;250584752673;15;0,1,2;3;9;1;1;1
250584752673;250584752713;40;0,1,2;3;9;1;1;1
250584752713;250584752750;37;0,1,2;3;9;1;1;1
250584752750;250584753056;306;0,1,2;3;9;1;1;1
250584753056;250584753780;724;0,1,2;3;9;1;1;1
250584753780;250584754675;895;0,1,2;3;9;1;1;1
250584754675;250584754962;287;0,1,2;3;9;1;1;1
250584754962;250584754984;22;0,1,2;3;9;1;1;1
250584754984;250584755181;197;0,1,2;3;9;1;1;1
250584755181;250584756135;954;0,1,2;3;9;1;1;1
250584756135;250584756190;55;0,1,2;3;9;1;1;1
250584756190;250584756408;218;0,1,2;3;9;1;1;1
250584756408;250584756671;263;0,1,2;3;9;1;1;1
250584756671;250584759425;2754;0,1,2;3;9;1;1;1
250584759425;250584760421;996;0,1,2;3;9;1;1;1
250584760421;250584763186;2765;0,1,2;3;9;1;1;1
250584763186;250584763239;53;0,1,2;3;9;1;1;1
250584763239;250584763267;28;0,1,2;3;9;1;1;1
250584763267;250584763684;417;0,1,2;3;9;1;1;1
250584763684;250584764071;387;0,1,2;3;9;1;1;1
250584764071;250584765773;1702;0,1,2;3;9;1;1;1
250584765773;250584766049;276;0,1,2;3;9;1;1;1
250584766049;250584766732;683;0,1,2;3;9;1;1;1
250584766732;250584767002;270;0,1,2;3;9;1;1;1
250584767002;250584769115;2113;0,1,2;3;9;1;1;1
250584769115;250584769237;122;0,1,2;3;9;1;1;1
250584769237;250584769685;448;0,1,2;3;9;1;1;1
250584769685;250584770104;419;0,1,2;3;9;1;1;1
250584770104;250584770153;49;0,1,2;3;9;1;1;1
250584770153;250584772854;2701;0,1,2;3;9;1;1;1
250584772854;250584773508;654;0,1,2;3;9;1;1;1
250584773508;250584773870;362;0,1,2;3;9;1;1;1
250584773870;250584774078;208;0,1,2;3;9;1;1;1
250584774078;250584776183;2105;0,1,2;3;9;1;1;1
250584776183;250584776239;56;0,1,2;3;9;1;1;1
250584776239;250584776268;29;0,1,2;3;9;1;1;1
250584776268;250584776879;611;0,1,2;3;9;1;1;1
250584776879;250584777462;583;0,1,2;3;9;1;1;1
250584777462;250584777674;212;0,1,2;3;9;1;1;1
250584777674;250584777767;93;0,1,2;3;9;1;1;1
250584777767;250584777872;105;0,1,2;3;9;1;1;1
250584777872;250584778014;142;0,1,2;3;9;1;1;1
250584778014;250584778247;233;0,1,2;3;9;1;1;1
250584778247;250584778336;89;0,1,2;3;9;1;1;1
250584778336;250584778619;283;0,1,2;3;9;1;1;1
250584778619;250584778776;157;0,1,2;3;9;1;1;1
250584778776;250584778818;42;0,1,2;3;9;1;1;1
250584778818;250584778925;107;0,1,2;3;9;1;1;1
250584778925;250584778987;62;0,1,2;3;9;1;1;1
250584778987;250584779448;461;0,1,2;3;9;1;1;1
250584779448;250584779458;10;0,1,2;3;9;1;1;1
250584779458;250584779490;32;0,1,2;3;9;1;1;1
250584779490;250584779535;45;0,1,2;3;9;1;1;1
250584779535;250584779743;208;0,1,2;3;9;1;1;1
250584779743;250584780165;422;0,1,2;3;9;1;1;1
250584780165;250584780223;58;0,1,2;3;9;1;1;1
250584780223;250584780247;24;0,1,2;3;9;1;1;1
250584780247;250584780262;15;0,1,2;3;9;1;1;1
250584780262;250584780790;528;0,1,2;3;9;1;1;1
250584780790;250584781238;448;0,1,2;3;9;1;1;1
250584781238;250584781287;49;0,1,2;3;9;1;1;1
250584781287;250584781385;98;0,1,2;3;9;1;1;1
250584781385;250584781497;112;0,1,2;3;9;1;1;1
250584781497;250584782015;518;0,1,2;3;9;1;1;1
250584782015;250584782236;221;0,1,2;3;9;1;1;1
250584782236;250584782504;268;0,1,2;3;9;1;1;1
250584782504;250584782619;115;0,1,2;3;9;1;1;1
250584782619;250584782807;188;0,1,2;3;9;1;1;1
250584782807;250584783288;481;0,1,2;3;9;1;1;1
250584783288;250584783305;17;0,1,2;3;9;1;1;1
250584783305;250584783482;177;0,1,2;3;9;1;1;1
250584783482;250584783512;30;0,1,2;3;9;1;1;1
250584783512;250584783562;50;0,1,2;3;9;1;1;1
250584783562;250584783570;8;0,1,2;3;9;1;1;1
250584783570;250584783662;92;0,1,2;3;9;1;1;1
250584783662;250584783767;105;0,1,2;3;9;1;1;1
250584783767;250584783889;122;0,1,2;3;9;1;1;1
250584783889;250584783990;101;0,1,2;3;9;1;1;1
250584783990;250584784263;273;0,1,2;3;9;1;1;1
250584784263;250584785693;1430;0,1,2;3;9;1;1;1
250584785693;250584786276;583;0,1,2;3;9;1;1;1
250584786276;250584787370;1094;0,1,2;3;9;1;1;1
250584787370;250584787614;244;0,1,2;3;9;1;1;1
250584787614;250584787801;187;0,1,2;3;9;1;1;1
250584787801;250584788042;241;0,1,2;3;9;1;1;1
250584788042;250584789162;1120;0,1,2;3;9;1;1;1
250584789162;250584789304;142;0,1,2;3;9;1;1;1
250584789304;250584790533;1229;0,1,2;3;9;1;1;1
250584790533;250584791153;620;0,1,2;3;9;1;1;1
250584791153;250584792266;1113;0,1,2;3;9;1;1;1
250584792266;250584792432;166;0,1,2;3;9;1;1;1
250584792432;250584792590;158;0,1,2;3;9;1;1;1
250584792590;250584793683;1093;0,1,2;3;9;1;1;1
250584793683;250584793793;110;0,1,2;3;9;1;1;1
250584793793;250584795104;1311;0,1,2;3;9;1;1;1
250584795104;250584796269;1165;0,1,2;3;9;1;1;1
250584796269;250584796685;416;0,1,2;3;9;1;1;1
250584796685;250584797301;616;0,1,2;3;9;1;1;1
250584797301;250584797326;25;0,1,2;3;9;1;1;1
250584797326;250584798224;898;0,1,2;3;9;1;1;1
250584798224;250584798298;74;0,1,2;3;9;1;1;1
250584798298;250584798372;74;0,1,2;3;9;1;1;1
250584798372;250584799103;731;0,1,2;3;9;1;1;1
250584799103;250584799710;607;0,1,2;3;9;1;1;1
250584799710;250584799914;204;0,1,2;3;9;1;1;1
250584799914;250584799952;38;0,1,2;3;9;1;1;1
250584799952;250584803484;3532;0,1,2;3;9;1;1;1
250584803484;250584804866;1382;0,1,2;3;9;1;1;1
250584804866;250584805117;251;0,1,2;3;9;1;1;1
250584805117;250584808447;3330;0,1,2;3;9;1;1;1
250584808447;250584808960;513;0,1,2;3;9;1;1;1
250584808960;250584809828;868;0,1,2;3;9;1;1;1
250584809828;250584810312;484;0,1,2;3;9;1;1;1
250584810312;250584810319;7;0,1,2;3;9;1;1;1
250584810319;250584810565;246;0,1,2;3;9;1;1;1
250584810565;250584810618;53;0,1,2;3;9;1;1;1
250584810618;250584810650;32;0,1,2;3;9;1;1;1
250584810650;250584810764;114;0,1,2;3;9;1;1;1
250584810764;250584810960;196;0,1,2;3;9;1;1;1
250584810960;250584811636;676;0,1,2;3;9;1;1;1
250584811636;250584811819;183;0,1,2;3;9;1;1;1
250584811819;250584811849;30;0,1,2;3;9;1;1;1
250584811849;250584813870;2021;0,1,2;3;9;1;1;1
250584813870;250584814116;246;0,1,2;3;9;1;1;1
250584814116;250584814520;404;0,1,2;3;9;1;1;1
250584814520;250584814572;52;0,1,2;3;9;1;1;1
250584814572;250584815817;1245;0,1,2;3;9;1;1;1
250584815817;250584816204;387;0,1,2;3;9;1;1;1
250584816204;250584816405;201;0,1,2;3;9;1;1;1
250584816405;250584817008;603;0,1,2;3;9;1;1;1
250584817008;250584817312;304;0,1,2;3;9;1;1;1
250584817312;250584817352;40;0,1,2;3;9;1;1;1
250584817352;250584818071;719;0,1,2;3;9;1;1;1
250584818071;250584818108;37;0,1,2;3;9;1;1;1
250584818108;250584818180;72;0,1,2;3;9;1;1;1
250584818180;250584818361;181;0,1,2;3;9;1;1;1
250584818361;250584820606;2245;0,1,2;3;9;1;1;1
250584820606;250584820924;318;0,1,2;3;9;1;1;1
250584820924;250584824224;3300;0,1,2;3;9;1;1;1
250584824224;250584824966;742;0,1,2;3;9;1;1;1
250584824966;250584825012;46;0,1,2;3;9;1;1;1
250584825012;250584825312;300;0,1,2;3;9;1;1;1
250584825312;250584825382;70;0,1,2;3;9;1;1;1
250584825382;250584825430;48;0,1,2;3;9;1;1;1
250584825430;250584825876;446;0,1,2;3;9;1;1;1
250584825876;250584826311;435;0,1,2;3;9;1;1;1
250584826311;250584826355;44;0,1,2;3;9;1;1;1
250584826355;250584826361;6;0,1,2;3;9;1;1;1
250584826361;250584827376;1015;0,1,2;3;9;1;1;1
250584827376;250584827488;112;0,1,2;3;9;1;1;1
250584827488;250584828277;789;0,1,2;3;9;1;1;1
250584828277;250584829722;1445;0,1,2;3;9;1;1;1
250584829722;250584830230;508;0,1,2;3;9;1;1;1
250584830230;250584830400;170;0,1,2;3;9;1;1;1
250584830400;250584830700;300;0,1,2;3;9;1;1;1
250584830700;250584830940;240;0,1,2;3;9;1;1;1
250584830940;250584831707;767;0,1,2;3;9;1;1;1
250584831707;250584831728;21;0,1,2;3;9;1;1;1
250584831728;250584831763;35;0,1,2;3;9;1;1;1
250584831763;250584831818;55;0,1,2;3;9;1;1;1
250584831818;250584835482;3664;0,1,2;3;9;1;1;1
250584835482;250584835805;323;0,1,2;3;9;1;1;1
250584835805;250584836157;352;0,1,2;3;9;1;1;1
250584836157;250584836188;31;0,1,2;3;9;1;1;1
250584836188;250584836497;309;0,1,2;3;9;1;1;1
250584836497;250584836585;88;0,1,2;3;9;1;1;1
250584836585;250584836963;378;0,1,2;3;9;1;1;1
250584836963;250584837001;38;0,1,2;3;9;1;1;1
250584837001;250584837116;115;0,1,2;3;9;1;1;1
250584837116;250584837392;276;0,1,2;3;9;1;1;1
250584837392;250584837550;158;0,1,2;3;9;1;1;1
250584837550;250584838307;757;0,1,2;3;9;1;1;1
250584838307;250584838521;214;0,1,2;3;9;1;1;1
250584838521;250584838574;53;0,1,2;3;9;1;1;1
250584838574;250584838615;41;0,1,2;3;9;1;1;1
250584838615;250584838782;167;0,1,2;3;9;1;1;1
250584838782;250584838814;32;0,1,2;3;9;1;1;1
250584838814;250584839005;191;0,1,2;3;9;1;1;1
250584839005;250584839200;195;0,1,2;3;9;1;1;1
250584839200;250584839268;68;0,1,2;3;9;1;1;1
250584839268;250584839375;107;0,1,2;3;9;1;1;1
250584839375;250584840095;720;0,1,2;3;9;1;1;1
250584840095;250584841058;963;0,1,2;3;9;1;1;1
250584841058;250584841187;129;0,1,2;3;9;1;1;1
250584841187;250584841621;434;0,1,2;3;9;1;1;1
250584841621;250584841656;35;0,1,2;3;9;1;1;1
250584841656;250584841696;40;0,1,2;3;9;1;1;1
250584841696;250584841790;94;0,1,2;3;9;1;1;1
250584841790;250584841963;173;0,1,2;3;9;1;1;1
250584841963;250584841997;34;0,1,2;3;9;1;1;1
250584841997;250584842057;60;0,1,2;3;9;1;1;1
250584842057;250584842188;131;0,1,2;3;9;1;1;1
250584842188;250584842475;287;0,1,2;3;9;1;1;1
250584842475;250584842795;320;0,1,2;3;9;1;1;1
250584842795;250584842906;111;0,1,2;3;9;1;1;1
250584842906;250584843002;96;0,1,2;3;9;1;1;1
250584843002;250584843542;540;0,1,2;3;9;1;1;1
250584843542;250584843592;50;0,1,2;3;9;1;1;1
250584843592;250584843828;236;0,1,2;3;9;1;1;1
250584843828;250584843852;24;0,1,2;3;9;1;1;1
250584843852;250584843864;12;0,1,2;3;9;1;1;1
250584843864;250584844074;210;0,1,2;3;9;1;1;1
250584844074;250584844150;76;0,1,2;3;9;1;1;1
250584844150;250584844228;78;0,1,2;3;9;1;1;1
250584844228;250584844266;38;0,1,2;3;9;1;1;1
250584844266;250584844348;82;0,1,2;3;9;1;1;1
250584844348;250584844368;20;0,1,2;3;9;1;1;1
250584844368;250584844761;393;0,1,2;3;9;1;1;1
250584844761;250584845179;418;0,1,2;3;9;1;1;1
250584845179;250584845270;91;0,1,2;3;9;1;1;1
250584845270;250584845305;35;0,1,2;3;9;1;1;1
250584845305;250584845317;12;0,1,2;3;9;1;1;1
250584845317;250584846740;1423;0,1,2;3;9;1;1;1
250584846740;250584847134;394;0,1,2;3;9;1;1;1
250584847134;250584847619;485;0,1,2;3;9;1;1;1
250584847619;250584847633;14;0,1,2;3;9;1;1;1
250584847633;250584848810;1177;0,1,2;3;9;1;1;1
250584848810;250584849343;533;0,1,2;3;9;1;1;1
250584849343;250584849969;626;0,1,2;3;9;1;1;1
250584849969;250584850175;206;0,1,2;3;9;1;1;1
250584850175;250584850554;379;0,1,2;3;9;1;1;1
250584850554;250584851058;504;0,1,2;3;9;1;1;1
250584851058;250584851181;123;0,1,2;3;9;1;1;1
250584851181;250584853238;2057;0,1,2;3;9;1;1;1
250584853238;250584853609;371;0,1,2;3;9;1;1;1
250584853609;250584854364;755;0,1,2;3;9;1;1;1
250584854364;250584854872;508;0,1,2;3;9;1;1;1
250584854872;250584855328;456;0,1,2;3;9;1;1;1
250584855328;250584855458;130;0,1,2;3;9;1;1;1
250584855458;250584856101;643;0,1,2;3;9;1;1;1
250584856101;250584856269;168;0,1,2;3;9;1;1;1
250584856269;250584856376;107;0,1,2;3;9;1;1;1
250584856376;250584856788;412;0,1,2;3;9;1;1;1
250584856788;250584857075;287;0,1,2;3;9;1;1;1
250584857075;250584857180;105;0,1,2;3;9;1;1;1
250584857180;250584857286;106;0,1,2;3;9;1;1;1
250584857286;250584858159;873;0,1,2;3;9;1;1;1
250584858159;250584858372;213;0,1,2;3;9;1;1;1
250584858372;250584858781;409;0,1,2;3;9;1;1;1
250584858781;250584858979;198;0,1,2;3;9;1;1;1
250584858979;250584859169;190;0,1,2;3;9;1;1;1
250584859169;250584859355;186;0,1,2;3;9;1;1;1
250584859355;250584859523;168;0,1,2;3;9;1;1;1
250584859523;250584859745;222;0,1,2;3;9;1;1;1
250584859745;250584860374;629;0,1,2;3;9;1;1;1
250584860374;250584860768;394;0,1,2;3;9;1;1;1
250584860768;250584860892;124;0,1,2;3;9;1;1;1
250584860892;250584861304;412;0,1,2;3;9;1;1;1
250584861304;250584861457;153;0,1,2;3;9;1;1;1
250584861457;250584863493;2036;0,1,2;3;9;1;1;1
250584863493;250584863670;177;0,1,2;3;9;1;1;1
250584863670;250584864288;618;0,1,2;3;9;1;1;1
250584864288;250584865290;1002;0,1,2;3;9;1;1;1
250584865290;250584865779;489;0,1,2;3;9;1;1;1
250584865779;250584866068;289;0,1,2;3;9;1;1;1
250584866068;250584867068;1000;0,1,2;3;9;1;1;1
250584867068;250584867638;570;0,1,2;3;9;1;1;1
250584867638;250584868635;997;0,1,2;3;9;1;1;1
250584868635;250584868734;99;0,1,2;3;9;1;1;1
250584868734;250584868857;123;0,1,2;3;9;1;1;1
250584868857;250584868996;139;0,1,2;3;9;1;1;1
250584868996;250584869098;102;0,1,2;3;9;1;1;1
250584869098;250584869977;879;0,1,2;3;9;1;1;1
250584869977;250584870244;267;0,1,2;3;9;1;1;1
250584870244;250584870769;525;0,1,2;3;9;1;1;1
250584870769;250584871419;650;0,1,2;3;9;1;1;1
250584871419;250584872250;831;0,1,2;3;9;1;1;1
250584872250;250584872625;375;0,1,2;3;9;1;1;1
250584872625;250584872831;206;0,1,2;3;9;1;1;1
250584872831;250584872874;43;0,1,2;3;9;1;1;1
250584872874;250584873070;196;0,1,2;3;9;1;1;1
250584873070;250584873085;15;0,1,2;3;9;1;1;1
250584873085;250584873109;24;0,1,2;3;9;1;1;1
250584873109;250584873143;34;0,1,2;3;9;1;1;1
250584873143;250584873170;27;0,1,2;3;9;1;1;1
250584873170;250584873227;57;0,1,2;3;9;1;1;1
250584873227;250584874633;1406;0,1,2;3;9;1;1;1
250584874633;250584875338;705;0,1,2;3;9;1;1;1
250584875338;250584876073;735;0,1,2;3;9;1;1;1
250584876073;250584877212;1139;0,1,2;3;9;1;1;1
250584877212;250584877312;100;0,1,2;3;9;1;1;1
250584877312;250584877423;111;0,1,2;3;9;1;1;1
250584877423;250584877967;544;0,1,2;3;9;1;1;1
250584877967;250584878454;487;0,1,2;3;9;1;1;1
250584878454;250584878487;33;0,1,2;3;9;1;1;1
250584878487;250584878842;355;0,1,2;3;9;1;1;1
250584878842;250584880711;1869;0,1,2;3;9;1;1;1
250584880711;250584881016;305;0,1,2;3;9;1;1;1
250584881016;250584881303;287;0,1,2;3;9;1;1;1
250584881303;250584881450;147;0,1,2;3;9;1;1;1
250584881450;250584881555;105;0,1,2;3;9;1;1;1
250584881555;250584883000;1445;0,1,2;3;9;1;1;1
250584883000;250584883320;320;0,1,2;3;9;1;1;1
250584883320;250584883416;96;0,1,2;3;9;1;1;1
250584883416;250584883777;361;0,1,2;3;9;1;1;1
250584883777;250584887171;3394;0,1,2;3;9;1;1;1
250584887171;250584888665;1494;0,1,2;3;9;1;1;1
250584888665;250584889205;540;0,1,2;3;9;1;1;1
250584889205;250584889332;127;0,1,2;3;9;1;1;1
250584889332;250584892075;2743;0,1,2;3;9;1;1;1
250584892075;250584892435;360;0,1,2;3;9;1;1;1
250584892435;250584892775;340;0,1,2;3;9;1;1;1
250584892775;250584892836;61;0,1,2;3;9;1;1;1
250584892836;250584893309;473;0,1,2;3;9;1;1;1
250584893309;250584893424;115;0,1,2;3;9;1;1;1
250584893424;250584893437;13;0,1,2;3;9;1;1;1
250584893437;250584893544;107;0,1,2;3;9;1;1;1
250584893544;250584894209;665;0,1,2;3;9;1;1;1
250584894209;250584895067;858;0,1,2;3;9;1;1;1
250584895067;250584895775;708;0,1,2;3;9;1;1;1
250584895775;250584896354;579;0,1,2;3;9;1;1;1
250584896354;250584897395;1041;0,1,2;3;9;1;1;1
250584897395;250584897558;163;0,1,2;3;9;1;1;1
250584897558;250584897995;437;0,1,2;3;9;1;1;1
250584897995;250584898336;341;0,1,2;3;9;1;1;1
250584898336;250584898436;100;0,1,2;3;9;1;1;1
250584898436;250584898591;155;0,1,2;3;9;1;1;1
250584898591;250584898808;217;0,1,2;3;9;1;1;1
250584898808;250584899214;406;0,1,2;3;9;1;1;1
250584899214;250584900204;990;0,1,2;3;9;1;1;1
250584900204;250584900309;105;0,1,2;3;9;1;1;1
250584900309;250584900420;111;0,1,2;3;9;1;1;1
250584900420;250584900651;231;0,1,2;3;9;1;1;1
250584900651;250584900925;274;0,1,2;3;9;1;1;1
250584900925;250584901418;493;0,1,2;3;9;1;1;1
250584901418;250584901543;125;0,1,2;3;9;1;1;1
250584901543;250584901653;110;0,1,2;3;9;1;1;1
250584901653;250584901731;78;0,1,2;3;9;1;1;1
250584901731;250584901900;169;0,1,2;3;9;1;1;1
250584901900;250584902909;1009;0,1,2;3;9;1;1;1
250584902909;250584903922;1013;0,1,2;3;9;1;1;1
250584903922;250584904109;187;0,1,2;3;9;1;1;1
250584904109;250584904987;878;0,1,2;3;9;1;1;1
250584904987;250584905045;58;0,1,2;3;9;1;1;1
250584905045;250584905710;665;0,1,2;3;9;1;1;1
250584905710;250584905748;38;0,1,2;3;9;1;1;1
250584905748;250584905783;35;0,1,2;3;9;1;1;1
250584905783;250584905845;62;0,1,2;3;9;1;1;1
250584905845;250584907229;1384;0,1,2;3;9;1;1;1
250584907229;250584907267;38;0,1,2;3;9;1;1;1
250584907267;250584907320;53;0,1,2;3;9;1;1;1
250584907320;250584907419;99;0,1,2;3;9;1;1;1
250584907419;250584907802;383;0,1,2;3;9;1;1;1
250584907802;250584907805;3;0,1,2;3;9;1;1;1
250584907805;250584907832;27;0,1,2;3;9;1;1;1
250584907832;250584907855;23;0,1,2;3;9;1;1;1
250584907855;250584907888;33;0,1,2;3;9;1;1;1
250584907888;250584907921;33;0,1,2;3;9;1;1;1
250584907921;250584908025;104;0,1,2;3;9;1;1;1
250584908025;250584908050;25;0,1,2;3;9;1;1;1
250584908050;250584908171;121;0,1,2;3;9;1;1;1
250584908171;250584908643;472;0,1,2;3;9;1;1;1
250584908643;250584909575;932;0,1,2;3;9;1;1;1
250584909575;250584909802;227;0,1,2;3;9;1;1;1
250584909802;250584911095;1293;0,1,2;3;9;1;1;1
250584911095;250584911142;47;0,1,2;3;9;1;1;1
250584911142;250584912387;1245;0,1,2;3;9;1;1;1
250584912387;250584912526;139;0,1,2;3;9;1;1;1
250584912526;250584912793;267;0,1,2;3;9;1;1;1
250584912793;250584912813;20;0,1,2;3;9;1;1;1
250584912813;250584912999;186;0,1,2;3;9;1;1;1
250584912999;250584913131;132;0,1,2;3;9;1;1;1
250584913131;250584913316;185;0,1,2;3;9;1;1;1
250584913316;250584913830;514;0,1,2;3;9;1;1;1
250584913830;250584914266;436;0,1,2;3;9;1;1;1
250584914266;250584914478;212;0,1,2;3;9;1;1;1
250584914478;250584914485;7;0,1,2;3;9;1;1;1
250584914485;250584915286;801;0,1,2;3;9;1;1;1
250584915286;250584915459;173;0,1,2;3;9;1;1;1
250584915459;250584915558;99;0,1,2;3;9;1;1;1
250584915558;250584915656;98;0,1,2;3;9;1;1;1
250584915656;250584916030;374;0,1,2;3;9;1;1;1
250584916030;250584916387;357;0,1,2;3;9;1;1;1
250584916387;250584916791;404;0,1,2;3;9;1;1;1
250584916791;250584916799;8;0,1,2;3;9;1;1;1
250584916799;250584916810;11;0,1,2;3;9;1;1;1
250584916810;250584916890;80;0,1,2;3;9;1;1;1
250584916890;250584916891;1;0,1,2;3;9;1;1;1
250584916891;250584917099;208;0,1,2;3;9;1;1;1
250584917099;250584917133;34;0,1,2;3;9;1;1;1
250584917133;250584918013;880;0,1,2;3;9;1;1;1
250584918013;250584918215;202;0,1,2;3;9;1;1;1
250584918215;250584918357;142;0,1,2;3;9;1;1;1
250584918357;250584918530;173;0,1,2;3;9;1;1;1
250584918530;250584919412;882;0,1,2;3;9;1;1;1
250584919412;250584919583;171;0,1,2;3;9;1;1;1
250584919583;250584919739;156;0,1,2;3;9;1;1;1
250584919739;250584919855;116;0,1,2;3;9;1;1;1
250584919855;250584919983;128;0,1,2;3;9;1;1;1
250584919983;250584920081;98;0,1,2;3;9;1;1;1
250584920081;250584920116;35;0,1,2;3;9;1;1;1
250584920116;250584920151;35;0,1,2;3;9;1;1;1
250584920151;250584920786;635;0,1,2;3;9;1;1;1
250584920786;250584920931;145;0,1,2;3;9;1;1;1
250584920931;250584920985;54;0,1,2;3;9;1;1;1
250584920985;250584921008;23;0,1,2;3;9;1;1;1
250584921008;250584921401;393;0,1,2;3;9;1;1;1
250584921401;250584922492;1091;0,1,2;3;9;1;1;1
250584922492;250584922987;495;0,1,2;3;9;1;1;1
250584922987;250584923065;78;0,1,2;3;9;1;1;1
250584923065;250584923755;690;0,1,2;3;9;1;1;1
250584923755;250584923799;44;0,1,2;3;9;1;1;1
250584923799;250584923860;61;0,1,2;3;9;1;1;1
250584923860;250584923940;80;0,1,2;3;9;1;1;1
250584923940;250584924012;72;0,1,2;3;9;1;1;1
250584924012;250584924255;243;0,1,2;3;9;1;1;1
250584924255;250584924316;61;0,1,2;3;9;1;1;1
250584924316;250584924455;139;0,1,2;3;9;1;1;1
250584924455;250584924623;168;0,1,2;3;9;1;1;1
250584924623;250584925094;471;0,1,2;3;9;1;1;1
250584925094;250584925247;153;0,1,2;3;9;1;1;1
250584925247;250584925321;74;0,1,2;3;9;1;1;1
250584925321;250584925420;99;0,1,2;3;9;1;1;1
250584925420;250584926007;587;0,1,2;3;9;1;1;1
250584926007;250584926587;580;0,1,2;3;9;1;1;1
250584926587;250584926752;165;0,1,2;3;9;1;1;1
250584926752;250584926782;30;0,1,2;3;9;1;1;1
250584926782;250584927090;308;0,1,2;3;9;1;1;1
250584927090;250584927546;456;0,1,2;3;9;1;1;1
250584927546;250584927941;395;0,1,2;3;9;1;1;1
250584927941;250584928111;170;0,1,2;3;9;1;1;1
250584928111;250584928349;238;0,1,2;3;9;1;1;1
250584928349;250584928658;309;0,1,2;3;9;1;1;1
250584928658;250584928843;185;0,1,2;3;9;1;1;1
250584928843;250584929133;290;0,1,2;3;9;1;1;1
250584929133;250584929226;93;0,1,2;3;9;1;1;1
250584929226;250584929466;240;0,1,2;3;9;1;1;1
250584929466;250584930003;537;0,1,2;3;9;1;1;1
250584930003;250584931697;1694;0,1,2;3;9;1;1;1
250584931697;250584932821;1124;0,1,2;3;9;1;1;1
250584932821;250584933025;204;0,1,2;3;9;1;1;1
250584933025;250584933940;915;0,1,2;3;9;1;1;1
250584933940;250584934063;123;0,1,2;3;9;1;1;1
250584934063;250584934202;139;0,1,2;3;9;1;1;1
250584934202;250584935141;939;0,1,2;3;9;1;1;1
250584935141;250584935865;724;0,1,2;3;9;1;1;1
250584935865;250584936085;220;0,1,2;3;9;1;1;1
250584936085;250584936087;2;0,1,2;3;9;1;1;1
250584936087;250584936287;200;0,1,2;3;9;1;1;1
250584936287;250584936389;102;0,1,2;3;9;1;1;1
250584936389;250584936439;50;0,1,2;3;9;1;1;1
250584936439;250584936761;322;0,1,2;3;9;1;1;1
250584936761;250584936880;119;0,1,2;3;9;1;1;1
250584936880;250584937556;676;0,1,2;3;9;1;1;1
250584937556;250584938291;735;0,1,2;3;9;1;1;1
250584938291;250584939333;1042;0,1,2;3;9;1;1;1
250584939333;250584940085;752;0,1,2;3;9;1;1;1
250584940085;250584940330;245;0,1,2;3;9;1;1;1
250584940330;250584940502;172;0,1,2;3;9;1;1;1
250584940502;250584940910;408;0,1,2;3;9;1;1;1
250584940910;250584941287;377;0,1,2;3;9;1;1;1
250584941287;250584941553;266;0,1,2;3;9;1;1;1
250584941553;250584942081;528;0,1,2;3;9;1;1;1
250584942081;250584942242;161;0,1,2;3;9;1;1;1
250584942242;250584942919;677;0,1,2;3;9;1;1;1
250584942919;250584943124;205;0,1,2;3;9;1;1;1
250584943124;250584943292;168;0,1,2;3;9;1;1;1
250584943292;250584943440;148;0,1,2;3;9;1;1;1
250584943440;250584943637;197;0,1,2;3;9;1;1;1
250584943637;250584943685;48;0,1,2;3;9;1;1;1
250584943685;250584943790;105;0,1,2;3;9;1;1;1
250584943790;250584943966;176;0,1,2;3;9;1;1;1
250584943966;250584944111;145;0,1,2;3;9;1;1;1
250584944111;250584944204;93;0,1,2;3;9;1;1;1
250584944204;250584944340;136;0,1,2;3;9;1;1;1
250584944340;250584944509;169;0,1,2;3;9;1;1;1
250584944509;250584944699;190;0,1,2;3;9;1;1;1
250584944699;250584944730;31;0,1,2;3;9;1;1;1
250584944730;250584944789;59;0,1,2;3;9;1;1;1
250584944789;250584945103;314;0,1,2;3;9;1;1;1
250584945103;250584945323;220;0,1,2;3;9;1;1;1
250584945323;250584945346;23;0,1,2;3;9;1;1;1
250584945346;250584945388;42;0,1,2;3;9;1;1;1
250584945388;250584945486;98;0,1,2;3;9;1;1;1
250584945486;250584945539;53;0,1,2;3;9;1;1;1
250584945539;250584946181;642;0,1,2;3;9;1;1;1
250584946181;250584946698;517;0,1,2;3;9;1;1;1
250584946698;250584947267;569;0,1,2;3;9;1;1;1
250584947267;250584947827;560;0,1,2;3;9;1;1;1
250584947827;250584948281;454;0,1,2;3;9;1;1;1
250584948281;250584948471;190;0,1,2;3;9;1;1;1
250584948471;250584948529;58;0,1,2;3;9;1;1;1
250584948529;250584948607;78;0,1,2;3;9;1;1;1
250584948607;250584948890;283;0,1,2;3;9;1;1;1
250584948890;250584949274;384;0,1,2;3;9;1;1;1
250584949274;250584949336;62;0,1,2;3;9;1;1;1
250584949336;250584950684;1348;0,1,2;3;9;1;1;1
250584950684;250584951154;470;0,1,2;3;9;1;1;1
250584951154;250584951832;678;0,1,2;3;9;1;1;1
250584951832;250584952139;307;0,1,2;3;9;1;1;1
250584952139;250584952147;8;0,1,2;3;9;1;1;1
250584952147;250584953790;1643;0,1,2;3;9;1;1;1
250584953790;250584953843;53;0,1,2;3;9;1;1;1
250584953843;250584954048;205;0,1,2;3;9;1;1;1
250584954048;250584954063;15;0,1,2;3;9;1;1;1
250584954063;250584954160;97;0,1,2;3;9;1;1;1
250584954160;250584954788;628;0,1,2;3;9;1;1;1
250584954788;250584955035;247;0,1,2;3;9;1;1;1
250584955035;250584955569;534;0,1,2;3;9;1;1;1
250584955569;250584955677;108;0,1,2;3;9;1;1;1
250584955677;250584955926;249;0,1,2;3;9;1;1;1
250584955926;250584955969;43;0,1,2;3;9;1;1;1
250584955969;250584956087;118;0,1,2;3;9;1;1;1
250584956087;250584956928;841;0,1,2;3;9;1;1;1
250584956928;250584957160;232;0,1,2;3;9;1;1;1
250584957160;250584957296;136;0,1,2;3;9;1;1;1
250584957296;250584957417;121;0,1,2;3;9;1;1;1
250584957417;250584957613;196;0,1,2;3;9;1;1;1
250584957613;250584957656;43;0,1,2;3;9;1;1;1
250584957656;250584957734;78;0,1,2;3;9;1;1;1
250584957734;250584958690;956;0,1,2;3;9;1;1;1
250584958690;250584958846;156;0,1,2;3;9;1;1;1
250584958846;250584958976;130;0,1,2;3;9;1;1;1
250584958976;250584959116;140;0,1,2;3;9;1;1;1
250584959116;250584959128;12;0,1,2;3;9;1;1;1
250584959128;250584959259;131;0,1,2;3;9;1;1;1
250584959259;250584959338;79;0,1,2;3;9;1;1;1
250584959338;250584959453;115;0,1,2;3;9;1;1;1
250584959453;250584959560;107;0,1,2;3;9;1;1;1
250584959560;250584959681;121;0,1,2;3;9;1;1;1
250584959681;250584959885;204;0,1,2;3;9;1;1;1
250584959885;250584959990;105;0,1,2;3;9;1;1;1
250584959990;250584960087;97;0,1,2;3;9;1;1;1
250584960087;250584960476;389;0,1,2;3;9;1;1;1
250584960476;250584960484;8;0,1,2;3;9;1;1;1
250584960484;250584960881;397;0,1,2;3;9;1;1;1
250584960881;250584961047;166;0,1,2;3;9;1;1;1
250584961047;250584961071;24;0,1,2;3;9;1;1;1
250584961071;250584961347;276;0,1,2;3;9;1;1;1
250584961347;250584961415;68;0,1,2;3;9;1;1;1
250584961415;250584961715;300;0,1,2;3;9;1;1;1
250584961715;250584961758;43;0,1,2;3;9;1;1;1
250584961758;250584961822;64;0,1,2;3;9;1;1;1
250584961822;250584962010;188;0,1,2;3;9;1;1;1
250584962010;250584962046;36;0,1,2;3;9;1;1;1
250584962046;250584962276;230;0,1,2;3;9;1;1;1
250584962276;250584962375;99;0,1,2;3;9;1;1;1
250584962375;250584962426;51;0,1,2;3;9;1;1;1
250584962426;250584962506;80;0,1,2;3;9;1;1;1
250584962506;250584962839;333;0,1,2;3;9;1;1;1
250584962839;250584963032;193;0,1,2;3;9;1;1;1
250584963032;250584963104;72;0,1,2;3;9;1;1;1
250584963104;250584963240;136;0,1,2;3;9;1;1;1
250584963240;250584963377;137;0,1,2;3;9;1;1;1
250584963377;250584963534;157;0,1,2;3;9;1;1;1
250584963534;250584963836;302;0,1,2;3;9;1;1;1
250584963836;250584963991;155;0,1,2;3;9;1;1;1
250584963991;250584964181;190;0,1,2;3;9;1;1;1
250584964181;250584964397;216;0,1,2;3;9;1;1;1
250584964397;250584964412;15;0,1,2;3;9;1;1;1
250584964412;250584964658;246;0,1,2;3;9;1;1;1
250584964658;250584964758;100;0,1,2;3;9;1;1;1
250584964758;250584964830;72;0,1,2;3;9;1;1;1
250584964830;250584965111;281;0,1,2;3;9;1;1;1
250584965111;250584965208;97;0,1,2;3;9;1;1;1
250584965208;250584965351;143;0,1,2;3;9;1;1;1
250584965351;250584965427;76;0,1,2;3;9;1;1;1
250584965427;250584965592;165;0,1,2;3;9;1;1;1
250584965592;250584965690;98;0,1,2;3;9;1;1;1
250584965690;250584965789;99;0,1,2;3;9;1;1;1
250584965789;250584966023;234;0,1,2;3;9;1;1;1
250584966023;250584966352;329;0,1,2;3;9;1;1;1
250584966352;250584966854;502;0,1,2;3;9;1;1;1
250584966854;250584966934;80;0,1,2;3;9;1;1;1
250584966934;250584966959;25;0,1,2;3;9;1;1;1
250584966959;250584967139;180;0,1,2;3;9;1;1;1
250584967139;250584967141;2;0,1,2;3;9;1;1;1
250584967141;250584967247;106;0,1,2;3;9;1;1;1
250584967247;250584967290;43;0,1,2;3;9;1;1;1
250584967290;250584967316;26;0,1,2;3;9;1;1;1
250584967316;250584967436;120;0,1,2;3;9;1;1;1
250584967436;250584967544;108;0,1,2;3;9;1;1;1
250584967544;250584967626;82;0,1,2;3;9;1;1;1
250584967626;250584967656;30;0,1,2;3;9;1;1;1
250584967656;250584968081;425;0,1,2;3;9;1;1;1
250584968081;250584968201;120;0,1,2;3;9;1;1;1
250584968201;250584968309;108;0,1,2;3;9;1;1;1
250584968309;250584968410;101;0,1,2;3;9;1;1;1
250584968410;250584968461;51;0,1,2;3;9;1;1;1
250584968461;250584968543;82;0,1,2;3;9;1;1;1
250584968543;250584968770;227;0,1,2;3;9;1;1;1
250584968770;250584968778;8;0,1,2;3;9;1;1;1
250584968778;250584969013;235;0,1,2;3;9;1;1;1
250584969013;250584969206;193;0,1,2;3;9;1;1;1
250584969206;250584969231;25;0,1,2;3;9;1;1;1
250584969231;250584969491;260;0,1,2;3;9;1;1;1
250584969491;250584969951;460;0,1,2;3;9;1;1;1
250584969951;250584970055;104;0,1,2;3;9;1;1;1
250584970055;250584970570;515;0,1,2;3;9;1;1;1
250584970570;250584970641;71;0,1,2;3;9;1;1;1
250584970641;250584971515;874;0,1,2;3;9;1;1;1
250584971515;250584971637;122;0,1,2;3;9;1;1;1
250584971637;250584971748;111;0,1,2;3;9;1;1;1
250584971748;250584971870;122;0,1,2;3;9;1;1;1
250584971870;250584971971;101;0,1,2;3;9;1;1;1
250584971971;250584972206;235;0,1,2;3;9;1;1;1
250584972206;250584972676;470;0,1,2;3;9;1;1;1
250584972676;250584974048;1372;0,1,2;3;9;1;1;1
250584974048;250584975058;1010;0,1,2;3;9;1;1;1
250584975058;250584977071;2013;0,1,2;3;9;1;1;1
250584977071;250584977194;123;0,1,2;3;9;1;1;1
250584977194;250584977463;269;0,1,2;3;9;1;1;1
250584977463;250584977600;137;0,1,2;3;9;1;1;1
250584977600;250584977952;352;0,1,2;3;9;1;1;1
250584977952;250584978605;653;0,1,2;3;9;1;1;1
250584978605;250584978617;12;0,1,2;3;9;1;1;1
250584978617;250584979239;622;0,1,2;3;9;1;1;1
250584979239;250584979476;237;0,1,2;3;9;1;1;1
250584979476;250584979589;113;0,1,2;3;9;1;1;1
250584979589;250584979803;214;0,1,2;3;9;1;1;1
250584979803;250584980019;216;0,1,2;3;9;1;1;1
250584980019;250584980309;290;0,1,2;3;9;1;1;1
250584980309;250584981050;741;0,1,2;3;9;1;1;1
250584981050;250584981148;98;0,1,2;3;9;1;1;1
250584981148;250584982196;1048;0,1,2;3;9;1;1;1
250584982196;250584982308;112;0,1,2;3;9;1;1;1
250584982308;250584982936;628;0,1,2;3;9;1;1;1
250584982936;250584983799;863;0,1,2;3;9;1;1;1
250584983799;250584984358;559;0,1,2;3;9;1;1;1
250584984358;250584984701;343;0,1,2;3;9;1;1;1
250584984701;250584984800;99;0,1,2;3;9;1;1;1
250584984800;250584984971;171;0,1,2;3;9;1;1;1
250584984971;250584985083;112;0,1,2;3;9;1;1;1
250584985083;250584986818;1735;0,1,2;3;9;1;1;1
250584986818;250584987075;257;0,1,2;3;9;1;1;1
250584987075;250584987186;111;0,1,2;3;9;1;1;1
250584987186;250584987314;128;0,1,2;3;9;1;1;1
250584987314;250584987447;133;0,1,2;3;9;1;1;1
250584987447;250584987793;346;0,1,2;3;9;1;1;1
250584987793;250584988182;389;0,1,2;3;9;1;1;1
250584988182;250584988398;216;0,1,2;3;9;1;1;1
250584988398;250584988964;566;0,1,2;3;9;1;1;1
250584988964;250584989083;119;0,1,2;3;9;1;1;1
250584989083;250584989576;493;0,1,2;3;9;1;1;1
250584989576;250584989813;237;0,1,2;3;9;1;1;1
250584989813;250584991662;1849;0,1,2;3;9;1;1;1
250584991662;250584993378;1716;0,1,2;3;9;1;1;1
250584993378;250584995365;1987;0,1,2;3;9;1;1;1
250584995365;250584995464;99;0,1,2;3;9;1;1;1
250584995464;250584995598;134;0,1,2;3;9;1;1;1
250584995598;250584996650;1052;0,1,2;3;9;1;1;1
250584996650;250584996661;11;0,1,2;3;9;1;1;1
250584996661;250584997254;593;0,1,2;3;9;1;1;1
250584997254;250584998196;942;0,1,2;3;9;1;1;1
250584998196;250584998504;308;0,1,2;3;9;1;1;1
250584998504;250584998964;460;0,1,2;3;9;1;1;1
250584998964;250584999277;313;0,1,2;3;9;1;1;1
250584999277;250584999586;309;0,1,2;3;9;1;1;1
250584999586;250584999678;92;0,1,2;3;9;1;1;1
250584999678;250585000015;337;0,1,2;3;9;1;1;1
250585000015;250585001080;1065;0,1,2;3;9;1;1;1
250585001080;250585001980;900;0,1,2;3;9;1;1;1
250585001980;250585002339;359;0,1,2;3;9;1;1;1
250585002339;250585002508;169;0,1,2;3;9;1;1;1
250585002508;250585002617;109;0,1,2;3;9;1;1;1
250585002617;250585003472;855;0,1,2;3;9;1;1;1
250585003472;250585005976;2504;0,1,2;3;9;1;1;1
250585005976;250585007563;1587;0,1,2;3;9;1;1;1
250585007563;250585007655;92;0,1,2;3;9;1;1;1
250585007655;250585007738;83;0,1,2;3;9;1;1;1
250585007738;250585007896;158;0,1,2;3;9;1;1;1
250585007896;250585007989;93;0,1,2;3;9;1;1;1
250585007989;250585008192;203;0,1,2;3;9;1;1;1
250585008192;250585008692;500;0,1,2;3;9;1;1;1
250585008692;250585009855;1163;0,1,2;3;9;1;1;1
250585009855;250585010366;511;0,1,2;3;9;1;1;1
250585010366;250585010476;110;0,1,2;3;9;1;1;1
250585010476;250585011241;765;0,1,2;3;9;1;1;1
250585011241;250585011569;328;0,1,2;3;9;1;1;1
250585011569;250585012566;997;0,1,2;3;9;1;1;1
250585012566;250585013166;600;0,1,2;3;9;1;1;1
250585013166;250585013505;339;0,1,2;3;9;1;1;1
250585013505;250585014536;1031;0,1,2;3;9;1;1;1
250585014536;250585015398;862;0,1,2;3;9;1;1;1
250585015398;250585016348;950;0,1,2;3;9;1;1;1
250585016348;250585017796;1448;0,1,2;3;9;1;1;1
250585017796;250585017893;97;0,1,2;3;9;1;1;1
250585017893;250585018280;387;0,1,2;3;9;1;1;1
250585018280;250585020006;1726;0,1,2;3;9;1;1;1
250585020006;250585020337;331;0,1,2;3;9;1;1;1
250585020337;250585021133;796;0,1,2;3;9;1;1;1
250585021133;250585021399;266;0,1,2;3;9;1;1;1
250585021399;250585021722;323;0,1,2;3;9;1;1;1
250585021722;250585022576;854;0,1,2;3;9;1;1;1
250585022576;250585022697;121;0,1,2;3;9;1;1;1
250585022697;250585024196;1499;0,1,2;3;9;1;1;1
250585024196;250585025218;1022;0,1,2;3;9;1;1;1
250585025218;250585025503;285;0,1,2;3;9;1;1;1
250585025503;250585027585;2082;0,1,2;3;9;1;1;1
250585027585;250585027963;378;0,1,2;3;9;1;1;1
250585027963;250585029866;1903;0,1,2;3;9;1;1;1
250585029866;250585031185;1319;0,1,2;3;9;1;1;1
250585031185;250585032357;1172;0,1,2;3;9;1;1;1
250585032357;250585035735;3378;0,1,2;3;9;1;1;1
250585035735;250585038671;2936;0,1,2;3;9;1;1;1
250585038671;250585040996;2325;0,1,2;3;9;1;1;1
250585040996;250585041101;105;0,1,2;3;9;1;1;1
250585041101;250585041358;257;0,1,2;3;9;1;1;1
250585041358;250585041456;98;0,1,2;3;9;1;1;1
250585041456;250585042032;576;0,1,2;3;9;1;1;1
250585042032;250585042603;571;0,1,2;3;9;1;1;1
250585042603;250585042711;108;0,1,2;3;9;1;1;1
250585042711;250585043606;895;0,1,2;3;9;1;1;1
250585043606;250585045082;1476;0,1,2;3;9;1;1;1
250585045082;250585045582;500;0,1,2;3;9;1;1;1
250585045582;250585045768;186;0,1,2;3;9;1;1;1
250585045768;250585045867;99;0,1,2;3;9;1;1;1
250585045867;250585046171;304;0,1,2;3;9;1;1;1
250585046171;250585046521;350;0,1,2;3;9;1;1;1
250585046521;250585048326;1805;0,1,2;3;9;1;1;1
250585048326;250585048594;268;0,1,2;3;9;1;1;1
250585048594;250585048765;171;0,1,2;3;9;1;1;1
250585048765;250585048785;20;0,1,2;3;9;1;1;1
250585048785;250585049107;322;0,1,2;3;9;1;1;1
250585049107;250585049680;573;0,1,2;3;9;1;1;1
250585049680;250585051107;1427;0,1,2;3;9;1;1;1
250585051107;250585053300;2193;0,1,2;3;9;1;1;1
250585053300;250585053613;313;0,1,2;3;9;1;1;1
250585053613;250621599205;36545592;1,2;2;9;1;1;1
250621599205;250621599259;54;0,1,2;3;9;1;1;1
250621599259;250621616470;17211;0,1,2;3;9;1;1;1
250621616470;250621618421;1951;0,1,2;3;9;1;1;1
250621618421;250621621685;3264;1,2;2;9;1;1;1
250621621685;250621621936;251;0,1,2;3;9;1;1;1
250621621936;250621622032;96;0,1,2;3;9;1;1;1
250621622032;250621622698;666;0,1,2;3;9;1;1;1
250621622698;250621622914;216;0,1,2;3;9;1;1;1
250621622914;250621625438;2524;0,1,2;3;9;1;1;1
250621625438;250621625545;107;0,1,2;3;9;1;1;1
250621625545;250621628220;2675;0,1,2;3;9;1;1;1
250621628220;250621632140;3920;0,1,2;3;9;1;1;1
250621632140;250621632459;319;0,1,2;3;9;1;1;1
250621632459;250621632591;132;0,1,2;3;9;1;1;1
250621632591;250621633104;513;0,1,2;3;9;1;1;1
250621633104;250621633700;596;0,1,2;3;9;1;1;1
250621633700;250621634631;931;0,1,2;3;9;1;1;1
250621634631;250621634783;152;0,1,2;3;9;1;1;1
250621634783;250621634989;206;0,1,2;3;9;1;1;1
250621634989;250621635071;82;0,1,2;3;9;1;1;1
250621635071;250621637025;1954;0,1,2;3;9;1;1;1
250621637025;250621637188;163;0,1,2;3;9;1;1;1
250621637188;250621642246;5058;0,1,2;3;9;1;1;1
250621642246;250621643435;1189;0,1,2;3;9;1;1;1
250621643435;250621643462;27;0,1,2;3;9;1;1;1
250621643462;250621645993;2531;0,1,2;3;9;1;1;1
250621645993;250621646009;16;0,1,2;3;9;1;1;1
250621646009;250621647963;1954;0,1,2;3;9;1;1;1
250621647963;250621649258;1295;0,1,2;3;9;1;1;1
250621649258;250621650055;797;0,1,2;3;9;1;1;1
250621650055;250621652797;2742;0,1,2;3;9;1;1;1
250621652797;250621656798;4001;0,1,2;3;9;1;1;1
250621656798;250621656997;199;0,1,2;3;9;1;1;1
250621656997;250621657010;13;0,1,2;3;9;1;1;1
250621657010;250621657276;266;0,1,2;3;9;1;1;1
250621657276;250621659867;2591;0,1,2;3;9;1;1;1
250621659867;250621659970;103;0,1,2;3;9;1;1;1
250621659970;250621660062;92;0,1,2;3;9;1;1;1
250621660062;250621660994;932;0,1,2;3;9;1;1;1
250621660994;250621661100;106;0,1,2;3;9;1;1;1
250621661100;250621661160;60;0,1,2;3;9;1;1;1
250621661160;250621663405;2245;0,1,2;3;9;1;1;1
250621663405;250621663758;353;0,1,2;3;9;1;1;1
250621663758;250621663890;132;0,1,2;3;9;1;1;1
250621663890;250621664170;280;0,1,2;3;9;1;1;1
250621664170;250621664608;438;0,1,2;3;9;1;1;1
250621664608;250621665565;957;0,1,2;3;9;1;1;1
250621665565;250621665755;190;0,1,2;3;9;1;1;1
250621665755;250621667421;1666;0,1,2;3;9;1;1;1
250621667421;250621667520;99;0,1,2;3;9;1;1;1
250621667520;250621668140;620;0,1,2;3;9;1;1;1
250621668140;250621668387;247;0,1,2;3;9;1;1;1
250621668387;250621670030;1643;0,1,2;3;9;1;1;1
250621670030;250621671457;1427;0,1,2;3;9;1;1;1
250621671457;250621672318;861;0,1,2;3;9;1;1;1
250621672318;250621672349;31;0,1,2;3;9;1;1;1
250621672349;250621672904;555;0,1,2;3;9;1;1;1
250621672904;250621673062;158;0,1,2;3;9;1;1;1
250621673062;250621673154;92;0,1,2;3;9;1;1;1
250621673154;250621673779;625;0,1,2;3;9;1;1;1
250621673779;250621674459;680;0,1,2;3;9;1;1;1
250621674459;250621674863;404;0,1,2;3;9;1;1;1
250621674863;250621675081;218;0,1,2;3;9;1;1;1
250621675081;250621677184;2103;0,1,2;3;9;1;1;1
250621677184;250621677613;429;0,1,2;3;9;1;1;1
250621677613;250621679631;2018;0,1,2;3;9;1;1;1
250621679631;250621680099;468;0,1,2;3;9;1;1;1
250621680099;250621680674;575;0,1,2;3;9;1;1;1
250621680674;250621681245;571;0,1,2;3;9;1;1;1
250621681245;250621681457;212;0,1,2;3;9;1;1;1
250621681457;250621681606;149;0,1,2;3;9;1;1;1
250621681606;250621681720;114;0,1,2;3;9;1;1;1
250621681720;250621682081;361;0,1,2;3;9;1;1;1
250621682081;250621684105;2024;0,1,2;3;9;1;1;1
250621684105;250621684320;215;0,1,2;3;9;1;1;1
250621684320;250621684878;558;0,1,2;3;9;1;1;1
250621684878;250621685483;605;0,1,2;3;9;1;1;1
250621685483;250621686098;615;0,1,2;3;9;1;1;1
250621686098;250621686241;143;0,1,2;3;9;1;1;1
250621686241;250621686299;58;0,1,2;3;9;1;1;1
250621686299;250621686582;283;0,1,2;3;9;1;1;1
250621686582;250621686960;378;0,1,2;3;9;1;1;1
250621686960;250621687365;405;0,1,2;3;9;1;1;1
250621687365;250621689572;2207;0,1,2;3;9;1;1;1
250621689572;250621689871;299;0,1,2;3;9;1;1;1
250621689871;250621695926;6055;0,1,2;3;9;1;1;1
250621695926;250621696436;510;0,1,2;3;9;1;1;1
250621696436;250621697066;630;0,1,2;3;9;1;1;1
250621697066;250621697494;428;0,1,2;3;9;1;1;1
250621697494;250621698873;1379;0,1,2;3;9;1;1;1
250621698873;250621699256;383;0,1,2;3;9;1;1;1
250621699256;250621699693;437;0,1,2;3;9;1;1;1
250621699693;250621699783;90;0,1,2;3;9;1;1;1
250621699783;250621699959;176;0,1,2;3;9;1;1;1
250621699959;250621699966;7;0,1,2;3;9;1;1;1
250621699966;250621700020;54;0,1,2;3;9;1;1;1
250621700020;250621700228;208;0,1,2;3;9;1;1;1
250621700228;250621700235;7;0,1,2;3;9;1;1;1
250621700235;250621700658;423;0,1,2;3;9;1;1;1
250621700658;250621701164;506;0,1,2;3;9;1;1;1
250621701164;250621702146;982;0,1,2;3;9;1;1;1
250621702146;250621702306;160;0,1,2;3;9;1;1;1
250621702306;250621702678;372;0,1,2;3;9;1;1;1
250621702678;250621703128;450;0,1,2;3;9;1;1;1
250621703128;250621703536;408;0,1,2;3;9;1;1;1
250621703536;250621704271;735;0,1,2;3;9;1;1;1
250621704271;250621704579;308;0,1,2;3;9;1;1;1
250621704579;250621704901;322;0,1,2;3;9;1;1;1
250621704901;250621705454;553;0,1,2;3;9;1;1;1
250621705454;250621705641;187;0,1,2;3;9;1;1;1
250621705641;250621706113;472;0,1,2;3;9;1;1;1
250621706113;250621706260;147;0,1,2;3;9;1;1;1
250621706260;250621706321;61;0,1,2;3;9;1;1;1
250621706321;250621706359;38;0,1,2;3;9;1;1;1
250621706359;250621706512;153;0,1,2;3;9;1;1;1
250621706512;250621708625;2113;0,1,2;3;9;1;1;1
250621708625;250621709166;541;0,1,2;3;9;1;1;1
250621709166;250621709278;112;0,1,2;3;9;1;1;1
250621709278;250621709758;480;0,1,2;3;9;1;1;1
250621709758;250621709841;83;0,1,2;3;9;1;1;1
250621709841;250621710198;357;0,1,2;3;9;1;1;1
250621710198;250621710560;362;0,1,2;3;9;1;1;1
250621710560;250621710783;223;0,1,2;3;9;1;1;1
250621710783;250621710947;164;0,1,2;3;9;1;1;1
250621710947;250621711634;687;0,1,2;3;9;1;1;1
250621711634;250621711759;125;0,1,2;3;9;1;1;1
250621711759;250621712041;282;0,1,2;3;9;1;1;1
250621712041;250621712172;131;0,1,2;3;9;1;1;1
250621712172;250621712463;291;0,1,2;3;9;1;1;1
250621712463;250621712527;64;0,1,2;3;9;1;1;1
250621712527;250621713036;509;0,1,2;3;9;1;1;1
250621713036;250621714216;1180;0,1,2;3;9;1;1;1
250621714216;250621715368;1152;0,1,2;3;9;1;1;1
250621715368;250621715619;251;0,1,2;3;9;1;1;1
250621715619;250621716634;1015;0,1,2;3;9;1;1;1
250621716634;250621716845;211;0,1,2;3;9;1;1;1
250621716845;250621717344;499;0,1,2;3;9;1;1;1
250621717344;250621717426;82;0,1,2;3;9;1;1;1
250621717426;250621717521;95;0,1,2;3;9;1;1;1
250621717521;250621717607;86;0,1,2;3;9;1;1;1
250621717607;250621717670;63;0,1,2;3;9;1;1;1
250621717670;250621720094;2424;0,1,2;3;9;1;1;1
250621720094;250621720216;122;0,1,2;3;9;1;1;1
250621720216;250621720695;479;0,1,2;3;9;1;1;1
250621720695;250621720822;127;0,1,2;3;9;1;1;1
250621720822;250621721216;394;0,1,2;3;9;1;1;1
250621721216;250621721272;56;0,1,2;3;9;1;1;1
250621721272;250621721421;149;0,1,2;3;9;1;1;1
250621721421;250621722147;726;0,1,2;3;9;1;1;1
250621722147;250621722704;557;0,1,2;3;9;1;1;1
250621722704;250621723211;507;0,1,2;3;9;1;1;1
250621723211;250621723743;532;0,1,2;3;9;1;1;1
250621723743;250621724942;1199;0,1,2;3;9;1;1;1
250621724942;250621724995;53;0,1,2;3;9;1;1;1
250621724995;250621725133;138;0,1,2;3;9;1;1;1
250621725133;250621725406;273;0,1,2;3;9;1;1;1
250621725406;250621725510;104;0,1,2;3;9;1;1;1
250621725510;250621725692;182;0,1,2;3;9;1;1;1
250621725692;250621726074;382;0,1,2;3;9;1;1;1
250621726074;250621726238;164;0,1,2;3;9;1;1;1
250621726238;250621727241;1003;0,1,2;3;9;1;1;1
250621727241;250621728013;772;0,1,2;3;9;1;1;1
250621728013;250621728346;333;0,1,2;3;9;1;1;1
250621728346;250621728757;411;0,1,2;3;9;1;1;1
250621728757;250621728831;74;0,1,2;3;9;1;1;1
250621728831;250621729323;492;0,1,2;3;9;1;1;1
250621729323;250621729896;573;0,1,2;3;9;1;1;1
250621729896;250621729967;71;0,1,2;3;9;1;1;1
250621729967;250621730998;1031;0,1,2;3;9;1;1;1
250621730998;250621731214;216;0,1,2;3;9;1;1;1
250621731214;250621731621;407;0,1,2;3;9;1;1;1
250621731621;250621731763;142;0,1,2;3;9;1;1;1
250621731763;250621732779;1016;0,1,2;3;9;1;1;1
250621732779;250621732914;135;0,1,2;3;9;1;1;1
250621732914;250621733596;682;0,1,2;3;9;1;1;1
250621733596;250621733633;37;0,1,2;3;9;1;1;1
250621733633;250621733848;215;0,1,2;3;9;1;1;1
250621733848;250621733978;130;0,1,2;3;9;1;1;1
250621733978;250621734655;677;0,1,2;3;9;1;1;1
250621734655;250621734771;116;0,1,2;3;9;1;1;1
250621734771;250621735317;546;0,1,2;3;9;1;1;1
250621735317;250621735467;150;0,1,2;3;9;1;1;1
250621735467;250621735576;109;0,1,2;3;9;1;1;1
250621735576;250621736305;729;0,1,2;3;9;1;1;1
250621736305;250621736778;473;0,1,2;3;9;1;1;1
250621736778;250621736952;174;0,1,2;3;9;1;1;1
250621736952;250621737007;55;0,1,2;3;9;1;1;1
250621737007;250621737540;533;0,1,2;3;9;1;1;1
250621737540;250621737827;287;0,1,2;3;9;1;1;1
250621737827;250621738091;264;0,1,2;3;9;1;1;1
250621738091;250621738200;109;0,1,2;3;9;1;1;1
250621738200;250621738558;358;0,1,2;3;9;1;1;1
250621738558;250621738601;43;0,1,2;3;9;1;1;1
250621738601;250621738938;337;0,1,2;3;9;1;1;1
250621738938;250621739921;983;0,1,2;3;9;1;1;1
250621739921;250621740351;430;0,1,2;3;9;1;1;1
250621740351;250621740518;167;0,1,2;3;9;1;1;1
250621740518;250621740685;167;0,1,2;3;9;1;1;1
250621740685;250621740842;157;0,1,2;3;9;1;1;1
250621740842;250621741353;511;0,1,2;3;9;1;1;1
250621741353;250621741401;48;0,1,2;3;9;1;1;1
250621741401;250621741702;301;0,1,2;3;9;1;1;1
250621741702;250621743899;2197;0,1,2;3;9;1;1;1
250621743899;250621743980;81;0,1,2;3;9;1;1;1
250621743980;250621744045;65;0,1,2;3;9;1;1;1
250621744045;250621744295;250;0,1,2;3;9;1;1;1
250621744295;250621745600;1305;0,1,2;3;9;1;1;1
250621745600;250621745863;263;0,1,2;3;9;1;1;1
250621745863;250621745964;101;0,1,2;3;9;1;1;1
250621745964;250621746681;717;0,1,2;3;9;1;1;1
250621746681;250621746851;170;0,1,2;3;9;1;1;1
250621746851;250621746912;61;0,1,2;3;9;1;1;1
250621746912;250621746944;32;0,1,2;3;9;1;1;1
250621746944;250621747007;63;0,1,2;3;9;1;1;1
250621747007;250621747587;580;0,1,2;3;9;1;1;1
250621747587;250621748020;433;0,1,2;3;9;1;1;1
250621748020;250621748194;174;0,1,2;3;9;1;1;1
250621748194;250621748481;287;0,1,2;3;9;1;1;1
250621748481;250621748754;273;0,1,2;3;9;1;1;1
250621748754;250621749330;576;0,1,2;3;9;1;1;1
250621749330;250621749845;515;0,1,2;3;9;1;1;1
250621749845;250621750377;532;0,1,2;3;9;1;1;1
250621750377;250621750543;166;0,1,2;3;9;1;1;1
250621750543;250621750896;353;0,1,2;3;9;1;1;1
250621750896;250621751035;139;0,1,2;3;9;1;1;1
250621751035;250621751366;331;0,1,2;3;9;1;1;1
250621751366;250621751685;319;0,1,2;3;9;1;1;1
250621751685;250621752358;673;0,1,2;3;9;1;1;1
250621752358;250621752558;200;0,1,2;3;9;1;1;1
250621752558;250621752873;315;0,1,2;3;9;1;1;1
250621752873;250621753486;613;0,1,2;3;9;1;1;1
250621753486;250621754053;567;0,1,2;3;9;1;1;1
250621754053;250621754207;154;0,1,2;3;9;1;1;1
250621754207;250621754271;64;0,1,2;3;9;1;1;1
250621754271;250621754488;217;0,1,2;3;9;1;1;1
250621754488;250621755721;1233;0,1,2;3;9;1;1;1
250621755721;250621755895;174;0,1,2;3;9;1;1;1
250621755895;250621756257;362;0,1,2;3;9;1;1;1
250621756257;250621757085;828;0,1,2;3;9;1;1;1
250621757085;250621757087;2;0,1,2;3;9;1;1;1
250621757087;250621757135;48;0,1,2;3;9;1;1;1
250621757135;250621757393;258;0,1,2;3;9;1;1;1
250621757393;250621757520;127;0,1,2;3;9;1;1;1
250621757520;250621757711;191;0,1,2;3;9;1;1;1
250621757711;250621759303;1592;0,1,2;3;9;1;1;1
250621759303;250621759692;389;0,1,2;3;9;1;1;1
250621759692;250621759811;119;0,1,2;3;9;1;1;1
250621759811;250621759885;74;0,1,2;3;9;1;1;1
250621759885;250621760203;318;0,1,2;3;9;1;1;1
250621760203;250621761262;1059;0,1,2;3;9;1;1;1
250621761262;250621761953;691;0,1,2;3;9;1;1;1
250621761953;250621762110;157;0,1,2;3;9;1;1;1
250621762110;250621762306;196;0,1,2;3;9;1;1;1
250621762306;250621763408;1102;0,1,2;3;9;1;1;1
250621763408;250621763467;59;0,1,2;3;9;1;1;1
250621763467;250621763572;105;0,1,2;3;9;1;1;1
250621763572;250621764812;1240;0,1,2;3;9;1;1;1
250621764812;250621764891;79;0,1,2;3;9;1;1;1
250621764891;250621765635;744;0,1,2;3;9;1;1;1
250621765635;250621765691;56;0,1,2;3;9;1;1;1
250621765691;250621765777;86;0,1,2;3;9;1;1;1
250621765777;250621765874;97;0,1,2;3;9;1;1;1
250621765874;250621765969;95;0,1,2;3;9;1;1;1
250621765969;250621766272;303;0,1,2;3;9;1;1;1
250621766272;250621766315;43;0,1,2;3;9;1;1;1
250621766315;250621766573;258;0,1,2;3;9;1;1;1
250621766573;250621766682;109;0,1,2;3;9;1;1;1
250621766682;250621766997;315;0,1,2;3;9;1;1;1
250621766997;250621767286;289;0,1,2;3;9;1;1;1
250621767286;250621767298;12;0,1,2;3;9;1;1;1
250621767298;250621767345;47;0,1,2;3;9;1;1;1
250621767345;250621768178;833;0,1,2;3;9;1;1;1
250621768178;250621768314;136;0,1,2;3;9;1;1;1
250621768314;250621768348;34;0,1,2;3;9;1;1;1
250621768348;250621768448;100;0,1,2;3;9;1;1;1
250621768448;250621768751;303;0,1,2;3;9;1;1;1
250621768751;250621768846;95;0,1,2;3;9;1;1;1
250621768846;250621768949;103;0,1,2;3;9;1;1;1
250621768949;250621768970;21;0,1,2;3;9;1;1;1
250621768970;250621769335;365;0,1,2;3;9;1;1;1
250621769335;250621769400;65;0,1,2;3;9;1;1;1
250621769400;250621769474;74;0,1,2;3;9;1;1;1
250621769474;250621769529;55;0,1,2;3;9;1;1;1
250621769529;250621769540;11;0,1,2;3;9;1;1;1
250621769540;250621769626;86;0,1,2;3;9;1;1;1
250621769626;250621769844;218;0,1,2;3;9;1;1;1
250621769844;250621770196;352;0,1,2;3;9;1;1;1
250621770196;250621770311;115;0,1,2;3;9;1;1;1
250621770311;250621770370;59;0,1,2;3;9;1;1;1
250621770370;250621770429;59;0,1,2;3;9;1;1;1
250621770429;250621770454;25;0,1,2;3;9;1;1;1
250621770454;250621771096;642;0,1,2;3;9;1;1;1
250621771096;250621771158;62;0,1,2;3;9;1;1;1
250621771158;250621771301;143;0,1,2;3;9;1;1;1
250621771301;250621771359;58;0,1,2;3;9;1;1;1
250621771359;250621771521;162;0,1,2;3;9;1;1;1
250621771521;250621771642;121;0,1,2;3;9;1;1;1
250621771642;250621771916;274;0,1,2;3;9;1;1;1
250621771916;250621772072;156;0,1,2;3;9;1;1;1
250621772072;250621773273;1201;0,1,2;3;9;1;1;1
250621773273;250621773972;699;0,1,2;3;9;1;1;1
250621773972;250621774097;125;0,1,2;3;9;1;1;1
250621774097;250621774127;30;0,1,2;3;9;1;1;1
250621774127;250621774359;232;0,1,2;3;9;1;1;1
250621774359;250621774649;290;0,1,2;3;9;1;1;1
250621774649;250621774917;268;0,1,2;3;9;1;1;1
250621774917;250621774925;8;0,1,2;3;9;1;1;1
250621774925;250621775133;208;0,1,2;3;9;1;1;1
250621775133;250621775515;382;0,1,2;3;9;1;1;1
250621775515;250621775990;475;0,1,2;3;9;1;1;1
250621775990;250621776356;366;0,1,2;3;9;1;1;1
250621776356;250621776629;273;0,1,2;3;9;1;1;1
250621776629;250621779365;2736;0,1,2;3;9;1;1;1
250621779365;250621779622;257;0,1,2;3;9;1;1;1
250621779622;250621779748;126;0,1,2;3;9;1;1;1
250621779748;250621779918;170;0,1,2;3;9;1;1;1
250621779918;250621780726;808;0,1,2;3;9;1;1;1
250621780726;250621780755;29;0,1,2;3;9;1;1;1
250621780755;250621780946;191;0,1,2;3;9;1;1;1
250621780946;250621781913;967;0,1,2;3;9;1;1;1
250621781913;250621782167;254;0,1,2;3;9;1;1;1
250621782167;250621782505;338;0,1,2;3;9;1;1;1
250621782505;250621782827;322;0,1,2;3;9;1;1;1
250621782827;250621783160;333;0,1,2;3;9;1;1;1
250621783160;250621783185;25;0,1,2;3;9;1;1;1
250621783185;250621783597;412;0,1,2;3;9;1;1;1
250621783597;250621783894;297;0,1,2;3;9;1;1;1
250621783894;250621785741;1847;0,1,2;3;9;1;1;1
250621785741;250621787189;1448;0,1,2;3;9;1;1;1
250621787189;250621787553;364;0,1,2;3;9;1;1;1
250621787553;250621787651;98;0,1,2;3;9;1;1;1
250621787651;250621787715;64;0,1,2;3;9;1;1;1
250621787715;250621788183;468;0,1,2;3;9;1;1;1
250621788183;250621788697;514;0,1,2;3;9;1;1;1
250621788697;250621789415;718;0,1,2;3;9;1;1;1
250621789415;250621789883;468;0,1,2;3;9;1;1;1
250621789883;250621790902;1019;0,1,2;3;9;1;1;1
250621790902;250621791217;315;0,1,2;3;9;1;1;1
250621791217;250621791767;550;0,1,2;3;9;1;1;1
250621791767;250621791817;50;0,1,2;3;9;1;1;1
250621791817;250621792947;1130;0,1,2;3;9;1;1;1
250621792947;250621793820;873;0,1,2;3;9;1;1;1
250621793820;250621794706;886;0,1,2;3;9;1;1;1
250621794706;250621795369;663;0,1,2;3;9;1;1;1
250621795369;250621795577;208;0,1,2;3;9;1;1;1
250621795577;250621796408;831;0,1,2;3;9;1;1;1
250621796408;250621796599;191;0,1,2;3;9;1;1;1
250621796599;250621796726;127;0,1,2;3;9;1;1;1
250621796726;250621796826;100;0,1,2;3;9;1;1;1
250621796826;250621797160;334;0,1,2;3;9;1;1;1
250621797160;250621797386;226;0,1,2;3;9;1;1;1
250621797386;250621797821;435;0,1,2;3;9;1;1;1
250621797821;250621798130;309;0,1,2;3;9;1;1;1
250621798130;250621798217;87;0,1,2;3;9;1;1;1
250621798217;250621798425;208;0,1,2;3;9;1;1;1
250621798425;250621799049;624;0,1,2;3;9;1;1;1
250621799049;250621800272;1223;0,1,2;3;9;1;1;1
250621800272;250621800441;169;0,1,2;3;9;1;1;1
250621800441;250621801481;1040;0,1,2;3;9;1;1;1
250621801481;250621802284;803;0,1,2;3;9;1;1;1
250621802284;250621803279;995;0,1,2;3;9;1;1;1
250621803279;250621803499;220;0,1,2;3;9;1;1;1
250621803499;250621803745;246;0,1,2;3;9;1;1;1
250621803745;250621803900;155;0,1,2;3;9;1;1;1
250621803900;250621804156;256;0,1,2;3;9;1;1;1
250621804156;250621804540;384;0,1,2;3;9;1;1;1
250621804540;250621804644;104;0,1,2;3;9;1;1;1
250621804644;250621804785;141;0,1,2;3;9;1;1;1
250621804785;250621805407;622;0,1,2;3;9;1;1;1
250621805407;250621806108;701;0,1,2;3;9;1;1;1
250621806108;250621806400;292;0,1,2;3;9;1;1;1
250621806400;250621806576;176;0,1,2;3;9;1;1;1
250621806576;250621806903;327;0,1,2;3;9;1;1;1
250621806903;250621809786;2883;0,1,2;3;9;1;1;1
250621809786;250621810005;219;0,1,2;3;9;1;1;1
250621810005;250621810131;126;0,1,2;3;9;1;1;1
250621810131;250621810358;227;0,1,2;3;9;1;1;1
250621810358;250621810519;161;0,1,2;3;9;1;1;1
250621810519;250621811317;798;0,1,2;3;9;1;1;1
250621811317;250621811374;57;0,1,2;3;9;1;1;1
250621811374;250621811594;220;0,1,2;3;9;1;1;1
250621811594;250621812003;409;0,1,2;3;9;1;1;1
250621812003;250621812744;741;0,1,2;3;9;1;1;1
250621812744;250621812775;31;0,1,2;3;9;1;1;1
250621812775;250621812802;27;0,1,2;3;9;1;1;1
250621812802;250621812907;105;0,1,2;3;9;1;1;1
250621812907;250621813040;133;0,1,2;3;9;1;1;1
250621813040;250621813125;85;0,1,2;3;9;1;1;1
250621813125;250621813247;122;0,1,2;3;9;1;1;1
250621813247;250621813530;283;0,1,2;3;9;1;1;1
250621813530;250621813543;13;0,1,2;3;9;1;1;1
250621813543;250621814049;506;0,1,2;3;9;1;1;1
250621814049;250621814054;5;0,1,2;3;9;1;1;1
250621814054;250621814114;60;0,1,2;3;9;1;1;1
250621814114;250621814179;65;0,1,2;3;9;1;1;1
250621814179;250621814263;84;0,1,2;3;9;1;1;1
250621814263;250621814289;26;0,1,2;3;9;1;1;1
250621814289;250621814348;59;0,1,2;3;9;1;1;1
250621814348;250621814643;295;0,1,2;3;9;1;1;1
250621814643;250621814702;59;0,1,2;3;9;1;1;1
250621814702;250621814868;166;0,1,2;3;9;1;1;1
250621814868;250621815262;394;0,1,2;3;9;1;1;1
250621815262;250621815967;705;0,1,2;3;9;1;1;1
250621815967;250621816346;379;0,1,2;3;9;1;1;1
250621816346;250621816800;454;0,1,2;3;9;1;1;1
250621816800;250621816867;67;0,1,2;3;9;1;1;1
250621816867;250621817072;205;0,1,2;3;9;1;1;1
250621817072;250621817167;95;0,1,2;3;9;1;1;1
250621817167;250621817345;178;0,1,2;3;9;1;1;1
250621817345;250621817422;77;0,1,2;3;9;1;1;1
250621817422;250621817577;155;0,1,2;3;9;1;1;1
250621817577;250621817864;287;0,1,2;3;9;1;1;1
250621817864;250621817928;64;0,1,2;3;9;1;1;1
250621817928;250621818118;190;0,1,2;3;9;1;1;1
250621818118;250621818167;49;0,1,2;3;9;1;1;1
250621818167;250621818260;93;0,1,2;3;9;1;1;1
250621818260;250621818266;6;0,1,2;3;9;1;1;1
250621818266;250621818392;126;0,1,2;3;9;1;1;1
250621818392;250621818828;436;0,1,2;3;9;1;1;1
250621818828;250621818942;114;0,1,2;3;9;1;1;1
250621818942;250621819442;500;0,1,2;3;9;1;1;1
250621819442;250621819524;82;0,1,2;3;9;1;1;1
250621819524;250621819884;360;0,1,2;3;9;1;1;1
250621819884;250621819914;30;0,1,2;3;9;1;1;1
250621819914;250621820187;273;0,1,2;3;9;1;1;1
250621820187;250621820463;276;0,1,2;3;9;1;1;1
250621820463;250621820588;125;0,1,2;3;9;1;1;1
250621820588;250621820719;131;0,1,2;3;9;1;1;1
250621820719;250621820996;277;0,1,2;3;9;1;1;1
250621820996;250621821079;83;0,1,2;3;9;1;1;1
250621821079;250621822111;1032;0,1,2;3;9;1;1;1
250621822111;250621823492;1381;0,1,2;3;9;1;1;1
250621823492;250621823591;99;0,1,2;3;9;1;1;1
250621823591;250621824197;606;0,1,2;3;9;1;1;1
250621824197;250621824304;107;0,1,2;3;9;1;1;1
250621824304;250621824420;116;0,1,2;3;9;1;1;1
250621824420;250621824615;195;0,1,2;3;9;1;1;1
250621824615;250621825547;932;0,1,2;3;9;1;1;1
250621825547;250621825627;80;0,1,2;3;9;1;1;1
250621825627;250621825682;55;0,1,2;3;9;1;1;1
250621825682;250621826013;331;0,1,2;3;9;1;1;1
250621826013;250621826201;188;0,1,2;3;9;1;1;1
250621826201;250621827539;1338;0,1,2;3;9;1;1;1
250621827539;250621827685;146;0,1,2;3;9;1;1;1
250621827685;250621828139;454;0,1,2;3;9;1;1;1
250621828139;250621828434;295;0,1,2;3;9;1;1;1
250621828434;250621828892;458;0,1,2;3;9;1;1;1
250621828892;250621828989;97;0,1,2;3;9;1;1;1
250621828989;250621829075;86;0,1,2;3;9;1;1;1
250621829075;250621829799;724;0,1,2;3;9;1;1;1
250621829799;250621830189;390;0,1,2;3;9;1;1;1
250621830189;250621830772;583;0,1,2;3;9;1;1;1
250621830772;250621831269;497;0,1,2;3;9;1;1;1
250621831269;250621831404;135;0,1,2;3;9;1;1;1
250621831404;250621831428;24;0,1,2;3;9;1;1;1
250621831428;250621831450;22;0,1,2;3;9;1;1;1
250621831450;250621831553;103;0,1,2;3;9;1;1;1
250621831553;250621832164;611;0,1,2;3;9;1;1;1
250621832164;250621833181;1017;0,1,2;3;9;1;1;1
250621833181;250621833182;1;0,1,2;3;9;1;1;1
250621833182;250621833352;170;0,1,2;3;9;1;1;1
250621833352;250621834139;787;0,1,2;3;9;1;1;1
250621834139;250621834712;573;0,1,2;3;9;1;1;1
250621834712;250621836394;1682;0,1,2;3;9;1;1;1
250621836394;250621836633;239;0,1,2;3;9;1;1;1
250621836633;250621836834;201;0,1,2;3;9;1;1;1
250621836834;250621837905;1071;0,1,2;3;9;1;1;1
250621837905;250621838191;286;0,1,2;3;9;1;1;1
250621838191;250621838679;488;0,1,2;3;9;1;1;1
250621838679;250621838885;206;0,1,2;3;9;1;1;1
250621838885;250621839449;564;0,1,2;3;9;1;1;1
250621839449;250621839607;158;0,1,2;3;9;1;1;1
250621839607;250621839719;112;0,1,2;3;9;1;1;1
250621839719;250621840051;332;0,1,2;3;9;1;1;1
250621840051;250621840309;258;0,1,2;3;9;1;1;1
250621840309;250621840966;657;0,1,2;3;9;1;1;1
250621840966;250621841012;46;0,1,2;3;9;1;1;1
250621841012;250621841732;720;0,1,2;3;9;1;1;1
250621841732;250621843376;1644;0,1,2;3;9;1;1;1
250621843376;250621843833;457;0,1,2;3;9;1;1;1
250621843833;250621844246;413;0,1,2;3;9;1;1;1
250621844246;250621844980;734;0,1,2;3;9;1;1;1
250621844980;250621846965;1985;0,1,2;3;9;1;1;1
250621846965;250621846977;12;0,1,2;3;9;1;1;1
250621846977;250621847098;121;0,1,2;3;9;1;1;1
250621847098;250621848038;940;0,1,2;3;9;1;1;1
250621848038;250621848838;800;0,1,2;3;9;1;1;1
250621848838;250621848962;124;0,1,2;3;9;1;1;1
250621848962;250621849024;62;0,1,2;3;9;1;1;1
250621849024;250621849277;253;0,1,2;3;9;1;1;1
250621849277;250621850038;761;0,1,2;3;9;1;1;1
250621850038;250621850327;289;0,1,2;3;9;1;1;1
250621850327;250621852175;1848;0,1,2;3;9;1;1;1
250621852175;250621852970;795;0,1,2;3;9;1;1;1
250621852970;250621852989;19;0,1,2;3;9;1;1;1
250621852989;250621853089;100;0,1,2;3;9;1;1;1
250621853089;250621853153;64;0,1,2;3;9;1;1;1
250621853153;250621855252;2099;0,1,2;3;9;1;1;1
250621855252;250621855676;424;0,1,2;3;9;1;1;1
250621855676;250621855813;137;0,1,2;3;9;1;1;1
250621855813;250621856092;279;0,1,2;3;9;1;1;1
250621856092;250621857286;1194;0,1,2;3;9;1;1;1
250621857286;250621857352;66;0,1,2;3;9;1;1;1
250621857352;250621857430;78;0,1,2;3;9;1;1;1
250621857430;250621858067;637;0,1,2;3;9;1;1;1
250621858067;250621858389;322;0,1,2;3;9;1;1;1
250621858389;250621858443;54;0,1,2;3;9;1;1;1
250621858443;250621860273;1830;0,1,2;3;9;1;1;1
250621860273;250621860477;204;0,1,2;3;9;1;1;1
250621860477;250621860559;82;0,1,2;3;9;1;1;1
250621860559;250621860822;263;0,1,2;3;9;1;1;1
250621860822;250621861596;774;0,1,2;3;9;1;1;1
250621861596;250621862850;1254;0,1,2;3;9;1;1;1
250621862850;250621862908;58;0,1,2;3;9;1;1;1
250621862908;250621862924;16;0,1,2;3;9;1;1;1
250621862924;250621863070;146;0,1,2;3;9;1;1;1
250621863070;250621864204;1134;0,1,2;3;9;1;1;1
250621864204;250621864809;605;0,1,2;3;9;1;1;1
250621864809;250621864868;59;0,1,2;3;9;1;1;1
250621864868;250621864931;63;0,1,2;3;9;1;1;1
250621864931;250621865316;385;0,1,2;3;9;1;1;1
250621865316;250621865880;564;0,1,2;3;9;1;1;1
250621865880;250621866661;781;0,1,2;3;9;1;1;1
250621866661;250621866756;95;0,1,2;3;9;1;1;1
250621866756;250621866867;111;0,1,2;3;9;1;1;1
250621866867;250621866876;9;0,1,2;3;9;1;1;1
250621866876;250621867429;553;0,1,2;3;9;1;1;1
250621867429;250621867495;66;0,1,2;3;9;1;1;1
250621867495;250621867663;168;0,1,2;3;9;1;1;1
250621867663;250621868549;886;0,1,2;3;9;1;1;1
250621868549;250621868609;60;0,1,2;3;9;1;1;1
250621868609;250621868656;47;0,1,2;3;9;1;1;1
250621868656;250621868804;148;0,1,2;3;9;1;1;1
250621868804;250621869015;211;0,1,2;3;9;1;1;1
250621869015;250621869126;111;0,1,2;3;9;1;1;1
250621869126;250621869245;119;0,1,2;3;9;1;1;1
250621869245;250621869403;158;0,1,2;3;9;1;1;1
250621869403;250621869428;25;0,1,2;3;9;1;1;1
250621869428;250621869485;57;0,1,2;3;9;1;1;1
250621869485;250621869693;208;0,1,2;3;9;1;1;1
250621869693;250621869767;74;0,1,2;3;9;1;1;1
250621869767;250621869879;112;0,1,2;3;9;1;1;1
250621869879;250621870052;173;0,1,2;3;9;1;1;1
250621870052;250621870104;52;0,1,2;3;9;1;1;1
250621870104;250621872173;2069;0,1,2;3;9;1;1;1
250621872173;250621872218;45;0,1,2;3;9;1;1;1
250621872218;250621872362;144;0,1,2;3;9;1;1;1
250621872362;250621872455;93;0,1,2;3;9;1;1;1
250621872455;250621872610;155;0,1,2;3;9;1;1;1
250621872610;250621872637;27;0,1,2;3;9;1;1;1
250621872637;250621872850;213;0,1,2;3;9;1;1;1
250621872850;250621872902;52;0,1,2;3;9;1;1;1
250621872902;250621874272;1370;0,1,2;3;9;1;1;1
250621874272;250621874303;31;0,1,2;3;9;1;1;1
250621874303;250621874460;157;0,1,2;3;9;1;1;1
250621874460;250621875284;824;0,1,2;3;9;1;1;1
250621875284;250621875631;347;0,1,2;3;9;1;1;1
250621875631;250621876117;486;0,1,2;3;9;1;1;1
250621876117;250621876262;145;0,1,2;3;9;1;1;1
250621876262;250621876322;60;0,1,2;3;9;1;1;1
250621876322;250621877018;696;0,1,2;3;9;1;1;1
250621877018;250621877098;80;0,1,2;3;9;1;1;1
250621877098;250621877688;590;0,1,2;3;9;1;1;1
250621877688;250621878544;856;0,1,2;3;9;1;1;1
250621878544;250621878718;174;0,1,2;3;9;1;1;1
250621878718;250621878994;276;0,1,2;3;9;1;1;1
250621878994;250621879026;32;0,1,2;3;9;1;1;1
250621879026;250621879104;78;0,1,2;3;9;1;1;1
250621879104;250621879780;676;0,1,2;3;9;1;1;1
250621879780;250621880302;522;0,1,2;3;9;1;1;1
250621880302;250621880392;90;0,1,2;3;9;1;1;1
250621880392;250621880613;221;0,1,2;3;9;1;1;1
250621880613;250621880658;45;0,1,2;3;9;1;1;1
250621880658;250621880683;25;0,1,2;3;9;1;1;1
250621880683;250621880715;32;0,1,2;3;9;1;1;1
250621880715;250621880764;49;0,1,2;3;9;1;1;1
250621880764;250621881014;250;0,1,2;3;9;1;1;1
250621881014;250621881425;411;0,1,2;3;9;1;1;1
250621881425;250621881850;425;0,1,2;3;9;1;1;1
250621881850;250621882296;446;0,1,2;3;9;1;1;1
250621882296;250621882376;80;0,1,2;3;9;1;1;1
250621882376;250621883174;798;0,1,2;3;9;1;1;1
250621883174;250621883320;146;0,1,2;3;9;1;1;1
250621883320;250621883676;356;0,1,2;3;9;1;1;1
250621883676;250621883735;59;0,1,2;3;9;1;1;1
250621883735;250621883743;8;0,1,2;3;9;1;1;1
250621883743;250621883973;230;0,1,2;3;9;1;1;1
250621883973;250621883984;11;0,1,2;3;9;1;1;1
250621883984;250621884013;29;0,1,2;3;9;1;1;1
250621884013;250621884017;4;0,1,2;3;9;1;1;1
250621884017;250621884336;319;0,1,2;3;9;1;1;1
250621884336;250621884388;52;0,1,2;3;9;1;1;1
250621884388;250621884609;221;0,1,2;3;9;1;1;1
250621884609;250621884623;14;0,1,2;3;9;1;1;1
250621884623;250621884666;43;0,1,2;3;9;1;1;1
250621884666;250621884751;85;0,1,2;3;9;1;1;1
250621884751;250621884773;22;0,1,2;3;9;1;1;1
250621884773;250621884811;38;0,1,2;3;9;1;1;1
250621884811;250621885311;500;0,1,2;3;9;1;1;1
250621885311;250621885958;647;0,1,2;3;9;1;1;1
250621885958;250621886388;430;0,1,2;3;9;1;1;1
250621886388;250621887315;927;0,1,2;3;9;1;1;1
250621887315;250621887651;336;0,1,2;3;9;1;1;1
250621887651;250621888396;745;0,1,2;3;9;1;1;1
250621888396;250621889864;1468;0,1,2;3;9;1;1;1
250621889864;250621889997;133;0,1,2;3;9;1;1;1
250621889997;250621891202;1205;0,1,2;3;9;1;1;1
250621891202;250621892627;1425;0,1,2;3;9;1;1;1
250621892627;250621892640;13;0,1,2;3;9;1;1;1
250621892640;250621892714;74;0,1,2;3;9;1;1;1
250621892714;250621892773;59;0,1,2;3;9;1;1;1
250621892773;250621893021;248;0,1,2;3;9;1;1;1
250621893021;250621893502;481;0,1,2;3;9;1;1;1
250621893502;250621894103;601;0,1,2;3;9;1;1;1
250621894103;250621894118;15;0,1,2;3;9;1;1;1
250621894118;250621894708;590;0,1,2;3;9;1;1;1
250621894708;250621895217;509;0,1,2;3;9;1;1;1
250621895217;250621895266;49;0,1,2;3;9;1;1;1
250621895266;250621895345;79;0,1,2;3;9;1;1;1
250621895345;250621896497;1152;0,1,2;3;9;1;1;1
250621896497;250621896591;94;0,1,2;3;9;1;1;1
250621896591;250621896823;232;0,1,2;3;9;1;1;1
250621896823;250621897057;234;0,1,2;3;9;1;1;1
250621897057;250621897226;169;0,1,2;3;9;1;1;1
250621897226;250621897541;315;0,1,2;3;9;1;1;1
250621897541;250621897638;97;0,1,2;3;9;1;1;1
250621897638;250621898980;1342;0,1,2;3;9;1;1;1
250621898980;250621900239;1259;0,1,2;3;9;1;1;1
250621900239;250621900658;419;0,1,2;3;9;1;1;1
250621900658;250621901397;739;0,1,2;3;9;1;1;1
250621901397;250621901451;54;0,1,2;3;9;1;1;1
250621901451;250621902318;867;0,1,2;3;9;1;1;1
250621902318;250621902381;63;0,1,2;3;9;1;1;1
250621902381;250621902431;50;0,1,2;3;9;1;1;1
250621902431;250621902453;22;0,1,2;3;9;1;1;1
250621902453;250621902460;7;0,1,2;3;9;1;1;1
250621902460;250621902601;141;0,1,2;3;9;1;1;1
250621902601;250621902736;135;0,1,2;3;9;1;1;1
250621902736;250621902861;125;0,1,2;3;9;1;1;1
250621902861;250621903364;503;0,1,2;3;9;1;1;1
250621903364;250621903507;143;0,1,2;3;9;1;1;1
250621903507;250621903606;99;0,1,2;3;9;1;1;1
250621903606;250621903821;215;0,1,2;3;9;1;1;1
250621903821;250621903844;23;0,1,2;3;9;1;1;1
250621903844;250621904458;614;0,1,2;3;9;1;1;1
250621904458;250621904491;33;0,1,2;3;9;1;1;1
250621904491;250621905287;796;0,1,2;3;9;1;1;1
250621905287;250621905850;563;0,1,2;3;9;1;1;1
250621905850;250621906181;331;0,1,2;3;9;1;1;1
250621906181;250621906392;211;0,1,2;3;9;1;1;1
250621906392;250621906482;90;0,1,2;3;9;1;1;1
250621906482;250621906758;276;0,1,2;3;9;1;1;1
250621906758;250621909015;2257;0,1,2;3;9;1;1;1
250621909015;250621909103;88;0,1,2;3;9;1;1;1
250621909103;250621909451;348;0,1,2;3;9;1;1;1
250621909451;250621909669;218;0,1,2;3;9;1;1;1
250621909669;250621909747;78;0,1,2;3;9;1;1;1
250621909747;250621909787;40;0,1,2;3;9;1;1;1
250621909787;250621909841;54;0,1,2;3;9;1;1;1
250621909841;250621910451;610;0,1,2;3;9;1;1;1
250621910451;250621910898;447;0,1,2;3;9;1;1;1
250621910898;250621911143;245;0,1,2;3;9;1;1;1
250621911143;250621911370;227;0,1,2;3;9;1;1;1
250621911370;250621911480;110;0,1,2;3;9;1;1;1
250621911480;250621911907;427;0,1,2;3;9;1;1;1
250621911907;250621912288;381;0,1,2;3;9;1;1;1
250621912288;250621912516;228;0,1,2;3;9;1;1;1
250621912516;250621912558;42;0,1,2;3;9;1;1;1
250621912558;250621912836;278;0,1,2;3;9;1;1;1
250621912836;250621912855;19;0,1,2;3;9;1;1;1
250621912855;250621912890;35;0,1,2;3;9;1;1;1
250621912890;250621912979;89;0,1,2;3;9;1;1;1
250621912979;250621913074;95;0,1,2;3;9;1;1;1
250621913074;250621913130;56;0,1,2;3;9;1;1;1
250621913130;250621913176;46;0,1,2;3;9;1;1;1
250621913176;250621913233;57;0,1,2;3;9;1;1;1
250621913233;250621913331;98;0,1,2;3;9;1;1;1
250621913331;250621913512;181;0,1,2;3;9;1;1;1
250621913512;250621913588;76;0,1,2;3;9;1;1;1
250621913588;250621913839;251;0,1,2;3;9;1;1;1
250621913839;250621914161;322;0,1,2;3;9;1;1;1
250621914161;250621914777;616;0,1,2;3;9;1;1;1
250621914777;250621914848;71;0,1,2;3;9;1;1;1
250621914848;250621915917;1069;0,1,2;3;9;1;1;1
250621915917;250621916003;86;0,1,2;3;9;1;1;1
250621916003;250621917096;1093;0,1,2;3;9;1;1;1
250621917096;250621917168;72;0,1,2;3;9;1;1;1
250621917168;250621917948;780;0,1,2;3;9;1;1;1
250621917948;250621918224;276;0,1,2;3;9;1;1;1
250621918224;250621919027;803;0,1,2;3;9;1;1;1
250621919027;250621919135;108;0,1,2;3;9;1;1;1
250621919135;250621919534;399;0,1,2;3;9;1;1;1
250621919534;250621919834;300;0,1,2;3;9;1;1;1
250621919834;250621919910;76;0,1,2;3;9;1;1;1
250621919910;250621919962;52;0,1,2;3;9;1;1;1
250621919962;250621920197;235;0,1,2;3;9;1;1;1
250621920197;250621920333;136;0,1,2;3;9;1;1;1
250621920333;250621920791;458;0,1,2;3;9;1;1;1
250621920791;250621920980;189;0,1,2;3;9;1;1;1
250621920980;250621921149;169;0,1,2;3;9;1;1;1
250621921149;250621921203;54;0,1,2;3;9;1;1;1
250621921203;250621921213;10;0,1,2;3;9;1;1;1
250621921213;250621921367;154;0,1,2;3;9;1;1;1
250621921367;250621921534;167;0,1,2;3;9;1;1;1
250621921534;250621921667;133;0,1,2;3;9;1;1;1
250621921667;250621921699;32;0,1,2;3;9;1;1;1
250621921699;250621922010;311;0,1,2;3;9;1;1;1
250621922010;250621922419;409;0,1,2;3;9;1;1;1
250621922419;250621922934;515;0,1,2;3;9;1;1;1
250621922934;250621923815;881;0,1,2;3;9;1;1;1
250621923815;250621923900;85;0,1,2;3;9;1;1;1
250621923900;250621923957;57;0,1,2;3;9;1;1;1
250621923957;250621923987;30;0,1,2;3;9;1;1;1
250621923987;250621924022;35;0,1,2;3;9;1;1;1
250621924022;250621926721;2699;0,1,2;3;9;1;1;1
250621926721;250621926871;150;0,1,2;3;9;1;1;1
250621926871;250621927722;851;0,1,2;3;9;1;1;1
250621927722;250621928570;848;0,1,2;3;9;1;1;1
250621928570;250621929049;479;0,1,2;3;9;1;1;1
250621929049;250621929054;5;0,1,2;3;9;1;1;1
250621929054;250621929113;59;0,1,2;3;9;1;1;1
250621929113;250621929188;75;0,1,2;3;9;1;1;1
250621929188;250621929513;325;0,1,2;3;9;1;1;1
250621929513;250621930006;493;0,1,2;3;9;1;1;1
250621930006;250621930034;28;0,1,2;3;9;1;1;1
250621930034;250621932010;1976;0,1,2;3;9;1;1;1
250621932010;250621932196;186;0,1,2;3;9;1;1;1
250621932196;250621932389;193;0,1,2;3;9;1;1;1
250621932389;250621932898;509;0,1,2;3;9;1;1;1
250621932898;250621932991;93;0,1,2;3;9;1;1;1
250621932991;250621933021;30;0,1,2;3;9;1;1;1
250621933021;250621933104;83;0,1,2;3;9;1;1;1
250621933104;250621933543;439;0,1,2;3;9;1;1;1
250621933543;250621933904;361;0,1,2;3;9;1;1;1
250621933904;250621933908;4;0,1,2;3;9;1;1;1
250621933908;250621934794;886;0,1,2;3;9;1;1;1
250621934794;250621935224;430;0,1,2;3;9;1;1;1
250621935224;250621935752;528;0,1,2;3;9;1;1;1
250621935752;250621935847;95;0,1,2;3;9;1;1;1
250621935847;250621935940;93;0,1,2;3;9;1;1;1
250621935940;250621936012;72;0,1,2;3;9;1;1;1
250621936012;250621936040;28;0,1,2;3;9;1;1;1
250621936040;250621936118;78;0,1,2;3;9;1;1;1
250621936118;250621936225;107;0,1,2;3;9;1;1;1
250621936225;250621936330;105;0,1,2;3;9;1;1;1
250621936330;250621936349;19;0,1,2;3;9;1;1;1
250621936349;250621936403;54;0,1,2;3;9;1;1;1
250621936403;250621936475;72;0,1,2;3;9;1;1;1
250621936475;250621937233;758;0,1,2;3;9;1;1;1
250621937233;250621937389;156;0,1,2;3;9;1;1;1
250621937389;250621937442;53;0,1,2;3;9;1;1;1
250621937442;250621937510;68;0,1,2;3;9;1;1;1
250621937510;250621937733;223;0,1,2;3;9;1;1;1
250621937733;250621937786;53;0,1,2;3;9;1;1;1
250621937786;250621937792;6;0,1,2;3;9;1;1;1
250621937792;250621937834;42;0,1,2;3;9;1;1;1
250621937834;250621937842;8;0,1,2;3;9;1;1;1
250621937842;250621937986;144;0,1,2;3;9;1;1;1
250621937986;250621938073;87;0,1,2;3;9;1;1;1
250621938073;250621938175;102;0,1,2;3;9;1;1;1
250621938175;250621938194;19;0,1,2;3;9;1;1;1
250621938194;250621938254;60;0,1,2;3;9;1;1;1
250621938254;250621938321;67;0,1,2;3;9;1;1;1
250621938321;250621938398;77;0,1,2;3;9;1;1;1
250621938398;250621938602;204;0,1,2;3;9;1;1;1
250621938602;250621938882;280;0,1,2;3;9;1;1;1
250621938882;250621938955;73;0,1,2;3;9;1;1;1
250621938955;250621939065;110;0,1,2;3;9;1;1;1
250621939065;250621939184;119;0,1,2;3;9;1;1;1
250621939184;250621939293;109;0,1,2;3;9;1;1;1
250621939293;250621939352;59;0,1,2;3;9;1;1;1
250621939352;250621940177;825;0,1,2;3;9;1;1;1
250621940177;250621940333;156;0,1,2;3;9;1;1;1
250621940333;250621940938;605;0,1,2;3;9;1;1;1
250621940938;250621941516;578;0,1,2;3;9;1;1;1
250621941516;250621941550;34;0,1,2;3;9;1;1;1
250621941550;250621943354;1804;0,1,2;3;9;1;1;1
250621943354;250621943487;133;0,1,2;3;9;1;1;1
250621943487;250621943578;91;0,1,2;3;9;1;1;1
250621943578;250621943644;66;0,1,2;3;9;1;1;1
250621943644;250621943732;88;0,1,2;3;9;1;1;1
250621943732;250621943789;57;0,1,2;3;9;1;1;1
250621943789;250621943942;153;0,1,2;3;9;1;1;1
250621943942;250621944004;62;0,1,2;3;9;1;1;1
250621944004;250621944019;15;0,1,2;3;9;1;1;1
250621944019;250621944249;230;0,1,2;3;9;1;1;1
250621944249;250621944688;439;0,1,2;3;9;1;1;1
250621944688;250621944983;295;0,1,2;3;9;1;1;1
250621944983;250621945153;170;0,1,2;3;9;1;1;1
250621945153;250621945294;141;0,1,2;3;9;1;1;1
250621945294;250621945589;295;0,1,2;3;9;1;1;1
250621945589;250621945596;7;0,1,2;3;9;1;1;1
250621945596;250621946011;415;0,1,2;3;9;1;1;1
250621946011;250621946324;313;0,1,2;3;9;1;1;1
250621946324;250621946412;88;0,1,2;3;9;1;1;1
250621946412;250621946793;381;0,1,2;3;9;1;1;1
250621946793;250621946970;177;0,1,2;3;9;1;1;1
250621946970;250621947792;822;0,1,2;3;9;1;1;1
250621947792;250621947944;152;0,1,2;3;9;1;1;1
250621947944;250621948186;242;0,1,2;3;9;1;1;1
250621948186;250621950432;2246;0,1,2;3;9;1;1;1
250621950432;250621966262;15830;1,2;2;9;1;1;1
250621966262;250621966291;29;0,1,2;3;9;1;1;1
250621966291;250621968502;2211;0,1,2;3;9;1;1;1
250621968502;250621970558;2056;0,1,2;3;9;1;1;1
250621970558;250621970688;130;0,1,2;3;9;1;1;1
250621970688;250621970740;52;0,1,2;3;9;1;1;1
250621970740;250621971854;1114;1,2;2;9;1;1;1
250621971854;250621972165;311;0,1,2;3;9;1;1;1
250621972165;250621972269;104;0,1,2;3;9;1;1;1
250621972269;250621974154;1885;0,1,2;3;9;1;1;1
250621974154;250621974366;212;0,1,2;3;9;1;1;1
250621974366;250621976592;2226;0,1,2;3;9;1;1;1
250621976592;250621976633;41;0,1,2;3;9;1;1;1
250621976633;250621976990;357;0,1,2;3;9;1;1;1
250621976990;250621977509;519;0,1,2;3;9;1;1;1
250621977509;250621978348;839;0,1,2;3;9;1;1;1
250621978348;250621980064;1716;0,1,2;3;9;1;1;1
250621980064;250621980799;735;0,1,2;3;9;1;1;1
250621980799;250621990067;9268;1,2;2;9;1;1;1
250621990067;250621994105;4038;0,1,2;3;9;1;1;1
250621994105;250621994840;735;1,2;2;9;1;1;1
250621994840;250621995408;568;0,1,2;3;9;1;1;1
250621995408;250621996367;959;0,1,2;3;9;1;1;1
250621996367;250621996506;139;0,1,2;3;9;1;1;1
250621996506;250621997137;631;0,1,2;3;9;1;1;1
250621997137;250621998908;1771;0,1,2;3;9;1;1;1
250621998908;250621999677;769;0,1,2;3;9;1;1;1
250621999677;250621999734;57;0,1,2;3;9;1;1;1
250621999734;250621999759;25;0,1,2;3;9;1;1;1
250621999759;250621999857;98;0,1,2;3;9;1;1;1
250621999857;250621999901;44;0,1,2;3;9;1;1;1
250621999901;250621999952;51;0,1,2;3;9;1;1;1
250621999952;250622000505;553;0,1,2;3;9;1;1;1
250622000505;250622000525;20;0,1,2;3;9;1;1;1
250622000525;250622000557;32;0,1,2;3;9;1;1;1
250622000557;250622001144;587;0,1,2;3;9;1;1;1
250622001144;250622001835;691;0,1,2;3;9;1;1;1
250622001835;250622002037;202;0,1,2;3;9;1;1;1
250622002037;250622002177;140;0,1,2;3;9;1;1;1
250622002177;250622002241;64;0,1,2;3;9;1;1;1
250622002241;250622002808;567;0,1,2;3;9;1;1;1
250622002808;250622002873;65;0,1,2;3;9;1;1;1
250622002873;250622002961;88;0,1,2;3;9;1;1;1
250622002961;250622003924;963;0,1,2;3;9;1;1;1
250622003924;250622004257;333;0,1,2;3;9;1;1;1
250622004257;250622004434;177;0,1,2;3;9;1;1;1
250622004434;250622004540;106;0,1,2;3;9;1;1;1
250622004540;250622004613;73;0,1,2;3;9;1;1;1
250622004613;250622005143;530;0,1,2;3;9;1;1;1
250622005143;250622005153;10;0,1,2;3;9;1;1;1
250622005153;250622007458;2305;0,1,2;3;9;1;1;1
250622007458;250622008050;592;0,1,2;3;9;1;1;1
250622008050;250622009266;1216;0,1,2;3;9;1;1;1
250622009266;250622009372;106;0,1,2;3;9;1;1;1
250622009372;250622009400;28;0,1,2;3;9;1;1;1
250622009400;250622009943;543;0,1,2;3;9;1;1;1
250622009943;250622010216;273;0,1,2;3;9;1;1;1
250622010216;250622011491;1275;0,1,2;3;9;1;1;1
250622011491;250622011879;388;0,1,2;3;9;1;1;1
250622011879;250622013877;1998;0,1,2;3;9;1;1;1
250622013877;250622014623;746;0,1,2;3;9;1;1;1
250622014623;250622015043;420;0,1,2;3;9;1;1;1
250622015043;250622015440;397;0,1,2;3;9;1;1;1
250622015440;250622015818;378;0,1,2;3;9;1;1;1
250622015818;250622015828;10;0,1,2;3;9;1;1;1
250622015828;250622016144;316;0,1,2;3;9;1;1;1
250622016144;250622016277;133;0,1,2;3;9;1;1;1
250622016277;250622016461;184;0,1,2;3;9;1;1;1
250622016461;250622016597;136;0,1,2;3;9;1;1;1
250622016597;250622016801;204;0,1,2;3;9;1;1;1
250622016801;250622017052;251;0,1,2;3;9;1;1;1
250622017052;250622017104;52;0,1,2;3;9;1;1;1
250622017104;250622017499;395;0,1,2;3;9;1;1;1
250622017499;250622019232;1733;0,1,2;3;9;1;1;1
250622019232;250622019837;605;0,1,2;3;9;1;1;1
250622019837;250622020484;647;0,1,2;3;9;1;1;1
250622020484;250622020544;60;0,1,2;3;9;1;1;1
250622020544;250622020958;414;0,1,2;3;9;1;1;1
250622020958;250622020972;14;0,1,2;3;9;1;1;1
250622020972;250622021235;263;0,1,2;3;9;1;1;1
250622021235;250622021965;730;0,1,2;3;9;1;1;1
250622021965;250622022271;306;0,1,2;3;9;1;1;1
250622022271;250622022449;178;0,1,2;3;9;1;1;1
250622022449;250622022812;363;0,1,2;3;9;1;1;1
250622022812;250622025338;2526;0,1,2;3;9;1;1;1
250622025338;250622026155;817;0,1,2;3;9;1;1;1
250622026155;250622026827;672;0,1,2;3;9;1;1;1
250622026827;250622027558;731;0,1,2;3;9;1;1;1
250622027558;250622027726;168;0,1,2;3;9;1;1;1
250622027726;250622028223;497;0,1,2;3;9;1;1;1
250622028223;250622029772;1549;0,1,2;3;9;1;1;1
250622029772;250622029863;91;0,1,2;3;9;1;1;1
250622029863;250622029928;65;0,1,2;3;9;1;1;1
250622029928;250622031544;1616;0,1,2;3;9;1;1;1
250622031544;250622032042;498;0,1,2;3;9;1;1;1
250622032042;250622032231;189;0,1,2;3;9;1;1;1
250622032231;250622037791;5560;1,2;2;9;1;1;1
250622037791;250622038887;1096;0,1,2;3;9;1;1;1
250622038887;250622038951;64;0,1,2;3;9;1;1;1
250622038951;250622040242;1291;0,1,2;3;9;1;1;1
250622040242;250622041596;1354;0,1,2;3;9;1;1;1
250622041596;250622041651;55;0,1,2;3;9;1;1;1
250622041651;250622042381;730;0,1,2;3;9;1;1;1
250622042381;250622043354;973;0,1,2;3;9;1;1;1
250622043354;250622044126;772;0,1,2;3;9;1;1;1
250622044126;250622044528;402;0,1,2;3;9;1;1;1
250622044528;250622045484;956;0,1,2;3;9;1;1;1
250622045484;250622046733;1249;0,1,2;3;9;1;1;1
250622046733;250622050675;3942;0,1,2;3;9;1;1;1
250622050675;250622051785;1110;0,1,2;3;9;1;1;1
250622051785;250622053023;1238;0,1,2;3;9;1;1;1
250622053023;250622053834;811;0,1,2;3;9;1;1;1
250622053834;250622054526;692;0,1,2;3;9;1;1;1
250622054526;250622054851;325;0,1,2;3;9;1;1;1
250622054851;250622054874;23;0,1,2;3;9;1;1;1
250622054874;250622055740;866;0,1,2;3;9;1;1;1
250622055740;250622057683;1943;0,1,2;3;9;1;1;1
250622057683;250622058199;516;0,1,2;3;9;1;1;1
250622058199;250622058963;764;0,1,2;3;9;1;1;1
250622058963;250622059167;204;0,1,2;3;9;1;1;1
250622059167;250622059206;39;0,1,2;3;9;1;1;1
250622059206;250622059318;112;0,1,2;3;9;1;1;1
250622059318;250622059545;227;0,1,2;3;9;1;1;1
250622059545;250622059629;84;0,1,2;3;9;1;1;1
250622059629;250622059715;86;0,1,2;3;9;1;1;1
250622059715;250622060049;334;0,1,2;3;9;1;1;1
250622060049;250622060315;266;0,1,2;3;9;1;1;1
250622060315;250622060423;108;0,1,2;3;9;1;1;1
250622060423;250622060726;303;0,1,2;3;9;1;1;1
250622060726;250622061594;868;0,1,2;3;9;1;1;1
250622061594;250622061628;34;0,1,2;3;9;1;1;1
250622061628;250622061681;53;0,1,2;3;9;1;1;1
250622061681;250622061703;22;0,1,2;3;9;1;1;1
250622061703;250622061833;130;0,1,2;3;9;1;1;1
250622061833;250622061897;64;0,1,2;3;9;1;1;1
250622061897;250622062444;547;0,1,2;3;9;1;1;1
250622062444;250622062473;29;0,1,2;3;9;1;1;1
250622062473;250622062524;51;0,1,2;3;9;1;1;1
250622062524;250622062656;132;0,1,2;3;9;1;1;1
250622062656;250622062716;60;0,1,2;3;9;1;1;1
250622062716;250622062739;23;0,1,2;3;9;1;1;1
250622062739;250622062864;125;0,1,2;3;9;1;1;1
250622062864;250622063011;147;0,1,2;3;9;1;1;1
250622063011;250622065599;2588;0,1,2;3;9;1;1;1
250622065599;250622066176;577;0,1,2;3;9;1;1;1
250622066176;250622066250;74;0,1,2;3;9;1;1;1
250622066250;250622066975;725;0,1,2;3;9;1;1;1
250622066975;250622068464;1489;0,1,2;3;9;1;1;1
250622068464;250622070587;2123;0,1,2;3;9;1;1;1
250622070587;250622070727;140;0,1,2;3;9;1;1;1
250622070727;250622070945;218;0,1,2;3;9;1;1;1
250622070945;250622071306;361;0,1,2;3;9;1;1;1
250622071306;250622076938;5632;0,1,2;3;9;1;1;1
250622076938;250622077293;355;0,1,2;3;9;1;1;1
250622077293;250622077382;89;0,1,2;3;9;1;1;1
250622077382;250622077435;53;0,1,2;3;9;1;1;1
250622077435;250622077528;93;0,1,2;3;9;1;1;1
250622077528;250622087559;10031;0,1,2;3;9;1;1;1
250622087559;250622154450;66891;0,1,2;3;9;1;1;1
250622154450;250622167622;13172;0,1,2;3;9;1;1;1
250622167622;250622167653;31;0,1,2;3;9;1;1;1
250622167653;250622171188;3535;0,1,2;3;9;1;1;1
250622171188;250622177127;5939;0,1,2;3;9;1;1;1
250622177127;250622283682;106555;0,1,2;3;9;1;1;1
250622283682;250622283899;217;0,1,2;3;9;1;1;1
250622283899;250622284130;231;0,1,2;3;9;1;1;1
250622284130;250622322464;38334;0,1,2;3;9;1;1;1
250622322464;250630573991;8251527;1,2;2;9;1;1;1
250630573991;250630657319;83328;1,2;2;9;1;1;1
250630657319;250630733602;76283;1,2;2;9;1;1;1
250630733602;250630812558;78956;1,2;2;9;1;1;1
250630812558;250630872369;59811;1,2;2;9;1;1;1
250630872369;250630926395;54026;1,2;2;9;1;1;1
250630926395;250630992429;66034;1,2;2;9;1;1;1
250630992429;250631028650;36221;1,2;2;9;1;1;1
250631028650;250631045433;16783;1,2;2;9;1;1;1
250631045433;250631099701;54268;1,2;2;9;1;1;1
250631099701;250631153487;53786;1,2;2;9;1;1;1
250631153487;250631196133;42646;1,2;2;9;1;1;1
250631196133;250631236614;40481;1,2;2;9;1;1;1
250631236614;250631243370;6756;1,2;2;9;1;1;1
250631243370;250631279072;35702;1,2;2;9;1;1;1
250631279072;250631311156;32084;1,2;2;9;1;1;1
250631311156;250631340947;29791;1,2;2;9;1;1;1
250631340947;250686439870;55098923;1,2;2;9;1;1;1
250686439870;250687275840;835970;1,2;2;9;1;1;1
250687275840;250687287889;12049;1,2;2;9;1;1;1
250687287889;250687375115;87226;1,2;2;9;1;1;1
250687375115;250687512237;137122;1,2;2;9;1;1;1
250687512237;250687563802;51565;1,2;2;9;1;1;1
250687563802;250687620415;56613;1,2;2;9;1;1;1
250687620415;250687697523;77108;1,2;2;9;1;1;1
250687697523;250687766457;68934;1,2;2;9;1;1;1
250687766457;250687931144;164687;1,2;2;9;1;1;1
250687931144;250688079305;148161;1,2;2;9;1;1;1
250688079305;250688396596;317291;1,2;2;9;1;1;1
250688396596;250688489522;92926;1,2;2;9;1;1;1
250688489522;250688614664;125142;1,2;2;9;1;1;1
250688614664;250688680707;66043;1,2;2;9;1;1;1
250688680707;250688718775;38068;1,2;2;9;1;1;1
250688718775;250688737934;19159;1,2;2;9;1;1;1
250688737934;250688822402;84468;1,2;2;9;1;1;1
250688822402;250688862637;40235;1,2;2;9;1;1;1
250688862637;250688874278;11641;1,2;2;9;1;1;1
250688874278;250688880003;5725;1,2;2;9;1;1;1
250688880003;250689003993;123990;1,2;2;9;1;1;1
250689003993;250689180671;176678;1,2;2;9;1;1;1
250689180671;250724015745;34835074;1,2;2;9;1;1;1
250724015745;250759245408;35229663;1,2;2;9;1;1;1
250759245408;250794351363;35105955;1,2;2;9;1;1;1
250794351363;250828769852;34418489;1,2;2;9;1;1;1
250828769852;250828803296;33444;1,2;2;9;1;1;1
250828803296;250828803367;71;0,1,2;3;9;1;1;1
250828803367;250828803427;60;0,1,2;3;9;1;1;1
250828803427;250828804196;769;0,1,2;3;9;1;1;1
250828804196;250828806616;2420;0,1,2;3;9;1;1;1
250828806616;250828812080;5464;0,1,2;3;9;1;1;1
250828812080;250828813752;1672;0,1,2;3;9;1;1;1
250828813752;250828814832;1080;0,1,2;3;9;1;1;1
250828814832;250828815261;429;0,1,2;3;9;1;1;1
250828815261;250828820914;5653;0,1,2;3;9;1;1;1
250828820914;250828823490;2576;0,1,2;3;9;1;1;1
250828823490;250828823639;149;0,1,2;3;9;1;1;1
250828823639;250828827151;3512;0,1,2;3;9;1;1;1
250828827151;250828828783;1632;0,1,2;3;9;1;1;1
250828828783;250828836307;7524;0,1,2;3;9;1;1;1
250828836307;250828838117;1810;0,1,2;3;9;1;1;1
250828838117;250828839138;1021;0,1,2;3;9;1;1;1
250828839138;250828839237;99;0,1,2;3;9;1;1;1
250828839237;250828839341;104;0,1,2;3;9;1;1;1
250828839341;250828839795;454;0,1,2;3;9;1;1;1
250828839795;250828840941;1146;0,1,2;3;9;1;1;1
250828840941;250828864174;23233;0,1,2;3;9;1;1;1
250828864174;250828866235;2061;0,1,2;3;9;1;1;1
250828866235;250828883451;17216;0,1,2;3;9;1;1;1
250828883451;250828887196;3745;0,1,2;3;9;1;1;1
250828887196;250828887297;101;0,1,2;3;9;1;1;1
250828887297;250828887658;361;0,1,2;3;9;1;1;1
250828887658;250828887678;20;0,1,2;3;9;1;1;1
250828887678;250828888133;455;0,1,2;3;9;1;1;1
250828888133;250828888151;18;0,1,2;3;9;1;1;1
250828888151;250828888254;103;0,1,2;3;9;1;1;1
250828888254;250828888457;203;0,1,2;3;9;1;1;1
250828888457;250828888537;80;0,1,2;3;9;1;1;1
250828888537;250828888712;175;0,1,2;3;9;1;1;1
250828888712;250828888732;20;0,1,2;3;9;1;1;1
250828888732;250828888788;56;0,1,2;3;9;1;1;1
250828888788;250828891188;2400;0,1,2;3;9;1;1;1
250828891188;250828891445;257;0,1,2;3;9;1;1;1
250828891445;250828891826;381;0,1,2;3;9;1;1;1
250828891826;250828891870;44;0,1,2;3;9;1;1;1
250828891870;250828891955;85;0,1,2;3;9;1;1;1
250828891955;250828892026;71;0,1,2;3;9;1;1;1
250828892026;250828892129;103;0,1,2;3;9;1;1;1
250828892129;250828892137;8;0,1,2;3;9;1;1;1
250828892137;250828892497;360;0,1,2;3;9;1;1;1
250828892497;250828892624;127;0,1,2;3;9;1;1;1
250828892624;250828892814;190;0,1,2;3;9;1;1;1
250828892814;250828892975;161;0,1,2;3;9;1;1;1
250828892975;250828893199;224;0,1,2;3;9;1;1;1
250828893199;250828895052;1853;0,1,2;3;9;1;1;1
250828895052;250828895432;380;0,1,2;3;9;1;1;1
250828895432;250828896537;1105;0,1,2;3;9;1;1;1
250828896537;250828896604;67;0,1,2;3;9;1;1;1
250828896604;250828897433;829;0,1,2;3;9;1;1;1
250828897433;250828897622;189;0,1,2;3;9;1;1;1
250828897622;250828897707;85;0,1,2;3;9;1;1;1
250828897707;250828897767;60;0,1,2;3;9;1;1;1
250828897767;250828900560;2793;0,1,2;3;9;1;1;1
250828900560;250828900575;15;0,1,2;3;9;1;1;1
250828900575;250828900639;64;0,1,2;3;9;1;1;1
250828900639;250828909799;9160;0,1,2;3;9;1;1;1
250828909799;250828912345;2546;0,1,2;3;9;1;1;1
250828912345;250828912487;142;0,1,2;3;9;1;1;1
250828912487;250828915340;2853;0,1,2;3;9;1;1;1
250828915340;250828915994;654;0,1,2;3;9;1;1;1
250828915994;250828916079;85;0,1,2;3;9;1;1;1
250828916079;250828923976;7897;0,1,2;3;9;1;1;1
250828923976;250828933365;9389;0,1,2;3;9;1;1;1
250828933365;250828942346;8981;0,1,2;3;9;1;1;1
250828942346;250828943033;687;0,1,2;3;9;1;1;1
250828943033;250828943091;58;0,1,2;3;9;1;1;1
250828943091;250828943530;439;0,1,2;3;9;1;1;1
250828943530;250828944002;472;0,1,2;3;9;1;1;1
250828944002;250828944176;174;0,1,2;3;9;1;1;1
250828944176;250828952623;8447;0,1,2;3;9;1;1;1
250828952623;250828953107;484;0,1,2;3;9;1;1;1
250828953107;250828953996;889;0,1,2;3;9;1;1;1
250828953996;250828964130;10134;0,1,2;3;9;1;1;1
250828964130;250828964870;740;0,1,2;3;9;1;1;1
250828964870;250828965160;290;0,1,2;3;9;1;1;1
250828965160;250828965664;504;0,1,2;3;9;1;1;1
250828965664;250828966589;925;0,1,2;3;9;1;1;1
250828966589;250828968844;2255;0,1,2;3;9;1;1;1
250828968844;250828970847;2003;0,1,2;3;9;1;1;1
250828970847;250828970905;58;0,1,2;3;9;1;1;1
250828970905;250828970946;41;0,1,2;3;9;1;1;1
250828970946;250828971244;298;0,1,2;3;9;1;1;1
250828971244;250828971304;60;0,1,2;3;9;1;1;1
250828971304;250828971358;54;0,1,2;3;9;1;1;1
250828971358;250828971425;67;0,1,2;3;9;1;1;1
250828971425;250828971962;537;0,1,2;3;9;1;1;1
250828971962;250828972083;121;0,1,2;3;9;1;1;1
250828972083;250828972507;424;0,1,2;3;9;1;1;1
250828972507;250828972547;40;0,1,2;3;9;1;1;1
250828972547;250828972869;322;0,1,2;3;9;1;1;1
250828972869;250828974756;1887;0,1,2;3;9;1;1;1
250828974756;250828974884;128;0,1,2;3;9;1;1;1
250828974884;250828976431;1547;0,1,2;3;9;1;1;1
250828976431;250828976703;272;0,1,2;3;9;1;1;1
250828976703;250828977084;381;0,1,2;3;9;1;1;1
250828977084;250828977151;67;0,1,2;3;9;1;1;1
250828977151;250828978947;1796;0,1,2;3;9;1;1;1
250828978947;250828978990;43;0,1,2;3;9;1;1;1
250828978990;250828979322;332;0,1,2;3;9;1;1;1
250828979322;250828979679;357;0,1,2;3;9;1;1;1
250828979679;250828979926;247;0,1,2;3;9;1;1;1
250828979926;250828982421;2495;0,1,2;3;9;1;1;1
250828982421;250828982981;560;0,1,2;3;9;1;1;1
250828982981;250828983979;998;0,1,2;3;9;1;1;1
250828983979;250828984119;140;0,1,2;3;9;1;1;1
250828984119;250828984749;630;0,1,2;3;9;1;1;1
250828984749;250828985651;902;0,1,2;3;9;1;1;1
250828985651;250828985800;149;0,1,2;3;9;1;1;1
250828985800;250828985890;90;0,1,2;3;9;1;1;1
250828985890;250828986069;179;0,1,2;3;9;1;1;1
250828986069;250828986184;115;0,1,2;3;9;1;1;1
250828986184;250828986242;58;0,1,2;3;9;1;1;1
250828986242;250828986335;93;0,1,2;3;9;1;1;1
250828986335;250828986389;54;0,1,2;3;9;1;1;1
250828986389;250828986446;57;0,1,2;3;9;1;1;1
250828986446;250828989655;3209;0,1,2;3;9;1;1;1
250828989655;250828989911;256;0,1,2;3;9;1;1;1
250828989911;250828990064;153;0,1,2;3;9;1;1;1
250828990064;250828990258;194;0,1,2;3;9;1;1;1
250828990258;250828990663;405;0,1,2;3;9;1;1;1
250828990663;250828990826;163;0,1,2;3;9;1;1;1
250828990826;250828991460;634;0,1,2;3;9;1;1;1
250828991460;250828991519;59;0,1,2;3;9;1;1;1
250828991519;250828991799;280;0,1,2;3;9;1;1;1
250828991799;250828991850;51;0,1,2;3;9;1;1;1
250828991850;250828992035;185;0,1,2;3;9;1;1;1
250828992035;250828992646;611;0,1,2;3;9;1;1;1
250828992646;250828992675;29;0,1,2;3;9;1;1;1
250828992675;250828992953;278;0,1,2;3;9;1;1;1
250828992953;250828993260;307;0,1,2;3;9;1;1;1
250828993260;250828993303;43;0,1,2;3;9;1;1;1
250828993303;250828993418;115;0,1,2;3;9;1;1;1
250828993418;250828993787;369;0,1,2;3;9;1;1;1
250828993787;250828993829;42;0,1,2;3;9;1;1;1
250828993829;250828993894;65;0,1,2;3;9;1;1;1
250828993894;250828994012;118;0,1,2;3;9;1;1;1
250828994012;250828996061;2049;0,1,2;3;9;1;1;1
250828996061;250828996082;21;0,1,2;3;9;1;1;1
250828996082;250828996151;69;0,1,2;3;9;1;1;1
250828996151;250828996508;357;0,1,2;3;9;1;1;1
250828996508;250828996554;46;0,1,2;3;9;1;1;1
250828996554;250828997505;951;0,1,2;3;9;1;1;1
250828997505;250828997896;391;0,1,2;3;9;1;1;1
250828997896;250828997932;36;0,1,2;3;9;1;1;1
250828997932;250828998102;170;0,1,2;3;9;1;1;1
250828998102;250828998415;313;0,1,2;3;9;1;1;1
250828998415;250828998602;187;0,1,2;3;9;1;1;1
250828998602;250828998777;175;0,1,2;3;9;1;1;1
250828998777;250828998926;149;0,1,2;3;9;1;1;1
250828998926;250829000086;1160;0,1,2;3;9;1;1;1
250829000086;250829000829;743;0,1,2;3;9;1;1;1
250829000829;250829000953;124;0,1,2;3;9;1;1;1
250829000953;250829001736;783;0,1,2;3;9;1;1;1
250829001736;250829002200;464;0,1,2;3;9;1;1;1
250829002200;250829002260;60;0,1,2;3;9;1;1;1
250829002260;250829002313;53;0,1,2;3;9;1;1;1
250829002313;250829002427;114;0,1,2;3;9;1;1;1
250829002427;250829002508;81;0,1,2;3;9;1;1;1
250829002508;250829002623;115;0,1,2;3;9;1;1;1
250829002623;250829002740;117;0,1,2;3;9;1;1;1
250829002740;250829002849;109;0,1,2;3;9;1;1;1
250829002849;250829003172;323;0,1,2;3;9;1;1;1
250829003172;250829003826;654;0,1,2;3;9;1;1;1
250829003826;250829004466;640;0,1,2;3;9;1;1;1
250829004466;250829004569;103;0,1,2;3;9;1;1;1
250829004569;250829004592;23;0,1,2;3;9;1;1;1
250829004592;250829004990;398;0,1,2;3;9;1;1;1
250829004990;250829005190;200;0,1,2;3;9;1;1;1
250829005190;250829005224;34;0,1,2;3;9;1;1;1
250829005224;250829007497;2273;0,1,2;3;9;1;1;1
250829007497;250829007684;187;0,1,2;3;9;1;1;1
250829007684;250829007994;310;0,1,2;3;9;1;1;1
250829007994;250829008065;71;0,1,2;3;9;1;1;1
250829008065;250829008121;56;0,1,2;3;9;1;1;1
250829008121;250829009450;1329;0,1,2;3;9;1;1;1
250829009450;250829009481;31;0,1,2;3;9;1;1;1
250829009481;250829009514;33;0,1,2;3;9;1;1;1
250829009514;250829009546;32;0,1,2;3;9;1;1;1
250829009546;250829009919;373;0,1,2;3;9;1;1;1
250829009919;250829009952;33;0,1,2;3;9;1;1;1
250829009952;250829009986;34;0,1,2;3;9;1;1;1
250829009986;250829010071;85;0,1,2;3;9;1;1;1
250829010071;250829010192;121;0,1,2;3;9;1;1;1
250829010192;250829010251;59;0,1,2;3;9;1;1;1
250829010251;250829010456;205;0,1,2;3;9;1;1;1
250829010456;250829010696;240;0,1,2;3;9;1;1;1
250829010696;250829010888;192;0,1,2;3;9;1;1;1
250829010888;250829011610;722;0,1,2;3;9;1;1;1
250829011610;250829011713;103;0,1,2;3;9;1;1;1
250829011713;250829012193;480;0,1,2;3;9;1;1;1
250829012193;250829012613;420;0,1,2;3;9;1;1;1
250829012613;250829012653;40;0,1,2;3;9;1;1;1
250829012653;250829012663;10;0,1,2;3;9;1;1;1
250829012663;250829013153;490;0,1,2;3;9;1;1;1
250829013153;250829013202;49;0,1,2;3;9;1;1;1
250829013202;250829014028;826;0,1,2;3;9;1;1;1
250829014028;250829014358;330;0,1,2;3;9;1;1;1
250829014358;250829014396;38;0,1,2;3;9;1;1;1
250829014396;250829014502;106;0,1,2;3;9;1;1;1
250829014502;250829014898;396;0,1,2;3;9;1;1;1
250829014898;250829015006;108;0,1,2;3;9;1;1;1
250829015006;250829015052;46;0,1,2;3;9;1;1;1
250829015052;250829015419;367;0,1,2;3;9;1;1;1
250829015419;250829015739;320;0,1,2;3;9;1;1;1
250829015739;250829016112;373;0,1,2;3;9;1;1;1
250829016112;250829016665;553;0,1,2;3;9;1;1;1
250829016665;250829017475;810;0,1,2;3;9;1;1;1
250829017475;250829018517;1042;0,1,2;3;9;1;1;1
250829018517;250829018578;61;0,1,2;3;9;1;1;1
250829018578;250829018962;384;0,1,2;3;9;1;1;1
250829018962;250829021437;2475;0,1,2;3;9;1;1;1
250829021437;250829022434;997;0,1,2;3;9;1;1;1
250829022434;250829022467;33;0,1,2;3;9;1;1;1
250829022467;250829022521;54;0,1,2;3;9;1;1;1
250829022521;250829023028;507;0,1,2;3;9;1;1;1
250829023028;250829023134;106;0,1,2;3;9;1;1;1
250829023134;250829023193;59;0,1,2;3;9;1;1;1
250829023193;250829023492;299;0,1,2;3;9;1;1;1
250829023492;250829024711;1219;0,1,2;3;9;1;1;1
250829024711;250829024773;62;0,1,2;3;9;1;1;1
250829024773;250829024866;93;0,1,2;3;9;1;1;1
250829024866;250829025011;145;0,1,2;3;9;1;1;1
250829025011;250829025124;113;0,1,2;3;9;1;1;1
250829025124;250829025295;171;0,1,2;3;9;1;1;1
250829025295;250829025400;105;0,1,2;3;9;1;1;1
250829025400;250829025841;441;0,1,2;3;9;1;1;1
250829025841;250829025937;96;0,1,2;3;9;1;1;1
250829025937;250829026179;242;0,1,2;3;9;1;1;1
250829026179;250829026364;185;0,1,2;3;9;1;1;1
250829026364;250829026599;235;0,1,2;3;9;1;1;1
250829026599;250829027682;1083;0,1,2;3;9;1;1;1
250829027682;250829027718;36;0,1,2;3;9;1;1;1
250829027718;250829027844;126;0,1,2;3;9;1;1;1
250829027844;250829028369;525;0,1,2;3;9;1;1;1
250829028369;250829028591;222;0,1,2;3;9;1;1;1
250829028591;250829028719;128;0,1,2;3;9;1;1;1
250829028719;250829028911;192;0,1,2;3;9;1;1;1
250829028911;250829029297;386;0,1,2;3;9;1;1;1
250829029297;250829029353;56;0,1,2;3;9;1;1;1
250829029353;250829029935;582;0,1,2;3;9;1;1;1
250829029935;250829029996;61;0,1,2;3;9;1;1;1
250829029996;250829030009;13;0,1,2;3;9;1;1;1
250829030009;250829030102;93;0,1,2;3;9;1;1;1
250829030102;250829030191;89;0,1,2;3;9;1;1;1
250829030191;250829030223;32;0,1,2;3;9;1;1;1
250829030223;250829031018;795;0,1,2;3;9;1;1;1
250829031018;250829031258;240;0,1,2;3;9;1;1;1
250829031258;250829031631;373;0,1,2;3;9;1;1;1
250829031631;250829031692;61;0,1,2;3;9;1;1;1
250829031692;250829031731;39;0,1,2;3;9;1;1;1
250829031731;250829031868;137;0,1,2;3;9;1;1;1
250829031868;250829032318;450;0,1,2;3;9;1;1;1
250829032318;250829032394;76;0,1,2;3;9;1;1;1
250829032394;250829032509;115;0,1,2;3;9;1;1;1
250829032509;250829032628;119;0,1,2;3;9;1;1;1
250829032628;250829032641;13;0,1,2;3;9;1;1;1
250829032641;250829032742;101;0,1,2;3;9;1;1;1
250829032742;250829032767;25;0,1,2;3;9;1;1;1
250829032767;250829033153;386;0,1,2;3;9;1;1;1
250829033153;250829033792;639;0,1,2;3;9;1;1;1
250829033792;250829037448;3656;0,1,2;3;9;1;1;1
250829037448;250829042317;4869;0,1,2;3;9;1;1;1
250829042317;250829044356;2039;0,1,2;3;9;1;1;1
250829044356;250829046295;1939;0,1,2;3;9;1;1;1
250829046295;250829046328;33;0,1,2;3;9;1;1;1
250829046328;250829047124;796;0,1,2;3;9;1;1;1
250829047124;250829047159;35;0,1,2;3;9;1;1;1
250829047159;250829047209;50;0,1,2;3;9;1;1;1
250829047209;250829047632;423;0,1,2;3;9;1;1;1
250829047632;250829048618;986;0,1,2;3;9;1;1;1
250829048618;250829048657;39;0,1,2;3;9;1;1;1
250829048657;250829048900;243;0,1,2;3;9;1;1;1
250829048900;250829049052;152;0,1,2;3;9;1;1;1
250829049052;250829050046;994;0,1,2;3;9;1;1;1
250829050046;250829050530;484;0,1,2;3;9;1;1;1
250829050530;250829051283;753;0,1,2;3;9;1;1;1
250829051283;250829053471;2188;0,1,2;3;9;1;1;1
250829053471;250829053517;46;0,1,2;3;9;1;1;1
250829053517;250829053679;162;0,1,2;3;9;1;1;1
250829053679;250829053752;73;0,1,2;3;9;1;1;1
250829053752;250829054347;595;0,1,2;3;9;1;1;1
250829054347;250829054378;31;0,1,2;3;9;1;1;1
250829054378;250829056746;2368;0,1,2;3;9;1;1;1
250829056746;250829056946;200;0,1,2;3;9;1;1;1
250829056946;250829057180;234;0,1,2;3;9;1;1;1
250829057180;250829057274;94;0,1,2;3;9;1;1;1
250829057274;250829057367;93;0,1,2;3;9;1;1;1
250829057367;250829057961;594;0,1,2;3;9;1;1;1
250829057961;250829058614;653;0,1,2;3;9;1;1;1
250829058614;250829059416;802;0,1,2;3;9;1;1;1
250829059416;250829059488;72;0,1,2;3;9;1;1;1
250829059488;250829059530;42;0,1,2;3;9;1;1;1
250829059530;250829059598;68;0,1,2;3;9;1;1;1
250829059598;250829059752;154;0,1,2;3;9;1;1;1
250829059752;250829059778;26;0,1,2;3;9;1;1;1
250829059778;250829059937;159;0,1,2;3;9;1;1;1
250829059937;250829060119;182;0,1,2;3;9;1;1;1
250829060119;250829060345;226;0,1,2;3;9;1;1;1
250829060345;250829060353;8;0,1,2;3;9;1;1;1
250829060353;250829061513;1160;0,1,2;3;9;1;1;1
250829061513;250829062069;556;0,1,2;3;9;1;1;1
250829062069;250829062258;189;0,1,2;3;9;1;1;1
250829062258;250829062345;87;0,1,2;3;9;1;1;1
250829062345;250829062541;196;0,1,2;3;9;1;1;1
250829062541;250829062571;30;0,1,2;3;9;1;1;1
250829062571;250829063222;651;0,1,2;3;9;1;1;1
250829063222;250829063527;305;0,1,2;3;9;1;1;1
250829063527;250829063602;75;0,1,2;3;9;1;1;1
250829063602;250829063845;243;0,1,2;3;9;1;1;1
250829063845;250829065561;1716;0,1,2;3;9;1;1;1
250829065561;250829065782;221;0,1,2;3;9;1;1;1
250829065782;250829066564;782;0,1,2;3;9;1;1;1
250829066564;250829069399;2835;0,1,2;3;9;1;1;1
250829069399;250829069666;267;0,1,2;3;9;1;1;1
250829069666;250829072694;3028;0,1,2;3;9;1;1;1
250829072694;250829073736;1042;0,1,2;3;9;1;1;1
250829073736;250829074082;346;0,1,2;3;9;1;1;1
250829074082;250829074166;84;0,1,2;3;9;1;1;1
250829074166;250829074384;218;0,1,2;3;9;1;1;1
250829074384;250829074707;323;0,1,2;3;9;1;1;1
250829074707;250829074739;32;0,1,2;3;9;1;1;1
250829074739;250829074772;33;0,1,2;3;9;1;1;1
250829074772;250829074967;195;0,1,2;3;9;1;1;1
250829074967;250829075583;616;0,1,2;3;9;1;1;1
250829075583;250829078314;2731;0,1,2;3;9;1;1;1
250829078314;250829078482;168;0,1,2;3;9;1;1;1
250829078482;250829080568;2086;0,1,2;3;9;1;1;1
250829080568;250829081529;961;0,1,2;3;9;1;1;1
250829081529;250829081586;57;0,1,2;3;9;1;1;1
250829081586;250829081727;141;0,1,2;3;9;1;1;1
250829081727;250829083503;1776;0,1,2;3;9;1;1;1
250829083503;250829083829;326;0,1,2;3;9;1;1;1
250829083829;250829087043;3214;0,1,2;3;9;1;1;1
250829087043;250829087546;503;0,1,2;3;9;1;1;1
250829087546;250829088195;649;0,1,2;3;9;1;1;1
250829088195;250829088271;76;0,1,2;3;9;1;1;1
250829088271;250829088305;34;0,1,2;3;9;1;1;1
250829088305;250829088353;48;0,1,2;3;9;1;1;1
250829088353;250829089008;655;0,1,2;3;9;1;1;1
250829089008;250829089043;35;0,1,2;3;9;1;1;1
250829089043;250829091584;2541;0,1,2;3;9;1;1;1
250829091584;250829094179;2595;0,1,2;3;9;1;1;1
250829094179;250829094490;311;0,1,2;3;9;1;1;1
250829094490;250829094856;366;0,1,2;3;9;1;1;1
250829094856;250829095750;894;0,1,2;3;9;1;1;1
250829095750;250829096762;1012;0,1,2;3;9;1;1;1
250829096762;250829096848;86;0,1,2;3;9;1;1;1
250829096848;250829097245;397;0,1,2;3;9;1;1;1
250829097245;250829097289;44;0,1,2;3;9;1;1;1
250829097289;250829097515;226;0,1,2;3;9;1;1;1
250829097515;250829098026;511;0,1,2;3;9;1;1;1
250829098026;250829098281;255;0,1,2;3;9;1;1;1
250829098281;250829101297;3016;0,1,2;3;9;1;1;1
250829101297;250829101824;527;0,1,2;3;9;1;1;1
250829101824;250829102430;606;0,1,2;3;9;1;1;1
250829102430;250829102567;137;0,1,2;3;9;1;1;1
250829102567;250829102908;341;0,1,2;3;9;1;1;1
250829102908;250829103332;424;0,1,2;3;9;1;1;1
250829103332;250829103506;174;0,1,2;3;9;1;1;1
250829103506;250829103736;230;0,1,2;3;9;1;1;1
250829103736;250829103752;16;0,1,2;3;9;1;1;1
250829103752;250829103849;97;0,1,2;3;9;1;1;1
250829103849;250829104157;308;0,1,2;3;9;1;1;1
250829104157;250829104192;35;0,1,2;3;9;1;1;1
250829104192;250829104377;185;0,1,2;3;9;1;1;1
250829104377;250829104405;28;0,1,2;3;9;1;1;1
250829104405;250829104436;31;0,1,2;3;9;1;1;1
250829104436;250829105135;699;0,1,2;3;9;1;1;1
250829105135;250829106238;1103;0,1,2;3;9;1;1;1
250829106238;250829108684;2446;0,1,2;3;9;1;1;1
250829108684;250829109293;609;0,1,2;3;9;1;1;1
250829109293;250829114216;4923;0,1,2;3;9;1;1;1
250829114216;250829114861;645;0,1,2;3;9;1;1;1
250829114861;250829114889;28;0,1,2;3;9;1;1;1
250829114889;250829114929;40;0,1,2;3;9;1;1;1
250829114929;250829115179;250;0,1,2;3;9;1;1;1
250829115179;250829115214;35;0,1,2;3;9;1;1;1
250829115214;250829115503;289;0,1,2;3;9;1;1;1
250829115503;250829115533;30;0,1,2;3;9;1;1;1
250829115533;250829117524;1991;0,1,2;3;9;1;1;1
250829117524;250829117651;127;0,1,2;3;9;1;1;1
250829117651;250829117802;151;0,1,2;3;9;1;1;1
250829117802;250829121648;3846;0,1,2;3;9;1;1;1
250829121648;250829122132;484;0,1,2;3;9;1;1;1
250829122132;250829122209;77;0,1,2;3;9;1;1;1
250829122209;250829122517;308;0,1,2;3;9;1;1;1
250829122517;250829122610;93;0,1,2;3;9;1;1;1
250829122610;250829123882;1272;0,1,2;3;9;1;1;1
250829123882;250829124312;430;0,1,2;3;9;1;1;1
250829124312;250829124719;407;0,1,2;3;9;1;1;1
250829124719;250829124792;73;0,1,2;3;9;1;1;1
250829124792;250829124924;132;0,1,2;3;9;1;1;1
250829124924;250829125583;659;0,1,2;3;9;1;1;1
250829125583;250829125997;414;0,1,2;3;9;1;1;1
250829125997;250829126140;143;0,1,2;3;9;1;1;1
250829126140;250829126360;220;0,1,2;3;9;1;1;1
250829126360;250829126393;33;0,1,2;3;9;1;1;1
250829126393;250829126494;101;0,1,2;3;9;1;1;1
250829126494;250829126698;204;0,1,2;3;9;1;1;1
250829126698;250829126732;34;0,1,2;3;9;1;1;1
250829126732;250829127000;268;0,1,2;3;9;1;1;1
250829127000;250829127305;305;0,1,2;3;9;1;1;1
250829127305;250829127403;98;0,1,2;3;9;1;1;1
250829127403;250829127617;214;0,1,2;3;9;1;1;1
250829127617;250829127922;305;0,1,2;3;9;1;1;1
250829127922;250829127987;65;0,1,2;3;9;1;1;1
250829127987;250829128739;752;0,1,2;3;9;1;1;1
250829128739;250829128765;26;0,1,2;3;9;1;1;1
250829128765;250829128889;124;0,1,2;3;9;1;1;1
250829128889;250829129088;199;0,1,2;3;9;1;1;1
250829129088;250829130642;1554;0,1,2;3;9;1;1;1
250829130642;250829130777;135;0,1,2;3;9;1;1;1
250829130777;250829141931;11154;0,1,2;3;9;1;1;1
250829141931;250829146312;4381;0,1,2;3;9;1;1;1
250829146312;250829146937;625;0,1,2;3;9;1;1;1
250829146937;250829150979;4042;0,1,2;3;9;1;1;1
250829150979;250829151602;623;0,1,2;3;9;1;1;1
250829151602;250829153171;1569;0,1,2;3;9;1;1;1
250829153171;250829153283;112;0,1,2;3;9;1;1;1
250829153283;250829153316;33;0,1,2;3;9;1;1;1
250829153316;250829154061;745;0,1,2;3;9;1;1;1
250829154061;250829154395;334;0,1,2;3;9;1;1;1
250829154395;250829154423;28;0,1,2;3;9;1;1;1
250829154423;250829154688;265;0,1,2;3;9;1;1;1
250829154688;250829154854;166;0,1,2;3;9;1;1;1
250829154854;250829155314;460;0,1,2;3;9;1;1;1
250829155314;250829155435;121;0,1,2;3;9;1;1;1
250829155435;250829156015;580;0,1,2;3;9;1;1;1
250829156015;250829156291;276;0,1,2;3;9;1;1;1
250829156291;250829157368;1077;0,1,2;3;9;1;1;1
250829157368;250829157396;28;0,1,2;3;9;1;1;1
250829157396;250829158046;650;0,1,2;3;9;1;1;1
250829158046;250829158085;39;0,1,2;3;9;1;1;1
250829158085;250829158112;27;0,1,2;3;9;1;1;1
250829158112;250829158179;67;0,1,2;3;9;1;1;1
250829158179;250829161895;3716;0,1,2;3;9;1;1;1
250829161895;250829161935;40;0,1,2;3;9;1;1;1
250829161935;250829162815;880;0,1,2;3;9;1;1;1
250829162815;250829164267;1452;0,1,2;3;9;1;1;1
250829164267;250829165225;958;0,1,2;3;9;1;1;1
250829165225;250829165404;179;0,1,2;3;9;1;1;1
250829165404;250829165890;486;0,1,2;3;9;1;1;1
250829165890;250829166046;156;0,1,2;3;9;1;1;1
250829166046;250829166176;130;0,1,2;3;9;1;1;1
250829166176;250829166200;24;0,1,2;3;9;1;1;1
250829166200;250829166233;33;0,1,2;3;9;1;1;1
250829166233;250829166334;101;0,1,2;3;9;1;1;1
250829166334;250829166488;154;0,1,2;3;9;1;1;1
250829166488;250829166772;284;0,1,2;3;9;1;1;1
250829166772;250829168479;1707;0,1,2;3;9;1;1;1
250829168479;250829168705;226;0,1,2;3;9;1;1;1
250829168705;250829168747;42;0,1,2;3;9;1;1;1
250829168747;250829168810;63;0,1,2;3;9;1;1;1
250829168810;250829169762;952;0,1,2;3;9;1;1;1
250829169762;250829169898;136;0,1,2;3;9;1;1;1
250829169898;250829170761;863;0,1,2;3;9;1;1;1
250829170761;250829170912;151;0,1,2;3;9;1;1;1
250829170912;250829172601;1689;0,1,2;3;9;1;1;1
250829172601;250829174028;1427;0,1,2;3;9;1;1;1
250829174028;250829174059;31;0,1,2;3;9;1;1;1
250829174059;250829177243;3184;0,1,2;3;9;1;1;1
250829177243;250829180601;3358;0,1,2;3;9;1;1;1
250829180601;250829182003;1402;0,1,2;3;9;1;1;1
250829182003;250829184671;2668;0,1,2;3;9;1;1;1
250829184671;250829185621;950;0,1,2;3;9;1;1;1
250829185621;250829187866;2245;0,1,2;3;9;1;1;1
250829187866;250829189291;1425;0,1,2;3;9;1;1;1
250829189291;250829189321;30;0,1,2;3;9;1;1;1
250829189321;250829192012;2691;0,1,2;3;9;1;1;1
250829192012;250829197761;5749;0,1,2;3;9;1;1;1
250829197761;250829197978;217;0,1,2;3;9;1;1;1
250829197978;250829208648;10670;0,1,2;3;9;1;1;1
250829208648;250829224359;15711;0,1,2;3;9;1;1;1
250829224359;250829226442;2083;0,1,2;3;9;1;1;1
250829226442;250829232910;6468;0,1,2;3;9;1;1;1
250829232910;250829238275;5365;0,1,2;3;9;1;1;1
250829238275;250829242669;4394;0,1,2;3;9;1;1;1
250829242669;250829266412;23743;0,1,2;3;9;1;1;1
250829266412;250829266476;64;0,1,2;3;9;1;1;1
250829266476;250829277761;11285;0,1,2;3;9;1;1;1
250829277761;250829278265;504;0,1,2;3;9;1;1;1
250829278265;250829283972;5707;0,1,2;3;9;1;1;1
250829283972;250829283993;21;0,1,2;3;9;1;1;1
250829283993;250829291538;7545;0,1,2;3;9;1;1;1
250829291538;250829293226;1688;0,1,2;3;9;1;1;1
250829293226;250829303994;10768;0,1,2;3;9;1;1;1
250829303994;250829312479;8485;0,1,2;3;9;1;1;1
250829312479;250829312640;161;0,1,2;3;9;1;1;1
250829312640;250829335333;22693;0,1,2;3;9;1;1;1
250829335333;250829407493;72160;0,1,2;3;9;1;1;1
250829407493;250829474757;67264;0,1,2;3;9;1;1;1
250829474757;250829480058;5301;0,1,2;3;9;1;1;1
250829480058;250829487385;7327;0,1,2;3;9;1;1;1
250829487385;250829499230;11845;0,1,2;3;9;1;1;1
250829499230;250829504745;5515;0,1,2;3;9;1;1;1
250829504745;250829505505;760;0,1,2;3;9;1;1;1
250829505505;250829519404;13899;0,1,2;3;9;1;1;1
250829519404;250829521612;2208;0,1,2;3;9;1;1;1
250829521612;250829521710;98;0,1,2;3;9;1;1;1
250829521710;250829526372;4662;0,1,2;3;9;1;1;1
250829526372;250829526519;147;0,1,2;3;9;1;1;1
250829526519;250829529139;2620;0,1,2;3;9;1;1;1
250829529139;250829532512;3373;0,1,2;3;9;1;1;1
250829532512;250829534606;2094;0,1,2;3;9;1;1;1
250829534606;250829541476;6870;0,1,2;3;9;1;1;1
250829541476;250829543034;1558;0,1,2;3;9;1;1;1
250829543034;250829544316;1282;0,1,2;3;9;1;1;1
250829544316;250829546331;2015;0,1,2;3;9;1;1;1
250829546331;250829550679;4348;0,1,2;3;9;1;1;1
250829550679;250829552200;1521;0,1,2;3;9;1;1;1
250829552200;250829553386;1186;0,1,2;3;9;1;1;1
250829553386;250829558664;5278;0,1,2;3;9;1;1;1
250829558664;250829559740;1076;0,1,2;3;9;1;1;1
250829559740;250829563773;4033;0,1,2;3;9;1;1;1
250829563773;250829566963;3190;0,1,2;3;9;1;1;1
250829566963;250829569241;2278;0,1,2;3;9;1;1;1
250829569241;250829575095;5854;0,1,2;3;9;1;1;1
250829575095;250829577606;2511;0,1,2;3;9;1;1;1
250829577606;250829579394;1788;0,1,2;3;9;1;1;1
250829579394;250829583608;4214;0,1,2;3;9;1;1;1
250829583608;250829585509;1901;0,1,2;3;9;1;1;1
250829585509;250829590909;5400;0,1,2;3;9;1;1;1
250829590909;250829596984;6075;0,1,2;3;9;1;1;1
250829596984;250829601695;4711;0,1,2;3;9;1;1;1
250829601695;250829602593;898;0,1,2;3;9;1;1;1
250829602593;250829603154;561;0,1,2;3;9;1;1;1
250829603154;250829603923;769;0,1,2;3;9;1;1;1
250829603923;250829609080;5157;0,1,2;3;9;1;1;1
250829609080;250829609314;234;0,1,2;3;9;1;1;1
250829609314;250829609650;336;0,1,2;3;9;1;1;1
250829609650;250829612036;2386;0,1,2;3;9;1;1;1
250829612036;250829612757;721;0,1,2;3;9;1;1;1
250829612757;250829612859;102;0,1,2;3;9;1;1;1
250829612859;250829618258;5399;0,1,2;3;9;1;1;1
250829618258;250829623562;5304;0,1,2;3;9;1;1;1
250829623562;250829623697;135;0,1,2;3;9;1;1;1
250829623697;250829623836;139;0,1,2;3;9;1;1;1
250829623836;250829631044;7208;0,1,2;3;9;1;1;1
250829631044;250829632097;1053;0,1,2;3;9;1;1;1
250829632097;250829632128;31;0,1,2;3;9;1;1;1
250829632128;250829632264;136;0,1,2;3;9;1;1;1
250829632264;250829632507;243;0,1,2;3;9;1;1;1
250829632507;250829632625;118;0,1,2;3;9;1;1;1
250829632625;250829633463;838;0,1,2;3;9;1;1;1
250829633463;250829634527;1064;0,1,2;3;9;1;1;1
250829634527;250829635573;1046;0,1,2;3;9;1;1;1
250829635573;250829636165;592;0,1,2;3;9;1;1;1
250829636165;250829636983;818;0,1,2;3;9;1;1;1
250829636983;250829637424;441;0,1,2;3;9;1;1;1
250829637424;250829638706;1282;0,1,2;3;9;1;1;1
250829638706;250829640312;1606;0,1,2;3;9;1;1;1
250829640312;250829640490;178;0,1,2;3;9;1;1;1
250829640490;250829641503;1013;0,1,2;3;9;1;1;1
250829641503;250829641882;379;0,1,2;3;9;1;1;1
250829641882;250829642742;860;0,1,2;3;9;1;1;1
250829642742;250829644765;2023;0,1,2;3;9;1;1;1
250829644765;250829645055;290;0,1,2;3;9;1;1;1
250829645055;250829645119;64;0,1,2;3;9;1;1;1
250829645119;250829645346;227;0,1,2;3;9;1;1;1
250829645346;250829645913;567;0,1,2;3;9;1;1;1
250829645913;250829646559;646;0,1,2;3;9;1;1;1
250829646559;250829646587;28;0,1,2;3;9;1;1;1
250829646587;250829646608;21;0,1,2;3;9;1;1;1
250829646608;250829646686;78;0,1,2;3;9;1;1;1
250829646686;250829646749;63;0,1,2;3;9;1;1;1
250829646749;250829650005;3256;0,1,2;3;9;1;1;1
250829650005;250829650098;93;0,1,2;3;9;1;1;1
250829650098;250829650203;105;0,1,2;3;9;1;1;1
250829650203;250829650238;35;0,1,2;3;9;1;1;1
250829650238;250829650340;102;0,1,2;3;9;1;1;1
250829650340;250829650432;92;0,1,2;3;9;1;1;1
250829650432;250829653352;2920;0,1,2;3;9;1;1;1
250829653352;250829653455;103;0,1,2;3;9;1;1;1
250829653455;250829653921;466;0,1,2;3;9;1;1;1
250829653921;250829655227;1306;0,1,2;3;9;1;1;1
250829655227;250829655331;104;0,1,2;3;9;1;1;1
250829655331;250829655966;635;0,1,2;3;9;1;1;1
250829655966;250829658480;2514;0,1,2;3;9;1;1;1
250829658480;250829658870;390;0,1,2;3;9;1;1;1
250829658870;250829658959;89;0,1,2;3;9;1;1;1
250829658959;250829662740;3781;0,1,2;3;9;1;1;1
250829662740;250829663716;976;0,1,2;3;9;1;1;1
250829663716;250829663840;124;0,1,2;3;9;1;1;1
250829663840;250829664113;273;0,1,2;3;9;1;1;1
250829664113;250829664277;164;0,1,2;3;9;1;1;1
250829664277;250829665422;1145;0,1,2;3;9;1;1;1
250829665422;250829666671;1249;0,1,2;3;9;1;1;1
250829666671;250829668168;1497;0,1,2;3;9;1;1;1
250829668168;250829669599;1431;0,1,2;3;9;1;1;1
250829669599;250829670258;659;0,1,2;3;9;1;1;1
250829670258;250829671927;1669;0,1,2;3;9;1;1;1
250829671927;250829672068;141;0,1,2;3;9;1;1;1
250829672068;250829675453;3385;0,1,2;3;9;1;1;1
250829675453;250829675981;528;0,1,2;3;9;1;1;1
250829675981;250829676054;73;0,1,2;3;9;1;1;1
250829676054;250829677321;1267;0,1,2;3;9;1;1;1
250829677321;250829677351;30;0,1,2;3;9;1;1;1
250829677351;250829678412;1061;0,1,2;3;9;1;1;1
250829678412;250829679263;851;0,1,2;3;9;1;1;1
250829679263;250829679452;189;0,1,2;3;9;1;1;1
250829679452;250829679818;366;0,1,2;3;9;1;1;1
250829679818;250829680346;528;0,1,2;3;9;1;1;1
250829680346;250829681107;761;0,1,2;3;9;1;1;1
250829681107;250829681438;331;0,1,2;3;9;1;1;1
250829681438;250829681789;351;0,1,2;3;9;1;1;1
250829681789;250829681946;157;0,1,2;3;9;1;1;1
250829681946;250829683933;1987;0,1,2;3;9;1;1;1
250829683933;250829685531;1598;0,1,2;3;9;1;1;1
250829685531;250829685725;194;0,1,2;3;9;1;1;1
250829685725;250829687175;1450;0,1,2;3;9;1;1;1
250829687175;250829688594;1419;0,1,2;3;9;1;1;1
250829688594;250829691461;2867;0,1,2;3;9;1;1;1
250829691461;250829692167;706;0,1,2;3;9;1;1;1
250829692167;250829693057;890;0,1,2;3;9;1;1;1
250829693057;250829693582;525;0,1,2;3;9;1;1;1
250829693582;250829694046;464;0,1,2;3;9;1;1;1
250829694046;250829695184;1138;0,1,2;3;9;1;1;1
250829695184;250829695434;250;0,1,2;3;9;1;1;1
250829695434;250829696173;739;0,1,2;3;9;1;1;1
250829696173;250829697431;1258;0,1,2;3;9;1;1;1
250829697431;250829697952;521;0,1,2;3;9;1;1;1
250829697952;250829698456;504;0,1,2;3;9;1;1;1
250829698456;250829698627;171;0,1,2;3;9;1;1;1
250829698627;250829699060;433;0,1,2;3;9;1;1;1
250829699060;250829700508;1448;0,1,2;3;9;1;1;1
250829700508;250829700546;38;0,1,2;3;9;1;1;1
250829700546;250829703342;2796;0,1,2;3;9;1;1;1
250829703342;250829705126;1784;0,1,2;3;9;1;1;1
250829705126;250829705184;58;0,1,2;3;9;1;1;1
250829705184;250829705476;292;0,1,2;3;9;1;1;1
250829705476;250829706226;750;0,1,2;3;9;1;1;1
250829706226;250829707217;991;0,1,2;3;9;1;1;1
250829707217;250829707376;159;0,1,2;3;9;1;1;1
250829707376;250829707430;54;0,1,2;3;9;1;1;1
250829707430;250829708794;1364;0,1,2;3;9;1;1;1
250829708794;250829709168;374;0,1,2;3;9;1;1;1
250829709168;250829710145;977;0,1,2;3;9;1;1;1
250829710145;250829710409;264;0,1,2;3;9;1;1;1
250829710409;250829711930;1521;0,1,2;3;9;1;1;1
250829711930;250829712133;203;0,1,2;3;9;1;1;1
250829712133;250829712162;29;0,1,2;3;9;1;1;1
250829712162;250829712258;96;0,1,2;3;9;1;1;1
250829712258;250829712449;191;0,1,2;3;9;1;1;1
250829712449;250829712702;253;0,1,2;3;9;1;1;1
250829712702;250829712801;99;0,1,2;3;9;1;1;1
250829712801;250829712869;68;0,1,2;3;9;1;1;1
250829712869;250829713358;489;0,1,2;3;9;1;1;1
250829713358;250829713408;50;0,1,2;3;9;1;1;1
250829713408;250829713459;51;0,1,2;3;9;1;1;1
250829713459;250829713644;185;0,1,2;3;9;1;1;1
250829713644;250829713708;64;0,1,2;3;9;1;1;1
250829713708;250829714003;295;0,1,2;3;9;1;1;1
250829714003;250829715092;1089;0,1,2;3;9;1;1;1
250829715092;250829715806;714;0,1,2;3;9;1;1;1
250829715806;250829716369;563;0,1,2;3;9;1;1;1
250829716369;250829716481;112;0,1,2;3;9;1;1;1
250829716481;250829716688;207;0,1,2;3;9;1;1;1
250829716688;250829716962;274;0,1,2;3;9;1;1;1
250829716962;250829717251;289;0,1,2;3;9;1;1;1
250829717251;250829717333;82;0,1,2;3;9;1;1;1
250829717333;250829717517;184;0,1,2;3;9;1;1;1
250829717517;250829719672;2155;0,1,2;3;9;1;1;1
250829719672;250829720615;943;0,1,2;3;9;1;1;1
250829720615;250829721109;494;0,1,2;3;9;1;1;1
250829721109;250829722277;1168;0,1,2;3;9;1;1;1
250829722277;250829724282;2005;0,1,2;3;9;1;1;1
250829724282;250829724331;49;0,1,2;3;9;1;1;1
250829724331;250829724461;130;0,1,2;3;9;1;1;1
250829724461;250829725670;1209;0,1,2;3;9;1;1;1
250829725670;250829725885;215;0,1,2;3;9;1;1;1
250829725885;250829726408;523;0,1,2;3;9;1;1;1
250829726408;250829727996;1588;0,1,2;3;9;1;1;1
250829727996;250829728176;180;0,1,2;3;9;1;1;1
250829728176;250829728210;34;0,1,2;3;9;1;1;1
250829728210;250829728972;762;0,1,2;3;9;1;1;1
250829728972;250829729153;181;0,1,2;3;9;1;1;1
250829729153;250829729720;567;0,1,2;3;9;1;1;1
250829729720;250829730310;590;0,1,2;3;9;1;1;1
250829730310;250829730336;26;0,1,2;3;9;1;1;1
250829730336;250829730605;269;0,1,2;3;9;1;1;1
250829730605;250829730844;239;0,1,2;3;9;1;1;1
250829730844;250829730975;131;0,1,2;3;9;1;1;1
250829730975;250829731228;253;0,1,2;3;9;1;1;1
250829731228;250829731255;27;0,1,2;3;9;1;1;1
250829731255;250829732599;1344;0,1,2;3;9;1;1;1
250829732599;250829732903;304;0,1,2;3;9;1;1;1
250829732903;250829733183;280;0,1,2;3;9;1;1;1
250829733183;250829733766;583;0,1,2;3;9;1;1;1
250829733766;250829734233;467;0,1,2;3;9;1;1;1
250829734233;250829734252;19;0,1,2;3;9;1;1;1
250829734252;250829734470;218;0,1,2;3;9;1;1;1
250829734470;250829735388;918;0,1,2;3;9;1;1;1
250829735388;250829736102;714;0,1,2;3;9;1;1;1
250829736102;250829736286;184;0,1,2;3;9;1;1;1
250829736286;250829736312;26;0,1,2;3;9;1;1;1
250829736312;250829737153;841;0,1,2;3;9;1;1;1
250829737153;250829737169;16;0,1,2;3;9;1;1;1
250829737169;250829737810;641;0,1,2;3;9;1;1;1
250829737810;250829738129;319;0,1,2;3;9;1;1;1
250829738129;250829738957;828;0,1,2;3;9;1;1;1
250829738957;250829739169;212;0,1,2;3;9;1;1;1
250829739169;250829739171;2;0,1,2;3;9;1;1;1
250829739171;250829739186;15;0,1,2;3;9;1;1;1
250829739186;250829740013;827;0,1,2;3;9;1;1;1
250829740013;250829740064;51;0,1,2;3;9;1;1;1
250829740064;250829740918;854;0,1,2;3;9;1;1;1
250829740918;250829741157;239;0,1,2;3;9;1;1;1
250829741157;250829741634;477;0,1,2;3;9;1;1;1
250829741634;250829742290;656;0,1,2;3;9;1;1;1
250829742290;250829742512;222;0,1,2;3;9;1;1;1
250829742512;250829743056;544;0,1,2;3;9;1;1;1
250829743056;250829743846;790;0,1,2;3;9;1;1;1
250829743846;250829743934;88;0,1,2;3;9;1;1;1
250829743934;250829744113;179;0,1,2;3;9;1;1;1
250829744113;250829745102;989;0,1,2;3;9;1;1;1
250829745102;250829745710;608;0,1,2;3;9;1;1;1
250829745710;250829746590;880;0,1,2;3;9;1;1;1
250829746590;250829747035;445;0,1,2;3;9;1;1;1
250829747035;250829747457;422;0,1,2;3;9;1;1;1
250829747457;250829747780;323;0,1,2;3;9;1;1;1
250829747780;250829748540;760;0,1,2;3;9;1;1;1
250829748540;250829749390;850;0,1,2;3;9;1;1;1
250829749390;250829750043;653;0,1,2;3;9;1;1;1
250829750043;250829750965;922;0,1,2;3;9;1;1;1
250829750965;250829752009;1044;0,1,2;3;9;1;1;1
250829752009;250829752284;275;0,1,2;3;9;1;1;1
250829752284;250829753251;967;0,1,2;3;9;1;1;1
250829753251;250829753432;181;0,1,2;3;9;1;1;1
250829753432;250829755034;1602;0,1,2;3;9;1;1;1
250829755034;250829756838;1804;0,1,2;3;9;1;1;1
250829756838;250829757062;224;0,1,2;3;9;1;1;1
250829757062;250829757580;518;0,1,2;3;9;1;1;1
250829757580;250829757683;103;0,1,2;3;9;1;1;1
250829757683;250829758029;346;0,1,2;3;9;1;1;1
250829758029;250829758572;543;0,1,2;3;9;1;1;1
250829758572;250829758642;70;0,1,2;3;9;1;1;1
250829758642;250829758798;156;0,1,2;3;9;1;1;1
250829758798;250829758845;47;0,1,2;3;9;1;1;1
250829758845;250829758966;121;0,1,2;3;9;1;1;1
250829758966;250829759230;264;0,1,2;3;9;1;1;1
250829759230;250829759934;704;0,1,2;3;9;1;1;1
250829759934;250829760228;294;0,1,2;3;9;1;1;1
250829760228;250829760273;45;0,1,2;3;9;1;1;1
250829760273;250829761378;1105;0,1,2;3;9;1;1;1
250829761378;250829761620;242;0,1,2;3;9;1;1;1
250829761620;250829761825;205;0,1,2;3;9;1;1;1
250829761825;250829762649;824;0,1,2;3;9;1;1;1
250829762649;250829763185;536;0,1,2;3;9;1;1;1
250829763185;250829763834;649;0,1,2;3;9;1;1;1
250829763834;250829764106;272;0,1,2;3;9;1;1;1
250829764106;250829764724;618;0,1,2;3;9;1;1;1
250829764724;250829764820;96;0,1,2;3;9;1;1;1
250829764820;250829764866;46;0,1,2;3;9;1;1;1
250829764866;250829765054;188;0,1,2;3;9;1;1;1
250829765054;250829765261;207;0,1,2;3;9;1;1;1
250829765261;250829765506;245;0,1,2;3;9;1;1;1
250829765506;250829765612;106;0,1,2;3;9;1;1;1
250829765612;250829765877;265;0,1,2;3;9;1;1;1
250829765877;250829766414;537;0,1,2;3;9;1;1;1
250829766414;250829767286;872;0,1,2;3;9;1;1;1
250829767286;250829767569;283;0,1,2;3;9;1;1;1
250829767569;250829767783;214;0,1,2;3;9;1;1;1
250829767783;250829769144;1361;0,1,2;3;9;1;1;1
250829769144;250829769286;142;0,1,2;3;9;1;1;1
250829769286;250829769867;581;0,1,2;3;9;1;1;1
250829769867;250829770012;145;0,1,2;3;9;1;1;1
250829770012;250829770120;108;0,1,2;3;9;1;1;1
250829770120;250829770137;17;0,1,2;3;9;1;1;1
250829770137;250829770140;3;0,1,2;3;9;1;1;1
250829770140;250829770421;281;0,1,2;3;9;1;1;1
250829770421;250829772025;1604;0,1,2;3;9;1;1;1
250829772025;250829772643;618;0,1,2;3;9;1;1;1
250829772643;250829772715;72;0,1,2;3;9;1;1;1
250829772715;250829773078;363;0,1,2;3;9;1;1;1
250829773078;250829773595;517;0,1,2;3;9;1;1;1
250829773595;250829774025;430;0,1,2;3;9;1;1;1
250829774025;250829774302;277;0,1,2;3;9;1;1;1
250829774302;250829774851;549;0,1,2;3;9;1;1;1
250829774851;250829775134;283;0,1,2;3;9;1;1;1
250829775134;250829775297;163;0,1,2;3;9;1;1;1
250829775297;250829775778;481;0,1,2;3;9;1;1;1
250829775778;250829776001;223;0,1,2;3;9;1;1;1
250829776001;250829776853;852;0,1,2;3;9;1;1;1
250829776853;250829777814;961;0,1,2;3;9;1;1;1
250829777814;250829778111;297;0,1,2;3;9;1;1;1
250829778111;250829778654;543;0,1,2;3;9;1;1;1
250829778654;250829779014;360;0,1,2;3;9;1;1;1
250829779014;250829779062;48;0,1,2;3;9;1;1;1
250829779062;250829779180;118;0,1,2;3;9;1;1;1
250829779180;250829779369;189;0,1,2;3;9;1;1;1
250829779369;250829779533;164;0,1,2;3;9;1;1;1
250829779533;250829779580;47;0,1,2;3;9;1;1;1
250829779580;250829780156;576;0,1,2;3;9;1;1;1
250829780156;250829780276;120;0,1,2;3;9;1;1;1
250829780276;250829781132;856;0,1,2;3;9;1;1;1
250829781132;250829781305;173;0,1,2;3;9;1;1;1
250829781305;250829782275;970;0,1,2;3;9;1;1;1
250829782275;250829783458;1183;0,1,2;3;9;1;1;1
250829783458;250829783755;297;0,1,2;3;9;1;1;1
250829783755;250829783790;35;0,1,2;3;9;1;1;1
250829783790;250829784164;374;0,1,2;3;9;1;1;1
250829784164;250829784495;331;0,1,2;3;9;1;1;1
250829784495;250829785415;920;0,1,2;3;9;1;1;1
250829785415;250829786025;610;0,1,2;3;9;1;1;1
250829786025;250829786617;592;0,1,2;3;9;1;1;1
250829786617;250829787134;517;0,1,2;3;9;1;1;1
250829787134;250829787573;439;0,1,2;3;9;1;1;1
250829787573;250829787705;132;0,1,2;3;9;1;1;1
250829787705;250829787843;138;0,1,2;3;9;1;1;1
250829787843;250829788051;208;0,1,2;3;9;1;1;1
250829788051;250829788434;383;0,1,2;3;9;1;1;1
250829788434;250829788528;94;0,1,2;3;9;1;1;1
250829788528;250829788861;333;0,1,2;3;9;1;1;1
250829788861;250829789399;538;0,1,2;3;9;1;1;1
250829789399;250829789668;269;0,1,2;3;9;1;1;1
250829789668;250829790714;1046;0,1,2;3;9;1;1;1
250829790714;250829790727;13;0,1,2;3;9;1;1;1
250829790727;250829791479;752;0,1,2;3;9;1;1;1
250829791479;250829791986;507;0,1,2;3;9;1;1;1
250829791986;250829792089;103;0,1,2;3;9;1;1;1
250829792089;250829792847;758;0,1,2;3;9;1;1;1
250829792847;250829793062;215;0,1,2;3;9;1;1;1
250829793062;250829793496;434;0,1,2;3;9;1;1;1
250829793496;250829794337;841;0,1,2;3;9;1;1;1
250829794337;250829794660;323;0,1,2;3;9;1;1;1
250829794660;250829795516;856;0,1,2;3;9;1;1;1
250829795516;250829795907;391;0,1,2;3;9;1;1;1
250829795907;250829796963;1056;0,1,2;3;9;1;1;1
250829796963;250829798421;1458;0,1,2;3;9;1;1;1
250829798421;250829799059;638;0,1,2;3;9;1;1;1
250829799059;250829799218;159;0,1,2;3;9;1;1;1
250829799218;250829799703;485;0,1,2;3;9;1;1;1
250829799703;250829799998;295;0,1,2;3;9;1;1;1
250829799998;250829800843;845;0,1,2;3;9;1;1;1
250829800843;250829800980;137;0,1,2;3;9;1;1;1
250829800980;250829801516;536;0,1,2;3;9;1;1;1
250829801516;250829801823;307;0,1,2;3;9;1;1;1
250829801823;250829802596;773;0,1,2;3;9;1;1;1
250829802596;250829803790;1194;0,1,2;3;9;1;1;1
250829803790;250829805209;1419;0,1,2;3;9;1;1;1
250829805209;250829805255;46;0,1,2;3;9;1;1;1
250829805255;250829805387;132;0,1,2;3;9;1;1;1
250829805387;250829805423;36;0,1,2;3;9;1;1;1
250829805423;250829805490;67;0,1,2;3;9;1;1;1
250829805490;250829805841;351;0,1,2;3;9;1;1;1
250829805841;250829806143;302;0,1,2;3;9;1;1;1
250829806143;250829806448;305;0,1,2;3;9;1;1;1
250829806448;250829808022;1574;0,1,2;3;9;1;1;1
250829808022;250829808122;100;0,1,2;3;9;1;1;1
250829808122;250829809266;1144;0,1,2;3;9;1;1;1
250829809266;250829812096;2830;0,1,2;3;9;1;1;1
250829812096;250829813706;1610;0,1,2;3;9;1;1;1
250829813706;250829813812;106;0,1,2;3;9;1;1;1
250829813812;250829814126;314;0,1,2;3;9;1;1;1
250829814126;250829816999;2873;0,1,2;3;9;1;1;1
250829816999;250829817008;9;0,1,2;3;9;1;1;1
250829817008;250829817255;247;0,1,2;3;9;1;1;1
250829817255;250829817436;181;0,1,2;3;9;1;1;1
250829817436;250829817638;202;0,1,2;3;9;1;1;1
250829817638;250829817738;100;0,1,2;3;9;1;1;1
250829817738;250829817821;83;0,1,2;3;9;1;1;1
250829817821;250829818084;263;0,1,2;3;9;1;1;1
250829818084;250829818170;86;0,1,2;3;9;1;1;1
250829818170;250829818211;41;0,1,2;3;9;1;1;1
250829818211;250829818320;109;0,1,2;3;9;1;1;1
250829818320;250829818362;42;0,1,2;3;9;1;1;1
250829818362;250829818402;40;0,1,2;3;9;1;1;1
250829818402;250829818550;148;0,1,2;3;9;1;1;1
250829818550;250829818591;41;0,1,2;3;9;1;1;1
250829818591;250829819330;739;0,1,2;3;9;1;1;1
250829819330;250829819689;359;0,1,2;3;9;1;1;1
250829819689;250829819739;50;0,1,2;3;9;1;1;1
250829819739;250829820204;465;0,1,2;3;9;1;1;1
250829820204;250829820644;440;0,1,2;3;9;1;1;1
250829820644;250829821798;1154;0,1,2;3;9;1;1;1
250829821798;250829822614;816;0,1,2;3;9;1;1;1
250829822614;250829822691;77;0,1,2;3;9;1;1;1
250829822691;250829823021;330;0,1,2;3;9;1;1;1
250829823021;250829823476;455;0,1,2;3;9;1;1;1
250829823476;250829823780;304;0,1,2;3;9;1;1;1
250829823780;250829823937;157;0,1,2;3;9;1;1;1
250829823937;250829825543;1606;0,1,2;3;9;1;1;1
250829825543;250829825751;208;0,1,2;3;9;1;1;1
250829825751;250829825823;72;0,1,2;3;9;1;1;1
250829825823;250829826531;708;0,1,2;3;9;1;1;1
250829826531;250829826944;413;0,1,2;3;9;1;1;1
250829826944;250829827823;879;0,1,2;3;9;1;1;1
250829827823;250829827948;125;0,1,2;3;9;1;1;1
250829827948;250829828426;478;0,1,2;3;9;1;1;1
250829828426;250829830349;1923;0,1,2;3;9;1;1;1
250829830349;250829831825;1476;0,1,2;3;9;1;1;1
250829831825;250829831922;97;0,1,2;3;9;1;1;1
250829831922;250829832318;396;0,1,2;3;9;1;1;1
250829832318;250829832539;221;0,1,2;3;9;1;1;1
250829832539;250829833030;491;0,1,2;3;9;1;1;1
250829833030;250829833178;148;0,1,2;3;9;1;1;1
250829833178;250829833746;568;0,1,2;3;9;1;1;1
250829833746;250829834177;431;0,1,2;3;9;1;1;1
250829834177;250829835396;1219;0,1,2;3;9;1;1;1
250829835396;250829835493;97;0,1,2;3;9;1;1;1
250829835493;250829835991;498;0,1,2;3;9;1;1;1
250829835991;250829836358;367;0,1,2;3;9;1;1;1
250829836358;250829836716;358;0,1,2;3;9;1;1;1
250829836716;250829836749;33;0,1,2;3;9;1;1;1
250829836749;250829836813;64;0,1,2;3;9;1;1;1
250829836813;250829837317;504;0,1,2;3;9;1;1;1
250829837317;250829837444;127;0,1,2;3;9;1;1;1
250829837444;250829837719;275;0,1,2;3;9;1;1;1
250829837719;250829838318;599;0,1,2;3;9;1;1;1
250829838318;250829838749;431;0,1,2;3;9;1;1;1
250829838749;250829841219;2470;0,1,2;3;9;1;1;1
250829841219;250829841398;179;0,1,2;3;9;1;1;1
250829841398;250829841521;123;0,1,2;3;9;1;1;1
250829841521;250829842453;932;0,1,2;3;9;1;1;1
250829842453;250829842742;289;0,1,2;3;9;1;1;1
250829842742;250829842764;22;0,1,2;3;9;1;1;1
250829842764;250829842858;94;0,1,2;3;9;1;1;1
250829842858;250829843146;288;0,1,2;3;9;1;1;1
250829843146;250829843574;428;0,1,2;3;9;1;1;1
250829843574;250829843831;257;0,1,2;3;9;1;1;1
250829843831;250829844203;372;0,1,2;3;9;1;1;1
250829844203;250829844780;577;0,1,2;3;9;1;1;1
250829844780;250829845325;545;0,1,2;3;9;1;1;1
250829845325;250829845685;360;0,1,2;3;9;1;1;1
250829845685;250829846571;886;0,1,2;3;9;1;1;1
250829846571;250829847018;447;0,1,2;3;9;1;1;1
250829847018;250829847154;136;0,1,2;3;9;1;1;1
250829847154;250829847239;85;0,1,2;3;9;1;1;1
250829847239;250829847455;216;0,1,2;3;9;1;1;1
250829847455;250829847493;38;0,1,2;3;9;1;1;1
250829847493;250829847626;133;0,1,2;3;9;1;1;1
250829847626;250829847986;360;0,1,2;3;9;1;1;1
250829847986;250829848346;360;0,1,2;3;9;1;1;1
250829848346;250829849048;702;0,1,2;3;9;1;1;1
250829849048;250829849182;134;0,1,2;3;9;1;1;1
250829849182;250829849494;312;0,1,2;3;9;1;1;1
250829849494;250829849859;365;0,1,2;3;9;1;1;1
250829849859;250829850634;775;0,1,2;3;9;1;1;1
250829850634;250829851162;528;0,1,2;3;9;1;1;1
250829851162;250829851230;68;0,1,2;3;9;1;1;1
250829851230;250829851328;98;0,1,2;3;9;1;1;1
250829851328;250829851440;112;0,1,2;3;9;1;1;1
250829851440;250829852003;563;0,1,2;3;9;1;1;1
250829852003;250829852115;112;0,1,2;3;9;1;1;1
250829852115;250829852514;399;0,1,2;3;9;1;1;1
250829852514;250829853306;792;0,1,2;3;9;1;1;1
250829853306;250829853339;33;0,1,2;3;9;1;1;1
250829853339;250829853778;439;0,1,2;3;9;1;1;1
250829853778;250829853850;72;0,1,2;3;9;1;1;1
250829853850;250829854139;289;0,1,2;3;9;1;1;1
250829854139;250829855097;958;0,1,2;3;9;1;1;1
250829855097;250829855186;89;0,1,2;3;9;1;1;1
250829855186;250829855483;297;0,1,2;3;9;1;1;1
250829855483;250829856348;865;0,1,2;3;9;1;1;1
250829856348;250829856507;159;0,1,2;3;9;1;1;1
250829856507;250829857352;845;0,1,2;3;9;1;1;1
250829857352;250829857447;95;0,1,2;3;9;1;1;1
250829857447;250829857600;153;0,1,2;3;9;1;1;1
250829857600;250829857625;25;0,1,2;3;9;1;1;1
250829857625;250829857734;109;0,1,2;3;9;1;1;1
250829857734;250829857939;205;0,1,2;3;9;1;1;1
250829857939;250829858146;207;0,1,2;3;9;1;1;1
250829858146;250829858524;378;0,1,2;3;9;1;1;1
250829858524;250829858632;108;0,1,2;3;9;1;1;1
250829858632;250829859110;478;0,1,2;3;9;1;1;1
250829859110;250829859280;170;0,1,2;3;9;1;1;1
250829859280;250829859542;262;0,1,2;3;9;1;1;1
250829859542;250829859813;271;0,1,2;3;9;1;1;1
250829859813;250829859931;118;0,1,2;3;9;1;1;1
250829859931;250829861120;1189;0,1,2;3;9;1;1;1
250829861120;250829861286;166;0,1,2;3;9;1;1;1
250829861286;250829861381;95;0,1,2;3;9;1;1;1
250829861381;250829862129;748;0,1,2;3;9;1;1;1
250829862129;250829862670;541;0,1,2;3;9;1;1;1
250829862670;250829862729;59;0,1,2;3;9;1;1;1
250829862729;250829862958;229;0,1,2;3;9;1;1;1
250829862958;250829863076;118;0,1,2;3;9;1;1;1
250829863076;250829863133;57;0,1,2;3;9;1;1;1
250829863133;250829863783;650;0,1,2;3;9;1;1;1
250829863783;250829863813;30;0,1,2;3;9;1;1;1
250829863813;250829863835;22;0,1,2;3;9;1;1;1
250829863835;250829863921;86;0,1,2;3;9;1;1;1
250829863921;250829864143;222;0,1,2;3;9;1;1;1
250829864143;250829864388;245;0,1,2;3;9;1;1;1
250829864388;250829864469;81;0,1,2;3;9;1;1;1
250829864469;250829864501;32;0,1,2;3;9;1;1;1
250829864501;250829865519;1018;0,1,2;3;9;1;1;1
250829865519;250829866105;586;0,1,2;3;9;1;1;1
250829866105;250829866237;132;0,1,2;3;9;1;1;1
250829866237;250829866404;167;0,1,2;3;9;1;1;1
250829866404;250829866454;50;0,1,2;3;9;1;1;1
250829866454;250829866958;504;0,1,2;3;9;1;1;1
250829866958;250829867013;55;0,1,2;3;9;1;1;1
250829867013;250829867163;150;0,1,2;3;9;1;1;1
250829867163;250829867465;302;0,1,2;3;9;1;1;1
250829867465;250829868288;823;0,1,2;3;9;1;1;1
250829868288;250829868568;280;0,1,2;3;9;1;1;1
250829868568;250829869065;497;0,1,2;3;9;1;1;1
250829869065;250829869080;15;0,1,2;3;9;1;1;1
250829869080;250829869524;444;0,1,2;3;9;1;1;1
250829869524;250829869890;366;0,1,2;3;9;1;1;1
250829869890;250829869899;9;0,1,2;3;9;1;1;1
250829869899;250829870165;266;0,1,2;3;9;1;1;1
250829870165;250829870292;127;0,1,2;3;9;1;1;1
250829870292;250829870920;628;0,1,2;3;9;1;1;1
250829870920;250829871367;447;0,1,2;3;9;1;1;1
250829871367;250829871583;216;0,1,2;3;9;1;1;1
250829871583;250829871700;117;0,1,2;3;9;1;1;1
250829871700;250829871851;151;0,1,2;3;9;1;1;1
250829871851;250829872393;542;0,1,2;3;9;1;1;1
250829872393;250829872525;132;0,1,2;3;9;1;1;1
250829872525;250829873436;911;0,1,2;3;9;1;1;1
250829873436;250829873628;192;0,1,2;3;9;1;1;1
250829873628;250829874660;1032;0,1,2;3;9;1;1;1
250829874660;250829876052;1392;0,1,2;3;9;1;1;1
250829876052;250829876919;867;0,1,2;3;9;1;1;1
250829876919;250829877012;93;0,1,2;3;9;1;1;1
250829877012;250829877109;97;0,1,2;3;9;1;1;1
250829877109;250829877256;147;0,1,2;3;9;1;1;1
250829877256;250829877403;147;0,1,2;3;9;1;1;1
250829877403;250829877478;75;0,1,2;3;9;1;1;1
250829877478;250829877764;286;0,1,2;3;9;1;1;1
250829877764;250829877831;67;0,1,2;3;9;1;1;1
250829877831;250829877968;137;0,1,2;3;9;1;1;1
250829877968;250829878067;99;0,1,2;3;9;1;1;1
250829878067;250829878172;105;0,1,2;3;9;1;1;1
250829878172;250829878176;4;0,1,2;3;9;1;1;1
250829878176;250829878412;236;0,1,2;3;9;1;1;1
250829878412;250829879060;648;0,1,2;3;9;1;1;1
250829879060;250829879232;172;0,1,2;3;9;1;1;1
250829879232;250829879319;87;0,1,2;3;9;1;1;1
250829879319;250829879393;74;0,1,2;3;9;1;1;1
250829879393;250829879550;157;0,1,2;3;9;1;1;1
250829879550;250829879572;22;0,1,2;3;9;1;1;1
250829879572;250829879622;50;0,1,2;3;9;1;1;1
250829879622;250829879748;126;0,1,2;3;9;1;1;1
250829879748;250829879772;24;0,1,2;3;9;1;1;1
250829879772;250829879934;162;0,1,2;3;9;1;1;1
250829879934;250829880499;565;0,1,2;3;9;1;1;1
250829880499;250829880529;30;0,1,2;3;9;1;1;1
250829880529;250829880812;283;0,1,2;3;9;1;1;1
250829880812;250829880960;148;0,1,2;3;9;1;1;1
250829880960;250829881835;875;0,1,2;3;9;1;1;1
250829881835;250829881851;16;0,1,2;3;9;1;1;1
250829881851;250829881857;6;0,1,2;3;9;1;1;1
250829881857;250829881967;110;0,1,2;3;9;1;1;1
250829881967;250829882020;53;0,1,2;3;9;1;1;1
250829882020;250829882040;20;0,1,2;3;9;1;1;1
250829882040;250829882136;96;0,1,2;3;9;1;1;1
250829882136;250829882516;380;0,1,2;3;9;1;1;1
250829882516;250829883216;700;0,1,2;3;9;1;1;1
250829883216;250829883667;451;0,1,2;3;9;1;1;1
250829883667;250829883715;48;0,1,2;3;9;1;1;1
250829883715;250829883843;128;0,1,2;3;9;1;1;1
250829883843;250829884163;320;0,1,2;3;9;1;1;1
250829884163;250829884432;269;0,1,2;3;9;1;1;1
250829884432;250829884533;101;0,1,2;3;9;1;1;1
250829884533;250829884672;139;0,1,2;3;9;1;1;1
250829884672;250829885168;496;0,1,2;3;9;1;1;1
250829885168;250829885205;37;0,1,2;3;9;1;1;1
250829885205;250829885403;198;0,1,2;3;9;1;1;1
250829885403;250829886489;1086;0,1,2;3;9;1;1;1
250829886489;250829886600;111;0,1,2;3;9;1;1;1
250829886600;250829886676;76;0,1,2;3;9;1;1;1
250829886676;250829886932;256;0,1,2;3;9;1;1;1
250829886932;250829887229;297;0,1,2;3;9;1;1;1
250829887229;250829887593;364;0,1,2;3;9;1;1;1
250829887593;250829887789;196;0,1,2;3;9;1;1;1
250829887789;250829887959;170;0,1,2;3;9;1;1;1
250829887959;250829888584;625;0,1,2;3;9;1;1;1
250829888584;250829888624;40;0,1,2;3;9;1;1;1
250829888624;250829888852;228;0,1,2;3;9;1;1;1
250829888852;250829889144;292;0,1,2;3;9;1;1;1
250829889144;250829889206;62;0,1,2;3;9;1;1;1
250829889206;250829889761;555;0,1,2;3;9;1;1;1
250829889761;250829889860;99;0,1,2;3;9;1;1;1
250829889860;250829889932;72;0,1,2;3;9;1;1;1
250829889932;250829890229;297;0,1,2;3;9;1;1;1
250829890229;250829890492;263;0,1,2;3;9;1;1;1
250829890492;250829890971;479;0,1,2;3;9;1;1;1
250829890971;250829891371;400;0,1,2;3;9;1;1;1
250829891371;250829891421;50;0,1,2;3;9;1;1;1
250829891421;250829891703;282;0,1,2;3;9;1;1;1
250829891703;250829892105;402;0,1,2;3;9;1;1;1
250829892105;250829892489;384;0,1,2;3;9;1;1;1
250829892489;250829892496;7;0,1,2;3;9;1;1;1
250829892496;250829892791;295;0,1,2;3;9;1;1;1
250829892791;250829893003;212;0,1,2;3;9;1;1;1
250829893003;250829894313;1310;0,1,2;3;9;1;1;1
250829894313;250829894777;464;0,1,2;3;9;1;1;1
250829894777;250829894982;205;0,1,2;3;9;1;1;1
250829894982;250829895267;285;0,1,2;3;9;1;1;1
250829895267;250829895339;72;0,1,2;3;9;1;1;1
250829895339;250829895417;78;0,1,2;3;9;1;1;1
250829895417;250829895484;67;0,1,2;3;9;1;1;1
250829895484;250829896394;910;0,1,2;3;9;1;1;1
250829896394;250829896439;45;0,1,2;3;9;1;1;1
250829896439;250829896502;63;0,1,2;3;9;1;1;1
250829896502;250829896831;329;0,1,2;3;9;1;1;1
250829896831;250829897061;230;0,1,2;3;9;1;1;1
250829897061;250829897934;873;0,1,2;3;9;1;1;1
250829897934;250829898434;500;0,1,2;3;9;1;1;1
250829898434;250829899162;728;0,1,2;3;9;1;1;1
250829899162;250829899292;130;0,1,2;3;9;1;1;1
250829899292;250829900045;753;0,1,2;3;9;1;1;1
250829900045;250829900154;109;0,1,2;3;9;1;1;1
250829900154;250829900178;24;0,1,2;3;9;1;1;1
250829900178;250829900309;131;0,1,2;3;9;1;1;1
250829900309;250829900634;325;0,1,2;3;9;1;1;1
250829900634;250829901558;924;0,1,2;3;9;1;1;1
250829901558;250829901936;378;0,1,2;3;9;1;1;1
250829901936;250829902628;692;0,1,2;3;9;1;1;1
250829902628;250829902969;341;0,1,2;3;9;1;1;1
250829902969;250829903213;244;0,1,2;3;9;1;1;1
250829903213;250829903320;107;0,1,2;3;9;1;1;1
250829903320;250829903506;186;0,1,2;3;9;1;1;1
250829903506;250829903758;252;0,1,2;3;9;1;1;1
250829903758;250829904019;261;0,1,2;3;9;1;1;1
250829904019;250829904048;29;0,1,2;3;9;1;1;1
250829904048;250829904236;188;0,1,2;3;9;1;1;1
250829904236;250829904988;752;0,1,2;3;9;1;1;1
250829904988;250829905009;21;0,1,2;3;9;1;1;1
250829905009;250829905107;98;0,1,2;3;9;1;1;1
250829905107;250829905128;21;0,1,2;3;9;1;1;1
250829905128;250829905388;260;0,1,2;3;9;1;1;1
250829905388;250829906157;769;0,1,2;3;9;1;1;1
250829906157;250829906721;564;0,1,2;3;9;1;1;1
250829906721;250829906823;102;0,1,2;3;9;1;1;1
250829906823;250829906898;75;0,1,2;3;9;1;1;1
250829906898;250829907053;155;0,1,2;3;9;1;1;1
250829907053;250829907075;22;0,1,2;3;9;1;1;1
250829907075;250829907156;81;0,1,2;3;9;1;1;1
250829907156;250829907170;14;0,1,2;3;9;1;1;1
250829907170;250829907366;196;0,1,2;3;9;1;1;1
250829907366;250829907765;399;0,1,2;3;9;1;1;1
250829907765;250829907805;40;0,1,2;3;9;1;1;1
250829907805;250829908699;894;0,1,2;3;9;1;1;1
250829908699;250829908744;45;0,1,2;3;9;1;1;1
250829908744;250829908784;40;0,1,2;3;9;1;1;1
250829908784;250829908848;64;0,1,2;3;9;1;1;1
250829908848;250829909003;155;0,1,2;3;9;1;1;1
250829909003;250829909168;165;0,1,2;3;9;1;1;1
250829909168;250829909670;502;0,1,2;3;9;1;1;1
250829909670;250829909733;63;0,1,2;3;9;1;1;1
250829909733;250829909760;27;0,1,2;3;9;1;1;1
250829909760;250829909956;196;0,1,2;3;9;1;1;1
250829909956;250829910262;306;0,1,2;3;9;1;1;1
250829910262;250829910698;436;0,1,2;3;9;1;1;1
250829910698;250829910956;258;0,1,2;3;9;1;1;1
250829910956;250829911130;174;0,1,2;3;9;1;1;1
250829911130;250829911300;170;0,1,2;3;9;1;1;1
250829911300;250829911663;363;0,1,2;3;9;1;1;1
250829911663;250829912068;405;0,1,2;3;9;1;1;1
250829912068;250829912358;290;0,1,2;3;9;1;1;1
250829912358;250829912585;227;0,1,2;3;9;1;1;1
250829912585;250829913383;798;0,1,2;3;9;1;1;1
250829913383;250829913505;122;0,1,2;3;9;1;1;1
250829913505;250829913526;21;0,1,2;3;9;1;1;1
250829913526;250829913770;244;0,1,2;3;9;1;1;1
250829913770;250829913921;151;0,1,2;3;9;1;1;1
250829913921;250829914295;374;0,1,2;3;9;1;1;1
250829914295;250829914844;549;0,1,2;3;9;1;1;1
250829914844;250829915245;401;0,1,2;3;9;1;1;1
250829915245;250829915635;390;0,1,2;3;9;1;1;1
250829915635;250829915956;321;0,1,2;3;9;1;1;1
250829915956;250829916747;791;0,1,2;3;9;1;1;1
250829916747;250829917021;274;0,1,2;3;9;1;1;1
250829917021;250829917482;461;0,1,2;3;9;1;1;1
250829917482;250829917832;350;0,1,2;3;9;1;1;1
250829917832;250829917907;75;0,1,2;3;9;1;1;1
250829917907;250829917977;70;0,1,2;3;9;1;1;1
250829917977;250829918368;391;0,1,2;3;9;1;1;1
250829918368;250829919014;646;0,1,2;3;9;1;1;1
250829919014;250829919135;121;0,1,2;3;9;1;1;1
250829919135;250829919255;120;0,1,2;3;9;1;1;1
250829919255;250829919379;124;0,1,2;3;9;1;1;1
250829919379;250829919719;340;0,1,2;3;9;1;1;1
250829919719;250829919802;83;0,1,2;3;9;1;1;1
250829919802;250829919936;134;0,1,2;3;9;1;1;1
250829919936;250829920279;343;0,1,2;3;9;1;1;1
250829920279;250829920398;119;0,1,2;3;9;1;1;1
250829920398;250829920718;320;0,1,2;3;9;1;1;1
250829920718;250829920845;127;0,1,2;3;9;1;1;1
250829920845;250829920980;135;0,1,2;3;9;1;1;1
250829920980;250829921317;337;0,1,2;3;9;1;1;1
250829921317;250829921519;202;0,1,2;3;9;1;1;1
250829921519;250829921556;37;0,1,2;3;9;1;1;1
250829921556;250829921655;99;0,1,2;3;9;1;1;1
250829921655;250829921918;263;0,1,2;3;9;1;1;1
250829921918;250829922331;413;0,1,2;3;9;1;1;1
250829922331;250829922672;341;0,1,2;3;9;1;1;1
250829922672;250829922771;99;0,1,2;3;9;1;1;1
250829922771;250829922830;59;0,1,2;3;9;1;1;1
250829922830;250829922849;19;0,1,2;3;9;1;1;1
250829922849;250829922907;58;0,1,2;3;9;1;1;1
250829922907;250829923126;219;0,1,2;3;9;1;1;1
250829923126;250829923215;89;0,1,2;3;9;1;1;1
250829923215;250829923220;5;0,1,2;3;9;1;1;1
250829923220;250829923305;85;0,1,2;3;9;1;1;1
250829923305;250829923355;50;0,1,2;3;9;1;1;1
250829923355;250829923884;529;0,1,2;3;9;1;1;1
250829923884;250829924926;1042;0,1,2;3;9;1;1;1
250829924926;250829925283;357;0,1,2;3;9;1;1;1
250829925283;250829925607;324;0,1,2;3;9;1;1;1
250829925607;250829925650;43;0,1,2;3;9;1;1;1
250829925650;250829925796;146;0,1,2;3;9;1;1;1
250829925796;250829926689;893;0,1,2;3;9;1;1;1
250829926689;250829926925;236;0,1,2;3;9;1;1;1
250829926925;250829927302;377;0,1,2;3;9;1;1;1
250829927302;250829927488;186;0,1,2;3;9;1;1;1
250829927488;250829927890;402;0,1,2;3;9;1;1;1
250829927890;250829928231;341;0,1,2;3;9;1;1;1
250829928231;250829928242;11;0,1,2;3;9;1;1;1
250829928242;250829928463;221;0,1,2;3;9;1;1;1
250829928463;250829928543;80;0,1,2;3;9;1;1;1
250829928543;250829928754;211;0,1,2;3;9;1;1;1
250829928754;250829928796;42;0,1,2;3;9;1;1;1
250829928796;250829928832;36;0,1,2;3;9;1;1;1
250829928832;250829928874;42;0,1,2;3;9;1;1;1
250829928874;250829929289;415;0,1,2;3;9;1;1;1
250829929289;250829929535;246;0,1,2;3;9;1;1;1
250829929535;250829929592;57;0,1,2;3;9;1;1;1
250829929592;250829929615;23;0,1,2;3;9;1;1;1
250829929615;250829929790;175;0,1,2;3;9;1;1;1
250829929790;250829929976;186;0,1,2;3;9;1;1;1
250829929976;250829930462;486;0,1,2;3;9;1;1;1
250829930462;250829930492;30;0,1,2;3;9;1;1;1
250829930492;250829931080;588;0,1,2;3;9;1;1;1
250829931080;250829931505;425;0,1,2;3;9;1;1;1
250829931505;250829931800;295;0,1,2;3;9;1;1;1
250829931800;250829931841;41;0,1,2;3;9;1;1;1
250829931841;250829932702;861;0,1,2;3;9;1;1;1
250829932702;250829932708;6;0,1,2;3;9;1;1;1
250829932708;250829933259;551;0,1,2;3;9;1;1;1
250829933259;250829933318;59;0,1,2;3;9;1;1;1
250829933318;250829933385;67;0,1,2;3;9;1;1;1
250829933385;250829933433;48;0,1,2;3;9;1;1;1
250829933433;250829933565;132;0,1,2;3;9;1;1;1
250829933565;250829933635;70;0,1,2;3;9;1;1;1
250829933635;250829934140;505;0,1,2;3;9;1;1;1
250829934140;250829934169;29;0,1,2;3;9;1;1;1
250829934169;250829934185;16;0,1,2;3;9;1;1;1
250829934185;250829934416;231;0,1,2;3;9;1;1;1
250829934416;250829934444;28;0,1,2;3;9;1;1;1
250829934444;250829934480;36;0,1,2;3;9;1;1;1
250829934480;250829935420;940;0,1,2;3;9;1;1;1
250829935420;250829935472;52;0,1,2;3;9;1;1;1
250829935472;250829935557;85;0,1,2;3;9;1;1;1
250829935557;250829935922;365;0,1,2;3;9;1;1;1
250829935922;250829936114;192;0,1,2;3;9;1;1;1
250829936114;250829936221;107;0,1,2;3;9;1;1;1
250829936221;250829936300;79;0,1,2;3;9;1;1;1
250829936300;250829936379;79;0,1,2;3;9;1;1;1
250829936379;250829936593;214;0,1,2;3;9;1;1;1
250829936593;250829936611;18;0,1,2;3;9;1;1;1
250829936611;250829936663;52;0,1,2;3;9;1;1;1
250829936663;250829936797;134;0,1,2;3;9;1;1;1
250829936797;250829937018;221;0,1,2;3;9;1;1;1
250829937018;250829937495;477;0,1,2;3;9;1;1;1
250829937495;250829937750;255;0,1,2;3;9;1;1;1
250829937750;250829938022;272;0,1,2;3;9;1;1;1
250829938022;250829938189;167;0,1,2;3;9;1;1;1
250829938189;250829938196;7;0,1,2;3;9;1;1;1
250829938196;250829938517;321;0,1,2;3;9;1;1;1
250829938517;250829938723;206;0,1,2;3;9;1;1;1
250829938723;250829938821;98;0,1,2;3;9;1;1;1
250829938821;250829939076;255;0,1,2;3;9;1;1;1
250829939076;250829939168;92;0,1,2;3;9;1;1;1
250829939168;250829939308;140;0,1,2;3;9;1;1;1
250829939308;250829939844;536;0,1,2;3;9;1;1;1
250829939844;250829939863;19;0,1,2;3;9;1;1;1
250829939863;250829939954;91;0,1,2;3;9;1;1;1
250829939954;250829940072;118;0,1,2;3;9;1;1;1
250829940072;250829940118;46;0,1,2;3;9;1;1;1
250829940118;250829940126;8;0,1,2;3;9;1;1;1
250829940126;250829940319;193;0,1,2;3;9;1;1;1
250829940319;250829940386;67;0,1,2;3;9;1;1;1
250829940386;250829940472;86;0,1,2;3;9;1;1;1
250829940472;250829940906;434;0,1,2;3;9;1;1;1
250829940906;250829940964;58;0,1,2;3;9;1;1;1
250829940964;250829941081;117;0,1,2;3;9;1;1;1
250829941081;250829941546;465;0,1,2;3;9;1;1;1
250829941546;250829941584;38;0,1,2;3;9;1;1;1
250829941584;250829941723;139;0,1,2;3;9;1;1;1
250829941723;250829942665;942;0,1,2;3;9;1;1;1
250829942665;250829942954;289;0,1,2;3;9;1;1;1
250829942954;250829943056;102;0,1,2;3;9;1;1;1
250829943056;250829943158;102;0,1,2;3;9;1;1;1
250829943158;250829943217;59;0,1,2;3;9;1;1;1
250829943217;250829943286;69;0,1,2;3;9;1;1;1
250829943286;250829943287;1;0,1,2;3;9;1;1;1
250829943287;250829943787;500;0,1,2;3;9;1;1;1
250829943787;250829943932;145;0,1,2;3;9;1;1;1
250829943932;250829944219;287;0,1,2;3;9;1;1;1
250829944219;250829944370;151;0,1,2;3;9;1;1;1
250829944370;250829945075;705;0,1,2;3;9;1;1;1
250829945075;250829945399;324;0,1,2;3;9;1;1;1
250829945399;250829945773;374;0,1,2;3;9;1;1;1
250829945773;250829945889;116;0,1,2;3;9;1;1;1
250829945889;250829945993;104;0,1,2;3;9;1;1;1
250829945993;250829946058;65;0,1,2;3;9;1;1;1
250829946058;250829946099;41;0,1,2;3;9;1;1;1
250829946099;250829946245;146;0,1,2;3;9;1;1;1
250829946245;250829946647;402;0,1,2;3;9;1;1;1
250829946647;250829946737;90;0,1,2;3;9;1;1;1
250829946737;250829946858;121;0,1,2;3;9;1;1;1
250829946858;250829946927;69;0,1,2;3;9;1;1;1
250829946927;250829947164;237;0,1,2;3;9;1;1;1
250829947164;250829947491;327;0,1,2;3;9;1;1;1
250829947491;250829947637;146;0,1,2;3;9;1;1;1
250829947637;250829947738;101;0,1,2;3;9;1;1;1
250829947738;250829947778;40;0,1,2;3;9;1;1;1
250829947778;250829948065;287;0,1,2;3;9;1;1;1
250829948065;250829948320;255;0,1,2;3;9;1;1;1
250829948320;250829948668;348;0,1,2;3;9;1;1;1
250829948668;250829948835;167;0,1,2;3;9;1;1;1
250829948835;250829948943;108;0,1,2;3;9;1;1;1
250829948943;250829949025;82;0,1,2;3;9;1;1;1
250829949025;250829949322;297;0,1,2;3;9;1;1;1
250829949322;250829949345;23;0,1,2;3;9;1;1;1
250829949345;250829949543;198;0,1,2;3;9;1;1;1
250829949543;250829949865;322;0,1,2;3;9;1;1;1
250829949865;250829949960;95;0,1,2;3;9;1;1;1
250829949960;250829950027;67;0,1,2;3;9;1;1;1
250829950027;250829950476;449;0,1,2;3;9;1;1;1
250829950476;250829951043;567;0,1,2;3;9;1;1;1
250829951043;250829952027;984;0,1,2;3;9;1;1;1
250829952027;250829952472;445;0,1,2;3;9;1;1;1
250829952472;250829953096;624;0,1,2;3;9;1;1;1
250829953096;250829953694;598;0,1,2;3;9;1;1;1
250829953694;250829954557;863;0,1,2;3;9;1;1;1
250829954557;250829954726;169;0,1,2;3;9;1;1;1
250829954726;250829954936;210;0,1,2;3;9;1;1;1
250829954936;250829955238;302;0,1,2;3;9;1;1;1
250829955238;250829956672;1434;0,1,2;3;9;1;1;1
250829956672;250829956807;135;0,1,2;3;9;1;1;1
250829956807;250829957528;721;0,1,2;3;9;1;1;1
250829957528;250829957788;260;0,1,2;3;9;1;1;1
250829957788;250829958098;310;0,1,2;3;9;1;1;1
250829958098;250829958399;301;0,1,2;3;9;1;1;1
250829958399;250829960320;1921;0,1,2;3;9;1;1;1
250829960320;250829961862;1542;0,1,2;3;9;1;1;1
250829961862;250829961953;91;0,1,2;3;9;1;1;1
250829961953;250829962019;66;0,1,2;3;9;1;1;1
250829962019;250829962200;181;0,1,2;3;9;1;1;1
250829962200;250829962307;107;0,1,2;3;9;1;1;1
250829962307;250829962385;78;0,1,2;3;9;1;1;1
250829962385;250829962633;248;0,1,2;3;9;1;1;1
250829962633;250829963041;408;0,1,2;3;9;1;1;1
250829963041;250829963066;25;0,1,2;3;9;1;1;1
250829963066;250829963108;42;0,1,2;3;9;1;1;1
250829963108;250829963546;438;0,1,2;3;9;1;1;1
250829963546;250829963932;386;0,1,2;3;9;1;1;1
250829963932;250829963975;43;0,1,2;3;9;1;1;1
250829963975;250829964838;863;0,1,2;3;9;1;1;1
250829964838;250829965097;259;0,1,2;3;9;1;1;1
250829965097;250829965180;83;0,1,2;3;9;1;1;1
250829965180;250829965221;41;0,1,2;3;9;1;1;1
250829965221;250829965250;29;0,1,2;3;9;1;1;1
250829965250;250829965434;184;0,1,2;3;9;1;1;1
250829965434;250829965439;5;0,1,2;3;9;1;1;1
250829965439;250829965594;155;0,1,2;3;9;1;1;1
250829965594;250829966171;577;0,1,2;3;9;1;1;1
250829966171;250829966257;86;0,1,2;3;9;1;1;1
250829966257;250829966346;89;0,1,2;3;9;1;1;1
250829966346;250829966919;573;0,1,2;3;9;1;1;1
250829966919;250829967798;879;0,1,2;3;9;1;1;1
250829967798;250829967902;104;0,1,2;3;9;1;1;1
250829967902;250829968060;158;0,1,2;3;9;1;1;1
250829968060;250829968157;97;0,1,2;3;9;1;1;1
250829968157;250829969292;1135;0,1,2;3;9;1;1;1
250829969292;250829970399;1107;0,1,2;3;9;1;1;1
250829970399;250829970735;336;0,1,2;3;9;1;1;1
250829970735;250829970757;22;0,1,2;3;9;1;1;1
250829970757;250829970850;93;0,1,2;3;9;1;1;1
250829970850;250829971016;166;0,1,2;3;9;1;1;1
250829971016;250829971092;76;0,1,2;3;9;1;1;1
250829971092;250829971602;510;0,1,2;3;9;1;1;1
250829971602;250829971719;117;0,1,2;3;9;1;1;1
250829971719;250829971749;30;0,1,2;3;9;1;1;1
250829971749;250829971799;50;0,1,2;3;9;1;1;1
250829971799;250829971899;100;0,1,2;3;9;1;1;1
250829971899;250829971915;16;0,1,2;3;9;1;1;1
250829971915;250829972033;118;0,1,2;3;9;1;1;1
250829972033;250829972326;293;0,1,2;3;9;1;1;1
250829972326;250829972399;73;0,1,2;3;9;1;1;1
250829972399;250829972560;161;0,1,2;3;9;1;1;1
250829972560;250829972824;264;0,1,2;3;9;1;1;1
250829972824;250829973042;218;0,1,2;3;9;1;1;1
250829973042;250829973140;98;0,1,2;3;9;1;1;1
250829973140;250829973193;53;0,1,2;3;9;1;1;1
250829973193;250829973326;133;0,1,2;3;9;1;1;1
250829973326;250829973343;17;0,1,2;3;9;1;1;1
250829973343;250829973926;583;0,1,2;3;9;1;1;1
250829973926;250829973953;27;0,1,2;3;9;1;1;1
250829973953;250829973994;41;0,1,2;3;9;1;1;1
250829973994;250829974038;44;0,1,2;3;9;1;1;1
250829974038;250829974101;63;0,1,2;3;9;1;1;1
250829974101;250829974157;56;0,1,2;3;9;1;1;1
250829974157;250829974329;172;0,1,2;3;9;1;1;1
250829974329;250829974462;133;0,1,2;3;9;1;1;1
250829974462;250829974655;193;0,1,2;3;9;1;1;1
250829974655;250829975639;984;0,1,2;3;9;1;1;1
250829975639;250829975663;24;0,1,2;3;9;1;1;1
250829975663;250829975833;170;0,1,2;3;9;1;1;1
250829975833;250829975925;92;0,1,2;3;9;1;1;1
250829975925;250829976237;312;0,1,2;3;9;1;1;1
250829976237;250829976685;448;0,1,2;3;9;1;1;1
250829976685;250829976803;118;0,1,2;3;9;1;1;1
250829976803;250829976808;5;0,1,2;3;9;1;1;1
250829976808;250829977147;339;0,1,2;3;9;1;1;1
250829977147;250829977691;544;0,1,2;3;9;1;1;1
250829977691;250829977760;69;0,1,2;3;9;1;1;1
250829977760;250829977781;21;0,1,2;3;9;1;1;1
250829977781;250829978903;1122;0,1,2;3;9;1;1;1
250829978903;250829978952;49;0,1,2;3;9;1;1;1
250829978952;250829979060;108;0,1,2;3;9;1;1;1
250829979060;250829979123;63;0,1,2;3;9;1;1;1
250829979123;250829979226;103;0,1,2;3;9;1;1;1
250829979226;250829979627;401;0,1,2;3;9;1;1;1
250829979627;250829979691;64;0,1,2;3;9;1;1;1
250829979691;250829979756;65;0,1,2;3;9;1;1;1
250829979756;250829979998;242;0,1,2;3;9;1;1;1
250829979998;250829980352;354;0,1,2;3;9;1;1;1
250829980352;250829980531;179;0,1,2;3;9;1;1;1
250829980531;250829981036;505;0,1,2;3;9;1;1;1
250829981036;250829981577;541;0,1,2;3;9;1;1;1
250829981577;250829981794;217;0,1,2;3;9;1;1;1
250829981794;250829982771;977;0,1,2;3;9;1;1;1
250829982771;250829983315;544;0,1,2;3;9;1;1;1
250829983315;250829983382;67;0,1,2;3;9;1;1;1
250829983382;250829983609;227;0,1,2;3;9;1;1;1
250829983609;250829983905;296;0,1,2;3;9;1;1;1
250829983905;250829984154;249;0,1,2;3;9;1;1;1
250829984154;250829984247;93;0,1,2;3;9;1;1;1
250829984247;250829984300;53;0,1,2;3;9;1;1;1
250829984300;250829984376;76;0,1,2;3;9;1;1;1
250829984376;250829984482;106;0,1,2;3;9;1;1;1
250829984482;250829984604;122;0,1,2;3;9;1;1;1
250829984604;250829984629;25;0,1,2;3;9;1;1;1
250829984629;250829984664;35;0,1,2;3;9;1;1;1
250829984664;250829984719;55;0,1,2;3;9;1;1;1
250829984719;250829985253;534;0,1,2;3;9;1;1;1
250829985253;250829985470;217;0,1,2;3;9;1;1;1
250829985470;250829985505;35;0,1,2;3;9;1;1;1
250829985505;250829985702;197;0,1,2;3;9;1;1;1
250829985702;250829985723;21;0,1,2;3;9;1;1;1
250829985723;250829985787;64;0,1,2;3;9;1;1;1
250829985787;250829985943;156;0,1,2;3;9;1;1;1
250829985943;250829986593;650;0,1,2;3;9;1;1;1
250829986593;250829987266;673;0,1,2;3;9;1;1;1
250829987266;250829987301;35;0,1,2;3;9;1;1;1
250829987301;250829987360;59;0,1,2;3;9;1;1;1
250829987360;250829987405;45;0,1,2;3;9;1;1;1
250829987405;250829987518;113;0,1,2;3;9;1;1;1
250829987518;250829987870;352;0,1,2;3;9;1;1;1
250829987870;250829987902;32;0,1,2;3;9;1;1;1
250829987902;250829987933;31;0,1,2;3;9;1;1;1
250829987933;250829987962;29;0,1,2;3;9;1;1;1
250829987962;250829988171;209;0,1,2;3;9;1;1;1
250829988171;250829988282;111;0,1,2;3;9;1;1;1
250829988282;250829988432;150;0,1,2;3;9;1;1;1
250829988432;250829988628;196;0,1,2;3;9;1;1;1
250829988628;250829988666;38;0,1,2;3;9;1;1;1
250829988666;250829988752;86;0,1,2;3;9;1;1;1
250829988752;250829989164;412;0,1,2;3;9;1;1;1
250829989164;250829989302;138;0,1,2;3;9;1;1;1
250829989302;250829989803;501;0,1,2;3;9;1;1;1
250829989803;250829990067;264;0,1,2;3;9;1;1;1
250829990067;250829990107;40;0,1,2;3;9;1;1;1
250829990107;250829990377;270;0,1,2;3;9;1;1;1
250829990377;250829990450;73;0,1,2;3;9;1;1;1
250829990450;250829990720;270;0,1,2;3;9;1;1;1
250829990720;250829990768;48;0,1,2;3;9;1;1;1
250829990768;250829990842;74;0,1,2;3;9;1;1;1
250829990842;250829990927;85;0,1,2;3;9;1;1;1
250829990927;250829991189;262;0,1,2;3;9;1;1;1
250829991189;250829991473;284;0,1,2;3;9;1;1;1
250829991473;250829991699;226;0,1,2;3;9;1;1;1
250829991699;250829991735;36;0,1,2;3;9;1;1;1
250829991735;250829992055;320;0,1,2;3;9;1;1;1
250829992055;250829992118;63;0,1,2;3;9;1;1;1
250829992118;250829992148;30;0,1,2;3;9;1;1;1
250829992148;250829992177;29;0,1,2;3;9;1;1;1
250829992177;250829992212;35;0,1,2;3;9;1;1;1
250829992212;250829992246;34;0,1,2;3;9;1;1;1
250829992246;250829992368;122;0,1,2;3;9;1;1;1
250829992368;250829992478;110;0,1,2;3;9;1;1;1
250829992478;250829992725;247;0,1,2;3;9;1;1;1
250829992725;250829992778;53;0,1,2;3;9;1;1;1
250829992778;250829992963;185;0,1,2;3;9;1;1;1
250829992963;250829992994;31;0,1,2;3;9;1;1;1
250829992994;250829993065;71;0,1,2;3;9;1;1;1
250829993065;250829993195;130;0,1,2;3;9;1;1;1
250829993195;250829993258;63;0,1,2;3;9;1;1;1
250829993258;250829993368;110;0,1,2;3;9;1;1;1
250829993368;250829993900;532;0,1,2;3;9;1;1;1
250829993900;250829994167;267;0,1,2;3;9;1;1;1
250829994167;250829994835;668;0,1,2;3;9;1;1;1
250829994835;250829994940;105;0,1,2;3;9;1;1;1
250829994940;250829995031;91;0,1,2;3;9;1;1;1
250829995031;250829995066;35;0,1,2;3;9;1;1;1
250829995066;250829995160;94;0,1,2;3;9;1;1;1
250829995160;250829995428;268;0,1,2;3;9;1;1;1
250829995428;250829995465;37;0,1,2;3;9;1;1;1
250829995465;250829995477;12;0,1,2;3;9;1;1;1
250829995477;250829995836;359;0,1,2;3;9;1;1;1
250829995836;250829995856;20;0,1,2;3;9;1;1;1
250829995856;250829996068;212;0,1,2;3;9;1;1;1
250829996068;250829996906;838;0,1,2;3;9;1;1;1
250829996906;250829997472;566;0,1,2;3;9;1;1;1
250829997472;250829997496;24;0,1,2;3;9;1;1;1
250829997496;250829997497;1;0,1,2;3;9;1;1;1
250829997497;250829997550;53;0,1,2;3;9;1;1;1
250829997550;250829997644;94;0,1,2;3;9;1;1;1
250829997644;250829997732;88;0,1,2;3;9;1;1;1
250829997732;250829997885;153;0,1,2;3;9;1;1;1
250829997885;250829998069;184;0,1,2;3;9;1;1;1
250829998069;250829998078;9;0,1,2;3;9;1;1;1
250829998078;250829998383;305;0,1,2;3;9;1;1;1
250829998383;250829998492;109;0,1,2;3;9;1;1;1
250829998492;250829998762;270;0,1,2;3;9;1;1;1
250829998762;250829998836;74;0,1,2;3;9;1;1;1
250829998836;250829999150;314;0,1,2;3;9;1;1;1
250829999150;250829999340;190;0,1,2;3;9;1;1;1
250829999340;250829999522;182;0,1,2;3;9;1;1;1
250829999522;250829999742;220;0,1,2;3;9;1;1;1
250829999742;250829999790;48;0,1,2;3;9;1;1;1
250829999790;250829999934;144;0,1,2;3;9;1;1;1
250829999934;250829999941;7;0,1,2;3;9;1;1;1
250829999941;250829999991;50;0,1,2;3;9;1;1;1
250829999991;250830000018;27;0,1,2;3;9;1;1;1
250830000018;250830000075;57;0,1,2;3;9;1;1;1
250830000075;250830000117;42;0,1,2;3;9;1;1;1
250830000117;250830000393;276;0,1,2;3;9;1;1;1
250830000393;250830000398;5;0,1,2;3;9;1;1;1
250830000398;250830000665;267;0,1,2;3;9;1;1;1
250830000665;250830000683;18;0,1,2;3;9;1;1;1
250830000683;250830000715;32;0,1,2;3;9;1;1;1
250830000715;250830000810;95;0,1,2;3;9;1;1;1
250830000810;250830000826;16;0,1,2;3;9;1;1;1
250830000826;250830000955;129;0,1,2;3;9;1;1;1
250830000955;250830001029;74;0,1,2;3;9;1;1;1
250830001029;250830001064;35;0,1,2;3;9;1;1;1
250830001064;250830001097;33;0,1,2;3;9;1;1;1
250830001097;250830001216;119;0,1,2;3;9;1;1;1
250830001216;250830001287;71;0,1,2;3;9;1;1;1
250830001287;250830001401;114;0,1,2;3;9;1;1;1
250830001401;250830001601;200;0,1,2;3;9;1;1;1
250830001601;250830001675;74;0,1,2;3;9;1;1;1
250830001675;250830001723;48;0,1,2;3;9;1;1;1
250830001723;250830001763;40;0,1,2;3;9;1;1;1
250830001763;250830001793;30;0,1,2;3;9;1;1;1
250830001793;250830001820;27;0,1,2;3;9;1;1;1
250830001820;250830002065;245;0,1,2;3;9;1;1;1
250830002065;250830002509;444;0,1,2;3;9;1;1;1
250830002509;250830002754;245;0,1,2;3;9;1;1;1
250830002754;250830002789;35;0,1,2;3;9;1;1;1
250830002789;250830002887;98;0,1,2;3;9;1;1;1
250830002887;250830003054;167;0,1,2;3;9;1;1;1
250830003054;250830003098;44;0,1,2;3;9;1;1;1
250830003098;250830003142;44;0,1,2;3;9;1;1;1
250830003142;250830003172;30;0,1,2;3;9;1;1;1
250830003172;250830003220;48;0,1,2;3;9;1;1;1
250830003220;250830003325;105;0,1,2;3;9;1;1;1
250830003325;250830003390;65;0,1,2;3;9;1;1;1
250830003390;250830003402;12;0,1,2;3;9;1;1;1
250830003402;250830003407;5;0,1,2;3;9;1;1;1
250830003407;250830003411;4;0,1,2;3;9;1;1;1
250830003411;250830003421;10;0,1,2;3;9;1;1;1
250830003421;250830003505;84;0,1,2;3;9;1;1;1
250830003505;250830003520;15;0,1,2;3;9;1;1;1
250830003520;250830003530;10;0,1,2;3;9;1;1;1
250830003530;250830003633;103;0,1,2;3;9;1;1;1
250830003633;250830003715;82;0,1,2;3;9;1;1;1
250830003715;250830003747;32;0,1,2;3;9;1;1;1
250830003747;250830003775;28;0,1,2;3;9;1;1;1
250830003775;250830003979;204;0,1,2;3;9;1;1;1
250830003979;250830004037;58;0,1,2;3;9;1;1;1
250830004037;250830004182;145;0,1,2;3;9;1;1;1
250830004182;250830004340;158;0,1,2;3;9;1;1;1
250830004340;250830004479;139;0,1,2;3;9;1;1;1
250830004479;250830004860;381;0,1,2;3;9;1;1;1
250830004860;250830005029;169;0,1,2;3;9;1;1;1
250830005029;250830005564;535;0,1,2;3;9;1;1;1
250830005564;250830006131;567;0,1,2;3;9;1;1;1
250830006131;250830006993;862;0,1,2;3;9;1;1;1
250830006993;250830007419;426;0,1,2;3;9;1;1;1
250830007419;250830007515;96;0,1,2;3;9;1;1;1
250830007515;250830007662;147;0,1,2;3;9;1;1;1
250830007662;250830007783;121;0,1,2;3;9;1;1;1
250830007783;250830008002;219;0,1,2;3;9;1;1;1
250830008002;250830008497;495;0,1,2;3;9;1;1;1
250830008497;250830008648;151;0,1,2;3;9;1;1;1
250830008648;250830009078;430;0,1,2;3;9;1;1;1
250830009078;250830009587;509;0,1,2;3;9;1;1;1
250830009587;250830010704;1117;0,1,2;3;9;1;1;1
250830010704;250830011458;754;0,1,2;3;9;1;1;1
250830011458;250830012578;1120;0,1,2;3;9;1;1;1
250830012578;250830012697;119;0,1,2;3;9;1;1;1
250830012697;250830012703;6;0,1,2;3;9;1;1;1
250830012703;250830012803;100;0,1,2;3;9;1;1;1
250830012803;250830014191;1388;0,1,2;3;9;1;1;1
250830014191;250830014282;91;0,1,2;3;9;1;1;1
250830014282;250830014767;485;0,1,2;3;9;1;1;1
250830014767;250830014798;31;0,1,2;3;9;1;1;1
250830014798;250830015114;316;0,1,2;3;9;1;1;1
250830015114;250830015162;48;0,1,2;3;9;1;1;1
250830015162;250830015256;94;0,1,2;3;9;1;1;1
250830015256;250830015821;565;0,1,2;3;9;1;1;1
250830015821;250830017722;1901;0,1,2;3;9;1;1;1
250830017722;250830017866;144;0,1,2;3;9;1;1;1
250830017866;250830017927;61;0,1,2;3;9;1;1;1
250830017927;250830017998;71;0,1,2;3;9;1;1;1
250830017998;250830018321;323;0,1,2;3;9;1;1;1
250830018321;250830019124;803;0,1,2;3;9;1;1;1
250830019124;250830019310;186;0,1,2;3;9;1;1;1
250830019310;250830019421;111;0,1,2;3;9;1;1;1
250830019421;250830019488;67;0,1,2;3;9;1;1;1
250830019488;250830019830;342;0,1,2;3;9;1;1;1
250830019830;250830020054;224;0,1,2;3;9;1;1;1
250830020054;250830020084;30;0,1,2;3;9;1;1;1
250830020084;250830020551;467;0,1,2;3;9;1;1;1
250830020551;250830020696;145;0,1,2;3;9;1;1;1
250830020696;250830020850;154;0,1,2;3;9;1;1;1
250830020850;250830020926;76;0,1,2;3;9;1;1;1
250830020926;250830021007;81;0,1,2;3;9;1;1;1
250830021007;250830021361;354;0,1,2;3;9;1;1;1
250830021361;250830021505;144;0,1,2;3;9;1;1;1
250830021505;250830021778;273;0,1,2;3;9;1;1;1
250830021778;250830021898;120;0,1,2;3;9;1;1;1
250830021898;250830021994;96;0,1,2;3;9;1;1;1
250830021994;250830022429;435;0,1,2;3;9;1;1;1
250830022429;250830022571;142;0,1,2;3;9;1;1;1
250830022571;250830022715;144;0,1,2;3;9;1;1;1
250830022715;250830022825;110;0,1,2;3;9;1;1;1
250830022825;250830022893;68;0,1,2;3;9;1;1;1
250830022893;250830022899;6;0,1,2;3;9;1;1;1
250830022899;250830022962;63;0,1,2;3;9;1;1;1
250830022962;250830022977;15;0,1,2;3;9;1;1;1
250830022977;250830023301;324;0,1,2;3;9;1;1;1
250830023301;250830023324;23;0,1,2;3;9;1;1;1
250830023324;250830023645;321;0,1,2;3;9;1;1;1
250830023645;250830023728;83;0,1,2;3;9;1;1;1
250830023728;250830024288;560;0,1,2;3;9;1;1;1
250830024288;250830024583;295;0,1,2;3;9;1;1;1
250830024583;250830024845;262;0,1,2;3;9;1;1;1
250830024845;250830024929;84;0,1,2;3;9;1;1;1
250830024929;250830025417;488;0,1,2;3;9;1;1;1
250830025417;250830025486;69;0,1,2;3;9;1;1;1
250830025486;250830025502;16;0,1,2;3;9;1;1;1
250830025502;250830025782;280;0,1,2;3;9;1;1;1
250830025782;250830025865;83;0,1,2;3;9;1;1;1
250830025865;250830026121;256;0,1,2;3;9;1;1;1
250830026121;250830026416;295;0,1,2;3;9;1;1;1
250830026416;250830026541;125;0,1,2;3;9;1;1;1
250830026541;250830026609;68;0,1,2;3;9;1;1;1
250830026609;250830026672;63;0,1,2;3;9;1;1;1
250830026672;250830027065;393;0,1,2;3;9;1;1;1
250830027065;250830027502;437;0,1,2;3;9;1;1;1
250830027502;250830027518;16;0,1,2;3;9;1;1;1
250830027518;250830027972;454;0,1,2;3;9;1;1;1
250830027972;250830028070;98;0,1,2;3;9;1;1;1
250830028070;250830028226;156;0,1,2;3;9;1;1;1
250830028226;250830028293;67;0,1,2;3;9;1;1;1
250830028293;250830028370;77;0,1,2;3;9;1;1;1
250830028370;250830028622;252;0,1,2;3;9;1;1;1
250830028622;250830029379;757;0,1,2;3;9;1;1;1
250830029379;250830029479;100;0,1,2;3;9;1;1;1
250830029479;250830029571;92;0,1,2;3;9;1;1;1
250830029571;250830029691;120;0,1,2;3;9;1;1;1
250830029691;250830029715;24;0,1,2;3;9;1;1;1
250830029715;250830029965;250;0,1,2;3;9;1;1;1
250830029965;250830030169;204;0,1,2;3;9;1;1;1
250830030169;250830030454;285;0,1,2;3;9;1;1;1
250830030454;250830030508;54;0,1,2;3;9;1;1;1
250830030508;250830030802;294;0,1,2;3;9;1;1;1
250830030802;250830031002;200;0,1,2;3;9;1;1;1
250830031002;250830031430;428;0,1,2;3;9;1;1;1
250830031430;250830031566;136;0,1,2;3;9;1;1;1
250830031566;250830031685;119;0,1,2;3;9;1;1;1
250830031685;250830031946;261;0,1,2;3;9;1;1;1
250830031946;250830032178;232;0,1,2;3;9;1;1;1
250830032178;250830032209;31;0,1,2;3;9;1;1;1
250830032209;250830032359;150;0,1,2;3;9;1;1;1
250830032359;250830032381;22;0,1,2;3;9;1;1;1
250830032381;250830032607;226;0,1,2;3;9;1;1;1
250830032607;250830032798;191;0,1,2;3;9;1;1;1
250830032798;250830032831;33;0,1,2;3;9;1;1;1
250830032831;250830032854;23;0,1,2;3;9;1;1;1
250830032854;250830032873;19;0,1,2;3;9;1;1;1
250830032873;250830032931;58;0,1,2;3;9;1;1;1
250830032931;250830033158;227;0,1,2;3;9;1;1;1
250830033158;250830033258;100;0,1,2;3;9;1;1;1
250830033258;250830033388;130;0,1,2;3;9;1;1;1
250830033388;250830034092;704;0,1,2;3;9;1;1;1
250830034092;250830034151;59;0,1,2;3;9;1;1;1
250830034151;250830034387;236;0,1,2;3;9;1;1;1
250830034387;250830034751;364;0,1,2;3;9;1;1;1
250830034751;250830035782;1031;0,1,2;3;9;1;1;1
250830035782;250830035983;201;0,1,2;3;9;1;1;1
250830035983;250830036282;299;0,1,2;3;9;1;1;1
250830036282;250830036589;307;0,1,2;3;9;1;1;1
250830036589;250830036658;69;0,1,2;3;9;1;1;1
250830036658;250830036970;312;0,1,2;3;9;1;1;1
250830036970;250830037177;207;0,1,2;3;9;1;1;1
250830037177;250830037622;445;0,1,2;3;9;1;1;1
250830037622;250830038029;407;0,1,2;3;9;1;1;1
250830038029;250830039038;1009;0,1,2;3;9;1;1;1
250830039038;250830039386;348;0,1,2;3;9;1;1;1
250830039386;250830039544;158;0,1,2;3;9;1;1;1
250830039544;250830039630;86;0,1,2;3;9;1;1;1
250830039630;250830039709;79;0,1,2;3;9;1;1;1
250830039709;250830040146;437;0,1,2;3;9;1;1;1
250830040146;250830040625;479;0,1,2;3;9;1;1;1
250830040625;250830041158;533;0,1,2;3;9;1;1;1
250830041158;250830041528;370;0,1,2;3;9;1;1;1
250830041528;250830041953;425;0,1,2;3;9;1;1;1
250830041953;250830041995;42;0,1,2;3;9;1;1;1
250830041995;250830042108;113;0,1,2;3;9;1;1;1
250830042108;250830042238;130;0,1,2;3;9;1;1;1
250830042238;250830042509;271;0,1,2;3;9;1;1;1
250830042509;250830042544;35;0,1,2;3;9;1;1;1
250830042544;250830042944;400;0,1,2;3;9;1;1;1
250830042944;250830043667;723;0,1,2;3;9;1;1;1
250830043667;250830044733;1066;0,1,2;3;9;1;1;1
250830044733;250830045052;319;0,1,2;3;9;1;1;1
250830045052;250830046158;1106;0,1,2;3;9;1;1;1
250830046158;250830046292;134;0,1,2;3;9;1;1;1
250830046292;250830046395;103;0,1,2;3;9;1;1;1
250830046395;250830046446;51;0,1,2;3;9;1;1;1
250830046446;250830046958;512;0,1,2;3;9;1;1;1
250830046958;250830047163;205;0,1,2;3;9;1;1;1
250830047163;250830047858;695;0,1,2;3;9;1;1;1
250830047858;250830048087;229;0,1,2;3;9;1;1;1
250830048087;250830048166;79;0,1,2;3;9;1;1;1
250830048166;250830049868;1702;0,1,2;3;9;1;1;1
250830049868;250830051587;1719;0,1,2;3;9;1;1;1
250830051587;250830051744;157;0,1,2;3;9;1;1;1
250830051744;250830052940;1196;0,1,2;3;9;1;1;1
250830052940;250830053997;1057;0,1,2;3;9;1;1;1
250830053997;250830055588;1591;0,1,2;3;9;1;1;1
250830055588;250830056219;631;0,1,2;3;9;1;1;1
250830056219;250830056603;384;0,1,2;3;9;1;1;1
250830056603;250830057131;528;0,1,2;3;9;1;1;1
250830057131;250830057233;102;0,1,2;3;9;1;1;1
250830057233;250830057327;94;0,1,2;3;9;1;1;1
250830057327;250830058428;1101;0,1,2;3;9;1;1;1
250830058428;250830058656;228;0,1,2;3;9;1;1;1
250830058656;250830058854;198;0,1,2;3;9;1;1;1
250830058854;250830059356;502;0,1,2;3;9;1;1;1
250830059356;250830059477;121;0,1,2;3;9;1;1;1
250830059477;250830059916;439;0,1,2;3;9;1;1;1
250830059916;250830060096;180;0,1,2;3;9;1;1;1
250830060096;250830060952;856;0,1,2;3;9;1;1;1
250830060952;250830061447;495;0,1,2;3;9;1;1;1
250830061447;250830061481;34;0,1,2;3;9;1;1;1
250830061481;250830062948;1467;0,1,2;3;9;1;1;1
250830062948;250830063032;84;0,1,2;3;9;1;1;1
250830063032;250830063249;217;0,1,2;3;9;1;1;1
250830063249;250830063923;674;0,1,2;3;9;1;1;1
250830063923;250830064284;361;0,1,2;3;9;1;1;1
250830064284;250830065027;743;0,1,2;3;9;1;1;1
250830065027;250830065353;326;0,1,2;3;9;1;1;1
250830065353;250830065434;81;0,1,2;3;9;1;1;1
250830065434;250830066243;809;0,1,2;3;9;1;1;1
250830066243;250830066385;142;0,1,2;3;9;1;1;1
250830066385;250830066857;472;0,1,2;3;9;1;1;1
250830066857;250830067054;197;0,1,2;3;9;1;1;1
250830067054;250830067583;529;0,1,2;3;9;1;1;1
250830067583;250830068180;597;0,1,2;3;9;1;1;1
250830068180;250830068249;69;0,1,2;3;9;1;1;1
250830068249;250830068495;246;0,1,2;3;9;1;1;1
250830068495;250830068728;233;0,1,2;3;9;1;1;1
250830068728;250830070894;2166;0,1,2;3;9;1;1;1
250830070894;250830072919;2025;0,1,2;3;9;1;1;1
250830072919;250830073613;694;0,1,2;3;9;1;1;1
250830073613;250830073829;216;0,1,2;3;9;1;1;1
250830073829;250830073994;165;0,1,2;3;9;1;1;1
250830073994;250830074427;433;0,1,2;3;9;1;1;1
250830074427;250830074540;113;0,1,2;3;9;1;1;1
250830074540;250830075023;483;0,1,2;3;9;1;1;1
250830075023;250830075360;337;0,1,2;3;9;1;1;1
250830075360;250830075969;609;0,1,2;3;9;1;1;1
250830075969;250830077785;1816;0,1,2;3;9;1;1;1
250830077785;250830077918;133;0,1,2;3;9;1;1;1
250830077918;250830078042;124;0,1,2;3;9;1;1;1
250830078042;250830078902;860;0,1,2;3;9;1;1;1
250830078902;250830079175;273;0,1,2;3;9;1;1;1
250830079175;250830080131;956;0,1,2;3;9;1;1;1
250830080131;250830081094;963;0,1,2;3;9;1;1;1
250830081094;250830081654;560;0,1,2;3;9;1;1;1
250830081654;250830081944;290;0,1,2;3;9;1;1;1
250830081944;250830082697;753;0,1,2;3;9;1;1;1
250830082697;250830083070;373;0,1,2;3;9;1;1;1
250830083070;250830084064;994;0,1,2;3;9;1;1;1
250830084064;250830084284;220;0,1,2;3;9;1;1;1
250830084284;250830084368;84;0,1,2;3;9;1;1;1
250830084368;250830084570;202;0,1,2;3;9;1;1;1
250830084570;250830085658;1088;0,1,2;3;9;1;1;1
250830085658;250830085731;73;0,1,2;3;9;1;1;1
250830085731;250830086163;432;0,1,2;3;9;1;1;1
250830086163;250830089272;3109;0,1,2;3;9;1;1;1
250830089272;250830090533;1261;0,1,2;3;9;1;1;1
250830090533;250830091547;1014;0,1,2;3;9;1;1;1
250830091547;250830092084;537;0,1,2;3;9;1;1;1
250830092084;250830094061;1977;0,1,2;3;9;1;1;1
250830094061;250830094283;222;0,1,2;3;9;1;1;1
250830094283;250830094969;686;0,1,2;3;9;1;1;1
250830094969;250830095056;87;0,1,2;3;9;1;1;1
250830095056;250830095445;389;0,1,2;3;9;1;1;1
250830095445;250830096401;956;0,1,2;3;9;1;1;1
250830096401;250830097609;1208;0,1,2;3;9;1;1;1
250830097609;250830099940;2331;0,1,2;3;9;1;1;1
250830099940;250830100467;527;0,1,2;3;9;1;1;1
250830100467;250830100735;268;0,1,2;3;9;1;1;1
250830100735;250830100825;90;0,1,2;3;9;1;1;1
250830100825;250830101910;1085;0,1,2;3;9;1;1;1
250830101910;250830102005;95;0,1,2;3;9;1;1;1
250830102005;250830102055;50;0,1,2;3;9;1;1;1
250830102055;250830103742;1687;0,1,2;3;9;1;1;1
250830103742;250830103782;40;0,1,2;3;9;1;1;1
250830103782;250830103864;82;0,1,2;3;9;1;1;1
250830103864;250830104151;287;0,1,2;3;9;1;1;1
250830104151;250830104411;260;0,1,2;3;9;1;1;1
250830104411;250830105304;893;0,1,2;3;9;1;1;1
250830105304;250830107768;2464;0,1,2;3;9;1;1;1
250830107768;250830108097;329;0,1,2;3;9;1;1;1
250830108097;250830108171;74;0,1,2;3;9;1;1;1
250830108171;250830108306;135;0,1,2;3;9;1;1;1
250830108306;250830108383;77;0,1,2;3;9;1;1;1
250830108383;250830108453;70;0,1,2;3;9;1;1;1
250830108453;250830109086;633;0,1,2;3;9;1;1;1
250830109086;250830109374;288;0,1,2;3;9;1;1;1
250830109374;250830110232;858;0,1,2;3;9;1;1;1
250830110232;250830111332;1100;0,1,2;3;9;1;1;1
250830111332;250830111847;515;0,1,2;3;9;1;1;1
250830111847;250830111992;145;0,1,2;3;9;1;1;1
250830111992;250830112094;102;0,1,2;3;9;1;1;1
250830112094;250830113266;1172;0,1,2;3;9;1;1;1
250830113266;250830113273;7;0,1,2;3;9;1;1;1
250830113273;250830116712;3439;0,1,2;3;9;1;1;1
250830116712;250830116945;233;0,1,2;3;9;1;1;1
250830116945;250830117292;347;0,1,2;3;9;1;1;1
250830117292;250830117683;391;0,1,2;3;9;1;1;1
250830117683;250830117809;126;0,1,2;3;9;1;1;1
250830117809;250830117898;89;0,1,2;3;9;1;1;1
250830117898;250830117931;33;0,1,2;3;9;1;1;1
250830117931;250830118039;108;0,1,2;3;9;1;1;1
250830118039;250830120284;2245;0,1,2;3;9;1;1;1
250830120284;250830120399;115;0,1,2;3;9;1;1;1
250830120399;250830120561;162;0,1,2;3;9;1;1;1
250830120561;250830121439;878;0,1,2;3;9;1;1;1
250830121439;250830122047;608;0,1,2;3;9;1;1;1
250830122047;250830122157;110;0,1,2;3;9;1;1;1
250830122157;250830123465;1308;0,1,2;3;9;1;1;1
250830123465;250830127686;4221;0,1,2;3;9;1;1;1
250830127686;250830128699;1013;0,1,2;3;9;1;1;1
250830128699;250830128893;194;0,1,2;3;9;1;1;1
250830128893;250830129184;291;0,1,2;3;9;1;1;1
250830129184;250830129689;505;0,1,2;3;9;1;1;1
250830129689;250830130396;707;0,1,2;3;9;1;1;1
250830130396;250830133314;2918;0,1,2;3;9;1;1;1
250830133314;250830136820;3506;0,1,2;3;9;1;1;1
250830136820;250830139211;2391;0,1,2;3;9;1;1;1
250830139211;250830139511;300;0,1,2;3;9;1;1;1
250830139511;250830140044;533;0,1,2;3;9;1;1;1
250830140044;250830140488;444;0,1,2;3;9;1;1;1
250830140488;250830140709;221;0,1,2;3;9;1;1;1
250830140709;250830140811;102;0,1,2;3;9;1;1;1
250830140811;250830140913;102;0,1,2;3;9;1;1;1
250830140913;250830141153;240;0,1,2;3;9;1;1;1
250830141153;250830142703;1550;0,1,2;3;9;1;1;1
250830142703;250830143031;328;0,1,2;3;9;1;1;1
250830143031;250830146525;3494;0,1,2;3;9;1;1;1
250830146525;250830146982;457;0,1,2;3;9;1;1;1
250830146982;250830147306;324;0,1,2;3;9;1;1;1
250830147306;250830147338;32;0,1,2;3;9;1;1;1
250830147338;250830148371;1033;0,1,2;3;9;1;1;1
250830148371;250830148486;115;0,1,2;3;9;1;1;1
250830148486;250830150065;1579;0,1,2;3;9;1;1;1
250830150065;250830151946;1881;0,1,2;3;9;1;1;1
250830151946;250830152998;1052;0,1,2;3;9;1;1;1
250830152998;250830153222;224;0,1,2;3;9;1;1;1
250830153222;250830153993;771;0,1,2;3;9;1;1;1
250830153993;250830154969;976;0,1,2;3;9;1;1;1
250830154969;250830155817;848;0,1,2;3;9;1;1;1
250830155817;250830159372;3555;0,1,2;3;9;1;1;1
250830159372;250830160020;648;0,1,2;3;9;1;1;1
250830160020;250830160482;462;0,1,2;3;9;1;1;1
250830160482;250830161027;545;0,1,2;3;9;1;1;1
250830161027;250830161233;206;0,1,2;3;9;1;1;1
250830161233;250830161506;273;0,1,2;3;9;1;1;1
250830161506;250830162887;1381;0,1,2;3;9;1;1;1
250830162887;250830162965;78;0,1,2;3;9;1;1;1
250830162965;250830163163;198;0,1,2;3;9;1;1;1
250830163163;250830163303;140;0,1,2;3;9;1;1;1
250830163303;250830165510;2207;0,1,2;3;9;1;1;1
250830165510;250830165876;366;0,1,2;3;9;1;1;1
250830165876;250830165973;97;0,1,2;3;9;1;1;1
250830165973;250830166061;88;0,1,2;3;9;1;1;1
250830166061;250830166441;380;0,1,2;3;9;1;1;1
250830166441;250830166476;35;0,1,2;3;9;1;1;1
250830166476;250830166921;445;0,1,2;3;9;1;1;1
250830166921;250830167330;409;0,1,2;3;9;1;1;1
250830167330;250830170665;3335;0,1,2;3;9;1;1;1
250830170665;250830170769;104;0,1,2;3;9;1;1;1
250830170769;250830171154;385;0,1,2;3;9;1;1;1
250830171154;250830171250;96;0,1,2;3;9;1;1;1
250830171250;250830173479;2229;0,1,2;3;9;1;1;1
250830173479;250830176242;2763;0,1,2;3;9;1;1;1
250830176242;250830176357;115;1,2;2;9;1;1;1
250830176357;250830176651;294;0,1,2;3;9;1;1;1
250830176651;250830178709;2058;0,1,2;3;9;1;1;1
250830178709;250830179830;1121;0,1,2;3;9;1;1;1
250830179830;250830182726;2896;0,1,2;3;9;1;1;1
250830182726;250830182813;87;0,1,2;3;9;1;1;1
250830182813;250830183733;920;0,1,2;3;9;1;1;1
250830183733;250830185037;1304;0,1,2;3;9;1;1;1
250830185037;250830185155;118;0,1,2;3;9;1;1;1
250830185155;250830186376;1221;0,1,2;3;9;1;1;1
250830186376;250830186539;163;0,1,2;3;9;1;1;1
250830186539;250830187893;1354;0,1,2;3;9;1;1;1
250830187893;250830188026;133;0,1,2;3;9;1;1;1
250830188026;250830188318;292;0,1,2;3;9;1;1;1
250830188318;250830188608;290;1,2;2;9;1;1;1
250830188608;250830188623;15;0,1,2;3;9;1;1;1
250830188623;250830189540;917;0,1,2;3;9;1;1;1
250830189540;250830190117;577;0,1,2;3;9;1;1;1
250830190117;250830192578;2461;0,1,2;3;9;1;1;1
250830192578;250830192648;70;0,1,2;3;9;1;1;1
250830192648;250830195308;2660;1,2;2;9;1;1;1
250830195308;250830195552;244;0,1,2;3;9;1;1;1
250830195552;250830200372;4820;1,2;2;9;1;1;1
250830200372;250830203359;2987;0,1,2;3;9;1;1;1
250830203359;250830220389;17030;1,2;2;9;1;1;1
250830220389;250830222627;2238;1,2;2;9;1;1;1
250830222627;250830222648;21;0,1,2;3;9;1;1;1
250830222648;250830222952;304;0,1,2;3;9;1;1;1
250830222952;250830223178;226;0,1,2;3;9;1;1;1
250830223178;250830292327;69149;1,2;2;9;1;1;1
250830292327;250830333808;41481;1,2;2;9;1;1;1
250830333808;250830436860;103052;1,2;2;9;1;1;1
250830436860;250830452772;15912;1,2;2;9;1;1;1
250830452772;250830877501;424729;1,2;2;9;1;1;1
250830877501;250831030274;152773;1,2;2;9;1;1;1
250831030274;250831055397;25123;1,2;2;9;1;1;1
250831055397;250831552880;497483;1,2;2;9;1;1;1
250831552880;250831674589;121709;1,2;2;9;1;1;1
250831674589;250831777941;103352;1,2;2;9;1;1;1
250831777941;250831896792;118851;1,2;2;9;1;1;1
250831896792;250834649992;2753200;1,2;2;9;1;1;1
250834649992;250835844894;1194902;1,2;2;9;1;1;1
250835844894;250835879667;34773;0,1,2;3;9;1;1;1
250835879667;250835896594;16927;0,1,2;3;9;1;1;1
250835896594;250835903883;7289;0,1,2;3;9;1;1;1
250835903883;250835914873;10990;0,1,2;3;9;1;1;1
250835914873;250835920084;5211;0,1,2;3;9;1;1;1
250835920084;250835931183;11099;0,1,2;3;9;1;1;1
250835931183;250835940948;9765;0,1,2;3;9;1;1;1
250835940948;250835980190;39242;1,2;2;9;1;1;1
250835980190;250835989087;8897;0,1,2;3;9;1;1;1
250835989087;250835989564;477;0,1,2;3;9;1;1;1
250835989564;250835998397;8833;0,1,2;3;9;1;1;1
250835998397;250836010407;12010;0,1,2;3;9;1;1;1
250836010407;250836013883;3476;0,1,2;3;9;1;1;1
250836013883;250836021070;7187;0,1,2;3;9;1;1;1
250836021070;250836036282;15212;0,1,2;3;9;1;1;1
250836036282;250836038126;1844;0,1,2;3;9;1;1;1
250836038126;250836047498;9372;0,1,2;3;9;1;1;1
250836047498;250836050287;2789;1,2;2;9;1;1;1
250836050287;250836067554;17267;0,1,2;3;9;1;1;1
250836067554;250836080933;13379;0,1,2;3;9;1;1;1
250836080933;250836089009;8076;0,1,2;3;9;1;1;1
250836089009;250836096089;7080;0,1,2;3;9;1;1;1
250836096089;250836102825;6736;0,1,2;3;9;1;1;1
250836102825;250836116690;13865;0,1,2;3;9;1;1;1
250836116690;250836120449;3759;0,1,2;3;9;1;1;1
250836120449;250836121808;1359;0,1,2;3;9;1;1;1
250836121808;250836136296;14488;0,1,2;3;9;1;1;1
250836136296;250836138275;1979;0,1,2;3;9;1;1;1
250836138275;250836139271;996;0,1,2;3;9;1;1;1
250836139271;250836153885;14614;0,1,2;3;9;1;1;1
250836153885;250836156838;2953;0,1,2;3;9;1;1;1
250836156838;250836169759;12921;0,1,2;3;9;1;1;1
250836169759;250836177898;8139;0,1,2;3;9;1;1;1
250836177898;250836178659;761;0,1,2;3;9;1;1;1
250836178659;250836180092;1433;0,1,2;3;9;1;1;1
250836180092;250836188039;7947;0,1,2;3;9;1;1;1
250836188039;250836188108;69;0,1,2;3;9;1;1;1
250836188108;250836188163;55;0,1,2;3;9;1;1;1
250836188163;250836188423;260;0,1,2;3;9;1;1;1
250836188423;250836197560;9137;0,1,2;3;9;1;1;1
250836197560;250836201499;3939;0,1,2;3;9;1;1;1
250836201499;250836201534;35;0,1,2;3;9;1;1;1
250836201534;250836213503;11969;0,1,2;3;9;1;1;1
250836213503;250836215607;2104;0,1,2;3;9;1;1;1
250836215607;250836217329;1722;0,1,2;3;9;1;1;1
250836217329;250836219453;2124;0,1,2;3;9;1;1;1
250836219453;250836225024;5571;0,1,2;3;9;1;1;1
250836225024;250836226021;997;0,1,2;3;9;1;1;1
250836226021;250836231470;5449;0,1,2;3;9;1;1;1
250836231470;250836241824;10354;0,1,2;3;9;1;1;1
250836241824;250836252052;10228;0,1,2;3;9;1;1;1
250836252052;250836257666;5614;0,1,2;3;9;1;1;1
250836257666;250836257734;68;0,1,2;3;9;1;1;1
250836257734;250836260017;2283;0,1,2;3;9;1;1;1
250836260017;250836262876;2859;0,1,2;3;9;1;1;1
250836262876;250836269427;6551;0,1,2;3;9;1;1;1
250836269427;250836272485;3058;0,1,2;3;9;1;1;1
250836272485;250836278285;5800;0,1,2;3;9;1;1;1
250836278285;250836281573;3288;0,1,2;3;9;1;1;1
250836281573;250836282599;1026;0,1,2;3;9;1;1;1
250836282599;250836282972;373;0,1,2;3;9;1;1;1
250836282972;250836287692;4720;0,1,2;3;9;1;1;1
250836287692;250836290204;2512;0,1,2;3;9;1;1;1
250836290204;250836293488;3284;0,1,2;3;9;1;1;1
250836293488;250836296924;3436;0,1,2;3;9;1;1;1
250836296924;250836297711;787;0,1,2;3;9;1;1;1
250836297711;250836302931;5220;0,1,2;3;9;1;1;1
250836302931;250836304276;1345;0,1,2;3;9;1;1;1
250836304276;250836305148;872;0,1,2;3;9;1;1;1
250836305148;250836305181;33;0,1,2;3;9;1;1;1
250836305181;250836305201;20;0,1,2;3;9;1;1;1
250836305201;250836308329;3128;0,1,2;3;9;1;1;1
250836308329;250836311006;2677;0,1,2;3;9;1;1;1
250836311006;250836315826;4820;0,1,2;3;9;1;1;1
250836315826;250836316001;175;0,1,2;3;9;1;1;1
250836316001;250836319122;3121;0,1,2;3;9;1;1;1
250836319122;250836320603;1481;0,1,2;3;9;1;1;1
250836320603;250836320634;31;0,1,2;3;9;1;1;1
250836320634;250836326642;6008;0,1,2;3;9;1;1;1
250836326642;250836326699;57;0,1,2;3;9;1;1;1
250836326699;250836337246;10547;0,1,2;3;9;1;1;1
250836337246;250836337955;709;0,1,2;3;9;1;1;1
250836337955;250836345492;7537;0,1,2;3;9;1;1;1
250836345492;250836349391;3899;0,1,2;3;9;1;1;1
250836349391;250836349626;235;0,1,2;3;9;1;1;1
250836349626;250836349648;22;0,1,2;3;9;1;1;1
250836349648;250836352948;3300;0,1,2;3;9;1;1;1
250836352948;250836353036;88;0,1,2;3;9;1;1;1
250836353036;250836353082;46;0,1,2;3;9;1;1;1
250836353082;250836358317;5235;0,1,2;3;9;1;1;1
250836358317;250836361879;3562;0,1,2;3;9;1;1;1
250836361879;250836362192;313;0,1,2;3;9;1;1;1
250836362192;250836365333;3141;0,1,2;3;9;1;1;1
250836365333;250836365812;479;0,1,2;3;9;1;1;1
250836365812;250836374343;8531;0,1,2;3;9;1;1;1
250836374343;250836380194;5851;0,1,2;3;9;1;1;1
250836380194;250836381069;875;0,1,2;3;9;1;1;1
250836381069;250836383386;2317;0,1,2;3;9;1;1;1
250836383386;250836392222;8836;0,1,2;3;9;1;1;1
250836392222;250836392819;597;0,1,2;3;9;1;1;1
250836392819;250836393404;585;0,1,2;3;9;1;1;1
250836393404;250836393844;440;0,1,2;3;9;1;1;1
250836393844;250836402256;8412;0,1,2;3;9;1;1;1
250836402256;250836402308;52;0,1,2;3;9;1;1;1
250836402308;250836407172;4864;0,1,2;3;9;1;1;1
250836407172;250836410594;3422;0,1,2;3;9;1;1;1
250836410594;250836410650;56;0,1,2;3;9;1;1;1
250836410650;250836410672;22;0,1,2;3;9;1;1;1
250836410672;250836412711;2039;0,1,2;3;9;1;1;1
250836412711;250836419138;6427;0,1,2;3;9;1;1;1
250836419138;250836424534;5396;0,1,2;3;9;1;1;1
250836424534;250836430750;6216;0,1,2;3;9;1;1;1
250836430750;250836431299;549;1,2;2;9;1;1;1
250836431299;250836443197;11898;0,1,2;3;9;1;1;1
250836443197;250836445246;2049;0,1,2;3;9;1;1;1
250836445246;250836446038;792;0,1,2;3;9;1;1;1
250836446038;250836455505;9467;0,1,2;3;9;1;1;1
250836455505;250836462355;6850;0,1,2;3;9;1;1;1
250836462355;250836463247;892;0,1,2;3;9;1;1;1
250836463247;250836467729;4482;0,1,2;3;9;1;1;1
250836467729;250836471843;4114;1,2;2;9;1;1;1
250836471843;250836476363;4520;0,1,2;3;9;1;1;1
250836476363;250836479128;2765;0,1,2;3;9;1;1;1
250836479128;250836479563;435;0,1,2;3;9;1;1;1
250836479563;250836479731;168;0,1,2;3;9;1;1;1
250836479731;250836486142;6411;0,1,2;3;9;1;1;1
250836486142;250836486453;311;0,1,2;3;9;1;1;1
250836486453;250836486791;338;0,1,2;3;9;1;1;1
250836486791;250836489423;2632;0,1,2;3;9;1;1;1
250836489423;250836491145;1722;0,1,2;3;9;1;1;1
250836491145;250836491284;139;0,1,2;3;9;1;1;1
250836491284;250836492616;1332;0,1,2;3;9;1;1;1
250836492616;250836494643;2027;0,1,2;3;9;1;1;1
250836494643;250836497358;2715;0,1,2;3;9;1;1;1
250836497358;250836498186;828;0,1,2;3;9;1;1;1
250836498186;250836498812;626;0,1,2;3;9;1;1;1
250836498812;250836500482;1670;0,1,2;3;9;1;1;1
250836500482;250836500768;286;0,1,2;3;9;1;1;1
250836500768;250836502584;1816;0,1,2;3;9;1;1;1
250836502584;250836503185;601;0,1,2;3;9;1;1;1
250836503185;250836504985;1800;0,1,2;3;9;1;1;1
250836504985;250836506244;1259;0,1,2;3;9;1;1;1
250836506244;250836507799;1555;0,1,2;3;9;1;1;1
250836507799;250836508142;343;0,1,2;3;9;1;1;1
250836508142;250836508688;546;0,1,2;3;9;1;1;1
250836508688;250836511749;3061;0,1,2;3;9;1;1;1
250836511749;250836514671;2922;0,1,2;3;9;1;1;1
250836514671;250836518427;3756;0,1,2;3;9;1;1;1
250836518427;250836526339;7912;1,2;2;9;1;1;1
250836526339;250836527582;1243;0,1,2;3;9;1;1;1
250836527582;250836531565;3983;0,1,2;3;9;1;1;1
250836531565;250836536805;5240;0,1,2;3;9;1;1;1
250836536805;250836537848;1043;0,1,2;3;9;1;1;1
250836537848;250836542158;4310;0,1,2;3;9;1;1;1
250836542158;250836543190;1032;0,1,2;3;9;1;1;1
250836543190;250836543432;242;0,1,2;3;9;1;1;1
250836543432;250836543829;397;0,1,2;3;9;1;1;1
250836543829;250836547744;3915;0,1,2;3;9;1;1;1
250836547744;250836547802;58;0,1,2;3;9;1;1;1
250836547802;250836548583;781;0,1,2;3;9;1;1;1
250836548583;250836550512;1929;0,1,2;3;9;1;1;1
250836550512;250836551777;1265;0,1,2;3;9;1;1;1
250836551777;250836551863;86;0,1,2;3;9;1;1;1
250836551863;250836551899;36;0,1,2;3;9;1;1;1
250836551899;250836551962;63;0,1,2;3;9;1;1;1
250836551962;250836552270;308;0,1,2;3;9;1;1;1
250836552270;250836555478;3208;0,1,2;3;9;1;1;1
250836555478;250836556925;1447;0,1,2;3;9;1;1;1
250836556925;250836561430;4505;0,1,2;3;9;1;1;1
250836561430;250836563469;2039;0,1,2;3;9;1;1;1
250836563469;250836563893;424;0,1,2;3;9;1;1;1
250836563893;250836566335;2442;0,1,2;3;9;1;1;1
250836566335;250836567115;780;0,1,2;3;9;1;1;1
250836567115;250836567951;836;0,1,2;3;9;1;1;1
250836567951;250836568504;553;0,1,2;3;9;1;1;1
250836568504;250836570116;1612;0,1,2;3;9;1;1;1
250836570116;250836570219;103;1,2;2;9;1;1;1
250836570219;250836570396;177;0,1,2;3;9;1;1;1
250836570396;250836574070;3674;1,2;2;9;1;1;1
250836574070;250836575331;1261;0,1,2;3;9;1;1;1
250836575331;250836578140;2809;1,2;2;9;1;1;1
250836578140;250836583943;5803;0,1,2;3;9;1;1;1
250836583943;250836587340;3397;0,1,2;3;9;1;1;1
250836587340;250836601076;13736;0,1,2;3;9;1;1;1
250836601076;250836603023;1947;0,1,2;3;9;1;1;1
250836603023;250836604891;1868;0,1,2;3;9;1;1;1
250836604891;250836611634;6743;0,1,2;3;9;1;1;1
250836611634;250836611810;176;0,1,2;3;9;1;1;1
250836611810;250836612624;814;0,1,2;3;9;1;1;1
250836612624;250836616879;4255;0,1,2;3;9;1;1;1
250836616879;250836617828;949;0,1,2;3;9;1;1;1
250836617828;250836625229;7401;0,1,2;3;9;1;1;1
250836625229;250836628546;3317;0,1,2;3;9;1;1;1
250836628546;250836631391;2845;0,1,2;3;9;1;1;1
250836631391;250836632443;1052;0,1,2;3;9;1;1;1
250836632443;250836639887;7444;0,1,2;3;9;1;1;1
250836639887;250836641784;1897;0,1,2;3;9;1;1;1
250836641784;250836643143;1359;0,1,2;3;9;1;1;1
250836643143;250836643344;201;0,1,2;3;9;1;1;1
250836643344;250836645762;2418;0,1,2;3;9;1;1;1
250836645762;250836650005;4243;0,1,2;3;9;1;1;1
250836650005;250836652518;2513;0,1,2;3;9;1;1;1
250836652518;250836652886;368;0,1,2;3;9;1;1;1
250836652886;250836656236;3350;0,1,2;3;9;1;1;1
250836656236;250836663517;7281;0,1,2;3;9;1;1;1
250836663517;250836667000;3483;0,1,2;3;9;1;1;1
250836667000;250836667063;63;0,1,2;3;9;1;1;1
250836667063;250836667278;215;0,1,2;3;9;1;1;1
250836667278;250836677197;9919;0,1,2;3;9;1;1;1
250836677197;250836695526;18329;0,1,2;3;9;1;1;1
250836695526;250836714651;19125;1,2;2;9;1;1;1
250836714651;250836714863;212;0,1,2;3;9;1;1;1
250836714863;250836730119;15256;1,2;2;9;1;1;1
250836730119;250836730481;362;0,1,2;3;9;1;1;1
250836730481;250836733622;3141;1,2;2;9;1;1;1
250836733622;250836745657;12035;1,2;2;9;1;1;1
250836745657;250836745671;14;0,1,2;3;9;1;1;1
250836745671;250836745832;161;0,1,2;3;9;1;1;1
250836745832;250836748802;2970;0,1,2;3;9;1;1;1
250836748802;250836749034;232;0,1,2;3;9;1;1;1
250836749034;250836750137;1103;0,1,2;3;9;1;1;1
250836750137;250836750714;577;0,1,2;3;9;1;1;1
250836750714;250836755111;4397;0,1,2;3;9;1;1;1
250836755111;250836755282;171;0,1,2;3;9;1;1;1
250836755282;250836768418;13136;0,1,2;3;9;1;1;1
250836768418;250836769014;596;0,1,2;3;9;1;1;1
250836769014;250836775020;6006;0,1,2;3;9;1;1;1
250836775020;250836775769;749;0,1,2;3;9;1;1;1
250836775769;250836778293;2524;0,1,2;3;9;1;1;1
250836778293;250836780265;1972;0,1,2;3;9;1;1;1
250836780265;250836780303;38;0,1,2;3;9;1;1;1
250836780303;250836780412;109;0,1,2;3;9;1;1;1
250836780412;250836781331;919;0,1,2;3;9;1;1;1
250836781331;250836781396;65;0,1,2;3;9;1;1;1
250836781396;250836781427;31;0,1,2;3;9;1;1;1
250836781427;250836781455;28;0,1,2;3;9;1;1;1
250836781455;250836781604;149;0,1,2;3;9;1;1;1
250836781604;250836781893;289;0,1,2;3;9;1;1;1
250836781893;250836783635;1742;0,1,2;3;9;1;1;1
250836783635;250836784893;1258;0,1,2;3;9;1;1;1
250836784893;250836784959;66;0,1,2;3;9;1;1;1
250836784959;250836785037;78;0,1,2;3;9;1;1;1
250836785037;250836785242;205;0,1,2;3;9;1;1;1
250836785242;250836785866;624;0,1,2;3;9;1;1;1
250836785866;250836785898;32;0,1,2;3;9;1;1;1
250836785898;250836786711;813;0,1,2;3;9;1;1;1
250836786711;250836787561;850;0,1,2;3;9;1;1;1
250836787561;250836795307;7746;0,1,2;3;9;1;1;1
250836795307;250836797529;2222;0,1,2;3;9;1;1;1
250836797529;250836800702;3173;0,1,2;3;9;1;1;1
250836800702;250836802127;1425;0,1,2;3;9;1;1;1
250836802127;250836802924;797;0,1,2;3;9;1;1;1
250836802924;250836803357;433;0,1,2;3;9;1;1;1
250836803357;250836804690;1333;0,1,2;3;9;1;1;1
250836804690;250836806621;1931;0,1,2;3;9;1;1;1
250836806621;250836807810;1189;0,1,2;3;9;1;1;1
250836807810;250836811354;3544;0,1,2;3;9;1;1;1
250836811354;250836815328;3974;0,1,2;3;9;1;1;1
250836815328;250836816825;1497;0,1,2;3;9;1;1;1
250836816825;250836819274;2449;0,1,2;3;9;1;1;1
250836819274;250836819506;232;0,1,2;3;9;1;1;1
250836819506;250836830814;11308;1,2;2;9;1;1;1
250836830814;250836832975;2161;0,1,2;3;9;1;1;1
250836832975;250836833465;490;0,1,2;3;9;1;1;1
250836833465;250836834359;894;0,1,2;3;9;1;1;1
250836834359;250836834360;1;1,2;2;9;1;1;1
250836834360;250836836956;2596;0,1,2;3;9;1;1;1
250836836956;250836840420;3464;0,1,2;3;9;1;1;1
250836840420;250836841962;1542;0,1,2;3;9;1;1;1
250836841962;250836843187;1225;0,1,2;3;9;1;1;1
250836843187;250836844258;1071;0,1,2;3;9;1;1;1
250836844258;250836847720;3462;0,1,2;3;9;1;1;1
250836847720;250836848304;584;0,1,2;3;9;1;1;1
250836848304;250836850102;1798;0,1,2;3;9;1;1;1
250836850102;250836854640;4538;0,1,2;3;9;1;1;1
250836854640;250836859715;5075;1,2;2;9;1;1;1
250836859715;250836860631;916;0,1,2;3;9;1;1;1
250836860631;250836860848;217;1,2;2;9;1;1;1
250836860848;250836861222;374;0,1,2;3;9;1;1;1
250836861222;250836861255;33;0,1,2;3;9;1;1;1
250836861255;250836863582;2327;0,1,2;3;9;1;1;1
250836863582;250836872461;8879;0,1,2;3;9;1;1;1
250836872461;250836872538;77;0,1,2;3;9;1;1;1
250836872538;250836873791;1253;0,1,2;3;9;1;1;1
250836873791;250836873820;29;0,1,2;3;9;1;1;1
250836873820;250836875694;1874;0,1,2;3;9;1;1;1
250836875694;250836876399;705;0,1,2;3;9;1;1;1
250836876399;250836876775;376;0,1,2;3;9;1;1;1
250836876775;250836882211;5436;0,1,2;3;9;1;1;1
250836882211;250836886217;4006;0,1,2;3;9;1;1;1
250836886217;250836888498;2281;0,1,2;3;9;1;1;1
250836888498;250836890273;1775;0,1,2;3;9;1;1;1
250836890273;250836895913;5640;0,1,2;3;9;1;1;1
250836895913;250836901612;5699;0,1,2;3;9;1;1;1
250836901612;250836902574;962;0,1,2;3;9;1;1;1
250836902574;250836903666;1092;0,1,2;3;9;1;1;1
250836903666;250836907506;3840;0,1,2;3;9;1;1;1
250836907506;250836911158;3652;0,1,2;3;9;1;1;1
250836911158;250836912450;1292;0,1,2;3;9;1;1;1
250836912450;250836913895;1445;0,1,2;3;9;1;1;1
250836913895;250836914058;163;0,1,2;3;9;1;1;1
250836914058;250836914549;491;0,1,2;3;9;1;1;1
250836914549;250836917549;3000;0,1,2;3;9;1;1;1
250836917549;250836919420;1871;0,1,2;3;9;1;1;1
250836919420;250836920091;671;0,1,2;3;9;1;1;1
250836920091;250836926846;6755;0,1,2;3;9;1;1;1
250836926846;250836928234;1388;0,1,2;3;9;1;1;1
250836928234;250836929274;1040;0,1,2;3;9;1;1;1
250836929274;250836929669;395;0,1,2;3;9;1;1;1
250836929669;250836931441;1772;0,1,2;3;9;1;1;1
250836931441;250836932701;1260;0,1,2;3;9;1;1;1
250836932701;250836934095;1394;0,1,2;3;9;1;1;1
250836934095;250836937528;3433;0,1,2;3;9;1;1;1
250836937528;250836939681;2153;0,1,2;3;9;1;1;1
250836939681;250836942493;2812;0,1,2;3;9;1;1;1
250836942493;250836943125;632;0,1,2;3;9;1;1;1
250836943125;250836946700;3575;0,1,2;3;9;1;1;1
250836946700;250836946742;42;0,1,2;3;9;1;1;1
250836946742;250836948320;1578;0,1,2;3;9;1;1;1
250836948320;250836948371;51;0,1,2;3;9;1;1;1
250836948371;250836948399;28;0,1,2;3;9;1;1;1
250836948399;250836948427;28;0,1,2;3;9;1;1;1
250836948427;250836948454;27;0,1,2;3;9;1;1;1
250836948454;250836948513;59;0,1,2;3;9;1;1;1
250836948513;250836951028;2515;0,1,2;3;9;1;1;1
250836951028;250836952021;993;0,1,2;3;9;1;1;1
250836952021;250836954429;2408;0,1,2;3;9;1;1;1
250836954429;250836954502;73;0,1,2;3;9;1;1;1
250836954502;250836954559;57;0,1,2;3;9;1;1;1
250836954559;250836954878;319;0,1,2;3;9;1;1;1
250836954878;250836955270;392;0,1,2;3;9;1;1;1
250836955270;250836955662;392;0,1,2;3;9;1;1;1
250836955662;250836957507;1845;0,1,2;3;9;1;1;1
250836957507;250836957623;116;0,1,2;3;9;1;1;1
250836957623;250836958242;619;0,1,2;3;9;1;1;1
250836958242;250836959928;1686;0,1,2;3;9;1;1;1
250836959928;250836966108;6180;0,1,2;3;9;1;1;1
250836966108;250836972274;6166;1,2;2;9;1;1;1
250836972274;250836974598;2324;0,1,2;3;9;1;1;1
250836974598;250836975744;1146;0,1,2;3;9;1;1;1
250836975744;250836975837;93;0,1,2;3;9;1;1;1
250836975837;250836976474;637;0,1,2;3;9;1;1;1
250836976474;250836976765;291;0,1,2;3;9;1;1;1
250836976765;250836978108;1343;0,1,2;3;9;1;1;1
250836978108;250836979057;949;0,1,2;3;9;1;1;1
250836979057;250836981418;2361;1,2;2;9;1;1;1
250836981418;250836984211;2793;0,1,2;3;9;1;1;1
250836984211;250836985049;838;1,2;2;9;1;1;1
250836985049;250836985222;173;0,1,2;3;9;1;1;1
250836985222;250837001569;16347;1,2;2;9;1;1;1
250837001569;250837018048;16479;0,1,2;3;9;1;1;1
250837018048;250837020156;2108;1,2;2;9;1;1;1
250837020156;250837020335;179;0,1,2;3;9;1;1;1
250837020335;250837027796;7461;1,2;2;9;1;1;1
250837027796;250837035022;7226;0,1,2;3;9;1;1;1
250837035022;250837158537;123515;1,2;2;9;1;1;1
250837158537;250837159595;1058;0,1,2;3;9;1;1;1
250837159595;250837160224;629;0,1,2;3;9;1;1;1
250837160224;250837164184;3960;0,1,2;3;9;1;1;1
250837164184;250837164252;68;0,1,2;3;9;1;1;1
250837164252;250837166290;2038;0,1,2;3;9;1;1;1
250837166290;250837166711;421;0,1,2;3;9;1;1;1
250837166711;250837166832;121;0,1,2;3;9;1;1;1
250837166832;250837166932;100;0,1,2;3;9;1;1;1
250837166932;250837168879;1947;0,1,2;3;9;1;1;1
250837168879;250837170339;1460;0,1,2;3;9;1;1;1
250837170339;250837179950;9611;0,1,2;3;9;1;1;1
250837179950;250837181493;1543;0,1,2;3;9;1;1;1
250837181493;250837183654;2161;0,1,2;3;9;1;1;1
250837183654;250837208337;24683;1,2;2;9;1;1;1
250837208337;250837212728;4391;0,1,2;3;9;1;1;1
250837212728;250837229567;16839;1,2;2;9;1;1;1
250837229567;250837245387;15820;0,1,2;3;9;1;1;1
250837245387;250837251377;5990;0,1,2;3;9;1;1;1
250837251377;250837257207;5830;0,1,2;3;9;1;1;1
250837257207;250837318043;60836;1,2;2;9;1;1;1
250837318043;250837321135;3092;0,1,2;3;9;1;1;1
250837321135;250837322076;941;0,1,2;3;9;1;1;1
250837322076;250837323039;963;0,1,2;3;9;1;1;1
250837323039;250837330267;7228;0,1,2;3;9;1;1;1
250837330267;250837341782;11515;0,1,2;3;9;1;1;1
250837341782;250837346617;4835;0,1,2;3;9;1;1;1
250837346617;250837347453;836;0,1,2;3;9;1;1;1
250837347453;250837347489;36;0,1,2;3;9;1;1;1
250837347489;250837347519;30;0,1,2;3;9;1;1;1
250837347519;250837347550;31;0,1,2;3;9;1;1;1
250837347550;250837347612;62;0,1,2;3;9;1;1;1
250837347612;250837347642;30;0,1,2;3;9;1;1;1
250837347642;250837348810;1168;0,1,2;3;9;1;1;1
250837348810;250837348842;32;0,1,2;3;9;1;1;1
250837348842;250837351834;2992;0,1,2;3;9;1;1;1
250837351834;250837352393;559;0,1,2;3;9;1;1;1
250837352393;250837354605;2212;0,1,2;3;9;1;1;1
250837354605;250837356035;1430;0,1,2;3;9;1;1;1
250837356035;250837356146;111;0,1,2;3;9;1;1;1
250837356146;250837356635;489;0,1,2;3;9;1;1;1
250837356635;250837358483;1848;0,1,2;3;9;1;1;1
250837358483;250837358530;47;0,1,2;3;9;1;1;1
250837358530;250837358593;63;0,1,2;3;9;1;1;1
250837358593;250837360151;1558;0,1,2;3;9;1;1;1
250837360151;250837364844;4693;0,1,2;3;9;1;1;1
250837364844;250837382081;17237;0,1,2;3;9;1;1;1
250837382081;250837382133;52;0,1,2;3;9;1;1;1
250837382133;250837382580;447;0,1,2;3;9;1;1;1
250837382580;250837402796;20216;0,1,2;3;9;1;1;1
250837402796;250837421236;18440;0,1,2;3;9;1;1;1
250837421236;250837426333;5097;0,1,2;3;9;1;1;1
250837426333;250837426763;430;0,1,2;3;9;1;1;1
250837426763;250837427829;1066;0,1,2;3;9;1;1;1
250837427829;250837578938;151109;1,2;2;9;1;1;1
250837578938;250837614544;35606;0,1,2;3;9;1;1;1
250837614544;250837650137;35593;1,2;2;9;1;1;1
250837650137;250837656706;6569;0,1,2;3;9;1;1;1
250837656706;250837677884;21178;0,1,2;3;9;1;1;1
250837677884;250837691201;13317;0,1,2;3;9;1;1;1
250837691201;250837702365;11164;0,1,2;3;9;1;1;1
250837702365;250837703874;1509;0,1,2;3;9;1;1;1
250837703874;250837738123;34249;0,1,2;3;9;1;1;1
250837738123;250837742443;4320;0,1,2;3;9;1;1;1
250837742443;250837768395;25952;0,1,2;3;9;1;1;1
250837768395;250837768460;65;0,1,2;3;9;1;1;1
250837768460;250837768510;50;0,1,2;3;9;1;1;1
250837768510;250837768527;17;0,1,2;3;9;1;1;1
250837768527;250837768547;20;0,1,2;3;9;1;1;1
250837768547;250837774216;5669;0,1,2;3;9;1;1;1
250837774216;250837777790;3574;0,1,2;3;9;1;1;1
250837777790;250837778226;436;0,1,2;3;9;1;1;1
250837778226;250837781177;2951;0,1,2;3;9;1;1;1
250837781177;250837798622;17445;0,1,2;3;9;1;1;1
250837798622;250837799077;455;0,1,2;3;9;1;1;1
250837799077;250837801412;2335;0,1,2;3;9;1;1;1
250837801412;250837807592;6180;0,1,2;3;9;1;1;1
250837807592;250837812176;4584;0,1,2;3;9;1;1;1
250837812176;250837814770;2594;0,1,2;3;9;1;1;1
250837814770;250837816356;1586;0,1,2;3;9;1;1;1
250837816356;250837816523;167;0,1,2;3;9;1;1;1
250837816523;250837822651;6128;0,1,2;3;9;1;1;1
250837822651;250837826232;3581;0,1,2;3;9;1;1;1
250837826232;250837826372;140;0,1,2;3;9;1;1;1
250837826372;250837826512;140;0,1,2;3;9;1;1;1
250837826512;250837827164;652;0,1,2;3;9;1;1;1
250837827164;250837827290;126;0,1,2;3;9;1;1;1
250837827290;250837832508;5218;0,1,2;3;9;1;1;1
250837832508;250837833589;1081;0,1,2;3;9;1;1;1
250837833589;250837843039;9450;0,1,2;3;9;1;1;1
250837843039;250837847415;4376;0,1,2;3;9;1;1;1
250837847415;250837850958;3543;0,1,2;3;9;1;1;1
250837850958;250837851433;475;0,1,2;3;9;1;1;1
250837851433;250837851565;132;0,1,2;3;9;1;1;1
250837851565;250837853288;1723;0,1,2;3;9;1;1;1
250837853288;250837854067;779;0,1,2;3;9;1;1;1
250837854067;250837857114;3047;0,1,2;3;9;1;1;1
250837857114;250837863071;5957;0,1,2;3;9;1;1;1
250837863071;250837863953;882;0,1,2;3;9;1;1;1
250837863953;250837866175;2222;0,1,2;3;9;1;1;1
250837866175;250837866258;83;0,1,2;3;9;1;1;1
250837866258;250837866334;76;0,1,2;3;9;1;1;1
250837866334;250837872096;5762;0,1,2;3;9;1;1;1
250837872096;250837873583;1487;0,1,2;3;9;1;1;1
250837873583;250837877029;3446;0,1,2;3;9;1;1;1
250837877029;250837881280;4251;0,1,2;3;9;1;1;1
250837881280;250837883544;2264;0,1,2;3;9;1;1;1
250837883544;250837889161;5617;0,1,2;3;9;1;1;1
250837889161;250837892544;3383;0,1,2;3;9;1;1;1
250837892544;250837892783;239;0,1,2;3;9;1;1;1
250837892783;250837893377;594;0,1,2;3;9;1;1;1
250837893377;250837899719;6342;0,1,2;3;9;1;1;1
250837899719;250837900871;1152;0,1,2;3;9;1;1;1
250837900871;250837901940;1069;0,1,2;3;9;1;1;1
250837901940;250837903236;1296;0,1,2;3;9;1;1;1
250837903236;250837909449;6213;0,1,2;3;9;1;1;1
250837909449;250837910342;893;0,1,2;3;9;1;1;1
250837910342;250837911360;1018;0,1,2;3;9;1;1;1
250837911360;250837911915;555;0,1,2;3;9;1;1;1
250837911915;250837914191;2276;0,1,2;3;9;1;1;1
250837914191;250837914489;298;0,1,2;3;9;1;1;1
250837914489;250837915397;908;0,1,2;3;9;1;1;1
250837915397;250837921321;5924;0,1,2;3;9;1;1;1
250837921321;250837928415;7094;0,1,2;3;9;1;1;1
250837928415;250837929240;825;0,1,2;3;9;1;1;1
250837929240;250837929397;157;0,1,2;3;9;1;1;1
250837929397;250837930715;1318;0,1,2;3;9;1;1;1
250837930715;250837935853;5138;0,1,2;3;9;1;1;1
250837935853;250837936122;269;0,1,2;3;9;1;1;1
250837936122;250837937750;1628;0,1,2;3;9;1;1;1
250837937750;250837944400;6650;0,1,2;3;9;1;1;1
250837944400;250837948977;4577;0,1,2;3;9;1;1;1
250837948977;250837950369;1392;0,1,2;3;9;1;1;1
250837950369;250837950432;63;0,1,2;3;9;1;1;1
250837950432;250837953498;3066;0,1,2;3;9;1;1;1
250837953498;250837954816;1318;0,1,2;3;9;1;1;1
250837954816;250837956957;2141;0,1,2;3;9;1;1;1
250837956957;250837957423;466;0,1,2;3;9;1;1;1
250837957423;250837960219;2796;0,1,2;3;9;1;1;1
250837960219;250837961779;1560;0,1,2;3;9;1;1;1
250837961779;250837964431;2652;0,1,2;3;9;1;1;1
250837964431;250837965686;1255;0,1,2;3;9;1;1;1
250837965686;250837970249;4563;0,1,2;3;9;1;1;1
250837970249;250837973561;3312;0,1,2;3;9;1;1;1
250837973561;250837973569;8;0,1,2;3;9;1;1;1
250837973569;250837975534;1965;0,1,2;3;9;1;1;1
250837975534;250837976157;623;0,1,2;3;9;1;1;1
250837976157;250837976653;496;0,1,2;3;9;1;1;1
250837976653;250837981256;4603;0,1,2;3;9;1;1;1
250837981256;250837981580;324;0,1,2;3;9;1;1;1
250837981580;250837981833;253;0,1,2;3;9;1;1;1
250837981833;250837990256;8423;0,1,2;3;9;1;1;1
250837990256;250837991983;1727;0,1,2;3;9;1;1;1
250837991983;250837992012;29;0,1,2;3;9;1;1;1
250837992012;250837993235;1223;0,1,2;3;9;1;1;1
250837993235;250837994054;819;0,1,2;3;9;1;1;1
250837994054;250837996473;2419;0,1,2;3;9;1;1;1
250837996473;250838000307;3834;0,1,2;3;9;1;1;1
250838000307;250838000443;136;0,1,2;3;9;1;1;1
250838000443;250838001346;903;0,1,2;3;9;1;1;1
250838001346;250838003917;2571;0,1,2;3;9;1;1;1
250838003917;250838004361;444;0,1,2;3;9;1;1;1
250838004361;250838007094;2733;0,1,2;3;9;1;1;1
250838007094;250838011355;4261;0,1,2;3;9;1;1;1
250838011355;250838011368;13;0,1,2;3;9;1;1;1
250838011368;250838014395;3027;0,1,2;3;9;1;1;1
250838014395;250838015658;1263;0,1,2;3;9;1;1;1
250838015658;250838015679;21;0,1,2;3;9;1;1;1
250838015679;250838017702;2023;0,1,2;3;9;1;1;1
250838017702;250838017870;168;0,1,2;3;9;1;1;1
250838017870;250838020294;2424;0,1,2;3;9;1;1;1
250838020294;250838020740;446;0,1,2;3;9;1;1;1
250838020740;250838025743;5003;0,1,2;3;9;1;1;1
250838025743;250838031151;5408;0,1,2;3;9;1;1;1
250838031151;250838031657;506;0,1,2;3;9;1;1;1
250838031657;250838035761;4104;0,1,2;3;9;1;1;1
250838035761;250838035903;142;0,1,2;3;9;1;1;1
250838035903;250838040058;4155;0,1,2;3;9;1;1;1
250838040058;250838041387;1329;0,1,2;3;9;1;1;1
250838041387;250838043930;2543;0,1,2;3;9;1;1;1
250838043930;250838045518;1588;0,1,2;3;9;1;1;1
250838045518;250838046147;629;0,1,2;3;9;1;1;1
250838046147;250838050708;4561;0,1,2;3;9;1;1;1
250838050708;250838050753;45;0,1,2;3;9;1;1;1
250838050753;250838056385;5632;0,1,2;3;9;1;1;1
250838056385;250838056509;124;0,1,2;3;9;1;1;1
250838056509;250838056581;72;0,1,2;3;9;1;1;1
250838056581;250838063876;7295;0,1,2;3;9;1;1;1
250838063876;250838066466;2590;0,1,2;3;9;1;1;1
250838066466;250838067542;1076;0,1,2;3;9;1;1;1
250838067542;250838067660;118;0,1,2;3;9;1;1;1
250838067660;250838071368;3708;0,1,2;3;9;1;1;1
250838071368;250838075258;3890;0,1,2;3;9;1;1;1
250838075258;250838076660;1402;0,1,2;3;9;1;1;1
250838076660;250838076714;54;0,1,2;3;9;1;1;1
250838076714;250838079207;2493;0,1,2;3;9;1;1;1
250838079207;250838079671;464;0,1,2;3;9;1;1;1
250838079671;250838081858;2187;0,1,2;3;9;1;1;1
250838081858;250838081932;74;0,1,2;3;9;1;1;1
250838081932;250838082209;277;0,1,2;3;9;1;1;1
250838082209;250838086155;3946;0,1,2;3;9;1;1;1
250838086155;250838090786;4631;0,1,2;3;9;1;1;1
250838090786;250838094725;3939;0,1,2;3;9;1;1;1
250838094725;250838095276;551;0,1,2;3;9;1;1;1
250838095276;250838096309;1033;0,1,2;3;9;1;1;1
250838096309;250838096330;21;0,1,2;3;9;1;1;1
250838096330;250838097209;879;0,1,2;3;9;1;1;1
250838097209;250838100677;3468;0,1,2;3;9;1;1;1
250838100677;250838101237;560;0,1,2;3;9;1;1;1
250838101237;250838102224;987;0,1,2;3;9;1;1;1
250838102224;250838103091;867;0,1,2;3;9;1;1;1
250838103091;250838104247;1156;0,1,2;3;9;1;1;1
250838104247;250838105926;1679;0,1,2;3;9;1;1;1
250838105926;250838107173;1247;0,1,2;3;9;1;1;1
250838107173;250838114272;7099;0,1,2;3;9;1;1;1
250838114272;250838115032;760;0,1,2;3;9;1;1;1
250838115032;250838120696;5664;0,1,2;3;9;1;1;1
250838120696;250838120875;179;0,1,2;3;9;1;1;1
250838120875;250838121956;1081;0,1,2;3;9;1;1;1
250838121956;250838124169;2213;0,1,2;3;9;1;1;1
250838124169;250838127040;2871;0,1,2;3;9;1;1;1
250838127040;250838127626;586;0,1,2;3;9;1;1;1
250838127626;250838129485;1859;0,1,2;3;9;1;1;1
250838129485;250838130147;662;0,1,2;3;9;1;1;1
250838130147;250838130197;50;0,1,2;3;9;1;1;1
250838130197;250838131002;805;0,1,2;3;9;1;1;1
250838131002;250838132860;1858;0,1,2;3;9;1;1;1
250838132860;250838134414;1554;0,1,2;3;9;1;1;1
250838134414;250838135835;1421;0,1,2;3;9;1;1;1
250838135835;250838139892;4057;0,1,2;3;9;1;1;1
250838139892;250838143161;3269;0,1,2;3;9;1;1;1
250838143161;250838145572;2411;0,1,2;3;9;1;1;1
250838145572;250838148358;2786;0,1,2;3;9;1;1;1
250838148358;250838148428;70;0,1,2;3;9;1;1;1
250838148428;250838149092;664;0,1,2;3;9;1;1;1
250838149092;250838155583;6491;0,1,2;3;9;1;1;1
250838155583;250838162350;6767;0,1,2;3;9;1;1;1
250838162350;250838162653;303;0,1,2;3;9;1;1;1
250838162653;250838164207;1554;0,1,2;3;9;1;1;1
250838164207;250838170173;5966;0,1,2;3;9;1;1;1
250838170173;250838171749;1576;0,1,2;3;9;1;1;1
250838171749;250838173396;1647;0,1,2;3;9;1;1;1
250838173396;250838176827;3431;0,1,2;3;9;1;1;1
250838176827;250838176987;160;0,1,2;3;9;1;1;1
250838176987;250838177781;794;0,1,2;3;9;1;1;1
250838177781;250838178292;511;0,1,2;3;9;1;1;1
250838178292;250838178673;381;0,1,2;3;9;1;1;1
250838178673;250838179039;366;0,1,2;3;9;1;1;1
250838179039;250838181006;1967;0,1,2;3;9;1;1;1
250838181006;250838186006;5000;0,1,2;3;9;1;1;1
250838186006;250838187548;1542;0,1,2;3;9;1;1;1
250838187548;250838188383;835;0,1,2;3;9;1;1;1
250838188383;250838192486;4103;0,1,2;3;9;1;1;1
250838192486;250838194111;1625;0,1,2;3;9;1;1;1
250838194111;250838194366;255;0,1,2;3;9;1;1;1
250838194366;250838198032;3666;0,1,2;3;9;1;1;1
250838198032;250838199613;1581;0,1,2;3;9;1;1;1
250838199613;250838199811;198;0,1,2;3;9;1;1;1
250838199811;250838201602;1791;0,1,2;3;9;1;1;1
250838201602;250838206556;4954;0,1,2;3;9;1;1;1
250838206556;250838207051;495;0,1,2;3;9;1;1;1
250838207051;250838209259;2208;0,1,2;3;9;1;1;1
250838209259;250838209294;35;0,1,2;3;9;1;1;1
250838209294;250838211835;2541;0,1,2;3;9;1;1;1
250838211835;250838212206;371;0,1,2;3;9;1;1;1
250838212206;250838214510;2304;0,1,2;3;9;1;1;1
250838214510;250838215163;653;0,1,2;3;9;1;1;1
250838215163;250838215263;100;0,1,2;3;9;1;1;1
250838215263;250838217084;1821;0,1,2;3;9;1;1;1
250838217084;250838217799;715;0,1,2;3;9;1;1;1
250838217799;250838218407;608;0,1,2;3;9;1;1;1
250838218407;250838222223;3816;0,1,2;3;9;1;1;1
250838222223;250838222256;33;0,1,2;3;9;1;1;1
250838222256;250838224558;2302;0,1,2;3;9;1;1;1
250838224558;250838226590;2032;0,1,2;3;9;1;1;1
250838226590;250838228282;1692;0,1,2;3;9;1;1;1
250838228282;250838228582;300;0,1,2;3;9;1;1;1
250838228582;250838229064;482;0,1,2;3;9;1;1;1
250838229064;250838232702;3638;0,1,2;3;9;1;1;1
250838232702;250838233332;630;0,1,2;3;9;1;1;1
250838233332;250838233991;659;0,1,2;3;9;1;1;1
250838233991;250838234048;57;0,1,2;3;9;1;1;1
250838234048;250838235424;1376;0,1,2;3;9;1;1;1
250838235424;250838235499;75;0,1,2;3;9;1;1;1
250838235499;250838236494;995;0,1,2;3;9;1;1;1
250838236494;250838237138;644;0,1,2;3;9;1;1;1
250838237138;250838237315;177;0,1,2;3;9;1;1;1
250838237315;250838238706;1391;0,1,2;3;9;1;1;1
250838238706;250838239769;1063;0,1,2;3;9;1;1;1
250838239769;250838240301;532;0,1,2;3;9;1;1;1
250838240301;250838243440;3139;0,1,2;3;9;1;1;1
250838243440;250838245024;1584;0,1,2;3;9;1;1;1
250838245024;250838245808;784;0,1,2;3;9;1;1;1
250838245808;250838245904;96;0,1,2;3;9;1;1;1
250838245904;250838245927;23;0,1,2;3;9;1;1;1
250838245927;250838250617;4690;0,1,2;3;9;1;1;1
250838250617;250838250781;164;0,1,2;3;9;1;1;1
250838250781;250838253917;3136;0,1,2;3;9;1;1;1
250838253917;250838254152;235;0,1,2;3;9;1;1;1
250838254152;250838254510;358;0,1,2;3;9;1;1;1
250838254510;250838255138;628;0,1,2;3;9;1;1;1
250838255138;250838255188;50;0,1,2;3;9;1;1;1
250838255188;250838258461;3273;0,1,2;3;9;1;1;1
250838258461;250838258614;153;0,1,2;3;9;1;1;1
250838258614;250838260732;2118;0,1,2;3;9;1;1;1
250838260732;250838260992;260;0,1,2;3;9;1;1;1
250838260992;250838261892;900;0,1,2;3;9;1;1;1
250838261892;250838262554;662;0,1,2;3;9;1;1;1
250838262554;250838262667;113;0,1,2;3;9;1;1;1
250838262667;250838264873;2206;0,1,2;3;9;1;1;1
250838264873;250838265213;340;0,1,2;3;9;1;1;1
250838265213;250838265765;552;0,1,2;3;9;1;1;1
250838265765;250838271976;6211;0,1,2;3;9;1;1;1
250838271976;250838272970;994;0,1,2;3;9;1;1;1
250838272970;250838273323;353;0,1,2;3;9;1;1;1
250838273323;250838273424;101;0,1,2;3;9;1;1;1
250838273424;250838275166;1742;0,1,2;3;9;1;1;1
250838275166;250838278588;3422;0,1,2;3;9;1;1;1
250838278588;250838278803;215;0,1,2;3;9;1;1;1
250838278803;250838280980;2177;0,1,2;3;9;1;1;1
250838280980;250838282313;1333;0,1,2;3;9;1;1;1
250838282313;250838282537;224;0,1,2;3;9;1;1;1
250838282537;250838282572;35;0,1,2;3;9;1;1;1
250838282572;250838283943;1371;0,1,2;3;9;1;1;1
250838283943;250838284951;1008;0,1,2;3;9;1;1;1
250838284951;250838286927;1976;0,1,2;3;9;1;1;1
250838286927;250838287240;313;0,1,2;3;9;1;1;1
250838287240;250838287775;535;0,1,2;3;9;1;1;1
250838287775;250838287894;119;0,1,2;3;9;1;1;1
250838287894;250838289007;1113;0,1,2;3;9;1;1;1
250838289007;250838289408;401;0,1,2;3;9;1;1;1
250838289408;250838290816;1408;0,1,2;3;9;1;1;1
250838290816;250838290939;123;0,1,2;3;9;1;1;1
250838290939;250838291059;120;0,1,2;3;9;1;1;1
250838291059;250838292143;1084;0,1,2;3;9;1;1;1
250838292143;250838292595;452;0,1,2;3;9;1;1;1
250838292595;250838293391;796;0,1,2;3;9;1;1;1
250838293391;250838294087;696;0,1,2;3;9;1;1;1
250838294087;250838294235;148;0,1,2;3;9;1;1;1
250838294235;250838295025;790;0,1,2;3;9;1;1;1
250838295025;250838295112;87;0,1,2;3;9;1;1;1
250838295112;250838301204;6092;0,1,2;3;9;1;1;1
250838301204;250838301257;53;0,1,2;3;9;1;1;1
250838301257;250838301323;66;0,1,2;3;9;1;1;1
250838301323;250838301620;297;0,1,2;3;9;1;1;1
250838301620;250838302753;1133;0,1,2;3;9;1;1;1
250838302753;250838303018;265;0,1,2;3;9;1;1;1
250838303018;250838305947;2929;0,1,2;3;9;1;1;1
250838305947;250838306314;367;0,1,2;3;9;1;1;1
250838306314;250838306682;368;0,1,2;3;9;1;1;1
250838306682;250838307091;409;0,1,2;3;9;1;1;1
250838307091;250838308762;1671;0,1,2;3;9;1;1;1
250838308762;250838310527;1765;0,1,2;3;9;1;1;1
250838310527;250838311449;922;0,1,2;3;9;1;1;1
250838311449;250838312156;707;0,1,2;3;9;1;1;1
250838312156;250838312993;837;0,1,2;3;9;1;1;1
250838312993;250838314750;1757;0,1,2;3;9;1;1;1
250838314750;250838315514;764;0,1,2;3;9;1;1;1
250838315514;250838316981;1467;0,1,2;3;9;1;1;1
250838316981;250838317276;295;0,1,2;3;9;1;1;1
250838317276;250838320528;3252;0,1,2;3;9;1;1;1
250838320528;250838320937;409;0,1,2;3;9;1;1;1
250838320937;250838323706;2769;0,1,2;3;9;1;1;1
250838323706;250838324416;710;0,1,2;3;9;1;1;1
250838324416;250838325998;1582;0,1,2;3;9;1;1;1
250838325998;250838327160;1162;0,1,2;3;9;1;1;1
250838327160;250838327245;85;0,1,2;3;9;1;1;1
250838327245;250838327351;106;0,1,2;3;9;1;1;1
250838327351;250838329123;1772;0,1,2;3;9;1;1;1
250838329123;250838331677;2554;0,1,2;3;9;1;1;1
250838331677;250838332670;993;0,1,2;3;9;1;1;1
250838332670;250838333411;741;0,1,2;3;9;1;1;1
250838333411;250838335350;1939;0,1,2;3;9;1;1;1
250838335350;250838335725;375;0,1,2;3;9;1;1;1
250838335725;250838335806;81;0,1,2;3;9;1;1;1
250838335806;250838336677;871;0,1,2;3;9;1;1;1
250838336677;250838337775;1098;0,1,2;3;9;1;1;1
250838337775;250838338576;801;0,1,2;3;9;1;1;1
250838338576;250838340739;2163;0,1,2;3;9;1;1;1
250838340739;250838340916;177;0,1,2;3;9;1;1;1
250838340916;250838342659;1743;0,1,2;3;9;1;1;1
250838342659;250838343875;1216;0,1,2;3;9;1;1;1
250838343875;250838345905;2030;0,1,2;3;9;1;1;1
250838345905;250838348832;2927;0,1,2;3;9;1;1;1
250838348832;250838349313;481;0,1,2;3;9;1;1;1
250838349313;250838350164;851;0,1,2;3;9;1;1;1
250838350164;250838350574;410;0,1,2;3;9;1;1;1
250838350574;250838350994;420;0,1,2;3;9;1;1;1
250838350994;250838351694;700;0,1,2;3;9;1;1;1
250838351694;250838351763;69;0,1,2;3;9;1;1;1
250838351763;250838352176;413;0,1,2;3;9;1;1;1
250838352176;250838353013;837;0,1,2;3;9;1;1;1
250838353013;250838353196;183;0,1,2;3;9;1;1;1
250838353196;250838353315;119;0,1,2;3;9;1;1;1
250838353315;250838353498;183;0,1,2;3;9;1;1;1
250838353498;250838354004;506;0,1,2;3;9;1;1;1
250838354004;250838354089;85;0,1,2;3;9;1;1;1
250838354089;250838354096;7;0,1,2;3;9;1;1;1
250838354096;250838354174;78;0,1,2;3;9;1;1;1
250838354174;250838358730;4556;0,1,2;3;9;1;1;1
250838358730;250838359880;1150;0,1,2;3;9;1;1;1
250838359880;250838360697;817;0,1,2;3;9;1;1;1
250838360697;250838360783;86;0,1,2;3;9;1;1;1
250838360783;250838360864;81;0,1,2;3;9;1;1;1
250838360864;250838365071;4207;0,1,2;3;9;1;1;1
250838365071;250838366878;1807;0,1,2;3;9;1;1;1
250838366878;250838367488;610;0,1,2;3;9;1;1;1
250838367488;250838368708;1220;0,1,2;3;9;1;1;1
250838368708;250838368820;112;0,1,2;3;9;1;1;1
250838368820;250838369675;855;0,1,2;3;9;1;1;1
250838369675;250838370056;381;0,1,2;3;9;1;1;1
250838370056;250838372133;2077;0,1,2;3;9;1;1;1
250838372133;250838372605;472;0,1,2;3;9;1;1;1
250838372605;250838373130;525;0,1,2;3;9;1;1;1
250838373130;250838373162;32;0,1,2;3;9;1;1;1
250838373162;250838373491;329;0,1,2;3;9;1;1;1
250838373491;250838374149;658;0,1,2;3;9;1;1;1
250838374149;250838374547;398;0,1,2;3;9;1;1;1
250838374547;250838375311;764;0,1,2;3;9;1;1;1
250838375311;250838375626;315;0,1,2;3;9;1;1;1
250838375626;250838376222;596;0,1,2;3;9;1;1;1
250838376222;250838377195;973;0,1,2;3;9;1;1;1
250838377195;250838379393;2198;0,1,2;3;9;1;1;1
250838379393;250838379731;338;0,1,2;3;9;1;1;1
250838379731;250838380539;808;0,1,2;3;9;1;1;1
250838380539;250838382878;2339;0,1,2;3;9;1;1;1
250838382878;250838383072;194;0,1,2;3;9;1;1;1
250838383072;250838383139;67;0,1,2;3;9;1;1;1
250838383139;250838383273;134;0,1,2;3;9;1;1;1
250838383273;250838384399;1126;0,1,2;3;9;1;1;1
250838384399;250838385549;1150;0,1,2;3;9;1;1;1
250838385549;250838385662;113;0,1,2;3;9;1;1;1
250838385662;250838387066;1404;0,1,2;3;9;1;1;1
250838387066;250838387696;630;0,1,2;3;9;1;1;1
250838387696;250838388346;650;0,1,2;3;9;1;1;1
250838388346;250838389790;1444;0,1,2;3;9;1;1;1
250838389790;250838390202;412;0,1,2;3;9;1;1;1
250838390202;250838390537;335;0,1,2;3;9;1;1;1
250838390537;250838390660;123;0,1,2;3;9;1;1;1
250838390660;250838390877;217;0,1,2;3;9;1;1;1
250838390877;250838391058;181;0,1,2;3;9;1;1;1
250838391058;250838391111;53;0,1,2;3;9;1;1;1
250838391111;250838391944;833;0,1,2;3;9;1;1;1
250838391944;250838392592;648;0,1,2;3;9;1;1;1
250838392592;250838394090;1498;0,1,2;3;9;1;1;1
250838394090;250838394288;198;0,1,2;3;9;1;1;1
250838394288;250838394358;70;0,1,2;3;9;1;1;1
250838394358;250838394406;48;0,1,2;3;9;1;1;1
250838394406;250838395229;823;0,1,2;3;9;1;1;1
250838395229;250838398289;3060;0,1,2;3;9;1;1;1
250838398289;250838399363;1074;0,1,2;3;9;1;1;1
250838399363;250838402426;3063;0,1,2;3;9;1;1;1
250838402426;250838404926;2500;0,1,2;3;9;1;1;1
250838404926;250838411401;6475;0,1,2;3;9;1;1;1
250838411401;250838412405;1004;0,1,2;3;9;1;1;1
250838412405;250838413082;677;0,1,2;3;9;1;1;1
250838413082;250838414020;938;0,1,2;3;9;1;1;1
250838414020;250838414473;453;0,1,2;3;9;1;1;1
250838414473;250838415146;673;0,1,2;3;9;1;1;1
250838415146;250838415869;723;0,1,2;3;9;1;1;1
250838415869;250838418012;2143;0,1,2;3;9;1;1;1
250838418012;250838419097;1085;0,1,2;3;9;1;1;1
250838419097;250838420766;1669;0,1,2;3;9;1;1;1
250838420766;250838420898;132;0,1,2;3;9;1;1;1
250838420898;250838421741;843;0,1,2;3;9;1;1;1
250838421741;250838421912;171;0,1,2;3;9;1;1;1
250838421912;250838422028;116;0,1,2;3;9;1;1;1
250838422028;250838423954;1926;0,1,2;3;9;1;1;1
250838423954;250838425257;1303;0,1,2;3;9;1;1;1
250838425257;250838426248;991;0,1,2;3;9;1;1;1
250838426248;250838426471;223;0,1,2;3;9;1;1;1
250838426471;250838427641;1170;0,1,2;3;9;1;1;1
250838427641;250838428760;1119;0,1,2;3;9;1;1;1
250838428760;250838428992;232;0,1,2;3;9;1;1;1
250838428992;250838429283;291;0,1,2;3;9;1;1;1
250838429283;250838429530;247;0,1,2;3;9;1;1;1
250838429530;250838430298;768;0,1,2;3;9;1;1;1
250838430298;250838431165;867;0,1,2;3;9;1;1;1
250838431165;250838431234;69;0,1,2;3;9;1;1;1
250838431234;250838431421;187;0,1,2;3;9;1;1;1
250838431421;250838431895;474;0,1,2;3;9;1;1;1
250838431895;250838434375;2480;0,1,2;3;9;1;1;1
250838434375;250838435198;823;0,1,2;3;9;1;1;1
250838435198;250838435451;253;0,1,2;3;9;1;1;1
250838435451;250838435928;477;0,1,2;3;9;1;1;1
250838435928;250838436450;522;0,1,2;3;9;1;1;1
250838436450;250838437493;1043;0,1,2;3;9;1;1;1
250838437493;250838437510;17;0,1,2;3;9;1;1;1
250838437510;250838437644;134;0,1,2;3;9;1;1;1
250838437644;250838437831;187;0,1,2;3;9;1;1;1
250838437831;250838438294;463;0,1,2;3;9;1;1;1
250838438294;250838438971;677;0,1,2;3;9;1;1;1
250838438971;250838439248;277;0,1,2;3;9;1;1;1
250838439248;250838439603;355;0,1,2;3;9;1;1;1
250838439603;250838440546;943;0,1,2;3;9;1;1;1
250838440546;250838441059;513;0,1,2;3;9;1;1;1
250838441059;250838441629;570;0,1,2;3;9;1;1;1
250838441629;250838441755;126;0,1,2;3;9;1;1;1
250838441755;250838443102;1347;0,1,2;3;9;1;1;1
250838443102;250838445491;2389;0,1,2;3;9;1;1;1
250838445491;250838445523;32;0,1,2;3;9;1;1;1
250838445523;250838445687;164;0,1,2;3;9;1;1;1
250838445687;250838447611;1924;0,1,2;3;9;1;1;1
250838447611;250838447657;46;0,1,2;3;9;1;1;1
250838447657;250838447709;52;0,1,2;3;9;1;1;1
250838447709;250838447973;264;0,1,2;3;9;1;1;1
250838447973;250838452629;4656;0,1,2;3;9;1;1;1
250838452629;250838452791;162;0,1,2;3;9;1;1;1
250838452791;250838454480;1689;0,1,2;3;9;1;1;1
250838454480;250838455278;798;0,1,2;3;9;1;1;1
250838455278;250838457841;2563;0,1,2;3;9;1;1;1
250838457841;250838461121;3280;0,1,2;3;9;1;1;1
250838461121;250838461474;353;0,1,2;3;9;1;1;1
250838461474;250838462171;697;0,1,2;3;9;1;1;1
250838462171;250838463883;1712;0,1,2;3;9;1;1;1
250838463883;250838464862;979;0,1,2;3;9;1;1;1
250838464862;250838465074;212;0,1,2;3;9;1;1;1
250838465074;250838465076;2;0,1,2;3;9;1;1;1
250838465076;250838465491;415;0,1,2;3;9;1;1;1
250838465491;250838466157;666;0,1,2;3;9;1;1;1
250838466157;250838466885;728;0,1,2;3;9;1;1;1
250838466885;250838467209;324;0,1,2;3;9;1;1;1
250838467209;250838468229;1020;0,1,2;3;9;1;1;1
250838468229;250838468343;114;0,1,2;3;9;1;1;1
250838468343;250838468650;307;0,1,2;3;9;1;1;1
250838468650;250838469112;462;0,1,2;3;9;1;1;1
250838469112;250838469152;40;0,1,2;3;9;1;1;1
250838469152;250838470121;969;0,1,2;3;9;1;1;1
250838470121;250838470222;101;0,1,2;3;9;1;1;1
250838470222;250838471615;1393;0,1,2;3;9;1;1;1
250838471615;250838471961;346;0,1,2;3;9;1;1;1
250838471961;250838472453;492;0,1,2;3;9;1;1;1
250838472453;250838472682;229;0,1,2;3;9;1;1;1
250838472682;250838472906;224;0,1,2;3;9;1;1;1
250838472906;250838475629;2723;0,1,2;3;9;1;1;1
250838475629;250838477283;1654;0,1,2;3;9;1;1;1
250838477283;250838478383;1100;0,1,2;3;9;1;1;1
250838478383;250838479707;1324;0,1,2;3;9;1;1;1
250838479707;250838480708;1001;0,1,2;3;9;1;1;1
250838480708;250838480983;275;0,1,2;3;9;1;1;1
250838480983;250838482144;1161;0,1,2;3;9;1;1;1
250838482144;250838482674;530;0,1,2;3;9;1;1;1
250838482674;250838482889;215;0,1,2;3;9;1;1;1
250838482889;250838483381;492;0,1,2;3;9;1;1;1
250838483381;250838483428;47;0,1,2;3;9;1;1;1
250838483428;250838484301;873;0,1,2;3;9;1;1;1
250838484301;250838484431;130;0,1,2;3;9;1;1;1
250838484431;250838485312;881;0,1,2;3;9;1;1;1
250838485312;250838489216;3904;0,1,2;3;9;1;1;1
250838489216;250838491165;1949;0,1,2;3;9;1;1;1
250838491165;250838492963;1798;0,1,2;3;9;1;1;1
250838492963;250838493378;415;0,1,2;3;9;1;1;1
250838493378;250838494388;1010;0,1,2;3;9;1;1;1
250838494388;250838494869;481;0,1,2;3;9;1;1;1
250838494869;250838495762;893;0,1,2;3;9;1;1;1
250838495762;250838497760;1998;0,1,2;3;9;1;1;1
250838497760;250838498968;1208;0,1,2;3;9;1;1;1
250838498968;250838499122;154;0,1,2;3;9;1;1;1
250838499122;250838500188;1066;0,1,2;3;9;1;1;1
250838500188;250838500916;728;0,1,2;3;9;1;1;1
250838500916;250838501308;392;0,1,2;3;9;1;1;1
250838501308;250838501973;665;0,1,2;3;9;1;1;1
250838501973;250838502543;570;0,1,2;3;9;1;1;1
250838502543;250838503085;542;0,1,2;3;9;1;1;1
250838503085;250838505212;2127;0,1,2;3;9;1;1;1
250838505212;250838505322;110;0,1,2;3;9;1;1;1
250838505322;250838505894;572;0,1,2;3;9;1;1;1
250838505894;250838508708;2814;0,1,2;3;9;1;1;1
250838508708;250838508882;174;0,1,2;3;9;1;1;1
250838508882;250838508958;76;0,1,2;3;9;1;1;1
250838508958;250838509804;846;0,1,2;3;9;1;1;1
250838509804;250838509870;66;0,1,2;3;9;1;1;1
250838509870;250838509900;30;0,1,2;3;9;1;1;1
250838509900;250838513290;3390;0,1,2;3;9;1;1;1
250838513290;250838514829;1539;0,1,2;3;9;1;1;1
250838514829;250838518905;4076;0,1,2;3;9;1;1;1
250838518905;250838519281;376;0,1,2;3;9;1;1;1
250838519281;250838520473;1192;0,1,2;3;9;1;1;1
250838520473;250838520596;123;0,1,2;3;9;1;1;1
250838520596;250838523672;3076;0,1,2;3;9;1;1;1
250838523672;250838523750;78;0,1,2;3;9;1;1;1
250838523750;250838527713;3963;0,1,2;3;9;1;1;1
250838527713;250838527826;113;0,1,2;3;9;1;1;1
250838527826;250838528011;185;0,1,2;3;9;1;1;1
250838528011;250838528306;295;0,1,2;3;9;1;1;1
250838528306;250838528495;189;0,1,2;3;9;1;1;1
250838528495;250838530872;2377;0,1,2;3;9;1;1;1
250838530872;250838532472;1600;0,1,2;3;9;1;1;1
250838532472;250838532660;188;0,1,2;3;9;1;1;1
250838532660;250838533195;535;0,1,2;3;9;1;1;1
250838533195;250838534669;1474;0,1,2;3;9;1;1;1
250838534669;250838534796;127;0,1,2;3;9;1;1;1
250838534796;250838537783;2987;0,1,2;3;9;1;1;1
250838537783;250838537871;88;0,1,2;3;9;1;1;1
250838537871;250838538750;879;0,1,2;3;9;1;1;1
250838538750;250838538831;81;0,1,2;3;9;1;1;1
250838538831;250838540082;1251;0,1,2;3;9;1;1;1
250838540082;250838542841;2759;0,1,2;3;9;1;1;1
250838542841;250838544131;1290;0,1,2;3;9;1;1;1
250838544131;250838544551;420;0,1,2;3;9;1;1;1
250838544551;250838545226;675;0,1,2;3;9;1;1;1
250838545226;250838546873;1647;0,1,2;3;9;1;1;1
250838546873;250838548250;1377;0,1,2;3;9;1;1;1
250838548250;250838548282;32;0,1,2;3;9;1;1;1
250838548282;250838550228;1946;0,1,2;3;9;1;1;1
250838550228;250838551479;1251;0,1,2;3;9;1;1;1
250838551479;250838551494;15;0,1,2;3;9;1;1;1
250838551494;250838551596;102;0,1,2;3;9;1;1;1
250838551596;250838551896;300;0,1,2;3;9;1;1;1
250838551896;250838553168;1272;0,1,2;3;9;1;1;1
250838553168;250838554022;854;0,1,2;3;9;1;1;1
250838554022;250838554063;41;0,1,2;3;9;1;1;1
250838554063;250838554415;352;0,1,2;3;9;1;1;1
250838554415;250838554425;10;0,1,2;3;9;1;1;1
250838554425;250838555584;1159;0,1,2;3;9;1;1;1
250838555584;250838557038;1454;0,1,2;3;9;1;1;1
250838557038;250838557219;181;0,1,2;3;9;1;1;1
250838557219;250838557931;712;0,1,2;3;9;1;1;1
250838557931;250838559762;1831;0,1,2;3;9;1;1;1
250838559762;250838560025;263;0,1,2;3;9;1;1;1
250838560025;250838560112;87;0,1,2;3;9;1;1;1
250838560112;250838560764;652;0,1,2;3;9;1;1;1
250838560764;250838560874;110;0,1,2;3;9;1;1;1
250838560874;250838562162;1288;0,1,2;3;9;1;1;1
250838562162;250838562598;436;0,1,2;3;9;1;1;1
250838562598;250838563983;1385;0,1,2;3;9;1;1;1
250838563983;250838565336;1353;0,1,2;3;9;1;1;1
250838565336;250838566010;674;0,1,2;3;9;1;1;1
250838566010;250838567072;1062;0,1,2;3;9;1;1;1
250838567072;250838567189;117;0,1,2;3;9;1;1;1
250838567189;250838567745;556;0,1,2;3;9;1;1;1
250838567745;250838567859;114;0,1,2;3;9;1;1;1
250838567859;250838569391;1532;0,1,2;3;9;1;1;1
250838569391;250838570419;1028;0,1,2;3;9;1;1;1
250838570419;250838571575;1156;0,1,2;3;9;1;1;1
250838571575;250838572597;1022;0,1,2;3;9;1;1;1
250838572597;250838575326;2729;0,1,2;3;9;1;1;1
250838575326;250838575368;42;0,1,2;3;9;1;1;1
250838575368;250838575625;257;0,1,2;3;9;1;1;1
250838575625;250838577897;2272;0,1,2;3;9;1;1;1
250838577897;250838580317;2420;0,1,2;3;9;1;1;1
250838580317;250838580908;591;0,1,2;3;9;1;1;1
250838580908;250838582981;2073;0,1,2;3;9;1;1;1
250838582981;250838585647;2666;0,1,2;3;9;1;1;1
250838585647;250838586405;758;0,1,2;3;9;1;1;1
250838586405;250838587428;1023;0,1,2;3;9;1;1;1
250838587428;250838588194;766;0,1,2;3;9;1;1;1
250838588194;250838589083;889;0,1,2;3;9;1;1;1
250838589083;250838590301;1218;0,1,2;3;9;1;1;1
250838590301;250838591386;1085;0,1,2;3;9;1;1;1
250838591386;250838591920;534;0,1,2;3;9;1;1;1
250838591920;250838592428;508;0,1,2;3;9;1;1;1
250838592428;250838592503;75;0,1,2;3;9;1;1;1
250838592503;250838593029;526;0,1,2;3;9;1;1;1
250838593029;250838594726;1697;0,1,2;3;9;1;1;1
250838594726;250838595750;1024;0,1,2;3;9;1;1;1
250838595750;250838598039;2289;0,1,2;3;9;1;1;1
250838598039;250838598430;391;0,1,2;3;9;1;1;1
250838598430;250838598775;345;0,1,2;3;9;1;1;1
250838598775;250838599567;792;0,1,2;3;9;1;1;1
250838599567;250838599927;360;0,1,2;3;9;1;1;1
250838599927;250838601962;2035;0,1,2;3;9;1;1;1
250838601962;250838602447;485;0,1,2;3;9;1;1;1
250838602447;250838604262;1815;0,1,2;3;9;1;1;1
250838604262;250838604492;230;0,1,2;3;9;1;1;1
250838604492;250838605525;1033;0,1,2;3;9;1;1;1
250838605525;250838606075;550;0,1,2;3;9;1;1;1
250838606075;250838606707;632;0,1,2;3;9;1;1;1
250838606707;250838607668;961;0,1,2;3;9;1;1;1
250838607668;250838609292;1624;0,1,2;3;9;1;1;1
250838609292;250838609550;258;0,1,2;3;9;1;1;1
250838609550;250838609780;230;0,1,2;3;9;1;1;1
250838609780;250838611855;2075;0,1,2;3;9;1;1;1
250838611855;250838612714;859;0,1,2;3;9;1;1;1
250838612714;250838614264;1550;0,1,2;3;9;1;1;1
250838614264;250838616158;1894;0,1,2;3;9;1;1;1
250838616158;250838616371;213;0,1,2;3;9;1;1;1
250838616371;250838616591;220;0,1,2;3;9;1;1;1
250838616591;250838618213;1622;0,1,2;3;9;1;1;1
250838618213;250838618379;166;0,1,2;3;9;1;1;1
250838618379;250838618744;365;0,1,2;3;9;1;1;1
250838618744;250838619121;377;0,1,2;3;9;1;1;1
250838619121;250838619215;94;0,1,2;3;9;1;1;1
250838619215;250838620906;1691;0,1,2;3;9;1;1;1
250838620906;250838621027;121;0,1,2;3;9;1;1;1
250838621027;250838621353;326;0,1,2;3;9;1;1;1
250838621353;250838621448;95;0,1,2;3;9;1;1;1
250838621448;250838622756;1308;0,1,2;3;9;1;1;1
250838622756;250838622777;21;0,1,2;3;9;1;1;1
250838622777;250838623249;472;0,1,2;3;9;1;1;1
250838623249;250838623936;687;0,1,2;3;9;1;1;1
250838623936;250838624323;387;0,1,2;3;9;1;1;1
250838624323;250838624380;57;0,1,2;3;9;1;1;1
250838624380;250838625360;980;0,1,2;3;9;1;1;1
250838625360;250838628088;2728;0,1,2;3;9;1;1;1
250838628088;250838628389;301;0,1,2;3;9;1;1;1
250838628389;250838628574;185;0,1,2;3;9;1;1;1
250838628574;250838628780;206;0,1,2;3;9;1;1;1
250838628780;250838629962;1182;0,1,2;3;9;1;1;1
250838629962;250838632525;2563;0,1,2;3;9;1;1;1
250838632525;250838632796;271;0,1,2;3;9;1;1;1
250838632796;250838632920;124;0,1,2;3;9;1;1;1
250838632920;250838632946;26;0,1,2;3;9;1;1;1
250838632946;250838634688;1742;0,1,2;3;9;1;1;1
250838634688;250838636917;2229;0,1,2;3;9;1;1;1
250838636917;250838637555;638;0,1,2;3;9;1;1;1
250838637555;250838637590;35;0,1,2;3;9;1;1;1
250838637590;250838638264;674;0,1,2;3;9;1;1;1
250838638264;250838638765;501;0,1,2;3;9;1;1;1
250838638765;250838638831;66;0,1,2;3;9;1;1;1
250838638831;250838640244;1413;0,1,2;3;9;1;1;1
250838640244;250838641603;1359;0,1,2;3;9;1;1;1
250838641603;250838642199;596;0,1,2;3;9;1;1;1
250838642199;250838642499;300;0,1,2;3;9;1;1;1
250838642499;250838642531;32;0,1,2;3;9;1;1;1
250838642531;250838642656;125;0,1,2;3;9;1;1;1
250838642656;250838642776;120;0,1,2;3;9;1;1;1
250838642776;250838643303;527;0,1,2;3;9;1;1;1
250838643303;250838643392;89;0,1,2;3;9;1;1;1
250838643392;250838644043;651;0,1,2;3;9;1;1;1
250838644043;250838644121;78;0,1,2;3;9;1;1;1
250838644121;250838644419;298;0,1,2;3;9;1;1;1
250838644419;250838644833;414;0,1,2;3;9;1;1;1
250838644833;250838646381;1548;0,1,2;3;9;1;1;1
250838646381;250838647472;1091;0,1,2;3;9;1;1;1
250838647472;250838647473;1;0,1,2;3;9;1;1;1
250838647473;250838648023;550;0,1,2;3;9;1;1;1
250838648023;250838648215;192;0,1,2;3;9;1;1;1
250838648215;250838650024;1809;0,1,2;3;9;1;1;1
250838650024;250838650985;961;0,1,2;3;9;1;1;1
250838650985;250838651330;345;0,1,2;3;9;1;1;1
250838651330;250838651714;384;0,1,2;3;9;1;1;1
250838651714;250838651773;59;0,1,2;3;9;1;1;1
250838651773;250838651914;141;0,1,2;3;9;1;1;1
250838651914;250838652793;879;0,1,2;3;9;1;1;1
250838652793;250838653860;1067;0,1,2;3;9;1;1;1
250838653860;250838654586;726;0,1,2;3;9;1;1;1
250838654586;250838656211;1625;0,1,2;3;9;1;1;1
250838656211;250838656767;556;0,1,2;3;9;1;1;1
250838656767;250838656781;14;0,1,2;3;9;1;1;1
250838656781;250838657713;932;0,1,2;3;9;1;1;1
250838657713;250838659932;2219;0,1,2;3;9;1;1;1
250838659932;250838660010;78;0,1,2;3;9;1;1;1
250838660010;250838660114;104;0,1,2;3;9;1;1;1
250838660114;250838660206;92;0,1,2;3;9;1;1;1
250838660206;250838660567;361;0,1,2;3;9;1;1;1
250838660567;250838662661;2094;0,1,2;3;9;1;1;1
250838662661;250838663055;394;0,1,2;3;9;1;1;1
250838663055;250838663165;110;0,1,2;3;9;1;1;1
250838663165;250838663424;259;0,1,2;3;9;1;1;1
250838663424;250838663986;562;0,1,2;3;9;1;1;1
250838663986;250838668052;4066;0,1,2;3;9;1;1;1
250838668052;250838668813;761;0,1,2;3;9;1;1;1
250838668813;250838669495;682;0,1,2;3;9;1;1;1
250838669495;250838669549;54;0,1,2;3;9;1;1;1
250838669549;250838669608;59;0,1,2;3;9;1;1;1
250838669608;250838669908;300;0,1,2;3;9;1;1;1
250838669908;250838670282;374;0,1,2;3;9;1;1;1
250838670282;250838672790;2508;0,1,2;3;9;1;1;1
250838672790;250838672840;50;0,1,2;3;9;1;1;1
250838672840;250838674425;1585;0,1,2;3;9;1;1;1
250838674425;250838675665;1240;0,1,2;3;9;1;1;1
250838675665;250838676149;484;0,1,2;3;9;1;1;1
250838676149;250838676371;222;0,1,2;3;9;1;1;1
250838676371;250838676997;626;0,1,2;3;9;1;1;1
250838676997;250838679292;2295;0,1,2;3;9;1;1;1
250838679292;250838679431;139;0,1,2;3;9;1;1;1
250838679431;250838679491;60;0,1,2;3;9;1;1;1
250838679491;250838681145;1654;0,1,2;3;9;1;1;1
250838681145;250838682107;962;0,1,2;3;9;1;1;1
250838682107;250838683677;1570;0,1,2;3;9;1;1;1
250838683677;250838684317;640;0,1,2;3;9;1;1;1
250838684317;250838684918;601;0,1,2;3;9;1;1;1
250838684918;250838685052;134;0,1,2;3;9;1;1;1
250838685052;250838685656;604;0,1,2;3;9;1;1;1
250838685656;250838685896;240;0,1,2;3;9;1;1;1
250838685896;250838686013;117;0,1,2;3;9;1;1;1
250838686013;250838686638;625;0,1,2;3;9;1;1;1
250838686638;250838688410;1772;0,1,2;3;9;1;1;1
250838688410;250838689484;1074;0,1,2;3;9;1;1;1
250838689484;250838689831;347;0,1,2;3;9;1;1;1
250838689831;250838690165;334;0,1,2;3;9;1;1;1
250838690165;250838692064;1899;0,1,2;3;9;1;1;1
250838692064;250838692460;396;0,1,2;3;9;1;1;1
250838692460;250838693137;677;0,1,2;3;9;1;1;1
250838693137;250838694109;972;0,1,2;3;9;1;1;1
250838694109;250838694769;660;0,1,2;3;9;1;1;1
250838694769;250838695389;620;0,1,2;3;9;1;1;1
250838695389;250838699257;3868;0,1,2;3;9;1;1;1
250838699257;250838699423;166;0,1,2;3;9;1;1;1
250838699423;250838700514;1091;0,1,2;3;9;1;1;1
250838700514;250838702164;1650;0,1,2;3;9;1;1;1
250838702164;250838703336;1172;0,1,2;3;9;1;1;1
250838703336;250838705659;2323;0,1,2;3;9;1;1;1
250838705659;250838706002;343;0,1,2;3;9;1;1;1
250838706002;250838706469;467;0,1,2;3;9;1;1;1
250838706469;250838707168;699;0,1,2;3;9;1;1;1
250838707168;250838707447;279;0,1,2;3;9;1;1;1
250838707447;250838707488;41;0,1,2;3;9;1;1;1
250838707488;250838710235;2747;0,1,2;3;9;1;1;1
250838710235;250838710854;619;0,1,2;3;9;1;1;1
250838710854;250838710892;38;0,1,2;3;9;1;1;1
250838710892;250838712602;1710;0,1,2;3;9;1;1;1
250838712602;250838714170;1568;0,1,2;3;9;1;1;1
250838714170;250838717055;2885;0,1,2;3;9;1;1;1
250838717055;250838717470;415;0,1,2;3;9;1;1;1
250838717470;250838717619;149;0,1,2;3;9;1;1;1
250838717619;250838717991;372;0,1,2;3;9;1;1;1
250838717991;250838718016;25;0,1,2;3;9;1;1;1
250838718016;250838718095;79;0,1,2;3;9;1;1;1
250838718095;250838718689;594;0,1,2;3;9;1;1;1
250838718689;250838719558;869;0,1,2;3;9;1;1;1
250838719558;250838722326;2768;0,1,2;3;9;1;1;1
250838722326;250838722953;627;0,1,2;3;9;1;1;1
250838722953;250838722995;42;0,1,2;3;9;1;1;1
250838722995;250838723191;196;0,1,2;3;9;1;1;1
250838723191;250838723234;43;0,1,2;3;9;1;1;1
250838723234;250838725512;2278;0,1,2;3;9;1;1;1
250838725512;250838726305;793;0,1,2;3;9;1;1;1
250838726305;250838726416;111;0,1,2;3;9;1;1;1
250838726416;250838727312;896;0,1,2;3;9;1;1;1
250838727312;250838727511;199;0,1,2;3;9;1;1;1
250838727511;250838728035;524;0,1,2;3;9;1;1;1
250838728035;250838728188;153;0,1,2;3;9;1;1;1
250838728188;250838728748;560;0,1,2;3;9;1;1;1
250838728748;250838729315;567;0,1,2;3;9;1;1;1
250838729315;250838731330;2015;0,1,2;3;9;1;1;1
250838731330;250838731960;630;0,1,2;3;9;1;1;1
250838731960;250838732108;148;0,1,2;3;9;1;1;1
250838732108;250838732326;218;0,1,2;3;9;1;1;1
250838732326;250838732660;334;0,1,2;3;9;1;1;1
250838732660;250838733726;1066;0,1,2;3;9;1;1;1
250838733726;250838734199;473;0,1,2;3;9;1;1;1
250838734199;250838734361;162;0,1,2;3;9;1;1;1
250838734361;250838738049;3688;0,1,2;3;9;1;1;1
250838738049;250838738072;23;0,1,2;3;9;1;1;1
250838738072;250838739702;1630;0,1,2;3;9;1;1;1
250838739702;250838741181;1479;0,1,2;3;9;1;1;1
250838741181;250838741816;635;0,1,2;3;9;1;1;1
250838741816;250838741941;125;0,1,2;3;9;1;1;1
250838741941;250838741986;45;0,1,2;3;9;1;1;1
250838741986;250838742066;80;0,1,2;3;9;1;1;1
250838742066;250838742160;94;0,1,2;3;9;1;1;1
250838742160;250838742777;617;0,1,2;3;9;1;1;1
250838742777;250838743554;777;0,1,2;3;9;1;1;1
250838743554;250838743656;102;0,1,2;3;9;1;1;1
250838743656;250838744574;918;0,1,2;3;9;1;1;1
250838744574;250838745875;1301;0,1,2;3;9;1;1;1
250838745875;250838746384;509;0,1,2;3;9;1;1;1
250838746384;250838746651;267;0,1,2;3;9;1;1;1
250838746651;250838747009;358;0,1,2;3;9;1;1;1
250838747009;250838748059;1050;0,1,2;3;9;1;1;1
250838748059;250838748300;241;0,1,2;3;9;1;1;1
250838748300;250838748808;508;0,1,2;3;9;1;1;1
250838748808;250838748852;44;0,1,2;3;9;1;1;1
250838748852;250838749035;183;0,1,2;3;9;1;1;1
250838749035;250838749553;518;0,1,2;3;9;1;1;1
250838749553;250838750580;1027;0,1,2;3;9;1;1;1
250838750580;250838751089;509;0,1,2;3;9;1;1;1
250838751089;250838751342;253;0,1,2;3;9;1;1;1
250838751342;250838753423;2081;0,1,2;3;9;1;1;1
250838753423;250838754295;872;0,1,2;3;9;1;1;1
250838754295;250838754371;76;0,1,2;3;9;1;1;1
250838754371;250838754413;42;0,1,2;3;9;1;1;1
250838754413;250838754954;541;0,1,2;3;9;1;1;1
250838754954;250838755390;436;0,1,2;3;9;1;1;1
250838755390;250838755917;527;0,1,2;3;9;1;1;1
250838755917;250838756001;84;0,1,2;3;9;1;1;1
250838756001;250838758596;2595;0,1,2;3;9;1;1;1
250838758596;250838758702;106;0,1,2;3;9;1;1;1
250838758702;250838760194;1492;0,1,2;3;9;1;1;1
250838760194;250838760288;94;0,1,2;3;9;1;1;1
250838760288;250838760487;199;0,1,2;3;9;1;1;1
250838760487;250838763194;2707;0,1,2;3;9;1;1;1
250838763194;250838764020;826;0,1,2;3;9;1;1;1
250838764020;250838765525;1505;0,1,2;3;9;1;1;1
250838765525;250838766638;1113;0,1,2;3;9;1;1;1
250838766638;250838767062;424;0,1,2;3;9;1;1;1
250838767062;250838767098;36;0,1,2;3;9;1;1;1
250838767098;250838767706;608;0,1,2;3;9;1;1;1
250838767706;250838769445;1739;0,1,2;3;9;1;1;1
250838769445;250838769726;281;0,1,2;3;9;1;1;1
250838769726;250838769964;238;0,1,2;3;9;1;1;1
250838769964;250838771244;1280;0,1,2;3;9;1;1;1
250838771244;250838771335;91;0,1,2;3;9;1;1;1
250838771335;250838771662;327;0,1,2;3;9;1;1;1
250838771662;250838772988;1326;0,1,2;3;9;1;1;1
250838772988;250838773055;67;0,1,2;3;9;1;1;1
250838773055;250838773408;353;0,1,2;3;9;1;1;1
250838773408;250838773842;434;0,1,2;3;9;1;1;1
250838773842;250838779874;6032;0,1,2;3;9;1;1;1
250838779874;250838782831;2957;0,1,2;3;9;1;1;1
250838782831;250838783389;558;0,1,2;3;9;1;1;1
250838783389;250838785888;2499;0,1,2;3;9;1;1;1
250838785888;250838787279;1391;0,1,2;3;9;1;1;1
250838787279;250838788707;1428;0,1,2;3;9;1;1;1
250838788707;250838793284;4577;0,1,2;3;9;1;1;1
250838793284;250838793494;210;0,1,2;3;9;1;1;1
250838793494;250838793537;43;0,1,2;3;9;1;1;1
250838793537;250838794471;934;0,1,2;3;9;1;1;1
250838794471;250838794755;284;0,1,2;3;9;1;1;1
250838794755;250838794919;164;0,1,2;3;9;1;1;1
250838794919;250838795164;245;0,1,2;3;9;1;1;1
250838795164;250838795641;477;0,1,2;3;9;1;1;1
250838795641;250838795683;42;0,1,2;3;9;1;1;1
250838795683;250838795691;8;0,1,2;3;9;1;1;1
250838795691;250838797290;1599;0,1,2;3;9;1;1;1
250838797290;250838797538;248;0,1,2;3;9;1;1;1
250838797538;250838798727;1189;0,1,2;3;9;1;1;1
250838798727;250838798829;102;0,1,2;3;9;1;1;1
250838798829;250838802149;3320;0,1,2;3;9;1;1;1
250838802149;250838803217;1068;0,1,2;3;9;1;1;1
250838803217;250838804842;1625;0,1,2;3;9;1;1;1
250838804842;250838804947;105;0,1,2;3;9;1;1;1
250838804947;250838805365;418;0,1,2;3;9;1;1;1
250838805365;250838806958;1593;0,1,2;3;9;1;1;1
250838806958;250838807389;431;0,1,2;3;9;1;1;1
250838807389;250838807787;398;0,1,2;3;9;1;1;1
250838807787;250838808118;331;0,1,2;3;9;1;1;1
250838808118;250838809595;1477;0,1,2;3;9;1;1;1
250838809595;250838810952;1357;0,1,2;3;9;1;1;1
250838810952;250838811182;230;0,1,2;3;9;1;1;1
250838811182;250838812183;1001;0,1,2;3;9;1;1;1
250838812183;250838812933;750;0,1,2;3;9;1;1;1
250838812933;250838813127;194;0,1,2;3;9;1;1;1
250838813127;250838815112;1985;0,1,2;3;9;1;1;1
250838815112;250838816367;1255;0,1,2;3;9;1;1;1
250838816367;250838817091;724;0,1,2;3;9;1;1;1
250838817091;250838817109;18;0,1,2;3;9;1;1;1
250838817109;250838818734;1625;0,1,2;3;9;1;1;1
250838818734;250838819789;1055;0,1,2;3;9;1;1;1
250838819789;250838820545;756;0,1,2;3;9;1;1;1
250838820545;250838828357;7812;0,1,2;3;9;1;1;1
250838828357;250838829041;684;0,1,2;3;9;1;1;1
250838829041;250838829928;887;0,1,2;3;9;1;1;1
250838829928;250838830973;1045;0,1,2;3;9;1;1;1
250838830973;250838834834;3861;0,1,2;3;9;1;1;1
250838834834;250838835444;610;0,1,2;3;9;1;1;1
250838835444;250838835666;222;0,1,2;3;9;1;1;1
250838835666;250838839016;3350;0,1,2;3;9;1;1;1
250838839016;250838839465;449;0,1,2;3;9;1;1;1
250838839465;250838839738;273;0,1,2;3;9;1;1;1
250838839738;250838840218;480;0,1,2;3;9;1;1;1
250838840218;250838840426;208;0,1,2;3;9;1;1;1
250838840426;250838840490;64;0,1,2;3;9;1;1;1
250838840490;250838840665;175;0,1,2;3;9;1;1;1
250838840665;250838841675;1010;0,1,2;3;9;1;1;1
250838841675;250838841964;289;0,1,2;3;9;1;1;1
250838841964;250838844071;2107;0,1,2;3;9;1;1;1
250838844071;250838845675;1604;0,1,2;3;9;1;1;1
250838845675;250838847368;1693;0,1,2;3;9;1;1;1
250838847368;250838847511;143;0,1,2;3;9;1;1;1
250838847511;250838849301;1790;0,1,2;3;9;1;1;1
250838849301;250838849627;326;0,1,2;3;9;1;1;1
250838849627;250838850548;921;0,1,2;3;9;1;1;1
250838850548;250838855483;4935;0,1,2;3;9;1;1;1
250838855483;250838856149;666;0,1,2;3;9;1;1;1
250838856149;250838856245;96;0,1,2;3;9;1;1;1
250838856245;250838856345;100;0,1,2;3;9;1;1;1
250838856345;250838857042;697;0,1,2;3;9;1;1;1
250838857042;250838858611;1569;0,1,2;3;9;1;1;1
250838858611;250838859394;783;0,1,2;3;9;1;1;1
250838859394;250838859562;168;0,1,2;3;9;1;1;1
250838859562;250838859969;407;0,1,2;3;9;1;1;1
250838859969;250838860440;471;0,1,2;3;9;1;1;1
250838860440;250838860844;404;0,1,2;3;9;1;1;1
250838860844;250838860936;92;0,1,2;3;9;1;1;1
250838860936;250838861707;771;0,1,2;3;9;1;1;1
250838861707;250838861737;30;0,1,2;3;9;1;1;1
250838861737;250838861777;40;0,1,2;3;9;1;1;1
250838861777;250838863202;1425;0,1,2;3;9;1;1;1
250838863202;250838863248;46;0,1,2;3;9;1;1;1
250838863248;250838864104;856;0,1,2;3;9;1;1;1
250838864104;250838864249;145;0,1,2;3;9;1;1;1
250838864249;250838864654;405;0,1,2;3;9;1;1;1
250838864654;250838865356;702;0,1,2;3;9;1;1;1
250838865356;250838865659;303;0,1,2;3;9;1;1;1
250838865659;250838865869;210;0,1,2;3;9;1;1;1
250838865869;250838865886;17;0,1,2;3;9;1;1;1
250838865886;250838865940;54;0,1,2;3;9;1;1;1
250838865940;250838866203;263;0,1,2;3;9;1;1;1
250838866203;250838866898;695;0,1,2;3;9;1;1;1
250838866898;250838868711;1813;0,1,2;3;9;1;1;1
250838868711;250838868732;21;0,1,2;3;9;1;1;1
250838868732;250838868762;30;0,1,2;3;9;1;1;1
250838868762;250838869063;301;0,1,2;3;9;1;1;1
250838869063;250838869155;92;0,1,2;3;9;1;1;1
250838869155;250838870248;1093;0,1,2;3;9;1;1;1
250838870248;250838870452;204;0,1,2;3;9;1;1;1
250838870452;250838871144;692;0,1,2;3;9;1;1;1
250838871144;250838871569;425;0,1,2;3;9;1;1;1
250838871569;250838875192;3623;0,1,2;3;9;1;1;1
250838875192;250838875237;45;0,1,2;3;9;1;1;1
250838875237;250838875284;47;0,1,2;3;9;1;1;1
250838875284;250838877712;2428;0,1,2;3;9;1;1;1
250838877712;250838880035;2323;0,1,2;3;9;1;1;1
250838880035;250838880511;476;0,1,2;3;9;1;1;1
250838880511;250838881117;606;0,1,2;3;9;1;1;1
250838881117;250838881197;80;0,1,2;3;9;1;1;1
250838881197;250838881959;762;0,1,2;3;9;1;1;1
250838881959;250838883051;1092;0,1,2;3;9;1;1;1
250838883051;250838886295;3244;0,1,2;3;9;1;1;1
250838886295;250838890288;3993;0,1,2;3;9;1;1;1
250838890288;250838890487;199;0,1,2;3;9;1;1;1
250838890487;250838891265;778;0,1,2;3;9;1;1;1
250838891265;250838892941;1676;0,1,2;3;9;1;1;1
250838892941;250838894012;1071;0,1,2;3;9;1;1;1
250838894012;250838895899;1887;0,1,2;3;9;1;1;1
250838895899;250838896354;455;0,1,2;3;9;1;1;1
250838896354;250838897014;660;0,1,2;3;9;1;1;1
250838897014;250838898695;1681;0,1,2;3;9;1;1;1
250838898695;250838898854;159;0,1,2;3;9;1;1;1
250838898854;250838899079;225;0,1,2;3;9;1;1;1
250838899079;250838900873;1794;0,1,2;3;9;1;1;1
250838900873;250838901299;426;0,1,2;3;9;1;1;1
250838901299;250838901384;85;0,1,2;3;9;1;1;1
250838901384;250838902719;1335;0,1,2;3;9;1;1;1
250838902719;250838903903;1184;0,1,2;3;9;1;1;1
250838903903;250838905657;1754;0,1,2;3;9;1;1;1
250838905657;250838905806;149;0,1,2;3;9;1;1;1
250838905806;250838907455;1649;0,1,2;3;9;1;1;1
250838907455;250838907997;542;0,1,2;3;9;1;1;1
250838907997;250838908658;661;0,1,2;3;9;1;1;1
250838908658;250838909636;978;0,1,2;3;9;1;1;1
250838909636;250838910138;502;0,1,2;3;9;1;1;1
250838910138;250838911442;1304;0,1,2;3;9;1;1;1
250838911442;250838912439;997;0,1,2;3;9;1;1;1
250838912439;250838914559;2120;0,1,2;3;9;1;1;1
250838914559;250838914776;217;0,1,2;3;9;1;1;1
250838914776;250838915379;603;0,1,2;3;9;1;1;1
250838915379;250838917128;1749;0,1,2;3;9;1;1;1
250838917128;250838917787;659;0,1,2;3;9;1;1;1
250838917787;250838919316;1529;0,1,2;3;9;1;1;1
250838919316;250838920222;906;0,1,2;3;9;1;1;1
250838920222;250838921383;1161;0,1,2;3;9;1;1;1
250838921383;250838922337;954;0,1,2;3;9;1;1;1
250838922337;250838922435;98;0,1,2;3;9;1;1;1
250838922435;250838922909;474;0,1,2;3;9;1;1;1
250838922909;250838924316;1407;0,1,2;3;9;1;1;1
250838924316;250838924440;124;0,1,2;3;9;1;1;1
250838924440;250838925103;663;0,1,2;3;9;1;1;1
250838925103;250838925503;400;0,1,2;3;9;1;1;1
250838925503;250838926134;631;0,1,2;3;9;1;1;1
250838926134;250838927469;1335;0,1,2;3;9;1;1;1
250838927469;250838928561;1092;0,1,2;3;9;1;1;1
250838928561;250838928890;329;0,1,2;3;9;1;1;1
250838928890;250838929305;415;0,1,2;3;9;1;1;1
250838929305;250838929464;159;0,1,2;3;9;1;1;1
250838929464;250838930193;729;0,1,2;3;9;1;1;1
250838930193;250838930238;45;0,1,2;3;9;1;1;1
250838930238;250838931126;888;0,1,2;3;9;1;1;1
250838931126;250838935510;4384;0,1,2;3;9;1;1;1
250838935510;250838935838;328;0,1,2;3;9;1;1;1
250838935838;250838938875;3037;0,1,2;3;9;1;1;1
250838938875;250838941448;2573;0,1,2;3;9;1;1;1
250838941448;250838941465;17;0,1,2;3;9;1;1;1
250838941465;250838941739;274;0,1,2;3;9;1;1;1
250838941739;250838944148;2409;0,1,2;3;9;1;1;1
250838944148;250838947951;3803;0,1,2;3;9;1;1;1
250838947951;250838948664;713;0,1,2;3;9;1;1;1
250838948664;250838950330;1666;0,1,2;3;9;1;1;1
250838950330;250838951614;1284;0,1,2;3;9;1;1;1
250838951614;250838954028;2414;0,1,2;3;9;1;1;1
250838954028;250838954105;77;0,1,2;3;9;1;1;1
250838954105;250838954456;351;0,1,2;3;9;1;1;1
250838954456;250838954500;44;0,1,2;3;9;1;1;1
250838954500;250838954515;15;0,1,2;3;9;1;1;1
250838954515;250838954734;219;0,1,2;3;9;1;1;1
250838954734;250838954772;38;0,1,2;3;9;1;1;1
250838954772;250838954884;112;0,1,2;3;9;1;1;1
250838954884;250838956217;1333;0,1,2;3;9;1;1;1
250838956217;250838956339;122;0,1,2;3;9;1;1;1
250838956339;250838958629;2290;0,1,2;3;9;1;1;1
250838958629;250838961583;2954;0,1,2;3;9;1;1;1
250838961583;250838963447;1864;0,1,2;3;9;1;1;1
250838963447;250838964439;992;0,1,2;3;9;1;1;1
250838964439;250838966374;1935;0,1,2;3;9;1;1;1
250838966374;250838966482;108;0,1,2;3;9;1;1;1
250838966482;250838966513;31;0,1,2;3;9;1;1;1
250838966513;250838966657;144;0,1,2;3;9;1;1;1
250838966657;250838970099;3442;0,1,2;3;9;1;1;1
250838970099;250838971980;1881;0,1,2;3;9;1;1;1
250838971980;250838972309;329;0,1,2;3;9;1;1;1
250838972309;250838972932;623;0,1,2;3;9;1;1;1
250838972932;250838973866;934;0,1,2;3;9;1;1;1
250838973866;250838973924;58;0,1,2;3;9;1;1;1
250838973924;250838974343;419;0,1,2;3;9;1;1;1
250838974343;250838974795;452;0,1,2;3;9;1;1;1
250838974795;250838980984;6189;0,1,2;3;9;1;1;1
250838980984;250838981948;964;0,1,2;3;9;1;1;1
250838981948;250838983821;1873;0,1,2;3;9;1;1;1
250838983821;250838984141;320;0,1,2;3;9;1;1;1
250838984141;250838985368;1227;0,1,2;3;9;1;1;1
250838985368;250838986366;998;0,1,2;3;9;1;1;1
250838986366;250838986440;74;0,1,2;3;9;1;1;1
250838986440;250838986507;67;0,1,2;3;9;1;1;1
250838986507;250838986595;88;0,1,2;3;9;1;1;1
250838986595;250838987071;476;0,1,2;3;9;1;1;1
250838987071;250838987371;300;0,1,2;3;9;1;1;1
250838987371;250838989193;1822;0,1,2;3;9;1;1;1
250838989193;250838989513;320;0,1,2;3;9;1;1;1
250838989513;250838989655;142;0,1,2;3;9;1;1;1
250838989655;250838994896;5241;0,1,2;3;9;1;1;1
250838994896;250838995767;871;0,1,2;3;9;1;1;1
250838995767;250838995789;22;0,1,2;3;9;1;1;1
250838995789;250838997553;1764;0,1,2;3;9;1;1;1
250838997553;250838998667;1114;0,1,2;3;9;1;1;1
250838998667;250838999222;555;0,1,2;3;9;1;1;1
250838999222;250839000984;1762;0,1,2;3;9;1;1;1
250839000984;250839002656;1672;0,1,2;3;9;1;1;1
250839002656;250839003970;1314;0,1,2;3;9;1;1;1
250839003970;250839004005;35;0,1,2;3;9;1;1;1
250839004005;250839004418;413;0,1,2;3;9;1;1;1
250839004418;250839004771;353;0,1,2;3;9;1;1;1
250839004771;250839006076;1305;0,1,2;3;9;1;1;1
250839006076;250839006630;554;0,1,2;3;9;1;1;1
250839006630;250839007243;613;0,1,2;3;9;1;1;1
250839007243;250839008476;1233;0,1,2;3;9;1;1;1
250839008476;250839010487;2011;0,1,2;3;9;1;1;1
250839010487;250839010640;153;0,1,2;3;9;1;1;1
250839010640;250839012582;1942;0,1,2;3;9;1;1;1
250839012582;250839013013;431;0,1,2;3;9;1;1;1
250839013013;250839013165;152;0,1,2;3;9;1;1;1
250839013165;250839014071;906;0,1,2;3;9;1;1;1
250839014071;250839014339;268;0,1,2;3;9;1;1;1
250839014339;250839014703;364;0,1,2;3;9;1;1;1
250839014703;250839014952;249;0,1,2;3;9;1;1;1
250839014952;250839015516;564;0,1,2;3;9;1;1;1
250839015516;250839015762;246;0,1,2;3;9;1;1;1
250839015762;250839016273;511;0,1,2;3;9;1;1;1
250839016273;250839016325;52;0,1,2;3;9;1;1;1
250839016325;250839016784;459;0,1,2;3;9;1;1;1
250839016784;250839017925;1141;0,1,2;3;9;1;1;1
250839017925;250839018790;865;0,1,2;3;9;1;1;1
250839018790;250839022901;4111;0,1,2;3;9;1;1;1
250839022901;250839024028;1127;0,1,2;3;9;1;1;1
250839024028;250839026113;2085;0,1,2;3;9;1;1;1
250839026113;250839027692;1579;0,1,2;3;9;1;1;1
250839027692;250839027884;192;0,1,2;3;9;1;1;1
250839027884;250839028218;334;0,1,2;3;9;1;1;1
250839028218;250839029574;1356;0,1,2;3;9;1;1;1
250839029574;250839030672;1098;0,1,2;3;9;1;1;1
250839030672;250839031104;432;0,1,2;3;9;1;1;1
250839031104;250839031326;222;0,1,2;3;9;1;1;1
250839031326;250839032341;1015;0,1,2;3;9;1;1;1
250839032341;250839032405;64;0,1,2;3;9;1;1;1
250839032405;250839032440;35;0,1,2;3;9;1;1;1
250839032440;250839033314;874;0,1,2;3;9;1;1;1
250839033314;250839033563;249;0,1,2;3;9;1;1;1
250839033563;250839033980;417;0,1,2;3;9;1;1;1
250839033980;250839034530;550;0,1,2;3;9;1;1;1
250839034530;250839034579;49;0,1,2;3;9;1;1;1
250839034579;250839034689;110;0,1,2;3;9;1;1;1
250839034689;250839034919;230;0,1,2;3;9;1;1;1
250839034919;250839035662;743;0,1,2;3;9;1;1;1
250839035662;250839037143;1481;0,1,2;3;9;1;1;1
250839037143;250839037193;50;0,1,2;3;9;1;1;1
250839037193;250839037677;484;0,1,2;3;9;1;1;1
250839037677;250839037700;23;0,1,2;3;9;1;1;1
250839037700;250839037924;224;0,1,2;3;9;1;1;1
250839037924;250839038051;127;0,1,2;3;9;1;1;1
250839038051;250839038189;138;0,1,2;3;9;1;1;1
250839038189;250839038955;766;0,1,2;3;9;1;1;1
250839038955;250839039060;105;0,1,2;3;9;1;1;1
250839039060;250839039064;4;0,1,2;3;9;1;1;1
250839039064;250839039971;907;0,1,2;3;9;1;1;1
250839039971;250839040807;836;0,1,2;3;9;1;1;1
250839040807;250839042490;1683;0,1,2;3;9;1;1;1
250839042490;250839042502;12;0,1,2;3;9;1;1;1
250839042502;250839043689;1187;0,1,2;3;9;1;1;1
250839043689;250839045327;1638;0,1,2;3;9;1;1;1
250839045327;250839045391;64;0,1,2;3;9;1;1;1
250839045391;250839046952;1561;0,1,2;3;9;1;1;1
250839046952;250839047253;301;0,1,2;3;9;1;1;1
250839047253;250839048505;1252;0,1,2;3;9;1;1;1
250839048505;250839048903;398;0,1,2;3;9;1;1;1
250839048903;250839049856;953;0,1,2;3;9;1;1;1
250839049856;250839050679;823;0,1,2;3;9;1;1;1
250839050679;250839050908;229;0,1,2;3;9;1;1;1
250839050908;250839051510;602;0,1,2;3;9;1;1;1
250839051510;250839052700;1190;0,1,2;3;9;1;1;1
250839052700;250839055523;2823;0,1,2;3;9;1;1;1
250839055523;250839055824;301;0,1,2;3;9;1;1;1
250839055824;250839056018;194;0,1,2;3;9;1;1;1
250839056018;250839057780;1762;0,1,2;3;9;1;1;1
250839057780;250839057801;21;0,1,2;3;9;1;1;1
250839057801;250839057940;139;0,1,2;3;9;1;1;1
250839057940;250839058191;251;0,1,2;3;9;1;1;1
250839058191;250839059329;1138;0,1,2;3;9;1;1;1
250839059329;250839063211;3882;0,1,2;3;9;1;1;1
250839063211;250839064755;1544;0,1,2;3;9;1;1;1
250839064755;250839065215;460;0,1,2;3;9;1;1;1
250839065215;250839065389;174;0,1,2;3;9;1;1;1
250839065389;250839065888;499;0,1,2;3;9;1;1;1
250839065888;250839066471;583;0,1,2;3;9;1;1;1
250839066471;250839067295;824;0,1,2;3;9;1;1;1
250839067295;250839067392;97;0,1,2;3;9;1;1;1
250839067392;250839067743;351;0,1,2;3;9;1;1;1
250839067743;250839067794;51;0,1,2;3;9;1;1;1
250839067794;250839073307;5513;0,1,2;3;9;1;1;1
250839073307;250839073841;534;0,1,2;3;9;1;1;1
250839073841;250839078179;4338;0,1,2;3;9;1;1;1
250839078179;250839078551;372;0,1,2;3;9;1;1;1
250839078551;250839079757;1206;0,1,2;3;9;1;1;1
250839079757;250839079796;39;0,1,2;3;9;1;1;1
250839079796;250839080215;419;0,1,2;3;9;1;1;1
250839080215;250839081438;1223;0,1,2;3;9;1;1;1
250839081438;250839084023;2585;0,1,2;3;9;1;1;1
250839084023;250839085095;1072;0,1,2;3;9;1;1;1
250839085095;250839087305;2210;0,1,2;3;9;1;1;1
250839087305;250839087448;143;0,1,2;3;9;1;1;1
250839087448;250839087532;84;0,1,2;3;9;1;1;1
250839087532;250839089124;1592;0,1,2;3;9;1;1;1
250839089124;250839091098;1974;0,1,2;3;9;1;1;1
250839091098;250839091766;668;0,1,2;3;9;1;1;1
250839091766;250839092478;712;0,1,2;3;9;1;1;1
250839092478;250839092638;160;0,1,2;3;9;1;1;1
250839092638;250839093137;499;0,1,2;3;9;1;1;1
250839093137;250839096400;3263;0,1,2;3;9;1;1;1
250839096400;250839097374;974;0,1,2;3;9;1;1;1
250839097374;250839099079;1705;0,1,2;3;9;1;1;1
250839099079;250839099748;669;0,1,2;3;9;1;1;1
250839099748;250839101635;1887;0,1,2;3;9;1;1;1
250839101635;250839104642;3007;0,1,2;3;9;1;1;1
250839104642;250839106818;2176;0,1,2;3;9;1;1;1
250839106818;250839107300;482;0,1,2;3;9;1;1;1
250839107300;250839109777;2477;0,1,2;3;9;1;1;1
250839109777;250839110950;1173;0,1,2;3;9;1;1;1
250839110950;250839112499;1549;0,1,2;3;9;1;1;1
250839112499;250839115821;3322;0,1,2;3;9;1;1;1
250839115821;250839115926;105;0,1,2;3;9;1;1;1
250839115926;250839116197;271;0,1,2;3;9;1;1;1
250839116197;250839116319;122;0,1,2;3;9;1;1;1
250839116319;250839117238;919;0,1,2;3;9;1;1;1
250839117238;250839118145;907;0,1,2;3;9;1;1;1
250839118145;250839120155;2010;0,1,2;3;9;1;1;1
250839120155;250839121182;1027;0,1,2;3;9;1;1;1
250839121182;250839121232;50;0,1,2;3;9;1;1;1
250839121232;250839121390;158;0,1,2;3;9;1;1;1
250839121390;250839122894;1504;0,1,2;3;9;1;1;1
250839122894;250839123725;831;0,1,2;3;9;1;1;1
250839123725;250839124711;986;0,1,2;3;9;1;1;1
250839124711;250839125381;670;0,1,2;3;9;1;1;1
250839125381;250839127117;1736;0,1,2;3;9;1;1;1
250839127117;250839127552;435;0,1,2;3;9;1;1;1
250839127552;250839128327;775;0,1,2;3;9;1;1;1
250839128327;250839129282;955;0,1,2;3;9;1;1;1
250839129282;250839130448;1166;0,1,2;3;9;1;1;1
250839130448;250839132093;1645;0,1,2;3;9;1;1;1
250839132093;250839133778;1685;0,1,2;3;9;1;1;1
250839133778;250839135033;1255;0,1,2;3;9;1;1;1
250839135033;250839135071;38;0,1,2;3;9;1;1;1
250839135071;250839137106;2035;0,1,2;3;9;1;1;1
250839137106;250839137349;243;0,1,2;3;9;1;1;1
250839137349;250839138333;984;0,1,2;3;9;1;1;1
250839138333;250839140771;2438;0,1,2;3;9;1;1;1
250839140771;250839141118;347;0,1,2;3;9;1;1;1
250839141118;250839141440;322;0,1,2;3;9;1;1;1
250839141440;250839144982;3542;0,1,2;3;9;1;1;1
250839144982;250839145322;340;0,1,2;3;9;1;1;1
250839145322;250839147480;2158;0,1,2;3;9;1;1;1
250839147480;250839147537;57;0,1,2;3;9;1;1;1
250839147537;250839150426;2889;0,1,2;3;9;1;1;1
250839150426;250839150859;433;0,1,2;3;9;1;1;1
250839150859;250839151361;502;0,1,2;3;9;1;1;1
250839151361;250839152493;1132;0,1,2;3;9;1;1;1
250839152493;250839152883;390;0,1,2;3;9;1;1;1
250839152883;250839152955;72;0,1,2;3;9;1;1;1
250839152955;250839156591;3636;0,1,2;3;9;1;1;1
250839156591;250839157807;1216;0,1,2;3;9;1;1;1
250839157807;250839159955;2148;0,1,2;3;9;1;1;1
250839159955;250839162380;2425;0,1,2;3;9;1;1;1
250839162380;250839165388;3008;0,1,2;3;9;1;1;1
250839165388;250839169716;4328;0,1,2;3;9;1;1;1
250839169716;250839173302;3586;0,1,2;3;9;1;1;1
250839173302;250839178837;5535;0,1,2;3;9;1;1;1
250839178837;250839179447;610;0,1,2;3;9;1;1;1
250839179447;250839182091;2644;0,1,2;3;9;1;1;1
250839182091;250839183246;1155;0,1,2;3;9;1;1;1
250839183246;250839186693;3447;0,1,2;3;9;1;1;1
250839186693;250839190541;3848;0,1,2;3;9;1;1;1
250839190541;250839191132;591;0,1,2;3;9;1;1;1
250839191132;250839192592;1460;0,1,2;3;9;1;1;1
250839192592;250839192960;368;0,1,2;3;9;1;1;1
250839192960;250839198561;5601;0,1,2;3;9;1;1;1
250839198561;250839199845;1284;0,1,2;3;9;1;1;1
250839199845;250839199960;115;0,1,2;3;9;1;1;1
250839199960;250839201556;1596;0,1,2;3;9;1;1;1
250839201556;250839202095;539;0,1,2;3;9;1;1;1
250839202095;250839202402;307;0,1,2;3;9;1;1;1
250839202402;250839202862;460;0,1,2;3;9;1;1;1
250839202862;250839203272;410;0,1,2;3;9;1;1;1
250839203272;250839203412;140;0,1,2;3;9;1;1;1
250839203412;250839203827;415;0,1,2;3;9;1;1;1
250839203827;250839205016;1189;0,1,2;3;9;1;1;1
250839205016;250839206634;1618;0,1,2;3;9;1;1;1
250839206634;250839208170;1536;0,1,2;3;9;1;1;1
250839208170;250839208538;368;0,1,2;3;9;1;1;1
250839208538;250839209460;922;0,1,2;3;9;1;1;1
250839209460;250839210874;1414;0,1,2;3;9;1;1;1
250839210874;250839211534;660;0,1,2;3;9;1;1;1
250839211534;250839211781;247;0,1,2;3;9;1;1;1
250839211781;250839212047;266;0,1,2;3;9;1;1;1
250839212047;250839212750;703;0,1,2;3;9;1;1;1
250839212750;250839213806;1056;0,1,2;3;9;1;1;1
250839213806;250839214106;300;0,1,2;3;9;1;1;1
250839214106;250839214703;597;0,1,2;3;9;1;1;1
250839214703;250839216340;1637;0,1,2;3;9;1;1;1
250839216340;250839216448;108;0,1,2;3;9;1;1;1
250839216448;250839217937;1489;0,1,2;3;9;1;1;1
250839217937;250839222470;4533;0,1,2;3;9;1;1;1
250839222470;250839229246;6776;0,1,2;3;9;1;1;1
250839229246;250839233318;4072;0,1,2;3;9;1;1;1
250839233318;250839233814;496;0,1,2;3;9;1;1;1
250839233814;250839237476;3662;0,1,2;3;9;1;1;1
250839237476;250839237543;67;0,1,2;3;9;1;1;1
250839237543;250839239605;2062;0,1,2;3;9;1;1;1
250839239605;250839241190;1585;0,1,2;3;9;1;1;1
250839241190;250839241723;533;0,1,2;3;9;1;1;1
250839241723;250839241745;22;0,1,2;3;9;1;1;1
250839241745;250839243046;1301;0,1,2;3;9;1;1;1
250839243046;250839244521;1475;0,1,2;3;9;1;1;1
250839244521;250839244649;128;0,1,2;3;9;1;1;1
250839244649;250839245789;1140;0,1,2;3;9;1;1;1
250839245789;250839245823;34;0,1,2;3;9;1;1;1
250839245823;250839245878;55;0,1,2;3;9;1;1;1
250839245878;250839246618;740;0,1,2;3;9;1;1;1
250839246618;250839250636;4018;0,1,2;3;9;1;1;1
250839250636;250839250667;31;0,1,2;3;9;1;1;1
250839250667;250839250749;82;0,1,2;3;9;1;1;1
250839250749;250839251929;1180;0,1,2;3;9;1;1;1
250839251929;250839255401;3472;0,1,2;3;9;1;1;1
250839255401;250839256734;1333;0,1,2;3;9;1;1;1
250839256734;250839257959;1225;0,1,2;3;9;1;1;1
250839257959;250839258592;633;0,1,2;3;9;1;1;1
250839258592;250839266625;8033;0,1,2;3;9;1;1;1
250839266625;250839270931;4306;0,1,2;3;9;1;1;1
250839270931;250839271268;337;0,1,2;3;9;1;1;1
250839271268;250839271725;457;0,1,2;3;9;1;1;1
250839271725;250839272992;1267;0,1,2;3;9;1;1;1
250839272992;250839275950;2958;0,1,2;3;9;1;1;1
250839275950;250839277850;1900;0,1,2;3;9;1;1;1
250839277850;250839279695;1845;0,1,2;3;9;1;1;1
250839279695;250839281366;1671;0,1,2;3;9;1;1;1
250839281366;250839284217;2851;0,1,2;3;9;1;1;1
250839284217;250839284502;285;0,1,2;3;9;1;1;1
250839284502;250839290773;6271;0,1,2;3;9;1;1;1
250839290773;250839292124;1351;0,1,2;3;9;1;1;1
250839292124;250839292281;157;0,1,2;3;9;1;1;1
250839292281;250839294774;2493;0,1,2;3;9;1;1;1
250839294774;250839299075;4301;0,1,2;3;9;1;1;1
250839299075;250839300918;1843;0,1,2;3;9;1;1;1
250839300918;250839302106;1188;0,1,2;3;9;1;1;1
250839302106;250839302206;100;0,1,2;3;9;1;1;1
250839302206;250839302572;366;0,1,2;3;9;1;1;1
250839302572;250839303924;1352;0,1,2;3;9;1;1;1
250839303924;250839303980;56;0,1,2;3;9;1;1;1
250839303980;250839304771;791;0,1,2;3;9;1;1;1
250839304771;250839306502;1731;0,1,2;3;9;1;1;1
250839306502;250839306894;392;0,1,2;3;9;1;1;1
250839306894;250839307145;251;0,1,2;3;9;1;1;1
250839307145;250839309089;1944;0,1,2;3;9;1;1;1
250839309089;250839309128;39;0,1,2;3;9;1;1;1
250839309128;250839310414;1286;0,1,2;3;9;1;1;1
250839310414;250839313364;2950;0,1,2;3;9;1;1;1
250839313364;250839315072;1708;0,1,2;3;9;1;1;1
250839315072;250839315572;500;0,1,2;3;9;1;1;1
250839315572;250839316818;1246;0,1,2;3;9;1;1;1
250839316818;250839319720;2902;0,1,2;3;9;1;1;1
250839319720;250839319781;61;0,1,2;3;9;1;1;1
250839319781;250839322590;2809;0,1,2;3;9;1;1;1
250839322590;250839326406;3816;0,1,2;3;9;1;1;1
250839326406;250839328982;2576;0,1,2;3;9;1;1;1
250839328982;250839329853;871;0,1,2;3;9;1;1;1
250839329853;250839332419;2566;0,1,2;3;9;1;1;1
250839332419;250839332450;31;0,1,2;3;9;1;1;1
250839332450;250839334390;1940;0,1,2;3;9;1;1;1
250839334390;250839337380;2990;0,1,2;3;9;1;1;1
250839337380;250839338705;1325;0,1,2;3;9;1;1;1
250839338705;250839340129;1424;0,1,2;3;9;1;1;1
250839340129;250839342328;2199;0,1,2;3;9;1;1;1
250839342328;250839346748;4420;0,1,2;3;9;1;1;1
250839346748;250839347760;1012;0,1,2;3;9;1;1;1
250839347760;250839353343;5583;0,1,2;3;9;1;1;1
250839353343;250839356720;3377;0,1,2;3;9;1;1;1
250839356720;250839361430;4710;0,1,2;3;9;1;1;1
250839361430;250839362440;1010;0,1,2;3;9;1;1;1
250839362440;250839363237;797;0,1,2;3;9;1;1;1
250839363237;250839364716;1479;0,1,2;3;9;1;1;1
250839364716;250839368364;3648;0,1,2;3;9;1;1;1
250839368364;250839369132;768;0,1,2;3;9;1;1;1
250839369132;250839369500;368;0,1,2;3;9;1;1;1
250839369500;250839370164;664;0,1,2;3;9;1;1;1
250839370164;250839371174;1010;0,1,2;3;9;1;1;1
250839371174;250839371425;251;0,1,2;3;9;1;1;1
250839371425;250839371885;460;0,1,2;3;9;1;1;1
250839371885;250839373535;1650;0,1,2;3;9;1;1;1
250839373535;250839377089;3554;0,1,2;3;9;1;1;1
250839377089;250839377253;164;0,1,2;3;9;1;1;1
250839377253;250839377800;547;0,1,2;3;9;1;1;1
250839377800;250839378231;431;0,1,2;3;9;1;1;1
250839378231;250839378624;393;0,1,2;3;9;1;1;1
250839378624;250839379678;1054;0,1,2;3;9;1;1;1
250839379678;250839379866;188;0,1,2;3;9;1;1;1
250839379866;250839383090;3224;0,1,2;3;9;1;1;1
250839383090;250839383346;256;0,1,2;3;9;1;1;1
250839383346;250839384101;755;0,1,2;3;9;1;1;1
250839384101;250839384366;265;0,1,2;3;9;1;1;1
250839384366;250839385471;1105;0,1,2;3;9;1;1;1
250839385471;250839390876;5405;0,1,2;3;9;1;1;1
250839390876;250839394505;3629;0,1,2;3;9;1;1;1
250839394505;250839394826;321;0,1,2;3;9;1;1;1
250839394826;250839395430;604;0,1,2;3;9;1;1;1
250839395430;250839395622;192;0,1,2;3;9;1;1;1
250839395622;250839405123;9501;0,1,2;3;9;1;1;1
250839405123;250839406584;1461;0,1,2;3;9;1;1;1
250839406584;250839412993;6409;0,1,2;3;9;1;1;1
250839412993;250839413307;314;0,1,2;3;9;1;1;1
250839413307;250839414668;1361;0,1,2;3;9;1;1;1
250839414668;250839419037;4369;0,1,2;3;9;1;1;1
250839419037;250839426187;7150;0,1,2;3;9;1;1;1
250839426187;250839426832;645;0,1,2;3;9;1;1;1
250839426832;250839428594;1762;0,1,2;3;9;1;1;1
250839428594;250839441252;12658;0,1,2;3;9;1;1;1
250839441252;250839441574;322;0,1,2;3;9;1;1;1
250839441574;250839447471;5897;0,1,2;3;9;1;1;1
250839447471;250839448259;788;0,1,2;3;9;1;1;1
250839448259;250839448375;116;0,1,2;3;9;1;1;1
250839448375;250839448553;178;0,1,2;3;9;1;1;1
250839448553;250839448588;35;0,1,2;3;9;1;1;1
250839448588;250839454225;5637;0,1,2;3;9;1;1;1
250839454225;250839455950;1725;0,1,2;3;9;1;1;1
250839455950;250839458750;2800;0,1,2;3;9;1;1;1
250839458750;250839460260;1510;0,1,2;3;9;1;1;1
250839460260;250839464506;4246;0,1,2;3;9;1;1;1
250839464506;250839464535;29;0,1,2;3;9;1;1;1
250839464535;250839464557;22;0,1,2;3;9;1;1;1
250839464557;250839464739;182;0,1,2;3;9;1;1;1
250839464739;250839465980;1241;0,1,2;3;9;1;1;1
250839465980;250839467058;1078;0,1,2;3;9;1;1;1
250839467058;250839467505;447;0,1,2;3;9;1;1;1
250839467505;250839468365;860;0,1,2;3;9;1;1;1
250839468365;250839471857;3492;0,1,2;3;9;1;1;1
250839471857;250839473314;1457;0,1,2;3;9;1;1;1
250839473314;250839473803;489;0,1,2;3;9;1;1;1
250839473803;250839475622;1819;0,1,2;3;9;1;1;1
250839475622;250839476372;750;0,1,2;3;9;1;1;1
250839476372;250839481255;4883;0,1,2;3;9;1;1;1
250839481255;250839482351;1096;0,1,2;3;9;1;1;1
250839482351;250839482862;511;0,1,2;3;9;1;1;1
250839482862;250839485831;2969;0,1,2;3;9;1;1;1
250839485831;250839486343;512;0,1,2;3;9;1;1;1
250839486343;250839489862;3519;0,1,2;3;9;1;1;1
250839489862;250839491505;1643;0,1,2;3;9;1;1;1
250839491505;250839494415;2910;0,1,2;3;9;1;1;1
250839494415;250839495520;1105;0,1,2;3;9;1;1;1
250839495520;250839496119;599;0,1,2;3;9;1;1;1
250839496119;250839497391;1272;0,1,2;3;9;1;1;1
250839497391;250839497447;56;0,1,2;3;9;1;1;1
250839497447;250839499334;1887;0,1,2;3;9;1;1;1
250839499334;250839503095;3761;0,1,2;3;9;1;1;1
250839503095;250839503834;739;0,1,2;3;9;1;1;1
250839503834;250839504260;426;0,1,2;3;9;1;1;1
250839504260;250839504997;737;0,1,2;3;9;1;1;1
250839504997;250839511441;6444;0,1,2;3;9;1;1;1
250839511441;250839511552;111;0,1,2;3;9;1;1;1
250839511552;250839516186;4634;0,1,2;3;9;1;1;1
250839516186;250839516359;173;0,1,2;3;9;1;1;1
250839516359;250839519052;2693;0,1,2;3;9;1;1;1
250839519052;250839520514;1462;0,1,2;3;9;1;1;1
250839520514;250839520821;307;0,1,2;3;9;1;1;1
250839520821;250839528216;7395;0,1,2;3;9;1;1;1
250839528216;250839529003;787;0,1,2;3;9;1;1;1
250839529003;250839530223;1220;0,1,2;3;9;1;1;1
250839530223;250839530738;515;0,1,2;3;9;1;1;1
250839530738;250839532477;1739;0,1,2;3;9;1;1;1
250839532477;250839537284;4807;0,1,2;3;9;1;1;1
250839537284;250839538132;848;0,1,2;3;9;1;1;1
250839538132;250839546747;8615;0,1,2;3;9;1;1;1
250839546747;250839559991;13244;0,1,2;3;9;1;1;1
250839559991;250839560884;893;0,1,2;3;9;1;1;1
250839560884;250839582362;21478;0,1,2;3;9;1;1;1
250839582362;250839586887;4525;0,1,2;3;9;1;1;1
250839586887;250839587561;674;0,1,2;3;9;1;1;1
250839587561;250839593435;5874;0,1,2;3;9;1;1;1
250839593435;250839598173;4738;0,1,2;3;9;1;1;1
250839598173;250839603179;5006;0,1,2;3;9;1;1;1
250839603179;250839603549;370;0,1,2;3;9;1;1;1
250839603549;250839607268;3719;0,1,2;3;9;1;1;1
250839607268;250839613750;6482;0,1,2;3;9;1;1;1
250839613750;250839613898;148;0,1,2;3;9;1;1;1
250839613898;250839618468;4570;0,1,2;3;9;1;1;1
250839618468;250839627065;8597;0,1,2;3;9;1;1;1
250839627065;250839628416;1351;0,1,2;3;9;1;1;1
250839628416;250839628437;21;0,1,2;3;9;1;1;1
250839628437;250839642102;13665;0,1,2;3;9;1;1;1
250839642102;250839644066;1964;0,1,2;3;9;1;1;1
250839644066;250839645598;1532;0,1,2;3;9;1;1;1
250839645598;250839653580;7982;0,1,2;3;9;1;1;1
250839653580;250839655619;2039;0,1,2;3;9;1;1;1
250839655619;250839657570;1951;0,1,2;3;9;1;1;1
250839657570;250839663920;6350;0,1,2;3;9;1;1;1
250839663920;250839665365;1445;0,1,2;3;9;1;1;1
250839665365;250839666092;727;0,1,2;3;9;1;1;1
250839666092;250839667785;1693;0,1,2;3;9;1;1;1
250839667785;250839668008;223;0,1,2;3;9;1;1;1
250839668008;250839668070;62;0,1,2;3;9;1;1;1
250839668070;250839671101;3031;0,1,2;3;9;1;1;1
250839671101;250839674514;3413;0,1,2;3;9;1;1;1
250839674514;250839675342;828;0,1,2;3;9;1;1;1
250839675342;250839676400;1058;0,1,2;3;9;1;1;1
250839676400;250839676663;263;0,1,2;3;9;1;1;1
250839676663;250839682454;5791;0,1,2;3;9;1;1;1
250839682454;250839683659;1205;0,1,2;3;9;1;1;1
250839683659;250839685137;1478;0,1,2;3;9;1;1;1
250839685137;250839686237;1100;0,1,2;3;9;1;1;1
250839686237;250839688273;2036;0,1,2;3;9;1;1;1
250839688273;250839689199;926;0,1,2;3;9;1;1;1
250839689199;250839689459;260;0,1,2;3;9;1;1;1
250839689459;250839689541;82;0,1,2;3;9;1;1;1
250839689541;250839690400;859;0,1,2;3;9;1;1;1
250839690400;250839690405;5;0,1,2;3;9;1;1;1
250839690405;250839690536;131;0,1,2;3;9;1;1;1
250839690536;250839691450;914;0,1,2;3;9;1;1;1
250839691450;250839692287;837;0,1,2;3;9;1;1;1
250839692287;250839696257;3970;0,1,2;3;9;1;1;1
250839696257;250839697652;1395;0,1,2;3;9;1;1;1
250839697652;250839699667;2015;0,1,2;3;9;1;1;1
250839699667;250839700815;1148;0,1,2;3;9;1;1;1
250839700815;250839701387;572;0,1,2;3;9;1;1;1
250839701387;250839703238;1851;0,1,2;3;9;1;1;1
250839703238;250839708148;4910;0,1,2;3;9;1;1;1
250839708148;250839713952;5804;0,1,2;3;9;1;1;1
250839713952;250839714454;502;0,1,2;3;9;1;1;1
250839714454;250839726186;11732;0,1,2;3;9;1;1;1
250839726186;250839735477;9291;0,1,2;3;9;1;1;1
250839735477;250839740127;4650;0,1,2;3;9;1;1;1
250839740127;250839757464;17337;0,1,2;3;9;1;1;1
250839757464;250839768081;10617;0,1,2;3;9;1;1;1
250839768081;250839768230;149;0,1,2;3;9;1;1;1
250839768230;250839777820;9590;0,1,2;3;9;1;1;1
250839777820;250839819795;41975;0,1,2;3;9;1;1;1
250839819795;250839838742;18947;0,1,2;3;9;1;1;1
250839838742;250839850815;12073;0,1,2;3;9;1;1;1
250839850815;250839852494;1679;0,1,2;3;9;1;1;1
250839852494;250839866657;14163;0,1,2;3;9;1;1;1
250839866657;250839868989;2332;0,1,2;3;9;1;1;1
250839868989;250839872167;3178;0,1,2;3;9;1;1;1
250839872167;250839881116;8949;0,1,2;3;9;1;1;1
250839881116;250839889166;8050;0,1,2;3;9;1;1;1
250839889166;250839900094;10928;0,1,2;3;9;1;1;1
250839900094;250839909062;8968;0,1,2;3;9;1;1;1
250839909062;250839910556;1494;0,1,2;3;9;1;1;1
250839910556;250839914472;3916;0,1,2;3;9;1;1;1
250839914472;250839917854;3382;0,1,2;3;9;1;1;1
250839917854;250839921661;3807;0,1,2;3;9;1;1;1
250839921661;250839934318;12657;0,1,2;3;9;1;1;1
250839934318;250839955554;21236;0,1,2;3;9;1;1;1
250839955554;250839964807;9253;0,1,2;3;9;1;1;1
250839964807;250839966715;1908;0,1,2;3;9;1;1;1
250839966715;250839990267;23552;0,1,2;3;9;1;1;1
250839990267;250839991777;1510;0,1,2;3;9;1;1;1
250839991777;250839996746;4969;0,1,2;3;9;1;1;1
250839996746;250839997057;311;0,1,2;3;9;1;1;1
250839997057;250840029353;32296;0,1,2;3;9;1;1;1
250840029353;250840054580;25227;0,1,2;3;9;1;1;1
250840054580;250840068392;13812;0,1,2;3;9;1;1;1
250840068392;250840072254;3862;0,1,2;3;9;1;1;1
250840072254;250840082401;10147;0,1,2;3;9;1;1;1
250840082401;250840085941;3540;0,1,2;3;9;1;1;1
250840085941;250840115872;29931;0,1,2;3;9;1;1;1
250840115872;250840129649;13777;0,1,2;3;9;1;1;1
250840129649;250840137969;8320;0,1,2;3;9;1;1;1
250840137969;250840138197;228;0,1,2;3;9;1;1;1
250840138197;250840152954;14757;0,1,2;3;9;1;1;1
250840152954;250840164185;11231;0,1,2;3;9;1;1;1
250840164185;250840165138;953;0,1,2;3;9;1;1;1
250840165138;250840171301;6163;0,1,2;3;9;1;1;1
250840171301;250840187012;15711;0,1,2;3;9;1;1;1
250840187012;250840192705;5693;0,1,2;3;9;1;1;1
250840192705;250840207111;14406;0,1,2;3;9;1;1;1
250840207111;250840209814;2703;0,1,2;3;9;1;1;1
250840209814;250840253995;44181;1,2;2;9;1;1;1
250840253995;250840268714;14719;0,1,2;3;9;1;1;1
250840268714;250840416041;147327;1,2;2;9;1;1;1
250840416041;250840431763;15722;0,1,2;3;9;1;1;1
250840431763;250840550538;118775;1,2;2;9;1;1;1
250840550538;250840673655;123117;0,1,2;3;9;1;1;1
250840673655;250841128505;454850;1,2;2;9;1;1;1
250841128505;250841177998;49493;0,1,2;3;9;1;1;1
250841177998;250843806437;2628439;1,2;2;9;1;1;1
250843806437;250851884377;8077940;1,2;2;9;1;1;1
250851884377;250868142284;16257907;1,2;2;9;1;1;1
250868142284;250868164173;21889;0,1,2;3;9;1;1;1
250868164173;250868169579;5406;0,1,2;3;9;1;1;1
250868169579;250868181173;11594;0,1,2;3;9;1;1;1
250868181173;250868181611;438;0,1,2;3;9;1;1;1
250868181611;250868199420;17809;0,1,2;3;9;1;1;1
250868199420;250868199466;46;0,1,2;3;9;1;1;1
250868199466;250868211445;11979;0,1,2;3;9;1;1;1
250868211445;250868217583;6138;0,1,2;3;9;1;1;1
250868217583;250868219888;2305;0,1,2;3;9;1;1;1
250868219888;250868228197;8309;0,1,2;3;9;1;1;1
250868228197;250868239441;11244;0,1,2;3;9;1;1;1
250868239441;250868246185;6744;0,1,2;3;9;1;1;1
250868246185;250868246259;74;0,1,2;3;9;1;1;1
250868246259;250868246294;35;0,1,2;3;9;1;1;1
250868246294;250868255546;9252;0,1,2;3;9;1;1;1
250868255546;250868264356;8810;0,1,2;3;9;1;1;1
250868264356;250868269709;5353;0,1,2;3;9;1;1;1
250868269709;250868276486;6777;0,1,2;3;9;1;1;1
250868276486;250868281961;5475;0,1,2;3;9;1;1;1
250868281961;250868289360;7399;0,1,2;3;9;1;1;1
250868289360;250868296549;7189;0,1,2;3;9;1;1;1
250868296549;250868298630;2081;1,2;2;9;1;1;1
250868298630;250868311866;13236;0,1,2;3;9;1;1;1
250868311866;250868342313;30447;1,2;2;9;1;1;1
250868342313;250868355676;13363;0,1,2;3;9;1;1;1
250868355676;250868385394;29718;1,2;2;9;1;1;1
250868385394;250868392665;7271;0,1,2;3;9;1;1;1
250868392665;250868400571;7906;1,2;2;9;1;1;1
250868400571;250868428048;27477;0,1,2;3;9;1;1;1
250868428048;250868432996;4948;1,2;2;9;1;1;1
250868432996;250868443312;10316;0,1,2;3;9;1;1;1
250868443312;250868477241;33929;1,2;2;9;1;1;1
250868477241;250868486387;9146;0,1,2;3;9;1;1;1
250868486387;250868515011;28624;1,2;2;9;1;1;1
250868515011;250868522878;7867;0,1,2;3;9;1;1;1
250868522878;250868524566;1688;1,2;2;9;1;1;1
250868524566;250868532361;7795;0,1,2;3;9;1;1;1
250868532361;250868533654;1293;0,1,2;3;9;1;1;1
250868533654;250868565835;32181;1,2;2;9;1;1;1
250868565835;250868574074;8239;0,1,2;3;9;1;1;1
250868574074;250868682769;108695;1,2;2;9;1;1;1
250868682769;250868702007;19238;0,1,2;3;9;1;1;1
250868702007;250868761170;59163;1,2;2;9;1;1;1
250868761170;250868761804;634;0,1,2;3;9;1;1;1
250868761804;250868771336;9532;0,1,2;3;9;1;1;1
250868771336;250868779235;7899;0,1,2;3;9;1;1;1
250868779235;250868831865;52630;1,2;2;9;1;1;1
250868831865;250868846848;14983;0,1,2;3;9;1;1;1
250868846848;250868850394;3546;1,2;2;9;1;1;1
250868850394;250868850915;521;0,1,2;3;9;1;1;1
250868850915;250868861140;10225;0,1,2;3;9;1;1;1
250868861140;250868861179;39;0,1,2;3;9;1;1;1
250868861179;250868894133;32954;1,2;2;9;1;1;1
250868894133;250868905428;11295;0,1,2;3;9;1;1;1
250868905428;250868909900;4472;1,2;2;9;1;1;1
250868909900;250868909957;57;0,1,2;3;9;1;1;1
250868909957;250868918872;8915;0,1,2;3;9;1;1;1
250868918872;250868921242;2370;0,1,2;3;9;1;1;1
250868921242;250868954248;33006;1,2;2;9;1;1;1
250868954248;250868961738;7490;0,1,2;3;9;1;1;1
250868961738;250868994918;33180;1,2;2;9;1;1;1
250868994918;250869002469;7551;0,1,2;3;9;1;1;1
250869002469;250869053192;50723;1,2;2;9;1;1;1
250869053192;250869061260;8068;0,1,2;3;9;1;1;1
250869061260;250869061899;639;0,1,2;3;9;1;1;1
250869061899;250869080437;18538;0,1,2;3;9;1;1;1
250869080437;250869089696;9259;0,1,2;3;9;1;1;1
250869089696;250869092962;3266;0,1,2;3;9;1;1;1
250869092962;250869141810;48848;1,2;2;9;1;1;1
250869141810;250869145815;4005;0,1,2;3;9;1;1;1
250869145815;250869151525;5710;0,1,2;3;9;1;1;1
250869151525;250869156792;5267;0,1,2;3;9;1;1;1
250869156792;250869225099;68307;1,2;2;9;1;1;1
250869225099;250869233314;8215;0,1,2;3;9;1;1;1
250869233314;250869278915;45601;1,2;2;9;1;1;1
250869278915;250869289691;10776;0,1,2;3;9;1;1;1
250869289691;250869330381;40690;1,2;2;9;1;1;1
250869330381;250869339070;8689;0,1,2;3;9;1;1;1
250869339070;250869340001;931;0,1,2;3;9;1;1;1
250869340001;250869353360;13359;0,1,2;3;9;1;1;1
250869353360;250869363499;10139;1,2;2;9;1;1;1
250869363499;250869373062;9563;0,1,2;3;9;1;1;1
250869373062;250869386241;13179;1,2;2;9;1;1;1
250869386241;250869392015;5774;0,1,2;3;9;1;1;1
250869392015;250869397473;5458;0,1,2;3;9;1;1;1
250869397473;250869401902;4429;0,1,2;3;9;1;1;1
250869401902;250869404498;2596;0,1,2;3;9;1;1;1
250869404498;250869414460;9962;0,1,2;3;9;1;1;1
250869414460;250869416299;1839;0,1,2;3;9;1;1;1
250869416299;250869416372;73;0,1,2;3;9;1;1;1
250869416372;250869418008;1636;0,1,2;3;9;1;1;1
250869418008;250869423713;5705;0,1,2;3;9;1;1;1
250869423713;250869428256;4543;0,1,2;3;9;1;1;1
250869428256;250869431990;3734;0,1,2;3;9;1;1;1
250869431990;250869434326;2336;0,1,2;3;9;1;1;1
250869434326;250869442030;7704;0,1,2;3;9;1;1;1
250869442030;250869464702;22672;1,2;2;9;1;1;1
250869464702;250869474534;9832;0,1,2;3;9;1;1;1
250869474534;250869480567;6033;1,2;2;9;1;1;1
250869480567;250869480987;420;0,1,2;3;9;1;1;1
250869480987;250869495114;14127;0,1,2;3;9;1;1;1
250869495114;250869496200;1086;0,1,2;3;9;1;1;1
250869496200;250869501687;5487;0,1,2;3;9;1;1;1
250869501687;250869509515;7828;0,1,2;3;9;1;1;1
250869509515;250869536395;26880;0,1,2;3;9;1;1;1
250869536395;250869561579;25184;0,1,2;3;9;1;1;1
250869561579;250869574415;12836;0,1,2;3;9;1;1;1
250869574415;250869650750;76335;0,1,2;3;9;1;1;1
250869650750;250869724747;73997;1,2;2;9;1;1;1
250869724747;250869728510;3763;0,1,2;3;9;1;1;1
250869728510;250869729733;1223;0,1,2;3;9;1;1;1
250869729733;250869735936;6203;0,1,2;3;9;1;1;1
250869735936;250869738581;2645;0,1,2;3;9;1;1;1
250869738581;250869741769;3188;0,1,2;3;9;1;1;1
250869741769;250869777847;36078;1,2;2;9;1;1;1
250869777847;250869787555;9708;0,1,2;3;9;1;1;1
250869787555;250869787665;110;0,1,2;3;9;1;1;1
250869787665;250869801481;13816;0,1,2;3;9;1;1;1
250869801481;250869802056;575;1,2;2;9;1;1;1
250869802056;250869816697;14641;0,1,2;3;9;1;1;1
250869816697;250869833276;16579;1,2;2;9;1;1;1
250869833276;250869845581;12305;0,1,2;3;9;1;1;1
250869845581;250869888867;43286;1,2;2;9;1;1;1
250869888867;250869918795;29928;0,1,2;3;9;1;1;1
250869918795;250869935345;16550;0,1,2;3;9;1;1;1
250869935345;250869974910;39565;0,1,2;3;9;1;1;1
250869974910;250869982028;7118;1,2;2;9;1;1;1
250869982028;250869994881;12853;0,1,2;3;9;1;1;1
250869994881;250869999679;4798;1,2;2;9;1;1;1
250869999679;250870018914;19235;0,1,2;3;9;1;1;1
250870018914;250870042699;23785;1,2;2;9;1;1;1
250870042699;250870057933;15234;0,1,2;3;9;1;1;1
250870057933;250870066773;8840;1,2;2;9;1;1;1
250870066773;250870071125;4352;0,1,2;3;9;1;1;1
250870071125;250870080554;9429;1,2;2;9;1;1;1
250870080554;250870107374;26820;0,1,2;3;9;1;1;1
250870107374;250870111414;4040;1,2;2;9;1;1;1
250870111414;250870121468;10054;0,1,2;3;9;1;1;1
250870121468;250870144514;23046;1,2;2;9;1;1;1
250870144514;250870153438;8924;0,1,2;3;9;1;1;1
250870153438;250870158076;4638;0,1,2;3;9;1;1;1
250870158076;250870161731;3655;0,1,2;3;9;1;1;1
250870161731;250870167304;5573;1,2;2;9;1;1;1
250870167304;250870177151;9847;0,1,2;3;9;1;1;1
250870177151;250870177237;86;1,2;2;9;1;1;1
250870177237;250870180479;3242;0,1,2;3;9;1;1;1
250870180479;250870193782;13303;1,2;2;9;1;1;1
250870193782;250870197022;3240;0,1,2;3;9;1;1;1
250870197022;250870206540;9518;1,2;2;9;1;1;1
250870206540;250870207478;938;0,1,2;3;9;1;1;1
250870207478;250870214529;7051;0,1,2;3;9;1;1;1
250870214529;250870214583;54;0,1,2;3;9;1;1;1
250870214583;250870218075;3492;0,1,2;3;9;1;1;1
250870218075;250870223186;5111;0,1,2;3;9;1;1;1
250870223186;250870256997;33811;1,2;2;9;1;1;1
250870256997;250870263679;6682;0,1,2;3;9;1;1;1
250870263679;250870273498;9819;1,2;2;9;1;1;1
250870273498;250870283947;10449;0,1,2;3;9;1;1;1
250870283947;250870286451;2504;1,2;2;9;1;1;1
250870286451;250870289790;3339;0,1,2;3;9;1;1;1
250870289790;250870289829;39;0,1,2;3;9;1;1;1
250870289829;250870295932;6103;0,1,2;3;9;1;1;1
250870295932;250870330828;34896;1,2;2;9;1;1;1
250870330828;250870371994;41166;0,1,2;3;9;1;1;1
250870371994;250870413541;41547;1,2;2;9;1;1;1
250870413541;250870421445;7904;0,1,2;3;9;1;1;1
250870421445;250870454950;33505;1,2;2;9;1;1;1
250870454950;250870460008;5058;0,1,2;3;9;1;1;1
250870460008;250870465176;5168;0,1,2;3;9;1;1;1
250870465176;250870477471;12295;0,1,2;3;9;1;1;1
250870477471;250870478586;1115;1,2;2;9;1;1;1
250870478586;250870479035;449;0,1,2;3;9;1;1;1
250870479035;250870483475;4440;0,1,2;3;9;1;1;1
250870483475;250870491697;8222;0,1,2;3;9;1;1;1
250870491697;250870499528;7831;1,2;2;9;1;1;1
250870499528;250870506564;7036;0,1,2;3;9;1;1;1
250870506564;250870509046;2482;0,1,2;3;9;1;1;1
250870509046;250870510548;1502;0,1,2;3;9;1;1;1
250870510548;250870533955;23407;1,2;2;9;1;1;1
250870533955;250870533978;23;0,1,2;3;9;1;1;1
250870533978;250870545173;11195;0,1,2;3;9;1;1;1
250870545173;250870549201;4028;0,1,2;3;9;1;1;1
250870549201;250870549238;37;1,2;2;9;1;1;1
250870549238;250870565873;16635;0,1,2;3;9;1;1;1
250870565873;250870566703;830;0,1,2;3;9;1;1;1
250870566703;250870575506;8803;0,1,2;3;9;1;1;1
250870575506;250870577715;2209;1,2;2;9;1;1;1
250870577715;250870581976;4261;0,1,2;3;9;1;1;1
250870581976;250870586516;4540;0,1,2;3;9;1;1;1
250870586516;250870591469;4953;0,1,2;3;9;1;1;1
250870591469;250870591502;33;0,1,2;3;9;1;1;1
250870591502;250870597905;6403;0,1,2;3;9;1;1;1
250870597905;250870605088;7183;0,1,2;3;9;1;1;1
250870605088;250870606862;1774;0,1,2;3;9;1;1;1
250870606862;250870610809;3947;1,2;2;9;1;1;1
250870610809;250870621100;10291;0,1,2;3;9;1;1;1
250870621100;250870629634;8534;1,2;2;9;1;1;1
250870629634;250870629990;356;0,1,2;3;9;1;1;1
250870629990;250870634374;4384;0,1,2;3;9;1;1;1
250870634374;250870638106;3732;0,1,2;3;9;1;1;1
250870638106;250870638988;882;0,1,2;3;9;1;1;1
250870638988;250870650237;11249;0,1,2;3;9;1;1;1
250870650237;250870660526;10289;0,1,2;3;9;1;1;1
250870660526;250870661940;1414;0,1,2;3;9;1;1;1
250870661940;250870667941;6001;0,1,2;3;9;1;1;1
250870667941;250870671097;3156;0,1,2;3;9;1;1;1
250870671097;250870675145;4048;0,1,2;3;9;1;1;1
250870675145;250870678525;3380;0,1,2;3;9;1;1;1
250870678525;250870684652;6127;1,2;2;9;1;1;1
250870684652;250870689603;4951;0,1,2;3;9;1;1;1
250870689603;250870689812;209;0,1,2;3;9;1;1;1
250870689812;250870699303;9491;0,1,2;3;9;1;1;1
250870699303;250870718319;19016;1,2;2;9;1;1;1
250870718319;250870727949;9630;0,1,2;3;9;1;1;1
250870727949;250870736201;8252;1,2;2;9;1;1;1
250870736201;250870739506;3305;0,1,2;3;9;1;1;1
250870739506;250870745872;6366;0,1,2;3;9;1;1;1
250870745872;250870755553;9681;0,1,2;3;9;1;1;1
250870755553;250870755576;23;1,2;2;9;1;1;1
250870755576;250870763091;7515;0,1,2;3;9;1;1;1
250870763091;250870766394;3303;1,2;2;9;1;1;1
250870766394;250870776652;10258;0,1,2;3;9;1;1;1
250870776652;250870776746;94;0,1,2;3;9;1;1;1
250870776746;250870787664;10918;0,1,2;3;9;1;1;1
250870787664;250870798762;11098;1,2;2;9;1;1;1
250870798762;250870804977;6215;0,1,2;3;9;1;1;1
250870804977;250870806756;1779;0,1,2;3;9;1;1;1
250870806756;250870813316;6560;0,1,2;3;9;1;1;1
250870813316;250870831241;17925;1,2;2;9;1;1;1
250870831241;250870833722;2481;0,1,2;3;9;1;1;1
250870833722;250870839842;6120;0,1,2;3;9;1;1;1
250870839842;250870842499;2657;0,1,2;3;9;1;1;1
250870842499;250870842938;439;0,1,2;3;9;1;1;1
250870842938;250870850114;7176;0,1,2;3;9;1;1;1
250870850114;250870850665;551;0,1,2;3;9;1;1;1
250870850665;250870854899;4234;0,1,2;3;9;1;1;1
250870854899;250870859442;4543;0,1,2;3;9;1;1;1
250870859442;250870861808;2366;0,1,2;3;9;1;1;1
250870861808;250870864837;3029;0,1,2;3;9;1;1;1
250870864837;250870864933;96;0,1,2;3;9;1;1;1
250870864933;250870866050;1117;0,1,2;3;9;1;1;1
250870866050;250870873689;7639;0,1,2;3;9;1;1;1
250870873689;250870884361;10672;1,2;2;9;1;1;1
250870884361;250870891833;7472;0,1,2;3;9;1;1;1
250870891833;250870892845;1012;0,1,2;3;9;1;1;1
250870892845;250870897077;4232;0,1,2;3;9;1;1;1
250870897077;250870906314;9237;1,2;2;9;1;1;1
250870906314;250870918363;12049;0,1,2;3;9;1;1;1
250870918363;250870930512;12149;1,2;2;9;1;1;1
250870930512;250870943933;13421;0,1,2;3;9;1;1;1
250870943933;250870954977;11044;0,1,2;3;9;1;1;1
250870954977;250871006709;51732;0,1,2;3;9;1;1;1
250871006709;250871022085;15376;1,2;2;9;1;1;1
250871022085;250871028554;6469;0,1,2;3;9;1;1;1
250871028554;250871050061;21507;1,2;2;9;1;1;1
250871050061;250871050485;424;0,1,2;3;9;1;1;1
250871050485;250871061731;11246;0,1,2;3;9;1;1;1
250871061731;250871061767;36;0,1,2;3;9;1;1;1
250871061767;250871076662;14895;1,2;2;9;1;1;1
250871076662;250871086401;9739;0,1,2;3;9;1;1;1
250871086401;250871108533;22132;1,2;2;9;1;1;1
250871108533;250871108559;26;0,1,2;3;9;1;1;1
250871108559;250871118262;9703;0,1,2;3;9;1;1;1
250871118262;250871119127;865;0,1,2;3;9;1;1;1
250871119127;250871170210;51083;1,2;2;9;1;1;1
250871170210;250871180852;10642;0,1,2;3;9;1;1;1
250871180852;250871226068;45216;1,2;2;9;1;1;1
250871226068;250871236529;10461;0,1,2;3;9;1;1;1
250871236529;250871251581;15052;1,2;2;9;1;1;1
250871251581;250871283351;31770;0,1,2;3;9;1;1;1
250871283351;250871335574;52223;1,2;2;9;1;1;1
250871335574;250871348587;13013;0,1,2;3;9;1;1;1
250871348587;250871399508;50921;1,2;2;9;1;1;1
250871399508;250871408518;9010;0,1,2;3;9;1;1;1
250871408518;250871449654;41136;1,2;2;9;1;1;1
250871449654;250871458947;9293;0,1,2;3;9;1;1;1
250871458947;250871498772;39825;1,2;2;9;1;1;1
250871498772;250871505619;6847;0,1,2;3;9;1;1;1
250871505619;250871505781;162;0,1,2;3;9;1;1;1
250871505781;250871508490;2709;0,1,2;3;9;1;1;1
250871508490;250871516633;8143;0,1,2;3;9;1;1;1
250871516633;250871521010;4377;0,1,2;3;9;1;1;1
250871521010;250871548658;27648;1,2;2;9;1;1;1
250871548658;250871553051;4393;0,1,2;3;9;1;1;1
250871553051;250871556949;3898;0,1,2;3;9;1;1;1
250871556949;250871557571;622;0,1,2;3;9;1;1;1
250871557571;250871566775;9204;0,1,2;3;9;1;1;1
250871566775;250871567714;939;0,1,2;3;9;1;1;1
250871567714;250871589986;22272;0,1,2;3;9;1;1;1
250871589986;250871590034;48;0,1,2;3;9;1;1;1
250871590034;250871610706;20672;1,2;2;9;1;1;1
250871610706;250871610817;111;0,1,2;3;9;1;1;1
250871610817;250871622083;11266;0,1,2;3;9;1;1;1
250871622083;250871622203;120;0,1,2;3;9;1;1;1
250871622203;250871668693;46490;1,2;2;9;1;1;1
250871668693;250871680442;11749;0,1,2;3;9;1;1;1
250871680442;250871696606;16164;1,2;2;9;1;1;1
250871696606;250871710070;13464;0,1,2;3;9;1;1;1
250871710070;250871765272;55202;1,2;2;9;1;1;1
250871765272;250871770803;5531;0,1,2;3;9;1;1;1
250871770803;250871780293;9490;0,1,2;3;9;1;1;1
250871780293;250871822414;42121;0,1,2;3;9;1;1;1
250871822414;250871837127;14713;1,2;2;9;1;1;1
250871837127;250871886755;49628;0,1,2;3;9;1;1;1
250871886755;250871891521;4766;1,2;2;9;1;1;1
250871891521;250871894717;3196;0,1,2;3;9;1;1;1
250871894717;250871904497;9780;0,1,2;3;9;1;1;1
250871904497;250871904581;84;0,1,2;3;9;1;1;1
250871904581;250871926525;21944;1,2;2;9;1;1;1
250871926525;250871931582;5057;0,1,2;3;9;1;1;1
250871931582;250871938998;7416;0,1,2;3;9;1;1;1
250871938998;250871940738;1740;0,1,2;3;9;1;1;1
250871940738;250871958526;17788;1,2;2;9;1;1;1
250871958526;250871961719;3193;0,1,2;3;9;1;1;1
250871961719;250871965297;3578;0,1,2;3;9;1;1;1
250871965297;250871968072;2775;0,1,2;3;9;1;1;1
250871968072;250871970615;2543;0,1,2;3;9;1;1;1
250871970615;250871972881;2266;0,1,2;3;9;1;1;1
250871972881;250871986974;14093;1,2;2;9;1;1;1
250871986974;250871987007;33;0,1,2;3;9;1;1;1
250871987007;250871994827;7820;0,1,2;3;9;1;1;1
250871994827;250871996928;2101;0,1,2;3;9;1;1;1
250871996928;250872000985;4057;0,1,2;3;9;1;1;1
250872000985;250872039873;38888;0,1,2;3;9;1;1;1
250872039873;250872048682;8809;0,1,2;3;9;1;1;1
250872048682;250872051303;2621;0,1,2;3;9;1;1;1
250872051303;250872057126;5823;1,2;2;9;1;1;1
250872057126;250872064708;7582;0,1,2;3;9;1;1;1
250872064708;250872076182;11474;1,2;2;9;1;1;1
250872076182;250872084958;8776;0,1,2;3;9;1;1;1
250872084958;250872135017;50059;1,2;2;9;1;1;1
250872135017;250872144335;9318;0,1,2;3;9;1;1;1
250872144335;250872239227;94892;1,2;2;9;1;1;1
250872239227;250872248616;9389;0,1,2;3;9;1;1;1
250872248616;250872270797;22181;1,2;2;9;1;1;1
250872270797;250872279512;8715;0,1,2;3;9;1;1;1
250872279512;250872297061;17549;1,2;2;9;1;1;1
250872297061;250872307318;10257;0,1,2;3;9;1;1;1
250872307318;250872339295;31977;1,2;2;9;1;1;1
250872339295;250872351769;12474;0,1,2;3;9;1;1;1
250872351769;250872474625;122856;1,2;2;9;1;1;1
250872474625;250872484194;9569;0,1,2;3;9;1;1;1
250872484194;250872490562;6368;0,1,2;3;9;1;1;1
250872490562;250872494696;4134;0,1,2;3;9;1;1;1
250872494696;250872505192;10496;0,1,2;3;9;1;1;1
250872505192;250872508419;3227;0,1,2;3;9;1;1;1
250872508419;250872550587;42168;1,2;2;9;1;1;1
250872550587;250872562491;11904;0,1,2;3;9;1;1;1
250872562491;250872562530;39;1,2;2;9;1;1;1
250872562530;250872568349;5819;0,1,2;3;9;1;1;1
250872568349;250872572305;3956;0,1,2;3;9;1;1;1
250872572305;250872587193;14888;0,1,2;3;9;1;1;1
250872587193;250872819767;232574;1,2;2;9;1;1;1
250872819767;250872833815;14048;0,1,2;3;9;1;1;1
250872833815;250872843247;9432;1,2;2;9;1;1;1
250872843247;250872853241;9994;0,1,2;3;9;1;1;1
250872853241;250872875420;22179;1,2;2;9;1;1;1
250872875420;250872887479;12059;0,1,2;3;9;1;1;1
250872887479;250872887912;433;0,1,2;3;9;1;1;1
250872887912;250872894102;6190;0,1,2;3;9;1;1;1
250872894102;250872907275;13173;1,2;2;9;1;1;1
250872907275;250872929174;21899;0,1,2;3;9;1;1;1
250872929174;250872938174;9000;1,2;2;9;1;1;1
250872938174;250872945664;7490;0,1,2;3;9;1;1;1
250872945664;250872947744;2080;0,1,2;3;9;1;1;1
250872947744;250872957122;9378;0,1,2;3;9;1;1;1
250872957122;250872986701;29579;1,2;2;9;1;1;1
250872986701;250872990420;3719;0,1,2;3;9;1;1;1
250872990420;250872997264;6844;0,1,2;3;9;1;1;1
250872997264;250872998419;1155;0,1,2;3;9;1;1;1
250872998419;250873004727;6308;1,2;2;9;1;1;1
250873004727;250873016952;12225;0,1,2;3;9;1;1;1
250873016952;250873021194;4242;0,1,2;3;9;1;1;1
250873021194;250873027646;6452;0,1,2;3;9;1;1;1
250873027646;250873117795;90149;1,2;2;9;1;1;1
250873117795;250873126370;8575;0,1,2;3;9;1;1;1
250873126370;250873127393;1023;0,1,2;3;9;1;1;1
250873127393;250873127838;445;0,1,2;3;9;1;1;1
250873127838;250873127862;24;0,1,2;3;9;1;1;1
250873127862;250873137048;9186;0,1,2;3;9;1;1;1
250873137048;250873143034;5986;0,1,2;3;9;1;1;1
250873143034;250873149238;6204;0,1,2;3;9;1;1;1
250873149238;250873153634;4396;0,1,2;3;9;1;1;1
250873153634;250873169493;15859;0,1,2;3;9;1;1;1
250873169493;250873184670;15177;0,1,2;3;9;1;1;1
250873184670;250873200772;16102;0,1,2;3;9;1;1;1
250873200772;250873202285;1513;0,1,2;3;9;1;1;1
250873202285;250873205777;3492;0,1,2;3;9;1;1;1
250873205777;250873211677;5900;0,1,2;3;9;1;1;1
250873211677;250873211748;71;0,1,2;3;9;1;1;1
250873211748;250873213445;1697;0,1,2;3;9;1;1;1
250873213445;250873216013;2568;0,1,2;3;9;1;1;1
250873216013;250873216169;156;0,1,2;3;9;1;1;1
250873216169;250873227065;10896;0,1,2;3;9;1;1;1
250873227065;250873227156;91;0,1,2;3;9;1;1;1
250873227156;250873238518;11362;0,1,2;3;9;1;1;1
250873238518;250873238569;51;0,1,2;3;9;1;1;1
250873238569;250873239978;1409;0,1,2;3;9;1;1;1
250873239978;250873248256;8278;0,1,2;3;9;1;1;1
250873248256;250873259878;11622;0,1,2;3;9;1;1;1
250873259878;250873268262;8384;1,2;2;9;1;1;1
250873268262;250873269851;1589;0,1,2;3;9;1;1;1
250873269851;250873286533;16682;0,1,2;3;9;1;1;1
250873286533;250873286557;24;0,1,2;3;9;1;1;1
250873286557;250873300088;13531;0,1,2;3;9;1;1;1
250873300088;250873302088;2000;0,1,2;3;9;1;1;1
250873302088;250873314974;12886;0,1,2;3;9;1;1;1
250873314974;250873316827;1853;0,1,2;3;9;1;1;1
250873316827;250876491883;3175056;1,2;2;9;1;1;1
250876491883;250876522663;30780;0,1,2;3;9;1;1;1
250876522663;250876535912;13249;0,1,2;3;9;1;1;1
250876535912;250876543896;7984;0,1,2;3;9;1;1;1
250876543896;250876565094;21198;0,1,2;3;9;1;1;1
250876565094;250876587978;22884;0,1,2;3;9;1;1;1
250876587978;250876629924;41946;0,1,2;3;9;1;1;1
250876629924;250876634421;4497;0,1,2;3;9;1;1;1
250876634421;250876634788;367;0,1,2;3;9;1;1;1
250876634788;250876643568;8780;0,1,2;3;9;1;1;1
250876643568;250876644032;464;0,1,2;3;9;1;1;1
250876644032;250876649891;5859;0,1,2;3;9;1;1;1
250876649891;250876721017;71126;0,1,2;3;9;1;1;1
250876721017;250876725517;4500;0,1,2;3;9;1;1;1
250876725517;250876752157;26640;0,1,2;3;9;1;1;1
250876752157;250876752535;378;0,1,2;3;9;1;1;1
250876752535;250876760684;8149;0,1,2;3;9;1;1;1
250876760684;250876763280;2596;0,1,2;3;9;1;1;1
250876763280;250876763657;377;0,1,2;3;9;1;1;1
250876763657;250876763738;81;0,1,2;3;9;1;1;1
250876763738;250876775779;12041;0,1,2;3;9;1;1;1
250876775779;250876783352;7573;0,1,2;3;9;1;1;1
250876783352;250876783416;64;0,1,2;3;9;1;1;1
250876783416;250876783454;38;0,1,2;3;9;1;1;1
250876783454;250876806271;22817;0,1,2;3;9;1;1;1
250876806271;250876806348;77;0,1,2;3;9;1;1;1
250876806348;250876814793;8445;0,1,2;3;9;1;1;1
250876814793;250876819179;4386;0,1,2;3;9;1;1;1
250876819179;250876820078;899;0,1,2;3;9;1;1;1
250876820078;250876831552;11474;0,1,2;3;9;1;1;1
250876831552;250876842426;10874;0,1,2;3;9;1;1;1
250876842426;250876849941;7515;0,1,2;3;9;1;1;1
250876849941;250876870815;20874;0,1,2;3;9;1;1;1
250876870815;250876875973;5158;0,1,2;3;9;1;1;1
250876875973;250876875999;26;0,1,2;3;9;1;1;1
250876875999;250876876047;48;0,1,2;3;9;1;1;1
250876876047;250876876078;31;0,1,2;3;9;1;1;1
250876876078;250876876108;30;0,1,2;3;9;1;1;1
250876876108;250876883066;6958;0,1,2;3;9;1;1;1
250876883066;250876886994;3928;0,1,2;3;9;1;1;1
250876886994;250876887095;101;0,1,2;3;9;1;1;1
250876887095;250876888300;1205;0,1,2;3;9;1;1;1
250876888300;250876888672;372;0,1,2;3;9;1;1;1
250876888672;250876889122;450;0,1,2;3;9;1;1;1
250876889122;250876890809;1687;0,1,2;3;9;1;1;1
250876890809;250876890864;55;0,1,2;3;9;1;1;1
250876890864;250876892784;1920;0,1,2;3;9;1;1;1
250876892784;250876897525;4741;0,1,2;3;9;1;1;1
250876897525;250876901055;3530;0,1,2;3;9;1;1;1
250876901055;250876901106;51;0,1,2;3;9;1;1;1
250876901106;250876902616;1510;0,1,2;3;9;1;1;1
250876902616;250876909313;6697;0,1,2;3;9;1;1;1
250876909313;250876910066;753;0,1,2;3;9;1;1;1
250876910066;250876911005;939;0,1,2;3;9;1;1;1
250876911005;250876911128;123;0,1,2;3;9;1;1;1
250876911128;250876913683;2555;0,1,2;3;9;1;1;1
250876913683;250876917375;3692;0,1,2;3;9;1;1;1
250876917375;250876917727;352;0,1,2;3;9;1;1;1
250876917727;250876932855;15128;0,1,2;3;9;1;1;1
250876932855;250876937547;4692;0,1,2;3;9;1;1;1
250876937547;250876938226;679;0,1,2;3;9;1;1;1
250876938226;250876938610;384;0,1,2;3;9;1;1;1
250876938610;250876940613;2003;0,1,2;3;9;1;1;1
250876940613;250876942889;2276;0,1,2;3;9;1;1;1
250876942889;250876949739;6850;0,1,2;3;9;1;1;1
250876949739;250876954497;4758;0,1,2;3;9;1;1;1
250876954497;250876954987;490;0,1,2;3;9;1;1;1
250876954987;250876957665;2678;0,1,2;3;9;1;1;1
250876957665;250876957881;216;0,1,2;3;9;1;1;1
250876957881;250876958292;411;0,1,2;3;9;1;1;1
250876958292;250876958333;41;0,1,2;3;9;1;1;1
250876958333;250876958379;46;0,1,2;3;9;1;1;1
250876958379;250876960589;2210;0,1,2;3;9;1;1;1
250876960589;250876961534;945;0,1,2;3;9;1;1;1
250876961534;250876962529;995;0,1,2;3;9;1;1;1
250876962529;250876962552;23;0,1,2;3;9;1;1;1
250876962552;250876964495;1943;0,1,2;3;9;1;1;1
250876964495;250876964517;22;0,1,2;3;9;1;1;1
250876964517;250876965866;1349;0,1,2;3;9;1;1;1
250876965866;250876969734;3868;0,1,2;3;9;1;1;1
250876969734;250876970933;1199;0,1,2;3;9;1;1;1
250876970933;250876974566;3633;0,1,2;3;9;1;1;1
250876974566;250876976858;2292;0,1,2;3;9;1;1;1
250876976858;250876986580;9722;0,1,2;3;9;1;1;1
250876986580;250876990342;3762;0,1,2;3;9;1;1;1
250876990342;250876990842;500;0,1,2;3;9;1;1;1
250876990842;250876991444;602;0,1,2;3;9;1;1;1
250876991444;250876992673;1229;0,1,2;3;9;1;1;1
250876992673;250876992760;87;0,1,2;3;9;1;1;1
250876992760;250876996181;3421;0,1,2;3;9;1;1;1
250876996181;250877002432;6251;0,1,2;3;9;1;1;1
250877002432;250877013262;10830;0,1,2;3;9;1;1;1
250877013262;250877013385;123;0,1,2;3;9;1;1;1
250877013385;250877016306;2921;0,1,2;3;9;1;1;1
250877016306;250877016335;29;0,1,2;3;9;1;1;1
250877016335;250877016792;457;0,1,2;3;9;1;1;1
250877016792;250877020834;4042;0,1,2;3;9;1;1;1
250877020834;250877021496;662;0,1,2;3;9;1;1;1
250877021496;250877025517;4021;0,1,2;3;9;1;1;1
250877025517;250877026987;1470;0,1,2;3;9;1;1;1
250877026987;250877027888;901;0,1,2;3;9;1;1;1
250877027888;250877029920;2032;0,1,2;3;9;1;1;1
250877029920;250877029997;77;0,1,2;3;9;1;1;1
250877029997;250877031311;1314;0,1,2;3;9;1;1;1
250877031311;250877036439;5128;0,1,2;3;9;1;1;1
250877036439;250877037200;761;0,1,2;3;9;1;1;1
250877037200;250877037290;90;0,1,2;3;9;1;1;1
250877037290;250877037445;155;0,1,2;3;9;1;1;1
250877037445;250877040002;2557;0,1,2;3;9;1;1;1
250877040002;250877040359;357;0,1,2;3;9;1;1;1
250877040359;250877040438;79;0,1,2;3;9;1;1;1
250877040438;250877040709;271;0,1,2;3;9;1;1;1
250877040709;250877041514;805;0,1,2;3;9;1;1;1
250877041514;250877041534;20;0,1,2;3;9;1;1;1
250877041534;250877041588;54;0,1,2;3;9;1;1;1
250877041588;250877041644;56;0,1,2;3;9;1;1;1
250877041644;250877041941;297;0,1,2;3;9;1;1;1
250877041941;250877044953;3012;0,1,2;3;9;1;1;1
250877044953;250877045236;283;0,1,2;3;9;1;1;1
250877045236;250877046240;1004;0,1,2;3;9;1;1;1
250877046240;250877048374;2134;0,1,2;3;9;1;1;1
250877048374;250877048868;494;0,1,2;3;9;1;1;1
250877048868;250877056477;7609;0,1,2;3;9;1;1;1
250877056477;250877056642;165;0,1,2;3;9;1;1;1
250877056642;250877058193;1551;0,1,2;3;9;1;1;1
250877058193;250877058521;328;0,1,2;3;9;1;1;1
250877058521;250877061265;2744;0,1,2;3;9;1;1;1
250877061265;250877061482;217;0,1,2;3;9;1;1;1
250877061482;250877061599;117;0,1,2;3;9;1;1;1
250877061599;250877061815;216;0,1,2;3;9;1;1;1
250877061815;250877061883;68;0,1,2;3;9;1;1;1
250877061883;250877062024;141;0,1,2;3;9;1;1;1
250877062024;250877072845;10821;0,1,2;3;9;1;1;1
250877072845;250877074167;1322;0,1,2;3;9;1;1;1
250877074167;250877074908;741;0,1,2;3;9;1;1;1
250877074908;250877075045;137;0,1,2;3;9;1;1;1
250877075045;250877076338;1293;0,1,2;3;9;1;1;1
250877076338;250877079953;3615;0,1,2;3;9;1;1;1
250877079953;250877080011;58;0,1,2;3;9;1;1;1
250877080011;250877087981;7970;0,1,2;3;9;1;1;1
250877087981;250877088618;637;0,1,2;3;9;1;1;1
250877088618;250877089092;474;0,1,2;3;9;1;1;1
250877089092;250877089273;181;0,1,2;3;9;1;1;1
250877089273;250877090346;1073;0,1,2;3;9;1;1;1
250877090346;250877090381;35;0,1,2;3;9;1;1;1
250877090381;250877093361;2980;0,1,2;3;9;1;1;1
250877093361;250877094013;652;0,1,2;3;9;1;1;1
250877094013;250877094489;476;0,1,2;3;9;1;1;1
250877094489;250877094520;31;0,1,2;3;9;1;1;1
250877094520;250877097683;3163;0,1,2;3;9;1;1;1
250877097683;250877098070;387;0,1,2;3;9;1;1;1
250877098070;250877098216;146;0,1,2;3;9;1;1;1
250877098216;250877098436;220;0,1,2;3;9;1;1;1
250877098436;250877103528;5092;0,1,2;3;9;1;1;1
250877103528;250877103655;127;0,1,2;3;9;1;1;1
250877103655;250877103717;62;0,1,2;3;9;1;1;1
250877103717;250877103801;84;0,1,2;3;9;1;1;1
250877103801;250877104885;1084;0,1,2;3;9;1;1;1
250877104885;250877112179;7294;0,1,2;3;9;1;1;1
250877112179;250877112201;22;0,1,2;3;9;1;1;1
250877112201;250877116082;3881;0,1,2;3;9;1;1;1
250877116082;250877116311;229;0,1,2;3;9;1;1;1
250877116311;250877121475;5164;0,1,2;3;9;1;1;1
250877121475;250877121685;210;0,1,2;3;9;1;1;1
250877121685;250877121735;50;0,1,2;3;9;1;1;1
250877121735;250877125533;3798;0,1,2;3;9;1;1;1
250877125533;250877129522;3989;0,1,2;3;9;1;1;1
250877129522;250877131017;1495;0,1,2;3;9;1;1;1
250877131017;250877133434;2417;0,1,2;3;9;1;1;1
250877133434;250877134358;924;0,1,2;3;9;1;1;1
250877134358;250877137724;3366;0,1,2;3;9;1;1;1
250877137724;250877156657;18933;0,1,2;3;9;1;1;1
250877156657;250877158257;1600;0,1,2;3;9;1;1;1
250877158257;250877159354;1097;0,1,2;3;9;1;1;1
250877159354;250877161797;2443;0,1,2;3;9;1;1;1
250877161797;250877161948;151;0,1,2;3;9;1;1;1
250877161948;250877161998;50;0,1,2;3;9;1;1;1
250877161998;250877162038;40;0,1,2;3;9;1;1;1
250877162038;250877164719;2681;0,1,2;3;9;1;1;1
250877164719;250877169992;5273;0,1,2;3;9;1;1;1
250877169992;250877171823;1831;0,1,2;3;9;1;1;1
250877171823;250877173784;1961;0,1,2;3;9;1;1;1
250877173784;250877174983;1199;0,1,2;3;9;1;1;1
250877174983;250877178092;3109;0,1,2;3;9;1;1;1
250877178092;250877183315;5223;0,1,2;3;9;1;1;1
250877183315;250877194779;11464;0,1,2;3;9;1;1;1
250877194779;250877195194;415;0,1,2;3;9;1;1;1
250877195194;250877197469;2275;0,1,2;3;9;1;1;1
250877197469;250877201271;3802;0,1,2;3;9;1;1;1
250877201271;250877201346;75;0,1,2;3;9;1;1;1
250877201346;250877202677;1331;0,1,2;3;9;1;1;1
250877202677;250877208243;5566;0,1,2;3;9;1;1;1
250877208243;250877218025;9782;0,1,2;3;9;1;1;1
250877218025;250877229338;11313;0,1,2;3;9;1;1;1
250877229338;250877229780;442;0,1,2;3;9;1;1;1
250877229780;250877230564;784;0,1,2;3;9;1;1;1
250877230564;250877239975;9411;0,1,2;3;9;1;1;1
250877239975;250877248593;8618;0,1,2;3;9;1;1;1
250877248593;250877262056;13463;0,1,2;3;9;1;1;1
250877262056;250877265509;3453;0,1,2;3;9;1;1;1
250877265509;250877274398;8889;0,1,2;3;9;1;1;1
250877274398;250877277886;3488;0,1,2;3;9;1;1;1
250877277886;250877281028;3142;0,1,2;3;9;1;1;1
250877281028;250877281049;21;0,1,2;3;9;1;1;1
250877281049;250877282873;1824;0,1,2;3;9;1;1;1
250877282873;250877286273;3400;0,1,2;3;9;1;1;1
250877286273;250877290066;3793;0,1,2;3;9;1;1;1
250877290066;250877294246;4180;0,1,2;3;9;1;1;1
250877294246;250877306346;12100;0,1,2;3;9;1;1;1
250877306346;250877309391;3045;0,1,2;3;9;1;1;1
250877309391;250877321729;12338;0,1,2;3;9;1;1;1
250877321729;250877324636;2907;0,1,2;3;9;1;1;1
250877324636;250877325862;1226;0,1,2;3;9;1;1;1
250877325862;250877326404;542;0,1,2;3;9;1;1;1
250877326404;250877327095;691;0,1,2;3;9;1;1;1
250877327095;250877327992;897;0,1,2;3;9;1;1;1
250877327992;250877333229;5237;0,1,2;3;9;1;1;1
250877333229;250877333274;45;0,1,2;3;9;1;1;1
250877333274;250877341153;7879;0,1,2;3;9;1;1;1
250877341153;250877346884;5731;0,1,2;3;9;1;1;1
250877346884;250877348903;2019;0,1,2;3;9;1;1;1
250877348903;250877351934;3031;0,1,2;3;9;1;1;1
250877351934;250877355492;3558;0,1,2;3;9;1;1;1
250877355492;250877367952;12460;0,1,2;3;9;1;1;1
250877367952;250877369022;1070;0,1,2;3;9;1;1;1
250877369022;250877369916;894;0,1,2;3;9;1;1;1
250877369916;250877381747;11831;0,1,2;3;9;1;1;1
250877381747;250877384414;2667;0,1,2;3;9;1;1;1
250877384414;250877385799;1385;0,1,2;3;9;1;1;1
250877385799;250877393006;7207;0,1,2;3;9;1;1;1
250877393006;250877393854;848;0,1,2;3;9;1;1;1
250877393854;250877393956;102;0,1,2;3;9;1;1;1
250877393956;250877396968;3012;0,1,2;3;9;1;1;1
250877396968;250877401274;4306;0,1,2;3;9;1;1;1
250877401274;250877408779;7505;0,1,2;3;9;1;1;1
250877408779;250877411910;3131;0,1,2;3;9;1;1;1
250877411910;250877412325;415;0,1,2;3;9;1;1;1
250877412325;250877412453;128;0,1,2;3;9;1;1;1
250877412453;250877417402;4949;0,1,2;3;9;1;1;1
250877417402;250877424144;6742;0,1,2;3;9;1;1;1
250877424144;250877427093;2949;0,1,2;3;9;1;1;1
250877427093;250877428947;1854;0,1,2;3;9;1;1;1
250877428947;250877429128;181;0,1,2;3;9;1;1;1
250877429128;250877440350;11222;0,1,2;3;9;1;1;1
250877440350;250877450526;10176;0,1,2;3;9;1;1;1
250877450526;250877453383;2857;0,1,2;3;9;1;1;1
250877453383;250877454900;1517;0,1,2;3;9;1;1;1
250877454900;250877463356;8456;0,1,2;3;9;1;1;1
250877463356;250877463542;186;0,1,2;3;9;1;1;1
250877463542;250877464491;949;0,1,2;3;9;1;1;1
250877464491;250877467652;3161;0,1,2;3;9;1;1;1
250877467652;250877470972;3320;0,1,2;3;9;1;1;1
250877470972;250877471017;45;0,1,2;3;9;1;1;1
250877471017;250877473829;2812;0,1,2;3;9;1;1;1
250877473829;250877474649;820;0,1,2;3;9;1;1;1
250877474649;250877474827;178;0,1,2;3;9;1;1;1
250877474827;250877476402;1575;0,1,2;3;9;1;1;1
250877476402;250877476657;255;0,1,2;3;9;1;1;1
250877476657;250877476978;321;0,1,2;3;9;1;1;1
250877476978;250877480589;3611;0,1,2;3;9;1;1;1
250877480589;250877480902;313;0,1,2;3;9;1;1;1
250877480902;250877481504;602;0,1,2;3;9;1;1;1
250877481504;250877484817;3313;0,1,2;3;9;1;1;1
250877484817;250877493542;8725;0,1,2;3;9;1;1;1
250877493542;250877493697;155;0,1,2;3;9;1;1;1
250877493697;250877496190;2493;0,1,2;3;9;1;1;1
250877496190;250877497094;904;0,1,2;3;9;1;1;1
250877497094;250877497171;77;0,1,2;3;9;1;1;1
250877497171;250877505374;8203;0,1,2;3;9;1;1;1
250877505374;250877508019;2645;0,1,2;3;9;1;1;1
250877508019;250877508307;288;0,1,2;3;9;1;1;1
250877508307;250877513759;5452;0,1,2;3;9;1;1;1
250877513759;250877518363;4604;0,1,2;3;9;1;1;1
250877518363;250877520609;2246;0,1,2;3;9;1;1;1
250877520609;250877520999;390;0,1,2;3;9;1;1;1
250877520999;250877530918;9919;0,1,2;3;9;1;1;1
250877530918;250877531091;173;0,1,2;3;9;1;1;1
250877531091;250877532758;1667;0,1,2;3;9;1;1;1
250877532758;250877535545;2787;0,1,2;3;9;1;1;1
250877535545;250877541209;5664;0,1,2;3;9;1;1;1
250877541209;250877541372;163;0,1,2;3;9;1;1;1
250877541372;250877542516;1144;0,1,2;3;9;1;1;1
250877542516;250877542981;465;0,1,2;3;9;1;1;1
250877542981;250877543234;253;0,1,2;3;9;1;1;1
250877543234;250877543501;267;0,1,2;3;9;1;1;1
250877543501;250877543731;230;0,1,2;3;9;1;1;1
250877543731;250877551715;7984;0,1,2;3;9;1;1;1
250877551715;250877553492;1777;0,1,2;3;9;1;1;1
250877553492;250877553996;504;0,1,2;3;9;1;1;1
250877553996;250877554836;840;0,1,2;3;9;1;1;1
250877554836;250877555023;187;0,1,2;3;9;1;1;1
250877555023;250877555262;239;0,1,2;3;9;1;1;1
250877555262;250877555483;221;0,1,2;3;9;1;1;1
250877555483;250877565308;9825;0,1,2;3;9;1;1;1
250877565308;250877565514;206;0,1,2;3;9;1;1;1
250877565514;250877566722;1208;0,1,2;3;9;1;1;1
250877566722;250877566888;166;0,1,2;3;9;1;1;1
250877566888;250877567374;486;0,1,2;3;9;1;1;1
250877567374;250877567530;156;0,1,2;3;9;1;1;1
250877567530;250877584527;16997;0,1,2;3;9;1;1;1
250877584527;250877588592;4065;0,1,2;3;9;1;1;1
250877588592;250877603338;14746;0,1,2;3;9;1;1;1
250877603338;250877603523;185;0,1,2;3;9;1;1;1
250877603523;250877612945;9422;0,1,2;3;9;1;1;1
250877612945;250877612979;34;0,1,2;3;9;1;1;1
250877612979;250877613481;502;0,1,2;3;9;1;1;1
250877613481;250877616353;2872;0,1,2;3;9;1;1;1
250877616353;250877616872;519;0,1,2;3;9;1;1;1
250877616872;250877621701;4829;0,1,2;3;9;1;1;1
250877621701;250877621857;156;0,1,2;3;9;1;1;1
250877621857;250877625952;4095;0,1,2;3;9;1;1;1
250877625952;250877626136;184;0,1,2;3;9;1;1;1
250877626136;250877648057;21921;0,1,2;3;9;1;1;1
250877648057;250877648232;175;0,1,2;3;9;1;1;1
250877648232;250877657791;9559;0,1,2;3;9;1;1;1
250877657791;250877658659;868;0,1,2;3;9;1;1;1
250877658659;250877660491;1832;0,1,2;3;9;1;1;1
250877660491;250877660671;180;0,1,2;3;9;1;1;1
250877660671;250877661085;414;0,1,2;3;9;1;1;1
250877661085;250877661311;226;0,1,2;3;9;1;1;1
250877661311;250877670805;9494;0,1,2;3;9;1;1;1
250877670805;250877670957;152;0,1,2;3;9;1;1;1
250877670957;250877672042;1085;0,1,2;3;9;1;1;1
250877672042;250877672206;164;0,1,2;3;9;1;1;1
250877672206;250877708501;36295;0,1,2;3;9;1;1;1
250877708501;250877726242;17741;0,1,2;3;9;1;1;1
250877726242;250877726462;220;0,1,2;3;9;1;1;1
250877726462;250877754118;27656;0,1,2;3;9;1;1;1
250877754118;250877761202;7084;0,1,2;3;9;1;1;1
250877761202;250877761509;307;0,1,2;3;9;1;1;1
250877761509;250877770421;8912;0,1,2;3;9;1;1;1
250877770421;250877770797;376;0,1,2;3;9;1;1;1
250877770797;250877772763;1966;0,1,2;3;9;1;1;1
250877772763;250877773525;762;0,1,2;3;9;1;1;1
250877773525;250877775566;2041;0,1,2;3;9;1;1;1
250877775566;250877775782;216;0,1,2;3;9;1;1;1
250877775782;250877806059;30277;0,1,2;3;9;1;1;1
250877806059;250877806107;48;0,1,2;3;9;1;1;1
250877806107;250877806617;510;0,1,2;3;9;1;1;1
250877806617;250877816971;10354;0,1,2;3;9;1;1;1
250877816971;250877817233;262;0,1,2;3;9;1;1;1
250877817233;250877818852;1619;0,1,2;3;9;1;1;1
250877818852;250877819462;610;0,1,2;3;9;1;1;1
250877819462;250877819660;198;0,1,2;3;9;1;1;1
250877819660;250877819899;239;0,1,2;3;9;1;1;1
250877819899;250877820125;226;0,1,2;3;9;1;1;1
250877820125;250877832465;12340;0,1,2;3;9;1;1;1
250877832465;250877832713;248;0,1,2;3;9;1;1;1
250877832713;250877850093;17380;0,1,2;3;9;1;1;1
250877850093;250877854286;4193;0,1,2;3;9;1;1;1
250877854286;250877854501;215;0,1,2;3;9;1;1;1
250877854501;250877860490;5989;0,1,2;3;9;1;1;1
250877860490;250877863314;2824;0,1,2;3;9;1;1;1
250877863314;250877864438;1124;0,1,2;3;9;1;1;1
250877864438;250877864895;457;0,1,2;3;9;1;1;1
250877864895;250877867238;2343;0,1,2;3;9;1;1;1
250877867238;250877867529;291;0,1,2;3;9;1;1;1
250877867529;250877867645;116;0,1,2;3;9;1;1;1
250877867645;250877867899;254;0,1,2;3;9;1;1;1
250877867899;250877877478;9579;0,1,2;3;9;1;1;1
250877877478;250877877634;156;0,1,2;3;9;1;1;1
250877877634;250877879180;1546;0,1,2;3;9;1;1;1
250877879180;250877879389;209;0,1,2;3;9;1;1;1
250877879389;250877887177;7788;0,1,2;3;9;1;1;1
250877887177;250877897130;9953;0,1,2;3;9;1;1;1
250877897130;250877901102;3972;0,1,2;3;9;1;1;1
250877901102;250877901285;183;0,1,2;3;9;1;1;1
250877901285;250877907198;5913;0,1,2;3;9;1;1;1
250877907198;250877910011;2813;0,1,2;3;9;1;1;1
250877910011;250877917165;7154;0,1,2;3;9;1;1;1
250877917165;250877919955;2790;0,1,2;3;9;1;1;1
250877919955;250877921605;1650;0,1,2;3;9;1;1;1
250877921605;250877921765;160;0,1,2;3;9;1;1;1
250877921765;250877923317;1552;0,1,2;3;9;1;1;1
250877923317;250877923584;267;0,1,2;3;9;1;1;1
250877923584;250877933736;10152;0,1,2;3;9;1;1;1
250877933736;250877935134;1398;0,1,2;3;9;1;1;1
250877935134;250877935314;180;0,1,2;3;9;1;1;1
250877935314;250877938212;2898;0,1,2;3;9;1;1;1
250877938212;250877944191;5979;0,1,2;3;9;1;1;1
250877944191;250877944377;186;0,1,2;3;9;1;1;1
250877944377;250877945012;635;0,1,2;3;9;1;1;1
250877945012;250877945207;195;0,1,2;3;9;1;1;1
250877945207;250877946820;1613;0,1,2;3;9;1;1;1
250877946820;250877947049;229;0,1,2;3;9;1;1;1
250877947049;250877949645;2596;0,1,2;3;9;1;1;1
250877949645;250877949831;186;0,1,2;3;9;1;1;1
250877949831;250877957574;7743;0,1,2;3;9;1;1;1
250877957574;250877957788;214;0,1,2;3;9;1;1;1
250877957788;250877960812;3024;0,1,2;3;9;1;1;1
250877960812;250877967654;6842;0,1,2;3;9;1;1;1
250877967654;250877967866;212;0,1,2;3;9;1;1;1
250877967866;250877969295;1429;0,1,2;3;9;1;1;1
250877969295;250877969497;202;0,1,2;3;9;1;1;1
250877969497;250877976482;6985;0,1,2;3;9;1;1;1
250877976482;250877978860;2378;0,1,2;3;9;1;1;1
250877978860;250877979652;792;0,1,2;3;9;1;1;1
250877979652;250877979909;257;0,1,2;3;9;1;1;1
250877979909;250877980055;146;0,1,2;3;9;1;1;1
250877980055;250877980099;44;0,1,2;3;9;1;1;1
250877980099;250877983865;3766;0,1,2;3;9;1;1;1
250877983865;250877984281;416;0,1,2;3;9;1;1;1
250877984281;250877984718;437;0,1,2;3;9;1;1;1
250877984718;250877990385;5667;0,1,2;3;9;1;1;1
250877990385;250877990575;190;0,1,2;3;9;1;1;1
250877990575;250877991450;875;0,1,2;3;9;1;1;1
250877991450;250877991662;212;0,1,2;3;9;1;1;1
250877991662;250877991892;230;0,1,2;3;9;1;1;1
250877991892;250877991985;93;0,1,2;3;9;1;1;1
250877991985;250877992117;132;0,1,2;3;9;1;1;1
250877992117;250877992160;43;0,1,2;3;9;1;1;1
250877992160;250877994263;2103;0,1,2;3;9;1;1;1
250877994263;250877994444;181;0,1,2;3;9;1;1;1
250877994444;250877995944;1500;0,1,2;3;9;1;1;1
250877995944;250877996113;169;0,1,2;3;9;1;1;1
250877996113;250877996724;611;0,1,2;3;9;1;1;1
250877996724;250877996951;227;0,1,2;3;9;1;1;1
250877996951;250878025508;28557;0,1,2;3;9;1;1;1
250878025508;250878025739;231;0,1,2;3;9;1;1;1
250878025739;250878026087;348;0,1,2;3;9;1;1;1
250878026087;250878026258;171;0,1,2;3;9;1;1;1
250878026258;250878030981;4723;0,1,2;3;9;1;1;1
250878030981;250878031152;171;0,1,2;3;9;1;1;1
250878031152;250878035775;4623;0,1,2;3;9;1;1;1
250878035775;250878036830;1055;0,1,2;3;9;1;1;1
250878036830;250878037693;863;0,1,2;3;9;1;1;1
250878037693;250878037774;81;0,1,2;3;9;1;1;1
250878037774;250878037845;71;0,1,2;3;9;1;1;1
250878037845;250878037991;146;0,1,2;3;9;1;1;1
250878037991;250878039335;1344;0,1,2;3;9;1;1;1
250878039335;250878039367;32;0,1,2;3;9;1;1;1
250878039367;250878039518;151;0,1,2;3;9;1;1;1
250878039518;250878039643;125;0,1,2;3;9;1;1;1
250878039643;250878040864;1221;0,1,2;3;9;1;1;1
250878040864;250878041033;169;0,1,2;3;9;1;1;1
250878041033;250878042125;1092;0,1,2;3;9;1;1;1
250878042125;250878042285;160;0,1,2;3;9;1;1;1
250878042285;250878049828;7543;0,1,2;3;9;1;1;1
250878049828;250878050013;185;0,1,2;3;9;1;1;1
250878050013;250878065371;15358;0,1,2;3;9;1;1;1
250878065371;250878078647;13276;0,1,2;3;9;1;1;1
250878078647;250878084445;5798;0,1,2;3;9;1;1;1
250878084445;250878084615;170;0,1,2;3;9;1;1;1
250878084615;250878094191;9576;0,1,2;3;9;1;1;1
250878094191;250878173599;79408;0,1,2;3;9;1;1;1
250878173599;250878173654;55;0,1,2;3;9;1;1;1
250878173654;250878194428;20774;0,1,2;3;9;1;1;1
250878194428;250878195913;1485;0,1,2;3;9;1;1;1
250878195913;250878216509;20596;0,1,2;3;9;1;1;1
250878216509;250878233139;16630;0,1,2;3;9;1;1;1
250878233139;250878233452;313;0,1,2;3;9;1;1;1
250878233452;250878238093;4641;0,1,2;3;9;1;1;1
250878238093;250878238120;27;0,1,2;3;9;1;1;1
250878238120;250878242706;4586;0,1,2;3;9;1;1;1
250878242706;250878242799;93;0,1,2;3;9;1;1;1
250878242799;250878244931;2132;0,1,2;3;9;1;1;1
250878244931;250878300998;56067;0,1,2;3;9;1;1;1
250878300998;250878310833;9835;0,1,2;3;9;1;1;1
250878310833;250878335458;24625;0,1,2;3;9;1;1;1
250878335458;250878430319;94861;0,1,2;3;9;1;1;1
250878430319;250878460317;29998;0,1,2;3;9;1;1;1
250878460317;250878465655;5338;0,1,2;3;9;1;1;1
250878465655;250878471341;5686;0,1,2;3;9;1;1;1
250878471341;250878477096;5755;0,1,2;3;9;1;1;1
250878477096;250878482846;5750;0,1,2;3;9;1;1;1
250878482846;250878484847;2001;0,1,2;3;9;1;1;1
250878484847;250878514075;29228;0,1,2;3;9;1;1;1
250878514075;250878532388;18313;0,1,2;3;9;1;1;1
250878532388;250878553008;20620;0,1,2;3;9;1;1;1
250878553008;250878566576;13568;0,1,2;3;9;1;1;1
250878566576;250878573352;6776;0,1,2;3;9;1;1;1
250878573352;250878573375;23;0,1,2;3;9;1;1;1
250878573375;250878575346;1971;0,1,2;3;9;1;1;1
250878575346;250878582768;7422;0,1,2;3;9;1;1;1
250878582768;250878584392;1624;0,1,2;3;9;1;1;1
250878584392;250878585905;1513;0,1,2;3;9;1;1;1
250878585905;250878631973;46068;0,1,2;3;9;1;1;1
250878631973;250878637278;5305;0,1,2;3;9;1;1;1
250878637278;250878649710;12432;0,1,2;3;9;1;1;1
250878649710;250878655256;5546;0,1,2;3;9;1;1;1
250878655256;250878655975;719;0,1,2;3;9;1;1;1
250878655975;250878717615;61640;0,1,2;3;9;1;1;1
250878717615;250878718806;1191;0,1,2;3;9;1;1;1
250878718806;250878725205;6399;0,1,2;3;9;1;1;1
250878725205;250878727014;1809;0,1,2;3;9;1;1;1
250878727014;250878727113;99;0,1,2;3;9;1;1;1
250878727113;250878728047;934;0,1,2;3;9;1;1;1
250878728047;250878730301;2254;0,1,2;3;9;1;1;1
250878730301;250878742505;12204;0,1,2;3;9;1;1;1
250878742505;250878743397;892;0,1,2;3;9;1;1;1
250878743397;250878750511;7114;0,1,2;3;9;1;1;1
250878750511;250878750819;308;0,1,2;3;9;1;1;1
250878750819;250878775920;25101;0,1,2;3;9;1;1;1
250878775920;250878781485;5565;0,1,2;3;9;1;1;1
250878781485;250878782978;1493;0,1,2;3;9;1;1;1
250878782978;250878789348;6370;0,1,2;3;9;1;1;1
250878789348;250878789536;188;0,1,2;3;9;1;1;1
250878789536;250878789559;23;0,1,2;3;9;1;1;1
250878789559;250878789585;26;0,1,2;3;9;1;1;1
250878789585;250878790446;861;0,1,2;3;9;1;1;1
250878790446;250878797212;6766;0,1,2;3;9;1;1;1
250878797212;250878797268;56;0,1,2;3;9;1;1;1
250878797268;250878797331;63;0,1,2;3;9;1;1;1
250878797331;250878798422;1091;0,1,2;3;9;1;1;1
250878798422;250878819350;20928;0,1,2;3;9;1;1;1
250878819350;250878838065;18715;0,1,2;3;9;1;1;1
250878838065;250878843401;5336;0,1,2;3;9;1;1;1
250878843401;250878844232;831;0,1,2;3;9;1;1;1
250878844232;250878845122;890;0,1,2;3;9;1;1;1
250878845122;250878856128;11006;0,1,2;3;9;1;1;1
250878856128;250878863957;7829;0,1,2;3;9;1;1;1
250878863957;250878873615;9658;0,1,2;3;9;1;1;1
250878873615;250878873808;193;0,1,2;3;9;1;1;1
250878873808;250878894088;20280;0,1,2;3;9;1;1;1
250878894088;250878900584;6496;0,1,2;3;9;1;1;1
250878900584;250878906354;5770;0,1,2;3;9;1;1;1
250878906354;250878926812;20458;0,1,2;3;9;1;1;1
250878926812;250878935205;8393;0,1,2;3;9;1;1;1
250878935205;250878951597;16392;0,1,2;3;9;1;1;1
250878951597;250878952613;1016;0,1,2;3;9;1;1;1
250878952613;250878966700;14087;0,1,2;3;9;1;1;1
250878966700;250878990686;23986;0,1,2;3;9;1;1;1
250878990686;250879013427;22741;0,1,2;3;9;1;1;1
250879013427;250879031496;18069;0,1,2;3;9;1;1;1
250879031496;250879032389;893;0,1,2;3;9;1;1;1
250879032389;250879042892;10503;0,1,2;3;9;1;1;1
250879042892;250879043791;899;0,1,2;3;9;1;1;1
250879043791;250879049358;5567;0,1,2;3;9;1;1;1
250879049358;250879053504;4146;0,1,2;3;9;1;1;1
250879053504;250879054063;559;0,1,2;3;9;1;1;1
250879054063;250879060335;6272;0,1,2;3;9;1;1;1
250879060335;250879065433;5098;0,1,2;3;9;1;1;1
250879065433;250879070667;5234;0,1,2;3;9;1;1;1
250879070667;250879080937;10270;0,1,2;3;9;1;1;1
250879080937;250879093849;12912;0,1,2;3;9;1;1;1
250879093849;250879098148;4299;0,1,2;3;9;1;1;1
250879098148;250879111989;13841;0,1,2;3;9;1;1;1
250879111989;250879114783;2794;0,1,2;3;9;1;1;1
250879114783;250879124033;9250;0,1,2;3;9;1;1;1
250879124033;250879128246;4213;0,1,2;3;9;1;1;1
250879128246;250879129047;801;0,1,2;3;9;1;1;1
250879129047;250879133297;4250;0,1,2;3;9;1;1;1
250879133297;250879135194;1897;0,1,2;3;9;1;1;1
250879135194;250879138852;3658;0,1,2;3;9;1;1;1
250879138852;250879139416;564;0,1,2;3;9;1;1;1
250879139416;250879139525;109;0,1,2;3;9;1;1;1
250879139525;250879148633;9108;0,1,2;3;9;1;1;1
250879148633;250879150119;1486;0,1,2;3;9;1;1;1
250879150119;250879154976;4857;0,1,2;3;9;1;1;1
250879154976;250879155244;268;0,1,2;3;9;1;1;1
250879155244;250879155706;462;0,1,2;3;9;1;1;1
250879155706;250879160770;5064;0,1,2;3;9;1;1;1
250879160770;250879172904;12134;0,1,2;3;9;1;1;1
250879172904;250879177939;5035;0,1,2;3;9;1;1;1
250879177939;250879178287;348;0,1,2;3;9;1;1;1
250879178287;250879180971;2684;0,1,2;3;9;1;1;1
250879180971;250879189156;8185;0,1,2;3;9;1;1;1
250879189156;250879194213;5057;0,1,2;3;9;1;1;1
250879194213;250879194955;742;0,1,2;3;9;1;1;1
250879194955;250879199493;4538;0,1,2;3;9;1;1;1
250879199493;250879201969;2476;0,1,2;3;9;1;1;1
250879201969;250879206611;4642;0,1,2;3;9;1;1;1
250879206611;250879212546;5935;0,1,2;3;9;1;1;1
250879212546;250879212986;440;0,1,2;3;9;1;1;1
250879212986;250879217348;4362;0,1,2;3;9;1;1;1
250879217348;250879217430;82;0,1,2;3;9;1;1;1
250879217430;250879242877;25447;0,1,2;3;9;1;1;1
250879242877;250879245986;3109;0,1,2;3;9;1;1;1
250879245986;250879252405;6419;0,1,2;3;9;1;1;1
250879252405;250879255871;3466;0,1,2;3;9;1;1;1
250879255871;250879261774;5903;0,1,2;3;9;1;1;1
250879261774;250879263831;2057;0,1,2;3;9;1;1;1
250879263831;250879266529;2698;0,1,2;3;9;1;1;1
250879266529;250879268019;1490;0,1,2;3;9;1;1;1
250879268019;250879270971;2952;0,1,2;3;9;1;1;1
250879270971;250879272851;1880;0,1,2;3;9;1;1;1
250879272851;250879274948;2097;0,1,2;3;9;1;1;1
250879274948;250879277693;2745;0,1,2;3;9;1;1;1
250879277693;250879277829;136;0,1,2;3;9;1;1;1
250879277829;250879278341;512;0,1,2;3;9;1;1;1
250879278341;250879278904;563;0,1,2;3;9;1;1;1
250879278904;250879280361;1457;0,1,2;3;9;1;1;1
250879280361;250879282901;2540;0,1,2;3;9;1;1;1
250879282901;250879284578;1677;0,1,2;3;9;1;1;1
250879284578;250879285382;804;0,1,2;3;9;1;1;1
250879285382;250879311328;25946;0,1,2;3;9;1;1;1
250879311328;250879322463;11135;0,1,2;3;9;1;1;1
250879322463;250879326340;3877;0,1,2;3;9;1;1;1
250879326340;250879328329;1989;0,1,2;3;9;1;1;1
250879328329;250879338471;10142;0,1,2;3;9;1;1;1
250879338471;250879342634;4163;0,1,2;3;9;1;1;1
250879342634;250879347964;5330;0,1,2;3;9;1;1;1
250879347964;250879353146;5182;0,1,2;3;9;1;1;1
250879353146;250879357632;4486;0,1,2;3;9;1;1;1
250879357632;250879358216;584;0,1,2;3;9;1;1;1
250879358216;250879361375;3159;0,1,2;3;9;1;1;1
250879361375;250879361988;613;0,1,2;3;9;1;1;1
250879361988;250879363810;1822;0,1,2;3;9;1;1;1
250879363810;250879376572;12762;0,1,2;3;9;1;1;1
250879376572;250879384254;7682;0,1,2;3;9;1;1;1
250879384254;250879394223;9969;0,1,2;3;9;1;1;1
250879394223;250879395556;1333;0,1,2;3;9;1;1;1
250879395556;250879398857;3301;0,1,2;3;9;1;1;1
250879398857;250879399422;565;0,1,2;3;9;1;1;1
250879399422;250879401113;1691;0,1,2;3;9;1;1;1
250879401113;250879404028;2915;0,1,2;3;9;1;1;1
250879404028;250879408267;4239;0,1,2;3;9;1;1;1
250879408267;250879419882;11615;0,1,2;3;9;1;1;1
250879419882;250879429228;9346;0,1,2;3;9;1;1;1
250879429228;250879432346;3118;0,1,2;3;9;1;1;1
250879432346;250879435766;3420;0,1,2;3;9;1;1;1
250879435766;250879438924;3158;0,1,2;3;9;1;1;1
250879438924;250879439424;500;0,1,2;3;9;1;1;1
250879439424;250879441723;2299;0,1,2;3;9;1;1;1
250879441723;250879442609;886;0,1,2;3;9;1;1;1
250879442609;250879470744;28135;0,1,2;3;9;1;1;1
250879470744;250879471304;560;0,1,2;3;9;1;1;1
250879471304;250879474131;2827;0,1,2;3;9;1;1;1
250879474131;250879476875;2744;0,1,2;3;9;1;1;1
250879476875;250879478298;1423;0,1,2;3;9;1;1;1
250879478298;250879490311;12013;0,1,2;3;9;1;1;1
250879490311;250879502698;12387;0,1,2;3;9;1;1;1
250879502698;250879507531;4833;0,1,2;3;9;1;1;1
250879507531;250879512016;4485;0,1,2;3;9;1;1;1
250879512016;250879512044;28;0,1,2;3;9;1;1;1
250879512044;250879512646;602;0,1,2;3;9;1;1;1
250879512646;250879513911;1265;0,1,2;3;9;1;1;1
250879513911;250879514373;462;0,1,2;3;9;1;1;1
250879514373;250879515141;768;0,1,2;3;9;1;1;1
250879515141;250879515634;493;0,1,2;3;9;1;1;1
250879515634;250879517128;1494;0,1,2;3;9;1;1;1
250879517128;250879528482;11354;0,1,2;3;9;1;1;1
250879528482;250879535649;7167;0,1,2;3;9;1;1;1
250879535649;250879536655;1006;0,1,2;3;9;1;1;1
250879536655;250879553072;16417;0,1,2;3;9;1;1;1
250879553072;250879556395;3323;0,1,2;3;9;1;1;1
250879556395;250879558556;2161;0,1,2;3;9;1;1;1
250879558556;250879560114;1558;0,1,2;3;9;1;1;1
250879560114;250879565457;5343;0,1,2;3;9;1;1;1
250879565457;250879565510;53;0,1,2;3;9;1;1;1
250879565510;250879565792;282;0,1,2;3;9;1;1;1
250879565792;250879566378;586;0,1,2;3;9;1;1;1
250879566378;250879569165;2787;0,1,2;3;9;1;1;1
250879569165;250879571167;2002;0,1,2;3;9;1;1;1
250879571167;250879575815;4648;0,1,2;3;9;1;1;1
250879575815;250879577143;1328;0,1,2;3;9;1;1;1
250879577143;250879578519;1376;0,1,2;3;9;1;1;1
250879578519;250879579360;841;0,1,2;3;9;1;1;1
250879579360;250879579451;91;0,1,2;3;9;1;1;1
250879579451;250879580782;1331;0,1,2;3;9;1;1;1
250879580782;250879585747;4965;0,1,2;3;9;1;1;1
250879585747;250879586136;389;0,1,2;3;9;1;1;1
250879586136;250879586229;93;0,1,2;3;9;1;1;1
250879586229;250879588563;2334;0,1,2;3;9;1;1;1
250879588563;250879591105;2542;0,1,2;3;9;1;1;1
250879591105;250879591107;2;0,1,2;3;9;1;1;1
250879591107;250879591268;161;0,1,2;3;9;1;1;1
250879591268;250879592028;760;0,1,2;3;9;1;1;1
250879592028;250879593608;1580;0,1,2;3;9;1;1;1
250879593608;250879595693;2085;0,1,2;3;9;1;1;1
250879595693;250879599872;4179;0,1,2;3;9;1;1;1
250879599872;250879602476;2604;0,1,2;3;9;1;1;1
250879602476;250879605851;3375;0,1,2;3;9;1;1;1
250879605851;250879615634;9783;0,1,2;3;9;1;1;1
250879615634;250879616376;742;0,1,2;3;9;1;1;1
250879616376;250879618397;2021;0,1,2;3;9;1;1;1
250879618397;250879621348;2951;0,1,2;3;9;1;1;1
250879621348;250879624237;2889;0,1,2;3;9;1;1;1
250879624237;250879628081;3844;0,1,2;3;9;1;1;1
250879628081;250879631267;3186;0,1,2;3;9;1;1;1
250879631267;250879632216;949;0,1,2;3;9;1;1;1
250879632216;250879632631;415;0,1,2;3;9;1;1;1
250879632631;250879640828;8197;0,1,2;3;9;1;1;1
250879640828;250879648058;7230;0,1,2;3;9;1;1;1
250879648058;250879648646;588;0,1,2;3;9;1;1;1
250879648646;250879652204;3558;0,1,2;3;9;1;1;1
250879652204;250879653582;1378;0,1,2;3;9;1;1;1
250879653582;250879654335;753;0,1,2;3;9;1;1;1
250879654335;250879656902;2567;0,1,2;3;9;1;1;1
250879656902;250879659446;2544;0,1,2;3;9;1;1;1
250879659446;250879682468;23022;0,1,2;3;9;1;1;1
250879682468;250879682540;72;0,1,2;3;9;1;1;1
250879682540;250879683561;1021;0,1,2;3;9;1;1;1
250879683561;250879683614;53;0,1,2;3;9;1;1;1
250879683614;250879683615;1;0,1,2;3;9;1;1;1
250879683615;250879683667;52;0,1,2;3;9;1;1;1
250879683667;250879683708;41;0,1,2;3;9;1;1;1
250879683708;250879689767;6059;0,1,2;3;9;1;1;1
250879689767;250879692014;2247;0,1,2;3;9;1;1;1
250879692014;250879692581;567;0,1,2;3;9;1;1;1
250879692581;250879694481;1900;0,1,2;3;9;1;1;1
250879694481;250879703762;9281;0,1,2;3;9;1;1;1
250879703762;250879704801;1039;0,1,2;3;9;1;1;1
250879704801;250879705495;694;0,1,2;3;9;1;1;1
250879705495;250879706257;762;0,1,2;3;9;1;1;1
250879706257;250879707895;1638;0,1,2;3;9;1;1;1
250879707895;250879707969;74;0,1,2;3;9;1;1;1
250879707969;250879708670;701;0,1,2;3;9;1;1;1
250879708670;250879711620;2950;0,1,2;3;9;1;1;1
250879711620;250879714067;2447;0,1,2;3;9;1;1;1
250879714067;250879716048;1981;0,1,2;3;9;1;1;1
250879716048;250879719893;3845;0,1,2;3;9;1;1;1
250879719893;250879721591;1698;0,1,2;3;9;1;1;1
250879721591;250879722047;456;0,1,2;3;9;1;1;1
250879722047;250879722873;826;0,1,2;3;9;1;1;1
250879722873;250879724679;1806;0,1,2;3;9;1;1;1
250879724679;250879725348;669;0,1,2;3;9;1;1;1
250879725348;250879728098;2750;0,1,2;3;9;1;1;1
250879728098;250879728139;41;0,1,2;3;9;1;1;1
250879728139;250879730581;2442;0,1,2;3;9;1;1;1
250879730581;250879731425;844;0,1,2;3;9;1;1;1
250879731425;250879732852;1427;0,1,2;3;9;1;1;1
250879732852;250879733868;1016;0,1,2;3;9;1;1;1
250879733868;250879735366;1498;0,1,2;3;9;1;1;1
250879735366;250879736451;1085;0,1,2;3;9;1;1;1
250879736451;250879739940;3489;0,1,2;3;9;1;1;1
250879739940;250879743996;4056;0,1,2;3;9;1;1;1
250879743996;250879748645;4649;0,1,2;3;9;1;1;1
250879748645;250879749297;652;0,1,2;3;9;1;1;1
250879749297;250879750738;1441;0,1,2;3;9;1;1;1
250879750738;250879751572;834;0,1,2;3;9;1;1;1
250879751572;250879753488;1916;0,1,2;3;9;1;1;1
250879753488;250879754682;1194;0,1,2;3;9;1;1;1
250879754682;250879755758;1076;0,1,2;3;9;1;1;1
250879755758;250879756181;423;0,1,2;3;9;1;1;1
250879756181;250879759004;2823;0,1,2;3;9;1;1;1
250879759004;250879760530;1526;0,1,2;3;9;1;1;1
250879760530;250879761088;558;0,1,2;3;9;1;1;1
250879761088;250879764763;3675;0,1,2;3;9;1;1;1
250879764763;250879764960;197;0,1,2;3;9;1;1;1
250879764960;250879766112;1152;0,1,2;3;9;1;1;1
250879766112;250879768878;2766;0,1,2;3;9;1;1;1
250879768878;250879768908;30;0,1,2;3;9;1;1;1
250879768908;250879769835;927;0,1,2;3;9;1;1;1
250879769835;250879770034;199;0,1,2;3;9;1;1;1
250879770034;250879770090;56;0,1,2;3;9;1;1;1
250879770090;250879776444;6354;0,1,2;3;9;1;1;1
250879776444;250879776471;27;0,1,2;3;9;1;1;1
250879776471;250879779255;2784;0,1,2;3;9;1;1;1
250879779255;250879780165;910;0,1,2;3;9;1;1;1
250879780165;250879780267;102;0,1,2;3;9;1;1;1
250879780267;250879781632;1365;0,1,2;3;9;1;1;1
250879781632;250879783969;2337;0,1,2;3;9;1;1;1
250879783969;250879784532;563;0,1,2;3;9;1;1;1
250879784532;250879788963;4431;0,1,2;3;9;1;1;1
250879788963;250879789277;314;0,1,2;3;9;1;1;1
250879789277;250879790303;1026;0,1,2;3;9;1;1;1
250879790303;250879791551;1248;0,1,2;3;9;1;1;1
250879791551;250879792753;1202;0,1,2;3;9;1;1;1
250879792753;250879807282;14529;0,1,2;3;9;1;1;1
250879807282;250879807370;88;0,1,2;3;9;1;1;1
250879807370;250879813310;5940;0,1,2;3;9;1;1;1
250879813310;250879814389;1079;0,1,2;3;9;1;1;1
250879814389;250879818237;3848;0,1,2;3;9;1;1;1
250879818237;250879818424;187;0,1,2;3;9;1;1;1
250879818424;250879823796;5372;0,1,2;3;9;1;1;1
250879823796;250879827844;4048;0,1,2;3;9;1;1;1
250879827844;250879828669;825;0,1,2;3;9;1;1;1
250879828669;250879829458;789;0,1,2;3;9;1;1;1
250879829458;250879838111;8653;0,1,2;3;9;1;1;1
250879838111;250879838628;517;0,1,2;3;9;1;1;1
250879838628;250879839081;453;0,1,2;3;9;1;1;1
250879839081;250879839898;817;0,1,2;3;9;1;1;1
250879839898;250879840289;391;0,1,2;3;9;1;1;1
250879840289;250879840416;127;0,1,2;3;9;1;1;1
250879840416;250879845915;5499;0,1,2;3;9;1;1;1
250879845915;250879849247;3332;0,1,2;3;9;1;1;1
250879849247;250879849482;235;0,1,2;3;9;1;1;1
250879849482;250879850863;1381;0,1,2;3;9;1;1;1
250879850863;250879850920;57;0,1,2;3;9;1;1;1
250879850920;250879851024;104;0,1,2;3;9;1;1;1
250879851024;250879854200;3176;0,1,2;3;9;1;1;1
250879854200;250879855176;976;0,1,2;3;9;1;1;1
250879855176;250879855417;241;0,1,2;3;9;1;1;1
250879855417;250879855542;125;0,1,2;3;9;1;1;1
250879855542;250879858209;2667;0,1,2;3;9;1;1;1
250879858209;250879859722;1513;0,1,2;3;9;1;1;1
250879859722;250879860063;341;0,1,2;3;9;1;1;1
250879860063;250879860083;20;0,1,2;3;9;1;1;1
250879860083;250879860828;745;0,1,2;3;9;1;1;1
250879860828;250879862369;1541;0,1,2;3;9;1;1;1
250879862369;250879863799;1430;0,1,2;3;9;1;1;1
250879863799;250879863866;67;0,1,2;3;9;1;1;1
250879863866;250879867308;3442;0,1,2;3;9;1;1;1
250879867308;250879870305;2997;0,1,2;3;9;1;1;1
250879870305;250879871098;793;0,1,2;3;9;1;1;1
250879871098;250879871488;390;0,1,2;3;9;1;1;1
250879871488;250879871735;247;0,1,2;3;9;1;1;1
250879871735;250879872557;822;0,1,2;3;9;1;1;1
250879872557;250879876149;3592;0,1,2;3;9;1;1;1
250879876149;250879876327;178;0,1,2;3;9;1;1;1
250879876327;250879876423;96;0,1,2;3;9;1;1;1
250879876423;250879876662;239;0,1,2;3;9;1;1;1
250879876662;250879880794;4132;0,1,2;3;9;1;1;1
250879880794;250879881151;357;0,1,2;3;9;1;1;1
250879881151;250879883554;2403;0,1,2;3;9;1;1;1
250879883554;250879886658;3104;0,1,2;3;9;1;1;1
250879886658;250879890728;4070;0,1,2;3;9;1;1;1
250879890728;250879894410;3682;0,1,2;3;9;1;1;1
250879894410;250879897124;2714;0,1,2;3;9;1;1;1
250879897124;250879897174;50;0,1,2;3;9;1;1;1
250879897174;250879901298;4124;0,1,2;3;9;1;1;1
250879901298;250879901788;490;0,1,2;3;9;1;1;1
250879901788;250879902015;227;0,1,2;3;9;1;1;1
250879902015;250879902743;728;0,1,2;3;9;1;1;1
250879902743;250879905813;3070;0,1,2;3;9;1;1;1
250879905813;250879906563;750;0,1,2;3;9;1;1;1
250879906563;250879906805;242;0,1,2;3;9;1;1;1
250879906805;250879911303;4498;0,1,2;3;9;1;1;1
250879911303;250879911484;181;0,1,2;3;9;1;1;1
250879911484;250879912245;761;0,1,2;3;9;1;1;1
250879912245;250879915543;3298;0,1,2;3;9;1;1;1
250879915543;250879917034;1491;0,1,2;3;9;1;1;1
250879917034;250879919609;2575;0,1,2;3;9;1;1;1
250879919609;250879919652;43;0,1,2;3;9;1;1;1
250879919652;250879923065;3413;0,1,2;3;9;1;1;1
250879923065;250879924597;1532;0,1,2;3;9;1;1;1
250879924597;250879925638;1041;0,1,2;3;9;1;1;1
250879925638;250879925700;62;0,1,2;3;9;1;1;1
250879925700;250879925992;292;0,1,2;3;9;1;1;1
250879925992;250879927798;1806;0,1,2;3;9;1;1;1
250879927798;250879929277;1479;0,1,2;3;9;1;1;1
250879929277;250879929713;436;0,1,2;3;9;1;1;1
250879929713;250879930410;697;0,1,2;3;9;1;1;1
250879930410;250879930991;581;0,1,2;3;9;1;1;1
250879930991;250879931027;36;0,1,2;3;9;1;1;1
250879931027;250879935171;4144;0,1,2;3;9;1;1;1
250879935171;250879935551;380;0,1,2;3;9;1;1;1
250879935551;250879935585;34;0,1,2;3;9;1;1;1
250879935585;250879943442;7857;0,1,2;3;9;1;1;1
250879943442;250879943856;414;0,1,2;3;9;1;1;1
250879943856;250879944589;733;0,1,2;3;9;1;1;1
250879944589;250879946691;2102;0,1,2;3;9;1;1;1
250879946691;250879946956;265;0,1,2;3;9;1;1;1
250879946956;250879948488;1532;0,1,2;3;9;1;1;1
250879948488;250879952988;4500;0,1,2;3;9;1;1;1
250879952988;250879955611;2623;0,1,2;3;9;1;1;1
250879955611;250879958411;2800;0,1,2;3;9;1;1;1
250879958411;250879958502;91;0,1,2;3;9;1;1;1
250879958502;250879958656;154;0,1,2;3;9;1;1;1
250879958656;250879961657;3001;0,1,2;3;9;1;1;1
250879961657;250879962183;526;0,1,2;3;9;1;1;1
250879962183;250879966308;4125;0,1,2;3;9;1;1;1
250879966308;250879969483;3175;0,1,2;3;9;1;1;1
250879969483;250879970635;1152;0,1,2;3;9;1;1;1
250879970635;250879970812;177;0,1,2;3;9;1;1;1
250879970812;250879971907;1095;0,1,2;3;9;1;1;1
250879971907;250879971952;45;0,1,2;3;9;1;1;1
250879971952;250879974447;2495;0,1,2;3;9;1;1;1
250879974447;250879974572;125;0,1,2;3;9;1;1;1
250879974572;250879974728;156;0,1,2;3;9;1;1;1
250879974728;250879980455;5727;0,1,2;3;9;1;1;1
250879980455;250879980611;156;0,1,2;3;9;1;1;1
250879980611;250879981285;674;0,1,2;3;9;1;1;1
250879981285;250879981604;319;0,1,2;3;9;1;1;1
250879981604;250879984892;3288;0,1,2;3;9;1;1;1
250879984892;250879985050;158;0,1,2;3;9;1;1;1
250879985050;250879985838;788;0,1,2;3;9;1;1;1
250879985838;250879987280;1442;0,1,2;3;9;1;1;1
250879987280;250879987495;215;0,1,2;3;9;1;1;1
250879987495;250879988551;1056;0,1,2;3;9;1;1;1
250879988551;250879989524;973;0,1,2;3;9;1;1;1
250879989524;250879991011;1487;0,1,2;3;9;1;1;1
250879991011;250879991365;354;0,1,2;3;9;1;1;1
250879991365;250879991521;156;0,1,2;3;9;1;1;1
250879991521;250879993094;1573;0,1,2;3;9;1;1;1
250879993094;250879993165;71;0,1,2;3;9;1;1;1
250879993165;250879993206;41;0,1,2;3;9;1;1;1
250879993206;250879993320;114;0,1,2;3;9;1;1;1
250879993320;250879993531;211;0,1,2;3;9;1;1;1
250879993531;250880001830;8299;0,1,2;3;9;1;1;1
250880001830;250880002137;307;0,1,2;3;9;1;1;1
250880002137;250880003150;1013;0,1,2;3;9;1;1;1
250880003150;250880003352;202;0,1,2;3;9;1;1;1
250880003352;250880004690;1338;0,1,2;3;9;1;1;1
250880004690;250880004887;197;0,1,2;3;9;1;1;1
250880004887;250880009253;4366;0,1,2;3;9;1;1;1
250880009253;250880014551;5298;0,1,2;3;9;1;1;1
250880014551;250880014679;128;0,1,2;3;9;1;1;1
250880014679;250880015337;658;0,1,2;3;9;1;1;1
250880015337;250880015583;246;0,1,2;3;9;1;1;1
250880015583;250880018409;2826;0,1,2;3;9;1;1;1
250880018409;250880018743;334;0,1,2;3;9;1;1;1
250880018743;250880018801;58;0,1,2;3;9;1;1;1
250880018801;250880018893;92;0,1,2;3;9;1;1;1
250880018893;250880021057;2164;0,1,2;3;9;1;1;1
250880021057;250880021877;820;0,1,2;3;9;1;1;1
250880021877;250880021980;103;0,1,2;3;9;1;1;1
250880021980;250880022089;109;0,1,2;3;9;1;1;1
250880022089;250880022297;208;0,1,2;3;9;1;1;1
250880022297;250880024935;2638;0,1,2;3;9;1;1;1
250880024935;250880026988;2053;0,1,2;3;9;1;1;1
250880026988;250880032659;5671;0,1,2;3;9;1;1;1
250880032659;250880033014;355;0,1,2;3;9;1;1;1
250880033014;250880033679;665;0,1,2;3;9;1;1;1
250880033679;250880034982;1303;0,1,2;3;9;1;1;1
250880034982;250880035173;191;0,1,2;3;9;1;1;1
250880035173;250880035890;717;0,1,2;3;9;1;1;1
250880035890;250880036175;285;0,1,2;3;9;1;1;1
250880036175;250880036330;155;0,1,2;3;9;1;1;1
250880036330;250880036443;113;0,1,2;3;9;1;1;1
250880036443;250880040248;3805;0,1,2;3;9;1;1;1
250880040248;250880048210;7962;0,1,2;3;9;1;1;1
250880048210;250880048336;126;0,1,2;3;9;1;1;1
250880048336;250880049000;664;0,1,2;3;9;1;1;1
250880049000;250880050673;1673;0,1,2;3;9;1;1;1
250880050673;250880050754;81;0,1,2;3;9;1;1;1
250880050754;250880051757;1003;0,1,2;3;9;1;1;1
250880051757;250880060796;9039;0,1,2;3;9;1;1;1
250880060796;250880061532;736;0,1,2;3;9;1;1;1
250880061532;250880061684;152;0,1,2;3;9;1;1;1
250880061684;250880062718;1034;0,1,2;3;9;1;1;1
250880062718;250880062873;155;0,1,2;3;9;1;1;1
250880062873;250880065513;2640;0,1,2;3;9;1;1;1
250880065513;250880071206;5693;0,1,2;3;9;1;1;1
250880071206;250880071422;216;0,1,2;3;9;1;1;1
250880071422;250880072724;1302;0,1,2;3;9;1;1;1
250880072724;250880073185;461;0,1,2;3;9;1;1;1
250880073185;250880076596;3411;0,1,2;3;9;1;1;1
250880076596;250880076728;132;0,1,2;3;9;1;1;1
250880076728;250880078517;1789;0,1,2;3;9;1;1;1
250880078517;250880082940;4423;0,1,2;3;9;1;1;1
250880082940;250880082974;34;0,1,2;3;9;1;1;1
250880082974;250880084332;1358;0,1,2;3;9;1;1;1
250880084332;250880091022;6690;0,1,2;3;9;1;1;1
250880091022;250880091180;158;0,1,2;3;9;1;1;1
250880091180;250880093981;2801;0,1,2;3;9;1;1;1
250880093981;250880094683;702;0,1,2;3;9;1;1;1
250880094683;250880094955;272;0,1,2;3;9;1;1;1
250880094955;250880096246;1291;0,1,2;3;9;1;1;1
250880096246;250880103607;7361;0,1,2;3;9;1;1;1
250880103607;250880103795;188;0,1,2;3;9;1;1;1
250880103795;250880113092;9297;0,1,2;3;9;1;1;1
250880113092;250880113114;22;0,1,2;3;9;1;1;1
250880113114;250880113599;485;0,1,2;3;9;1;1;1
250880113599;250880117343;3744;0,1,2;3;9;1;1;1
250880117343;250880117348;5;0,1,2;3;9;1;1;1
250880117348;250880118768;1420;0,1,2;3;9;1;1;1
250880118768;250880125501;6733;0,1,2;3;9;1;1;1
250880125501;250880127453;1952;0,1,2;3;9;1;1;1
250880127453;250880129588;2135;0,1,2;3;9;1;1;1
250880129588;250880137374;7786;0,1,2;3;9;1;1;1
250880137374;250880139275;1901;0,1,2;3;9;1;1;1
250880139275;250880139474;199;0,1,2;3;9;1;1;1
250880139474;250880142751;3277;0,1,2;3;9;1;1;1
250880142751;250880143948;1197;0,1,2;3;9;1;1;1
250880143948;250880144898;950;0,1,2;3;9;1;1;1
250880144898;250880145468;570;0,1,2;3;9;1;1;1
250880145468;250880146512;1044;0,1,2;3;9;1;1;1
250880146512;250880148415;1903;0,1,2;3;9;1;1;1
250880148415;250880148438;23;0,1,2;3;9;1;1;1
250880148438;250880148596;158;0,1,2;3;9;1;1;1
250880148596;250880151192;2596;0,1,2;3;9;1;1;1
250880151192;250880154696;3504;0,1,2;3;9;1;1;1
250880154696;250880154856;160;0,1,2;3;9;1;1;1
250880154856;250880155933;1077;0,1,2;3;9;1;1;1
250880155933;250880156489;556;0,1,2;3;9;1;1;1
250880156489;250880156623;134;0,1,2;3;9;1;1;1
250880156623;250880163906;7283;0,1,2;3;9;1;1;1
250880163906;250880167293;3387;0,1,2;3;9;1;1;1
250880167293;250880171407;4114;0,1,2;3;9;1;1;1
250880171407;250880172756;1349;0,1,2;3;9;1;1;1
250880172756;250880173235;479;0,1,2;3;9;1;1;1
250880173235;250880173256;21;0,1,2;3;9;1;1;1
250880173256;250880173533;277;0,1,2;3;9;1;1;1
250880173533;250880173707;174;0,1,2;3;9;1;1;1
250880173707;250880178601;4894;0,1,2;3;9;1;1;1
250880178601;250880181805;3204;0,1,2;3;9;1;1;1
250880181805;250880183312;1507;0,1,2;3;9;1;1;1
250880183312;250880183530;218;0,1,2;3;9;1;1;1
250880183530;250880183758;228;0,1,2;3;9;1;1;1
250880183758;250880185174;1416;0,1,2;3;9;1;1;1
250880185174;250880185498;324;0,1,2;3;9;1;1;1
250880185498;250880185525;27;0,1,2;3;9;1;1;1
250880185525;250880188231;2706;0,1,2;3;9;1;1;1
250880188231;250880189841;1610;0,1,2;3;9;1;1;1
250880189841;250880189953;112;0,1,2;3;9;1;1;1
250880189953;250880190112;159;0,1,2;3;9;1;1;1
250880190112;250880192061;1949;0,1,2;3;9;1;1;1
250880192061;250880192077;16;0,1,2;3;9;1;1;1
250880192077;250880192357;280;0,1,2;3;9;1;1;1
250880192357;250880194363;2006;0,1,2;3;9;1;1;1
250880194363;250880198853;4490;0,1,2;3;9;1;1;1
250880198853;250880201361;2508;0,1,2;3;9;1;1;1
250880201361;250880202326;965;0,1,2;3;9;1;1;1
250880202326;250880204393;2067;0,1,2;3;9;1;1;1
250880204393;250880207878;3485;0,1,2;3;9;1;1;1
250880207878;250880208056;178;0,1,2;3;9;1;1;1
250880208056;250880211322;3266;0,1,2;3;9;1;1;1
250880211322;250880214156;2834;0,1,2;3;9;1;1;1
250880214156;250880214704;548;0,1,2;3;9;1;1;1
250880214704;250880216137;1433;0,1,2;3;9;1;1;1
250880216137;250880219432;3295;0,1,2;3;9;1;1;1
250880219432;250880221646;2214;0,1,2;3;9;1;1;1
250880221646;250880222666;1020;0,1,2;3;9;1;1;1
250880222666;250880225348;2682;0,1,2;3;9;1;1;1
250880225348;250880226202;854;0,1,2;3;9;1;1;1
250880226202;250880230960;4758;0,1,2;3;9;1;1;1
250880230960;250880234799;3839;0,1,2;3;9;1;1;1
250880234799;250880236971;2172;0,1,2;3;9;1;1;1
250880236971;250880242434;5463;0,1,2;3;9;1;1;1
250880242434;250880247780;5346;0,1,2;3;9;1;1;1
250880247780;250880248291;511;0,1,2;3;9;1;1;1
250880248291;250880248335;44;0,1,2;3;9;1;1;1
250880248335;250880249693;1358;0,1,2;3;9;1;1;1
250880249693;250880249868;175;0,1,2;3;9;1;1;1
250880249868;250880252309;2441;0,1,2;3;9;1;1;1
250880252309;250880253662;1353;0,1,2;3;9;1;1;1
250880253662;250880259758;6096;0,1,2;3;9;1;1;1
250880259758;250880259781;23;0,1,2;3;9;1;1;1
250880259781;250880263294;3513;0,1,2;3;9;1;1;1
250880263294;250880271587;8293;0,1,2;3;9;1;1;1
250880271587;250880272835;1248;0,1,2;3;9;1;1;1
250880272835;250880276533;3698;0,1,2;3;9;1;1;1
250880276533;250880281906;5373;0,1,2;3;9;1;1;1
250880281906;250880283431;1525;0,1,2;3;9;1;1;1
250880283431;250880284028;597;0,1,2;3;9;1;1;1
250880284028;250880287389;3361;0,1,2;3;9;1;1;1
250880287389;250880289327;1938;0,1,2;3;9;1;1;1
250880289327;250880289565;238;0,1,2;3;9;1;1;1
250880289565;250880297121;7556;0,1,2;3;9;1;1;1
250880297121;250880299262;2141;0,1,2;3;9;1;1;1
250880299262;250880299304;42;0,1,2;3;9;1;1;1
250880299304;250880300523;1219;0,1,2;3;9;1;1;1
250880300523;250880304734;4211;0,1,2;3;9;1;1;1
250880304734;250880305910;1176;0,1,2;3;9;1;1;1
250880305910;250880312008;6098;0,1,2;3;9;1;1;1
250880312008;250880312192;184;0,1,2;3;9;1;1;1
250880312192;250880313005;813;0,1,2;3;9;1;1;1
250880313005;250880313308;303;0,1,2;3;9;1;1;1
250880313308;250880313564;256;0,1,2;3;9;1;1;1
250880313564;250880315139;1575;0,1,2;3;9;1;1;1
250880315139;250880317472;2333;0,1,2;3;9;1;1;1
250880317472;250880318182;710;0,1,2;3;9;1;1;1
250880318182;250880322896;4714;0,1,2;3;9;1;1;1
250880322896;250880322958;62;0,1,2;3;9;1;1;1
250880322958;250880324156;1198;0,1,2;3;9;1;1;1
250880324156;250880324330;174;0,1,2;3;9;1;1;1
250880324330;250880326888;2558;0,1,2;3;9;1;1;1
250880326888;250880330027;3139;0,1,2;3;9;1;1;1
250880330027;250880330810;783;0,1,2;3;9;1;1;1
250880330810;250880332019;1209;0,1,2;3;9;1;1;1
250880332019;250880332376;357;0,1,2;3;9;1;1;1
250880332376;250880334052;1676;0,1,2;3;9;1;1;1
250880334052;250880334276;224;0,1,2;3;9;1;1;1
250880334276;250880334451;175;0,1,2;3;9;1;1;1
250880334451;250880334912;461;0,1,2;3;9;1;1;1
250880334912;250880335746;834;0,1,2;3;9;1;1;1
250880335746;250880335914;168;0,1,2;3;9;1;1;1
250880335914;250880339193;3279;0,1,2;3;9;1;1;1
250880339193;250880339312;119;0,1,2;3;9;1;1;1
250880339312;250880339351;39;0,1,2;3;9;1;1;1
250880339351;250880342880;3529;0,1,2;3;9;1;1;1
250880342880;250880343076;196;0,1,2;3;9;1;1;1
250880343076;250880346180;3104;0,1,2;3;9;1;1;1
250880346180;250880346467;287;0,1,2;3;9;1;1;1
250880346467;250880346768;301;0,1,2;3;9;1;1;1
250880346768;250880347040;272;0,1,2;3;9;1;1;1
250880347040;250880347525;485;0,1,2;3;9;1;1;1
250880347525;250880347741;216;0,1,2;3;9;1;1;1
250880347741;250880348308;567;0,1,2;3;9;1;1;1
250880348308;250880348331;23;0,1,2;3;9;1;1;1
250880348331;250880348759;428;0,1,2;3;9;1;1;1
250880348759;250880351343;2584;0,1,2;3;9;1;1;1
250880351343;250880351881;538;0,1,2;3;9;1;1;1
250880351881;250880352656;775;0,1,2;3;9;1;1;1
250880352656;250880353794;1138;0,1,2;3;9;1;1;1
250880353794;250880355017;1223;0,1,2;3;9;1;1;1
250880355017;250880356614;1597;0,1,2;3;9;1;1;1
250880356614;250880356855;241;0,1,2;3;9;1;1;1
250880356855;250880357339;484;0,1,2;3;9;1;1;1
250880357339;250880357608;269;0,1,2;3;9;1;1;1
250880357608;250880357769;161;0,1,2;3;9;1;1;1
250880357769;250880358145;376;0,1,2;3;9;1;1;1
250880358145;250880358298;153;0,1,2;3;9;1;1;1
250880358298;250880360422;2124;0,1,2;3;9;1;1;1
250880360422;250880367400;6978;0,1,2;3;9;1;1;1
250880367400;250880367745;345;0,1,2;3;9;1;1;1
250880367745;250880367777;32;0,1,2;3;9;1;1;1
250880367777;250880367868;91;0,1,2;3;9;1;1;1
250880367868;250880368366;498;0,1,2;3;9;1;1;1
250880368366;250880371303;2937;0,1,2;3;9;1;1;1
250880371303;250880377289;5986;0,1,2;3;9;1;1;1
250880377289;250880377468;179;0,1,2;3;9;1;1;1
250880377468;250880380664;3196;0,1,2;3;9;1;1;1
250880380664;250880385284;4620;0,1,2;3;9;1;1;1
250880385284;250880386313;1029;0,1,2;3;9;1;1;1
250880386313;250880387478;1165;0,1,2;3;9;1;1;1
250880387478;250880387751;273;0,1,2;3;9;1;1;1
250880387751;250880387814;63;0,1,2;3;9;1;1;1
250880387814;250880388932;1118;0,1,2;3;9;1;1;1
250880388932;250880389090;158;0,1,2;3;9;1;1;1
250880389090;250880391629;2539;0,1,2;3;9;1;1;1
250880391629;250880391825;196;0,1,2;3;9;1;1;1
250880391825;250880399335;7510;0,1,2;3;9;1;1;1
250880399335;250880399816;481;0,1,2;3;9;1;1;1
250880399816;250880402042;2226;0,1,2;3;9;1;1;1
250880402042;250880402297;255;0,1,2;3;9;1;1;1
250880402297;250880402634;337;0,1,2;3;9;1;1;1
250880402634;250880404144;1510;0,1,2;3;9;1;1;1
250880404144;250880404400;256;0,1,2;3;9;1;1;1
250880404400;250880408139;3739;0,1,2;3;9;1;1;1
250880408139;250880408231;92;0,1,2;3;9;1;1;1
250880408231;250880410797;2566;0,1,2;3;9;1;1;1
250880410797;250880412452;1655;0,1,2;3;9;1;1;1
250880412452;250880414111;1659;0,1,2;3;9;1;1;1
250880414111;250880416793;2682;0,1,2;3;9;1;1;1
250880416793;250880420876;4083;0,1,2;3;9;1;1;1
250880420876;250880423519;2643;0,1,2;3;9;1;1;1
250880423519;250880425948;2429;0,1,2;3;9;1;1;1
250880425948;250880426778;830;0,1,2;3;9;1;1;1
250880426778;250880426882;104;0,1,2;3;9;1;1;1
250880426882;250880427050;168;0,1,2;3;9;1;1;1
250880427050;250880428138;1088;0,1,2;3;9;1;1;1
250880428138;250880428357;219;0,1,2;3;9;1;1;1
250880428357;250880431848;3491;0,1,2;3;9;1;1;1
250880431848;250880431887;39;0,1,2;3;9;1;1;1
250880431887;250880434065;2178;0,1,2;3;9;1;1;1
250880434065;250880434709;644;0,1,2;3;9;1;1;1
250880434709;250880434770;61;0,1,2;3;9;1;1;1
250880434770;250880434827;57;0,1,2;3;9;1;1;1
250880434827;250880434942;115;0,1,2;3;9;1;1;1
250880434942;250880435124;182;0,1,2;3;9;1;1;1
250880435124;250880436804;1680;0,1,2;3;9;1;1;1
250880436804;250880441677;4873;0,1,2;3;9;1;1;1
250880441677;250880444654;2977;0,1,2;3;9;1;1;1
250880444654;250880445702;1048;0,1,2;3;9;1;1;1
250880445702;250880445788;86;0,1,2;3;9;1;1;1
250880445788;250880447586;1798;0,1,2;3;9;1;1;1
250880447586;250880448291;705;0,1,2;3;9;1;1;1
250880448291;250880449028;737;0,1,2;3;9;1;1;1
250880449028;250880449044;16;0,1,2;3;9;1;1;1
250880449044;250880449254;210;0,1,2;3;9;1;1;1
250880449254;250880449604;350;0,1,2;3;9;1;1;1
250880449604;250880449900;296;0,1,2;3;9;1;1;1
250880449900;250880450222;322;0,1,2;3;9;1;1;1
250880450222;250880450382;160;0,1,2;3;9;1;1;1
250880450382;250880451294;912;0,1,2;3;9;1;1;1
250880451294;250880451334;40;0,1,2;3;9;1;1;1
250880451334;250880451385;51;0,1,2;3;9;1;1;1
250880451385;250880454381;2996;0,1,2;3;9;1;1;1
250880454381;250880454491;110;0,1,2;3;9;1;1;1
250880454491;250880457679;3188;0,1,2;3;9;1;1;1
250880457679;250880458820;1141;0,1,2;3;9;1;1;1
250880458820;250880459158;338;0,1,2;3;9;1;1;1
250880459158;250880460797;1639;0,1,2;3;9;1;1;1
250880460797;250880460972;175;0,1,2;3;9;1;1;1
250880460972;250880462635;1663;0,1,2;3;9;1;1;1
250880462635;250880465645;3010;0,1,2;3;9;1;1;1
250880465645;250880469144;3499;0,1,2;3;9;1;1;1
250880469144;250880469433;289;0,1,2;3;9;1;1;1
250880469433;250880469724;291;0,1,2;3;9;1;1;1
250880469724;250880471145;1421;0,1,2;3;9;1;1;1
250880471145;250880471231;86;0,1,2;3;9;1;1;1
250880471231;250880471399;168;0,1,2;3;9;1;1;1
250880471399;250880471555;156;0,1,2;3;9;1;1;1
250880471555;250880471784;229;0,1,2;3;9;1;1;1
250880471784;250880473129;1345;0,1,2;3;9;1;1;1
250880473129;250880473292;163;0,1,2;3;9;1;1;1
250880473292;250880475576;2284;0,1,2;3;9;1;1;1
250880475576;250880475784;208;0,1,2;3;9;1;1;1
250880475784;250880477417;1633;0,1,2;3;9;1;1;1
250880477417;250880477611;194;0,1,2;3;9;1;1;1
250880477611;250880479523;1912;0,1,2;3;9;1;1;1
250880479523;250880480391;868;0,1,2;3;9;1;1;1
250880480391;250880481884;1493;0,1,2;3;9;1;1;1
250880481884;250880482130;246;0,1,2;3;9;1;1;1
250880482130;250880482928;798;0,1,2;3;9;1;1;1
250880482928;250880483161;233;0,1,2;3;9;1;1;1
250880483161;250880483889;728;0,1,2;3;9;1;1;1
250880483889;250880486626;2737;0,1,2;3;9;1;1;1
250880486626;250880489685;3059;0,1,2;3;9;1;1;1
250880489685;250880495441;5756;0,1,2;3;9;1;1;1
250880495441;250880495643;202;0,1,2;3;9;1;1;1
250880495643;250880500032;4389;0,1,2;3;9;1;1;1
250880500032;250880503208;3176;0,1,2;3;9;1;1;1
250880503208;250880504656;1448;0,1,2;3;9;1;1;1
250880504656;250880505562;906;0,1,2;3;9;1;1;1
250880505562;250880505958;396;0,1,2;3;9;1;1;1
250880505958;250880505995;37;0,1,2;3;9;1;1;1
250880505995;250880506283;288;0,1,2;3;9;1;1;1
250880506283;250880506790;507;0,1,2;3;9;1;1;1
250880506790;250880508382;1592;0,1,2;3;9;1;1;1
250880508382;250880509618;1236;0,1,2;3;9;1;1;1
250880509618;250880509789;171;0,1,2;3;9;1;1;1
250880509789;250880511755;1966;0,1,2;3;9;1;1;1
250880511755;250880511912;157;0,1,2;3;9;1;1;1
250880511912;250880512036;124;0,1,2;3;9;1;1;1
250880512036;250880513301;1265;0,1,2;3;9;1;1;1
250880513301;250880514414;1113;0,1,2;3;9;1;1;1
250880514414;250880516525;2111;0,1,2;3;9;1;1;1
250880516525;250880517542;1017;0,1,2;3;9;1;1;1
250880517542;250880517698;156;0,1,2;3;9;1;1;1
250880517698;250880518189;491;0,1,2;3;9;1;1;1
250880518189;250880518441;252;0,1,2;3;9;1;1;1
250880518441;250880518616;175;0,1,2;3;9;1;1;1
250880518616;250880519613;997;0,1,2;3;9;1;1;1
250880519613;250880519733;120;0,1,2;3;9;1;1;1
250880519733;250880520034;301;0,1,2;3;9;1;1;1
250880520034;250880520488;454;0,1,2;3;9;1;1;1
250880520488;250880520740;252;0,1,2;3;9;1;1;1
250880520740;250880520779;39;0,1,2;3;9;1;1;1
250880520779;250880521724;945;0,1,2;3;9;1;1;1
250880521724;250880522137;413;0,1,2;3;9;1;1;1
250880522137;250880522784;647;0,1,2;3;9;1;1;1
250880522784;250880523131;347;0,1,2;3;9;1;1;1
250880523131;250880524823;1692;0,1,2;3;9;1;1;1
250880524823;250880525039;216;0,1,2;3;9;1;1;1
250880525039;250880525710;671;0,1,2;3;9;1;1;1
250880525710;250880526536;826;0,1,2;3;9;1;1;1
250880526536;250880528014;1478;0,1,2;3;9;1;1;1
250880528014;250880528717;703;0,1,2;3;9;1;1;1
250880528717;250880528739;22;0,1,2;3;9;1;1;1
250880528739;250880528898;159;0,1,2;3;9;1;1;1
250880528898;250880529520;622;0,1,2;3;9;1;1;1
250880529520;250880529727;207;0,1,2;3;9;1;1;1
250880529727;250880529974;247;0,1,2;3;9;1;1;1
250880529974;250880530156;182;0,1,2;3;9;1;1;1
250880530156;250880530680;524;0,1,2;3;9;1;1;1
250880530680;250880530853;173;0,1,2;3;9;1;1;1
250880530853;250880530894;41;0,1,2;3;9;1;1;1
250880530894;250880531092;198;0,1,2;3;9;1;1;1
250880531092;250880533453;2361;0,1,2;3;9;1;1;1
250880533453;250880538560;5107;0,1,2;3;9;1;1;1
250880538560;250880540989;2429;0,1,2;3;9;1;1;1
250880540989;250880541659;670;0,1,2;3;9;1;1;1
250880541659;250880543695;2036;0,1,2;3;9;1;1;1
250880543695;250880544028;333;0,1,2;3;9;1;1;1
250880544028;250880544606;578;0,1,2;3;9;1;1;1
250880544606;250880545337;731;0,1,2;3;9;1;1;1
250880545337;250880545613;276;0,1,2;3;9;1;1;1
250880545613;250880553454;7841;0,1,2;3;9;1;1;1
250880553454;250880555630;2176;0,1,2;3;9;1;1;1
250880555630;250880555842;212;0,1,2;3;9;1;1;1
250880555842;250880557341;1499;0,1,2;3;9;1;1;1
250880557341;250880557728;387;0,1,2;3;9;1;1;1
250880557728;250880557821;93;0,1,2;3;9;1;1;1
250880557821;250880557856;35;0,1,2;3;9;1;1;1
250880557856;250880558080;224;0,1,2;3;9;1;1;1
250880558080;250880565848;7768;0,1,2;3;9;1;1;1
250880565848;250880566669;821;0,1,2;3;9;1;1;1
250880566669;250880567786;1117;0,1,2;3;9;1;1;1
250880567786;250880569046;1260;0,1,2;3;9;1;1;1
250880569046;250880570770;1724;0,1,2;3;9;1;1;1
250880570770;250880570971;201;0,1,2;3;9;1;1;1
250880570971;250880571047;76;0,1,2;3;9;1;1;1
250880571047;250880571804;757;0,1,2;3;9;1;1;1
250880571804;250880572447;643;0,1,2;3;9;1;1;1
250880572447;250880577504;5057;0,1,2;3;9;1;1;1
250880577504;250880580513;3009;0,1,2;3;9;1;1;1
250880580513;250880581160;647;0,1,2;3;9;1;1;1
250880581160;250880581525;365;0,1,2;3;9;1;1;1
250880581525;250880581557;32;0,1,2;3;9;1;1;1
250880581557;250880582021;464;0,1,2;3;9;1;1;1
250880582021;250880582109;88;0,1,2;3;9;1;1;1
250880582109;250880583497;1388;0,1,2;3;9;1;1;1
250880583497;250880588146;4649;0,1,2;3;9;1;1;1
250880588146;250880590846;2700;0,1,2;3;9;1;1;1
250880590846;250880591016;170;0,1,2;3;9;1;1;1
250880591016;250880593723;2707;0,1,2;3;9;1;1;1
250880593723;250880594946;1223;0,1,2;3;9;1;1;1
250880594946;250880597073;2127;0,1,2;3;9;1;1;1
250880597073;250880599167;2094;0,1,2;3;9;1;1;1
250880599167;250880601724;2557;0,1,2;3;9;1;1;1
250880601724;250880606422;4698;0,1,2;3;9;1;1;1
250880606422;250880606792;370;0,1,2;3;9;1;1;1
250880606792;250880609164;2372;0,1,2;3;9;1;1;1
250880609164;250880610374;1210;0,1,2;3;9;1;1;1
250880610374;250880613784;3410;0,1,2;3;9;1;1;1
250880613784;250880616792;3008;0,1,2;3;9;1;1;1
250880616792;250880623333;6541;0,1,2;3;9;1;1;1
250880623333;250880625344;2011;0,1,2;3;9;1;1;1
250880625344;250880626385;1041;0,1,2;3;9;1;1;1
250880626385;250880629093;2708;0,1,2;3;9;1;1;1
250880629093;250880648059;18966;0,1,2;3;9;1;1;1
250880648059;250880652290;4231;0,1,2;3;9;1;1;1
250880652290;250880652827;537;0,1,2;3;9;1;1;1
250880652827;250880660058;7231;0,1,2;3;9;1;1;1
250880660058;250880663265;3207;0,1,2;3;9;1;1;1
250880663265;250880664040;775;0,1,2;3;9;1;1;1
250880664040;250880665743;1703;0,1,2;3;9;1;1;1
250880665743;250880669836;4093;0,1,2;3;9;1;1;1
250880669836;250880673046;3210;0,1,2;3;9;1;1;1
250880673046;250880683790;10744;0,1,2;3;9;1;1;1
250880683790;250880693062;9272;0,1,2;3;9;1;1;1
250880693062;250880693550;488;0,1,2;3;9;1;1;1
250880693550;250880694859;1309;0,1,2;3;9;1;1;1
250880694859;250880705974;11115;0,1,2;3;9;1;1;1
250880705974;250880711124;5150;0,1,2;3;9;1;1;1
250880711124;250880712241;1117;0,1,2;3;9;1;1;1
250880712241;250880715237;2996;0,1,2;3;9;1;1;1
250880715237;250880728916;13679;0,1,2;3;9;1;1;1
250880728916;250880731030;2114;0,1,2;3;9;1;1;1
250880731030;250880732113;1083;0,1,2;3;9;1;1;1
250880732113;250880733265;1152;0,1,2;3;9;1;1;1
250880733265;250880749511;16246;0,1,2;3;9;1;1;1
250880749511;250880781595;32084;0,1,2;3;9;1;1;1
250880781595;250880784122;2527;0,1,2;3;9;1;1;1
250880784122;250880787565;3443;0,1,2;3;9;1;1;1
250880787565;250880788035;470;0,1,2;3;9;1;1;1
250880788035;250880788671;636;0,1,2;3;9;1;1;1
250880788671;250880791360;2689;0,1,2;3;9;1;1;1
250880791360;250880794569;3209;0,1,2;3;9;1;1;1
250880794569;250880796365;1796;0,1,2;3;9;1;1;1
250880796365;250880799059;2694;0,1,2;3;9;1;1;1
250880799059;250880799501;442;0,1,2;3;9;1;1;1
250880799501;250880799925;424;0,1,2;3;9;1;1;1
250880799925;250880803978;4053;0,1,2;3;9;1;1;1
250880803978;250880804306;328;0,1,2;3;9;1;1;1
250880804306;250880804829;523;0,1,2;3;9;1;1;1
250880804829;250880815716;10887;0,1,2;3;9;1;1;1
250880815716;250880815898;182;0,1,2;3;9;1;1;1
250880815898;250880816839;941;0,1,2;3;9;1;1;1
250880816839;250880825179;8340;0,1,2;3;9;1;1;1
250880825179;250880829797;4618;0,1,2;3;9;1;1;1
250880829797;250880837209;7412;0,1,2;3;9;1;1;1
250880837209;250880838774;1565;0,1,2;3;9;1;1;1
250880838774;250880848254;9480;0,1,2;3;9;1;1;1
250880848254;250880851955;3701;0,1,2;3;9;1;1;1
250880851955;250880852346;391;0,1,2;3;9;1;1;1
250880852346;250880859672;7326;0,1,2;3;9;1;1;1
250880859672;250880862350;2678;0,1,2;3;9;1;1;1
250880862350;250880862515;165;0,1,2;3;9;1;1;1
250880862515;250880864701;2186;0,1,2;3;9;1;1;1
250880864701;250880865366;665;0,1,2;3;9;1;1;1
250880865366;250880865539;173;0,1,2;3;9;1;1;1
250880865539;250880870619;5080;0,1,2;3;9;1;1;1
250880870619;250880871134;515;0,1,2;3;9;1;1;1
250880871134;250880871770;636;0,1,2;3;9;1;1;1
250880871770;250880877664;5894;0,1,2;3;9;1;1;1
250880877664;250880877850;186;0,1,2;3;9;1;1;1
250880877850;250880884564;6714;0,1,2;3;9;1;1;1
250880884564;250880884624;60;0,1,2;3;9;1;1;1
250880884624;250880891658;7034;0,1,2;3;9;1;1;1
250880891658;250880896206;4548;0,1,2;3;9;1;1;1
250880896206;250880897154;948;0,1,2;3;9;1;1;1
250880897154;250880901657;4503;0,1,2;3;9;1;1;1
250880901657;250880908081;6424;0,1,2;3;9;1;1;1
250880908081;250880912912;4831;0,1,2;3;9;1;1;1
250880912912;250880915694;2782;0,1,2;3;9;1;1;1
250880915694;250880922554;6860;0,1,2;3;9;1;1;1
250880922554;250880928437;5883;0,1,2;3;9;1;1;1
250880928437;250880928693;256;0,1,2;3;9;1;1;1
250880928693;250880932589;3896;0,1,2;3;9;1;1;1
250880932589;250880939599;7010;0,1,2;3;9;1;1;1
250880939599;250880941856;2257;0,1,2;3;9;1;1;1
250880941856;250880944554;2698;0,1,2;3;9;1;1;1
250880944554;250880944767;213;0,1,2;3;9;1;1;1
250880944767;250880947687;2920;0,1,2;3;9;1;1;1
250880947687;250880954593;6906;0,1,2;3;9;1;1;1
250880954593;250880955012;419;0,1,2;3;9;1;1;1
250880955012;250880957811;2799;0,1,2;3;9;1;1;1
250880957811;250880960773;2962;0,1,2;3;9;1;1;1
250880960773;250880966146;5373;0,1,2;3;9;1;1;1
250880966146;250880966740;594;0,1,2;3;9;1;1;1
250880966740;250880967265;525;0,1,2;3;9;1;1;1
250880967265;250880970085;2820;0,1,2;3;9;1;1;1
250880970085;250880970347;262;0,1,2;3;9;1;1;1
250880970347;250880971069;722;0,1,2;3;9;1;1;1
250880971069;250880981548;10479;0,1,2;3;9;1;1;1
250880981548;250880988612;7064;0,1,2;3;9;1;1;1
250880988612;250880990364;1752;0,1,2;3;9;1;1;1
250880990364;250880996074;5710;0,1,2;3;9;1;1;1
250880996074;250881010087;14013;0,1,2;3;9;1;1;1
250881010087;250881011134;1047;0,1,2;3;9;1;1;1
250881011134;250881021791;10657;0,1,2;3;9;1;1;1
250881021791;250881035884;14093;0,1,2;3;9;1;1;1
250881035884;250881042738;6854;0,1,2;3;9;1;1;1
250881042738;250881050002;7264;0,1,2;3;9;1;1;1
250881050002;250881052945;2943;0,1,2;3;9;1;1;1
250881052945;250881053019;74;0,1,2;3;9;1;1;1
250881053019;250881053354;335;0,1,2;3;9;1;1;1
250881053354;250881060229;6875;0,1,2;3;9;1;1;1
250881060229;250881060473;244;0,1,2;3;9;1;1;1
250881060473;250881066128;5655;0,1,2;3;9;1;1;1
250881066128;250881067014;886;0,1,2;3;9;1;1;1
250881067014;250881067463;449;0,1,2;3;9;1;1;1
250881067463;250881074193;6730;0,1,2;3;9;1;1;1
250881074193;250881079721;5528;0,1,2;3;9;1;1;1
250881079721;250881081023;1302;0,1,2;3;9;1;1;1
250881081023;250881090656;9633;0,1,2;3;9;1;1;1
250881090656;250881095689;5033;0,1,2;3;9;1;1;1
250881095689;250881096593;904;0,1,2;3;9;1;1;1
250881096593;250881105898;9305;0,1,2;3;9;1;1;1
250881105898;250881108557;2659;0,1,2;3;9;1;1;1
250881108557;250881118064;9507;0,1,2;3;9;1;1;1
250881118064;250881125767;7703;0,1,2;3;9;1;1;1
250881125767;250881125803;36;0,1,2;3;9;1;1;1
250881125803;250881127603;1800;0,1,2;3;9;1;1;1
250881127603;250881129768;2165;0,1,2;3;9;1;1;1
250881129768;250881133156;3388;0,1,2;3;9;1;1;1
250881133156;250881134246;1090;0,1,2;3;9;1;1;1
250881134246;250881136289;2043;0,1,2;3;9;1;1;1
250881136289;250881136294;5;0,1,2;3;9;1;1;1
250881136294;250881139716;3422;0,1,2;3;9;1;1;1
250881139716;250881140423;707;0,1,2;3;9;1;1;1
250881140423;250881143158;2735;0,1,2;3;9;1;1;1
250881143158;250881148544;5386;0,1,2;3;9;1;1;1
250881148544;250881151110;2566;0,1,2;3;9;1;1;1
250881151110;250881167792;16682;0,1,2;3;9;1;1;1
250881167792;250881169030;1238;0,1,2;3;9;1;1;1
250881169030;250881174283;5253;0,1,2;3;9;1;1;1
250881174283;250881177847;3564;0,1,2;3;9;1;1;1
250881177847;250881184150;6303;0,1,2;3;9;1;1;1
250881184150;250881185623;1473;0,1,2;3;9;1;1;1
250881185623;250881199353;13730;0,1,2;3;9;1;1;1
250881199353;250881201430;2077;0,1,2;3;9;1;1;1
250881201430;250881201882;452;0,1,2;3;9;1;1;1
250881201882;250881206937;5055;0,1,2;3;9;1;1;1
250881206937;250881208237;1300;0,1,2;3;9;1;1;1
250881208237;250881212779;4542;0,1,2;3;9;1;1;1
250881212779;250881221165;8386;0,1,2;3;9;1;1;1
250881221165;250881227656;6491;0,1,2;3;9;1;1;1
250881227656;250881228347;691;0,1,2;3;9;1;1;1
250881228347;250881239924;11577;0,1,2;3;9;1;1;1
250881239924;250881249192;9268;0,1,2;3;9;1;1;1
250881249192;250881256001;6809;0,1,2;3;9;1;1;1
250881256001;250881265113;9112;0,1,2;3;9;1;1;1
250881265113;250881266031;918;0,1,2;3;9;1;1;1
250881266031;250881267741;1710;0,1,2;3;9;1;1;1
250881267741;250881269635;1894;0,1,2;3;9;1;1;1
250881269635;250881272193;2558;0,1,2;3;9;1;1;1
250881272193;250881283239;11046;0,1,2;3;9;1;1;1
250881283239;250881283737;498;0,1,2;3;9;1;1;1
250881283737;250881287993;4256;0,1,2;3;9;1;1;1
250881287993;250881308709;20716;0,1,2;3;9;1;1;1
250881308709;250881308781;72;0,1,2;3;9;1;1;1
250881308781;250881319283;10502;0,1,2;3;9;1;1;1
250881319283;250881320036;753;0,1,2;3;9;1;1;1
250881320036;250881320596;560;0,1,2;3;9;1;1;1
250881320596;250881323180;2584;0,1,2;3;9;1;1;1
250881323180;250881323191;11;0,1,2;3;9;1;1;1
250881323191;250881336238;13047;0,1,2;3;9;1;1;1
250881336238;250881337070;832;0,1,2;3;9;1;1;1
250881337070;250881346674;9604;0,1,2;3;9;1;1;1
250881346674;250881351207;4533;0,1,2;3;9;1;1;1
250881351207;250881351384;177;0,1,2;3;9;1;1;1
250881351384;250881359312;7928;0,1,2;3;9;1;1;1
250881359312;250881363434;4122;0,1,2;3;9;1;1;1
250881363434;250881367905;4471;0,1,2;3;9;1;1;1
250881367905;250881369364;1459;0,1,2;3;9;1;1;1
250881369364;250881396483;27119;0,1,2;3;9;1;1;1
250881396483;250881396606;123;0,1,2;3;9;1;1;1
250881396606;250881399308;2702;0,1,2;3;9;1;1;1
250881399308;250881402307;2999;0,1,2;3;9;1;1;1
250881402307;250881404439;2132;0,1,2;3;9;1;1;1
250881404439;250881404838;399;0,1,2;3;9;1;1;1
250881404838;250881406974;2136;0,1,2;3;9;1;1;1
250881406974;250881408662;1688;0,1,2;3;9;1;1;1
250881408662;250881411214;2552;0,1,2;3;9;1;1;1
250881411214;250881412932;1718;0,1,2;3;9;1;1;1
250881412932;250881414899;1967;0,1,2;3;9;1;1;1
250881414899;250881416203;1304;0,1,2;3;9;1;1;1
250881416203;250881416227;24;0,1,2;3;9;1;1;1
250881416227;250881419582;3355;0,1,2;3;9;1;1;1
250881419582;250881419695;113;0,1,2;3;9;1;1;1
250881419695;250881419709;14;0,1,2;3;9;1;1;1
250881419709;250881422616;2907;0,1,2;3;9;1;1;1
250881422616;250881428454;5838;0,1,2;3;9;1;1;1
250881428454;250881429524;1070;0,1,2;3;9;1;1;1
250881429524;250881430985;1461;0,1,2;3;9;1;1;1
250881430985;250881436449;5464;0,1,2;3;9;1;1;1
250881436449;250881441819;5370;0,1,2;3;9;1;1;1
250881441819;250881442702;883;0,1,2;3;9;1;1;1
250881442702;250881451837;9135;0,1,2;3;9;1;1;1
250881451837;250881455689;3852;0,1,2;3;9;1;1;1
250881455689;250881465205;9516;0,1,2;3;9;1;1;1
250881465205;250881465307;102;0,1,2;3;9;1;1;1
250881465307;250881468276;2969;0,1,2;3;9;1;1;1
250881468276;250881476913;8637;0,1,2;3;9;1;1;1
250881476913;250881478081;1168;0,1,2;3;9;1;1;1
250881478081;250881481544;3463;0,1,2;3;9;1;1;1
250881481544;250881481584;40;0,1,2;3;9;1;1;1
250881481584;250881484031;2447;0,1,2;3;9;1;1;1
250881484031;250881484452;421;0,1,2;3;9;1;1;1
250881484452;250881485242;790;0,1,2;3;9;1;1;1
250881485242;250881487658;2416;0,1,2;3;9;1;1;1
250881487658;250881487902;244;0,1,2;3;9;1;1;1
250881487902;250881489749;1847;0,1,2;3;9;1;1;1
250881489749;250881491695;1946;0,1,2;3;9;1;1;1
250881491695;250881493228;1533;0,1,2;3;9;1;1;1
250881493228;250881495035;1807;0,1,2;3;9;1;1;1
250881495035;250881500169;5134;0,1,2;3;9;1;1;1
250881500169;250881501245;1076;0,1,2;3;9;1;1;1
250881501245;250881502616;1371;0,1,2;3;9;1;1;1
250881502616;250881506003;3387;0,1,2;3;9;1;1;1
250881506003;250881514327;8324;0,1,2;3;9;1;1;1
250881514327;250881516204;1877;0,1,2;3;9;1;1;1
250881516204;250881518302;2098;0,1,2;3;9;1;1;1
250881518302;250881524969;6667;0,1,2;3;9;1;1;1
250881524969;250881525717;748;0,1,2;3;9;1;1;1
250881525717;250881528529;2812;0,1,2;3;9;1;1;1
250881528529;250881532050;3521;0,1,2;3;9;1;1;1
250881532050;250881535805;3755;0,1,2;3;9;1;1;1
250881535805;250881540769;4964;0,1,2;3;9;1;1;1
250881540769;250881542503;1734;0,1,2;3;9;1;1;1
250881542503;250881546462;3959;0,1,2;3;9;1;1;1
250881546462;250881546499;37;0,1,2;3;9;1;1;1
250881546499;250881547498;999;0,1,2;3;9;1;1;1
250881547498;250881550388;2890;0,1,2;3;9;1;1;1
250881550388;250881552120;1732;0,1,2;3;9;1;1;1
250881552120;250881553754;1634;0,1,2;3;9;1;1;1
250881553754;250881556341;2587;0,1,2;3;9;1;1;1
250881556341;250881557312;971;0,1,2;3;9;1;1;1
250881557312;250881558062;750;0,1,2;3;9;1;1;1
250881558062;250881558490;428;0,1,2;3;9;1;1;1
250881558490;250881563453;4963;0,1,2;3;9;1;1;1
250881563453;250881570079;6626;0,1,2;3;9;1;1;1
250881570079;250881575414;5335;0,1,2;3;9;1;1;1
250881575414;250881579667;4253;0,1,2;3;9;1;1;1
250881579667;250881583342;3675;0,1,2;3;9;1;1;1
250881583342;250881583417;75;0,1,2;3;9;1;1;1
250881583417;250881586200;2783;0,1,2;3;9;1;1;1
250881586200;250881587237;1037;0,1,2;3;9;1;1;1
250881587237;250881593238;6001;0,1,2;3;9;1;1;1
250881593238;250881597036;3798;0,1,2;3;9;1;1;1
250881597036;250881603994;6958;0,1,2;3;9;1;1;1
250881603994;250881604073;79;0,1,2;3;9;1;1;1
250881604073;250881604948;875;0,1,2;3;9;1;1;1
250881604948;250881610241;5293;0,1,2;3;9;1;1;1
250881610241;250881612106;1865;0,1,2;3;9;1;1;1
250881612106;250881612922;816;0,1,2;3;9;1;1;1
250881612922;250881613198;276;0,1,2;3;9;1;1;1
250881613198;250881626790;13592;0,1,2;3;9;1;1;1
250881626790;250881632551;5761;0,1,2;3;9;1;1;1
250881632551;250881633672;1121;0,1,2;3;9;1;1;1
250881633672;250881637768;4096;0,1,2;3;9;1;1;1
250881637768;250881639052;1284;0,1,2;3;9;1;1;1
250881639052;250881639939;887;0,1,2;3;9;1;1;1
250881639939;250881647955;8016;0,1,2;3;9;1;1;1
250881647955;250881648012;57;0,1,2;3;9;1;1;1
250881648012;250881650612;2600;0,1,2;3;9;1;1;1
250881650612;250881651384;772;0,1,2;3;9;1;1;1
250881651384;250881657110;5726;0,1,2;3;9;1;1;1
250881657110;250881657221;111;0,1,2;3;9;1;1;1
250881657221;250881658347;1126;0,1,2;3;9;1;1;1
250881658347;250881664610;6263;0,1,2;3;9;1;1;1
250881664610;250881668510;3900;0,1,2;3;9;1;1;1
250881668510;250881668904;394;0,1,2;3;9;1;1;1
250881668904;250881669478;574;0,1,2;3;9;1;1;1
250881669478;250881669518;40;0,1,2;3;9;1;1;1
250881669518;250881672294;2776;0,1,2;3;9;1;1;1
250881672294;250881683887;11593;0,1,2;3;9;1;1;1
250881683887;250881683899;12;0,1,2;3;9;1;1;1
250881683899;250881703303;19404;0,1,2;3;9;1;1;1
250881703303;250881706806;3503;0,1,2;3;9;1;1;1
250881706806;250881710829;4023;0,1,2;3;9;1;1;1
250881710829;250881712058;1229;0,1,2;3;9;1;1;1
250881712058;250881714857;2799;0,1,2;3;9;1;1;1
250881714857;250881717420;2563;0,1,2;3;9;1;1;1
250881717420;250881720546;3126;0,1,2;3;9;1;1;1
250881720546;250881722064;1518;0,1,2;3;9;1;1;1
250881722064;250881724435;2371;0,1,2;3;9;1;1;1
250881724435;250881725916;1481;0,1,2;3;9;1;1;1
250881725916;250881727572;1656;0,1,2;3;9;1;1;1
250881727572;250881728690;1118;0,1,2;3;9;1;1;1
250881728690;250881734952;6262;0,1,2;3;9;1;1;1
250881734952;250881736769;1817;0,1,2;3;9;1;1;1
250881736769;250881740165;3396;0,1,2;3;9;1;1;1
250881740165;250881743009;2844;0,1,2;3;9;1;1;1
250881743009;250881743169;160;0,1,2;3;9;1;1;1
250881743169;250881748044;4875;0,1,2;3;9;1;1;1
250881748044;250881750596;2552;0,1,2;3;9;1;1;1
250881750596;250881754933;4337;0,1,2;3;9;1;1;1
250881754933;250881761644;6711;0,1,2;3;9;1;1;1
250881761644;250881771588;9944;0,1,2;3;9;1;1;1
250881771588;250881780515;8927;0,1,2;3;9;1;1;1
250881780515;250881781186;671;0,1,2;3;9;1;1;1
250881781186;250881789573;8387;0,1,2;3;9;1;1;1
250881789573;250881795258;5685;0,1,2;3;9;1;1;1
250881795258;250881799241;3983;0,1,2;3;9;1;1;1
250881799241;250881799557;316;0,1,2;3;9;1;1;1
250881799557;250881800319;762;0,1,2;3;9;1;1;1
250881800319;250881801536;1217;0,1,2;3;9;1;1;1
250881801536;250881802654;1118;0,1,2;3;9;1;1;1
250881802654;250881804650;1996;0,1,2;3;9;1;1;1
250881804650;250881812987;8337;0,1,2;3;9;1;1;1
250881812987;250881813547;560;0,1,2;3;9;1;1;1
250881813547;250881827584;14037;0,1,2;3;9;1;1;1
250881827584;250881830507;2923;0,1,2;3;9;1;1;1
250881830507;250881835109;4602;0,1,2;3;9;1;1;1
250881835109;250881839949;4840;0,1,2;3;9;1;1;1
250881839949;250881841312;1363;0,1,2;3;9;1;1;1
250881841312;250881847342;6030;0,1,2;3;9;1;1;1
250881847342;250881858674;11332;0,1,2;3;9;1;1;1
250881858674;250881860169;1495;0,1,2;3;9;1;1;1
250881860169;250881860241;72;0,1,2;3;9;1;1;1
250881860241;250881860308;67;0,1,2;3;9;1;1;1
250881860308;250881866183;5875;0,1,2;3;9;1;1;1
250881866183;250881866370;187;0,1,2;3;9;1;1;1
250881866370;250881872232;5862;0,1,2;3;9;1;1;1
250881872232;250881875994;3762;0,1,2;3;9;1;1;1
250881875994;250881877430;1436;0,1,2;3;9;1;1;1
250881877430;250881898497;21067;0,1,2;3;9;1;1;1
250881898497;250881906610;8113;0,1,2;3;9;1;1;1
250881906610;250881912954;6344;0,1,2;3;9;1;1;1
250881912954;250881919023;6069;0,1,2;3;9;1;1;1
250881919023;250881919369;346;0,1,2;3;9;1;1;1
250881919369;250881926992;7623;0,1,2;3;9;1;1;1
250881926992;250881936180;9188;0,1,2;3;9;1;1;1
250881936180;250881940739;4559;0,1,2;3;9;1;1;1
250881940739;250881942597;1858;0,1,2;3;9;1;1;1
250881942597;250881944345;1748;0,1,2;3;9;1;1;1
250881944345;250881946114;1769;0,1,2;3;9;1;1;1
250881946114;250881947817;1703;0,1,2;3;9;1;1;1
250881947817;250881950711;2894;0,1,2;3;9;1;1;1
250881950711;250881952516;1805;0,1,2;3;9;1;1;1
250881952516;250881957112;4596;0,1,2;3;9;1;1;1
250881957112;250881957323;211;0,1,2;3;9;1;1;1
250881957323;250881957598;275;0,1,2;3;9;1;1;1
250881957598;250881963642;6044;0,1,2;3;9;1;1;1
250881963642;250881964157;515;0,1,2;3;9;1;1;1
250881964157;250881967036;2879;0,1,2;3;9;1;1;1
250881967036;250881969039;2003;0,1,2;3;9;1;1;1
250881969039;250881970082;1043;0,1,2;3;9;1;1;1
250881970082;250881970358;276;0,1,2;3;9;1;1;1
250881970358;250881971251;893;0,1,2;3;9;1;1;1
250881971251;250881974969;3718;0,1,2;3;9;1;1;1
250881974969;250881976118;1149;0,1,2;3;9;1;1;1
250881976118;250881979167;3049;0,1,2;3;9;1;1;1
250881979167;250881980959;1792;0,1,2;3;9;1;1;1
250881980959;250881981817;858;0,1,2;3;9;1;1;1
250881981817;250881983811;1994;0,1,2;3;9;1;1;1
250881983811;250881983911;100;0,1,2;3;9;1;1;1
250881983911;250881988445;4534;0,1,2;3;9;1;1;1
250881988445;250881991981;3536;0,1,2;3;9;1;1;1
250881991981;250881992080;99;0,1,2;3;9;1;1;1
250881992080;250881992169;89;0,1,2;3;9;1;1;1
250881992169;250881992701;532;0,1,2;3;9;1;1;1
250881992701;250881993155;454;0,1,2;3;9;1;1;1
250881993155;250881994415;1260;0,1,2;3;9;1;1;1
250881994415;250881995189;774;0,1,2;3;9;1;1;1
250881995189;250882002738;7549;0,1,2;3;9;1;1;1
250882002738;250882006790;4052;0,1,2;3;9;1;1;1
250882006790;250882007352;562;0,1,2;3;9;1;1;1
250882007352;250882010222;2870;0,1,2;3;9;1;1;1
250882010222;250882010897;675;0,1,2;3;9;1;1;1
250882010897;250882011349;452;0,1,2;3;9;1;1;1
250882011349;250882011944;595;0,1,2;3;9;1;1;1
250882011944;250882014134;2190;0,1,2;3;9;1;1;1
250882014134;250882017497;3363;0,1,2;3;9;1;1;1
250882017497;250882021243;3746;0,1,2;3;9;1;1;1
250882021243;250882023975;2732;0,1,2;3;9;1;1;1
250882023975;250882025724;1749;0,1,2;3;9;1;1;1
250882025724;250882026849;1125;0,1,2;3;9;1;1;1
250882026849;250882027270;421;0,1,2;3;9;1;1;1
250882027270;250882034292;7022;0,1,2;3;9;1;1;1
250882034292;250882035535;1243;0,1,2;3;9;1;1;1
250882035535;250882035998;463;0,1,2;3;9;1;1;1
250882035998;250882036060;62;0,1,2;3;9;1;1;1
250882036060;250882040836;4776;0,1,2;3;9;1;1;1
250882040836;250882040995;159;0,1,2;3;9;1;1;1
250882040995;250882042432;1437;0,1,2;3;9;1;1;1
250882042432;250882043836;1404;0,1,2;3;9;1;1;1
250882043836;250882043869;33;0,1,2;3;9;1;1;1
250882043869;250882044320;451;0,1,2;3;9;1;1;1
250882044320;250882046670;2350;0,1,2;3;9;1;1;1
250882046670;250882046963;293;0,1,2;3;9;1;1;1
250882046963;250882048044;1081;0,1,2;3;9;1;1;1
250882048044;250882048489;445;0,1,2;3;9;1;1;1
250882048489;250882050794;2305;0,1,2;3;9;1;1;1
250882050794;250882051371;577;0,1,2;3;9;1;1;1
250882051371;250882052447;1076;0,1,2;3;9;1;1;1
250882052447;250882055580;3133;0,1,2;3;9;1;1;1
250882055580;250882056438;858;0,1,2;3;9;1;1;1
250882056438;250882057307;869;0,1,2;3;9;1;1;1
250882057307;250882057875;568;0,1,2;3;9;1;1;1
250882057875;250882058778;903;0,1,2;3;9;1;1;1
250882058778;250882058915;137;0,1,2;3;9;1;1;1
250882058915;250882059014;99;0,1,2;3;9;1;1;1
250882059014;250882059321;307;0,1,2;3;9;1;1;1
250882059321;250882059758;437;0,1,2;3;9;1;1;1
250882059758;250882063721;3963;0,1,2;3;9;1;1;1
250882063721;250882066803;3082;0,1,2;3;9;1;1;1
250882066803;250882067149;346;0,1,2;3;9;1;1;1
250882067149;250882068429;1280;0,1,2;3;9;1;1;1
250882068429;250882073045;4616;0,1,2;3;9;1;1;1
250882073045;250882076214;3169;0,1,2;3;9;1;1;1
250882076214;250882079300;3086;0,1,2;3;9;1;1;1
250882079300;250882083359;4059;0,1,2;3;9;1;1;1
250882083359;250882084345;986;0,1,2;3;9;1;1;1
250882084345;250882084443;98;0,1,2;3;9;1;1;1
250882084443;250882085012;569;0,1,2;3;9;1;1;1
250882085012;250882092368;7356;0,1,2;3;9;1;1;1
250882092368;250882094008;1640;0,1,2;3;9;1;1;1
250882094008;250882096647;2639;0,1,2;3;9;1;1;1
250882096647;250882097448;801;0,1,2;3;9;1;1;1
250882097448;250882099071;1623;0,1,2;3;9;1;1;1
250882099071;250882099146;75;0,1,2;3;9;1;1;1
250882099146;250882102556;3410;0,1,2;3;9;1;1;1
250882102556;250882105989;3433;0,1,2;3;9;1;1;1
250882105989;250882107371;1382;0,1,2;3;9;1;1;1
250882107371;250882107488;117;0,1,2;3;9;1;1;1
250882107488;250882113421;5933;0,1,2;3;9;1;1;1
250882113421;250882113458;37;0,1,2;3;9;1;1;1
250882113458;250882116691;3233;0,1,2;3;9;1;1;1
250882116691;250882117495;804;0,1,2;3;9;1;1;1
250882117495;250882117561;66;0,1,2;3;9;1;1;1
250882117561;250882118029;468;0,1,2;3;9;1;1;1
250882118029;250882119532;1503;0,1,2;3;9;1;1;1
250882119532;250882124804;5272;0,1,2;3;9;1;1;1
250882124804;250882127827;3023;0,1,2;3;9;1;1;1
250882127827;250882128916;1089;0,1,2;3;9;1;1;1
250882128916;250882129513;597;0,1,2;3;9;1;1;1
250882129513;250882130202;689;0,1,2;3;9;1;1;1
250882130202;250882133017;2815;0,1,2;3;9;1;1;1
250882133017;250882141723;8706;0,1,2;3;9;1;1;1
250882141723;250882142355;632;0,1,2;3;9;1;1;1
250882142355;250882142745;390;0,1,2;3;9;1;1;1
250882142745;250882146969;4224;0,1,2;3;9;1;1;1
250882146969;250882154271;7302;0,1,2;3;9;1;1;1
250882154271;250882157038;2767;0,1,2;3;9;1;1;1
250882157038;250882158765;1727;0,1,2;3;9;1;1;1
250882158765;250882161752;2987;0,1,2;3;9;1;1;1
250882161752;250882161793;41;0,1,2;3;9;1;1;1
250882161793;250882162433;640;0,1,2;3;9;1;1;1
250882162433;250882167119;4686;0,1,2;3;9;1;1;1
250882167119;250882170259;3140;0,1,2;3;9;1;1;1
250882170259;250882170921;662;0,1,2;3;9;1;1;1
250882170921;250882170963;42;0,1,2;3;9;1;1;1
250882170963;250882171105;142;0,1,2;3;9;1;1;1
250882171105;250882171387;282;0,1,2;3;9;1;1;1
250882171387;250882175669;4282;0,1,2;3;9;1;1;1
250882175669;250882183465;7796;0,1,2;3;9;1;1;1
250882183465;250882184334;869;0,1,2;3;9;1;1;1
250882184334;250882184566;232;0,1,2;3;9;1;1;1
250882184566;250882184616;50;0,1,2;3;9;1;1;1
250882184616;250882186935;2319;0,1,2;3;9;1;1;1
250882186935;250882187577;642;0,1,2;3;9;1;1;1
250882187577;250882197512;9935;0,1,2;3;9;1;1;1
250882197512;250882200612;3100;0,1,2;3;9;1;1;1
250882200612;250882205239;4627;0,1,2;3;9;1;1;1
250882205239;250882209101;3862;0,1,2;3;9;1;1;1
250882209101;250882214385;5284;0,1,2;3;9;1;1;1
250882214385;250882219648;5263;0,1,2;3;9;1;1;1
250882219648;250882223972;4324;0,1,2;3;9;1;1;1
250882223972;250882224051;79;0,1,2;3;9;1;1;1
250882224051;250882224621;570;0,1,2;3;9;1;1;1
250882224621;250882227438;2817;0,1,2;3;9;1;1;1
250882227438;250882232870;5432;0,1,2;3;9;1;1;1
250882232870;250882233493;623;0,1,2;3;9;1;1;1
250882233493;250882235203;1710;0,1,2;3;9;1;1;1
250882235203;250882235358;155;0,1,2;3;9;1;1;1
250882235358;250882236401;1043;0,1,2;3;9;1;1;1
250882236401;250882238453;2052;0,1,2;3;9;1;1;1
250882238453;250882244729;6276;0,1,2;3;9;1;1;1
250882244729;250882247687;2958;0,1,2;3;9;1;1;1
250882247687;250882249950;2263;0,1,2;3;9;1;1;1
250882249950;250882255751;5801;0,1,2;3;9;1;1;1
250882255751;250882257138;1387;0,1,2;3;9;1;1;1
250882257138;250882261436;4298;0,1,2;3;9;1;1;1
250882261436;250882274708;13272;0,1,2;3;9;1;1;1
250882274708;250882275260;552;0,1,2;3;9;1;1;1
250882275260;250882278997;3737;0,1,2;3;9;1;1;1
250882278997;250882286322;7325;0,1,2;3;9;1;1;1
250882286322;250882289878;3556;0,1,2;3;9;1;1;1
250882289878;250882291326;1448;0,1,2;3;9;1;1;1
250882291326;250882297452;6126;0,1,2;3;9;1;1;1
250882297452;250882298455;1003;0,1,2;3;9;1;1;1
250882298455;250882300207;1752;0,1,2;3;9;1;1;1
250882300207;250882305421;5214;0,1,2;3;9;1;1;1
250882305421;250882310100;4679;0,1,2;3;9;1;1;1
250882310100;250882313915;3815;0,1,2;3;9;1;1;1
250882313915;250882314128;213;0,1,2;3;9;1;1;1
250882314128;250882316716;2588;0,1,2;3;9;1;1;1
250882316716;250882319940;3224;0,1,2;3;9;1;1;1
250882319940;250882320561;621;0,1,2;3;9;1;1;1
250882320561;250882325660;5099;0,1,2;3;9;1;1;1
250882325660;250882325730;70;0,1,2;3;9;1;1;1
250882325730;250882331091;5361;0,1,2;3;9;1;1;1
250882331091;250882334528;3437;0,1,2;3;9;1;1;1
250882334528;250882339545;5017;0,1,2;3;9;1;1;1
250882339545;250882341258;1713;0,1,2;3;9;1;1;1
250882341258;250882341324;66;0,1,2;3;9;1;1;1
250882341324;250882341355;31;0,1,2;3;9;1;1;1
250882341355;250882347235;5880;0,1,2;3;9;1;1;1
250882347235;250882349550;2315;0,1,2;3;9;1;1;1
250882349550;250882352586;3036;0,1,2;3;9;1;1;1
250882352586;250882353313;727;0,1,2;3;9;1;1;1
250882353313;250882355389;2076;0,1,2;3;9;1;1;1
250882355389;250882362796;7407;0,1,2;3;9;1;1;1
250882362796;250882377018;14222;0,1,2;3;9;1;1;1
250882377018;250882378556;1538;0,1,2;3;9;1;1;1
250882378556;250882386191;7635;0,1,2;3;9;1;1;1
250882386191;250882387255;1064;0,1,2;3;9;1;1;1
250882387255;250882387456;201;0,1,2;3;9;1;1;1
250882387456;250882388126;670;0,1,2;3;9;1;1;1
250882388126;250882389212;1086;0,1,2;3;9;1;1;1
250882389212;250882394088;4876;0,1,2;3;9;1;1;1
250882394088;250882397523;3435;0,1,2;3;9;1;1;1
250882397523;250882398465;942;0,1,2;3;9;1;1;1
250882398465;250882399442;977;0,1,2;3;9;1;1;1
250882399442;250882405354;5912;0,1,2;3;9;1;1;1
250882405354;250882408928;3574;0,1,2;3;9;1;1;1
250882408928;250882410036;1108;0,1,2;3;9;1;1;1
250882410036;250882411353;1317;0,1,2;3;9;1;1;1
250882411353;250882414208;2855;0,1,2;3;9;1;1;1
250882414208;250882414738;530;0,1,2;3;9;1;1;1
250882414738;250882415258;520;0,1,2;3;9;1;1;1
250882415258;250882417568;2310;0,1,2;3;9;1;1;1
250882417568;250882419441;1873;0,1,2;3;9;1;1;1
250882419441;250882420594;1153;0,1,2;3;9;1;1;1
250882420594;250882423874;3280;0,1,2;3;9;1;1;1
250882423874;250882431648;7774;0,1,2;3;9;1;1;1
250882431648;250882433871;2223;0,1,2;3;9;1;1;1
250882433871;250882436582;2711;0,1,2;3;9;1;1;1
250882436582;250882436751;169;0,1,2;3;9;1;1;1
250882436751;250882444099;7348;0,1,2;3;9;1;1;1
250882444099;250882446800;2701;0,1,2;3;9;1;1;1
250882446800;250882447955;1155;0,1,2;3;9;1;1;1
250882447955;250882450024;2069;0,1,2;3;9;1;1;1
250882450024;250882450957;933;0,1,2;3;9;1;1;1
250882450957;250882453055;2098;0,1,2;3;9;1;1;1
250882453055;250882454688;1633;0,1,2;3;9;1;1;1
250882454688;250882460491;5803;0,1,2;3;9;1;1;1
250882460491;250882461397;906;0,1,2;3;9;1;1;1
250882461397;250882464247;2850;0,1,2;3;9;1;1;1
250882464247;250882464329;82;0,1,2;3;9;1;1;1
250882464329;250882465879;1550;0,1,2;3;9;1;1;1
250882465879;250882465944;65;0,1,2;3;9;1;1;1
250882465944;250882466306;362;0,1,2;3;9;1;1;1
250882466306;250882467868;1562;0,1,2;3;9;1;1;1
250882467868;250882475380;7512;0,1,2;3;9;1;1;1
250882475380;250882479726;4346;0,1,2;3;9;1;1;1
250882479726;250882479735;9;0,1,2;3;9;1;1;1
250882479735;250882479833;98;0,1,2;3;9;1;1;1
250882479833;250882487181;7348;0,1,2;3;9;1;1;1
250882487181;250882487805;624;0,1,2;3;9;1;1;1
250882487805;250882495401;7596;0,1,2;3;9;1;1;1
250882495401;250882499715;4314;0,1,2;3;9;1;1;1
250882499715;250882500492;777;0,1,2;3;9;1;1;1
250882500492;250882504773;4281;0,1,2;3;9;1;1;1
250882504773;250882511492;6719;0,1,2;3;9;1;1;1
250882511492;250882513838;2346;0,1,2;3;9;1;1;1
250882513838;250882514042;204;0,1,2;3;9;1;1;1
250882514042;250882515759;1717;0,1,2;3;9;1;1;1
250882515759;250882516247;488;0,1,2;3;9;1;1;1
250882516247;250882523640;7393;0,1,2;3;9;1;1;1
250882523640;250882524819;1179;0,1,2;3;9;1;1;1
250882524819;250882524975;156;0,1,2;3;9;1;1;1
250882524975;250882525098;123;0,1,2;3;9;1;1;1
250882525098;250882525158;60;0,1,2;3;9;1;1;1
250882525158;250882526222;1064;0,1,2;3;9;1;1;1
250882526222;250882535003;8781;0,1,2;3;9;1;1;1
250882535003;250882538297;3294;0,1,2;3;9;1;1;1
250882538297;250882538557;260;0,1,2;3;9;1;1;1
250882538557;250882541694;3137;0,1,2;3;9;1;1;1
250882541694;250882544001;2307;0,1,2;3;9;1;1;1
250882544001;250882548098;4097;0,1,2;3;9;1;1;1
250882548098;250882553109;5011;0,1,2;3;9;1;1;1
250882553109;250882554768;1659;0,1,2;3;9;1;1;1
250882554768;250882556777;2009;0,1,2;3;9;1;1;1
250882556777;250882557131;354;0,1,2;3;9;1;1;1
250882557131;250882562595;5464;0,1,2;3;9;1;1;1
250882562595;250882563197;602;0,1,2;3;9;1;1;1
250882563197;250882565082;1885;0,1,2;3;9;1;1;1
250882565082;250882568951;3869;0,1,2;3;9;1;1;1
250882568951;250882575402;6451;0,1,2;3;9;1;1;1
250882575402;250882576696;1294;0,1,2;3;9;1;1;1
250882576696;250882578668;1972;0,1,2;3;9;1;1;1
250882578668;250882580643;1975;0,1,2;3;9;1;1;1
250882580643;250882588326;7683;0,1,2;3;9;1;1;1
250882588326;250882588827;501;0,1,2;3;9;1;1;1
250882588827;250882590105;1278;0,1,2;3;9;1;1;1
250882590105;250882592143;2038;0,1,2;3;9;1;1;1
250882592143;250882593828;1685;0,1,2;3;9;1;1;1
250882593828;250882596239;2411;0,1,2;3;9;1;1;1
250882596239;250882599878;3639;0,1,2;3;9;1;1;1
250882599878;250882603651;3773;0,1,2;3;9;1;1;1
250882603651;250882615903;12252;0,1,2;3;9;1;1;1
250882615903;250882616711;808;0,1,2;3;9;1;1;1
250882616711;250882617819;1108;0,1,2;3;9;1;1;1
250882617819;250882623695;5876;0,1,2;3;9;1;1;1
250882623695;250882624519;824;0,1,2;3;9;1;1;1
250882624519;250882627977;3458;0,1,2;3;9;1;1;1
250882627977;250882633890;5913;0,1,2;3;9;1;1;1
250882633890;250882635181;1291;0,1,2;3;9;1;1;1
250882635181;250882637015;1834;0,1,2;3;9;1;1;1
250882637015;250882637134;119;0,1,2;3;9;1;1;1
250882637134;250882641203;4069;0,1,2;3;9;1;1;1
250882641203;250882641225;22;0,1,2;3;9;1;1;1
250882641225;250882642884;1659;0,1,2;3;9;1;1;1
250882642884;250882644044;1160;0,1,2;3;9;1;1;1
250882644044;250882646440;2396;0,1,2;3;9;1;1;1
250882646440;250882648100;1660;0,1,2;3;9;1;1;1
250882648100;250882648995;895;0,1,2;3;9;1;1;1
250882648995;250882649486;491;0,1,2;3;9;1;1;1
250882649486;250882650867;1381;0,1,2;3;9;1;1;1
250882650867;250882654639;3772;0,1,2;3;9;1;1;1
250882654639;250882655771;1132;0,1,2;3;9;1;1;1
250882655771;250882659707;3936;0,1,2;3;9;1;1;1
250882659707;250882660298;591;0,1,2;3;9;1;1;1
250882660298;250882661505;1207;0,1,2;3;9;1;1;1
250882661505;250882663078;1573;0,1,2;3;9;1;1;1
250882663078;250882667619;4541;0,1,2;3;9;1;1;1
250882667619;250882667939;320;0,1,2;3;9;1;1;1
250882667939;250882668141;202;0,1,2;3;9;1;1;1
250882668141;250882669013;872;0,1,2;3;9;1;1;1
250882669013;250882673821;4808;0,1,2;3;9;1;1;1
250882673821;250882678438;4617;0,1,2;3;9;1;1;1
250882678438;250882684417;5979;0,1,2;3;9;1;1;1
250882684417;250882691743;7326;0,1,2;3;9;1;1;1
250882691743;250882696167;4424;0,1,2;3;9;1;1;1
250882696167;250882699732;3565;0,1,2;3;9;1;1;1
250882699732;250882704242;4510;0,1,2;3;9;1;1;1
250882704242;250882705808;1566;0,1,2;3;9;1;1;1
250882705808;250882706096;288;0,1,2;3;9;1;1;1
250882706096;250882707808;1712;0,1,2;3;9;1;1;1
250882707808;250882715333;7525;0,1,2;3;9;1;1;1
250882715333;250882716652;1319;0,1,2;3;9;1;1;1
250882716652;250882716922;270;0,1,2;3;9;1;1;1
250882716922;250882723724;6802;0,1,2;3;9;1;1;1
250882723724;250882723817;93;0,1,2;3;9;1;1;1
250882723817;250882724152;335;0,1,2;3;9;1;1;1
250882724152;250882724336;184;0,1,2;3;9;1;1;1
250882724336;250882725088;752;0,1,2;3;9;1;1;1
250882725088;250882729422;4334;0,1,2;3;9;1;1;1
250882729422;250882733740;4318;0,1,2;3;9;1;1;1
250882733740;250882734841;1101;0,1,2;3;9;1;1;1
250882734841;250882736633;1792;0,1,2;3;9;1;1;1
250882736633;250882737412;779;0,1,2;3;9;1;1;1
250882737412;250882741040;3628;0,1,2;3;9;1;1;1
250882741040;250882741208;168;0,1,2;3;9;1;1;1
250882741208;250882743768;2560;0,1,2;3;9;1;1;1
250882743768;250882745714;1946;0,1,2;3;9;1;1;1
250882745714;250882748229;2515;0,1,2;3;9;1;1;1
250882748229;250882748385;156;0,1,2;3;9;1;1;1
250882748385;250882749307;922;0,1,2;3;9;1;1;1
250882749307;250882751748;2441;0,1,2;3;9;1;1;1
250882751748;250882752442;694;0,1,2;3;9;1;1;1
250882752442;250882758312;5870;0,1,2;3;9;1;1;1
250882758312;250882761752;3440;0,1,2;3;9;1;1;1
250882761752;250882762303;551;0,1,2;3;9;1;1;1
250882762303;250882766213;3910;0,1,2;3;9;1;1;1
250882766213;250882766500;287;0,1,2;3;9;1;1;1
250882766500;250882772701;6201;0,1,2;3;9;1;1;1
250882772701;250882773769;1068;0,1,2;3;9;1;1;1
250882773769;250882783644;9875;0,1,2;3;9;1;1;1
250882783644;250882786849;3205;0,1,2;3;9;1;1;1
250882786849;250882794669;7820;0,1,2;3;9;1;1;1
250882794669;250882797285;2616;0,1,2;3;9;1;1;1
250882797285;250882798877;1592;0,1,2;3;9;1;1;1
250882798877;250882799957;1080;0,1,2;3;9;1;1;1
250882799957;250882800012;55;0,1,2;3;9;1;1;1
250882800012;250882800744;732;0,1,2;3;9;1;1;1
250882800744;250882807647;6903;0,1,2;3;9;1;1;1
250882807647;250882808727;1080;0,1,2;3;9;1;1;1
250882808727;250882815466;6739;0,1,2;3;9;1;1;1
250882815466;250882817078;1612;0,1,2;3;9;1;1;1
250882817078;250882818691;1613;0,1,2;3;9;1;1;1
250882818691;250882818746;55;0,1,2;3;9;1;1;1
250882818746;250882821295;2549;0,1,2;3;9;1;1;1
250882821295;250882821803;508;0,1,2;3;9;1;1;1
250882821803;250882822307;504;0,1,2;3;9;1;1;1
250882822307;250882824409;2102;0,1,2;3;9;1;1;1
250882824409;250882825112;703;0,1,2;3;9;1;1;1
250882825112;250882827077;1965;0,1,2;3;9;1;1;1
250882827077;250882828136;1059;0,1,2;3;9;1;1;1
250882828136;250882828139;3;0,1,2;3;9;1;1;1
250882828139;250882835249;7110;0,1,2;3;9;1;1;1
250882835249;250882836156;907;0,1,2;3;9;1;1;1
250882836156;250882836694;538;0,1,2;3;9;1;1;1
250882836694;250882838045;1351;0,1,2;3;9;1;1;1
250882838045;250882841053;3008;0,1,2;3;9;1;1;1
250882841053;250882843400;2347;0,1,2;3;9;1;1;1
250882843400;250882846109;2709;0,1,2;3;9;1;1;1
250882846109;250882847732;1623;0,1,2;3;9;1;1;1
250882847732;250882848935;1203;0,1,2;3;9;1;1;1
250882848935;250882849689;754;0,1,2;3;9;1;1;1
250882849689;250882849941;252;0,1,2;3;9;1;1;1
250882849941;250882854733;4792;0,1,2;3;9;1;1;1
250882854733;250882856944;2211;0,1,2;3;9;1;1;1
250882856944;250882868139;11195;0,1,2;3;9;1;1;1
250882868139;250882873512;5373;0,1,2;3;9;1;1;1
250882873512;250882876356;2844;0,1,2;3;9;1;1;1
250882876356;250882880960;4604;0,1,2;3;9;1;1;1
250882880960;250882882968;2008;0,1,2;3;9;1;1;1
250882882968;250882884372;1404;0,1,2;3;9;1;1;1
250882884372;250882889075;4703;0,1,2;3;9;1;1;1
250882889075;250882889235;160;0,1,2;3;9;1;1;1
250882889235;250882890877;1642;0,1,2;3;9;1;1;1
250882890877;250882892805;1928;0,1,2;3;9;1;1;1
250882892805;250882893536;731;0,1,2;3;9;1;1;1
250882893536;250882893995;459;0,1,2;3;9;1;1;1
250882893995;250882897159;3164;0,1,2;3;9;1;1;1
250882897159;250882899379;2220;0,1,2;3;9;1;1;1
250882899379;250882901092;1713;0,1,2;3;9;1;1;1
250882901092;250882901426;334;0,1,2;3;9;1;1;1
250882901426;250882903875;2449;0,1,2;3;9;1;1;1
250882903875;250882904779;904;0,1,2;3;9;1;1;1
250882904779;250882905280;501;0,1,2;3;9;1;1;1
250882905280;250882905589;309;0,1,2;3;9;1;1;1
250882905589;250882909265;3676;0,1,2;3;9;1;1;1
250882909265;250882910187;922;0,1,2;3;9;1;1;1
250882910187;250882910977;790;0,1,2;3;9;1;1;1
250882910977;250882912216;1239;0,1,2;3;9;1;1;1
250882912216;250882912492;276;0,1,2;3;9;1;1;1
250882912492;250882912570;78;0,1,2;3;9;1;1;1
250882912570;250882913697;1127;0,1,2;3;9;1;1;1
250882913697;250882915359;1662;0,1,2;3;9;1;1;1
250882915359;250882917163;1804;0,1,2;3;9;1;1;1
250882917163;250882921832;4669;0,1,2;3;9;1;1;1
250882921832;250882921878;46;0,1,2;3;9;1;1;1
250882921878;250882922603;725;0,1,2;3;9;1;1;1
250882922603;250882922917;314;0,1,2;3;9;1;1;1
250882922917;250882925540;2623;0,1,2;3;9;1;1;1
250882925540;250882927229;1689;0,1,2;3;9;1;1;1
250882927229;250882932633;5404;0,1,2;3;9;1;1;1
250882932633;250882935801;3168;0,1,2;3;9;1;1;1
250882935801;250882935881;80;0,1,2;3;9;1;1;1
250882935881;250882938294;2413;0,1,2;3;9;1;1;1
250882938294;250882939229;935;0,1,2;3;9;1;1;1
250882939229;250882942735;3506;0,1,2;3;9;1;1;1
250882942735;250882944672;1937;0,1,2;3;9;1;1;1
250882944672;250882944837;165;0,1,2;3;9;1;1;1
250882944837;250882949952;5115;0,1,2;3;9;1;1;1
250882949952;250882951943;1991;0,1,2;3;9;1;1;1
250882951943;250882956067;4124;0,1,2;3;9;1;1;1
250882956067;250882957994;1927;0,1,2;3;9;1;1;1
250882957994;250882960597;2603;0,1,2;3;9;1;1;1
250882960597;250882961169;572;0,1,2;3;9;1;1;1
250882961169;250882970994;9825;0,1,2;3;9;1;1;1
250882970994;250882973106;2112;0,1,2;3;9;1;1;1
250882973106;250882973399;293;0,1,2;3;9;1;1;1
250882973399;250882974555;1156;0,1,2;3;9;1;1;1
250882974555;250882974832;277;0,1,2;3;9;1;1;1
250882974832;250882979261;4429;0,1,2;3;9;1;1;1
250882979261;250882984392;5131;0,1,2;3;9;1;1;1
250882984392;250882985676;1284;0,1,2;3;9;1;1;1
250882985676;250882985797;121;0,1,2;3;9;1;1;1
250882985797;250882987162;1365;0,1,2;3;9;1;1;1
250882987162;250882987430;268;0,1,2;3;9;1;1;1
250882987430;250882988106;676;0,1,2;3;9;1;1;1
250882988106;250882991308;3202;0,1,2;3;9;1;1;1
250882991308;250882995424;4116;0,1,2;3;9;1;1;1
250882995424;250882996256;832;0,1,2;3;9;1;1;1
250882996256;250882998097;1841;0,1,2;3;9;1;1;1
250882998097;250882999865;1768;0,1,2;3;9;1;1;1
250882999865;250883000183;318;0,1,2;3;9;1;1;1
250883000183;250883003822;3639;0,1,2;3;9;1;1;1
250883003822;250883005634;1812;0,1,2;3;9;1;1;1
250883005634;250883006318;684;0,1,2;3;9;1;1;1
250883006318;250883010984;4666;0,1,2;3;9;1;1;1
250883010984;250883016659;5675;0,1,2;3;9;1;1;1
250883016659;250883018352;1693;0,1,2;3;9;1;1;1
250883018352;250883020444;2092;0,1,2;3;9;1;1;1
250883020444;250883021957;1513;0,1,2;3;9;1;1;1
250883021957;250883022862;905;0,1,2;3;9;1;1;1
250883022862;250883030436;7574;0,1,2;3;9;1;1;1
250883030436;250883030716;280;0,1,2;3;9;1;1;1
250883030716;250883031161;445;0,1,2;3;9;1;1;1
250883031161;250883032263;1102;0,1,2;3;9;1;1;1
250883032263;250883035516;3253;0,1,2;3;9;1;1;1
250883035516;250883039166;3650;0,1,2;3;9;1;1;1
250883039166;250883041368;2202;0,1,2;3;9;1;1;1
250883041368;250883042778;1410;0,1,2;3;9;1;1;1
250883042778;250883043805;1027;0,1,2;3;9;1;1;1
250883043805;250883043899;94;0,1,2;3;9;1;1;1
250883043899;250883045014;1115;0,1,2;3;9;1;1;1
250883045014;250883046802;1788;0,1,2;3;9;1;1;1
250883046802;250883047496;694;0,1,2;3;9;1;1;1
250883047496;250883047677;181;0,1,2;3;9;1;1;1
250883047677;250883055629;7952;0,1,2;3;9;1;1;1
250883055629;250883056187;558;0,1,2;3;9;1;1;1
250883056187;250883056217;30;0,1,2;3;9;1;1;1
250883056217;250883060728;4511;0,1,2;3;9;1;1;1
250883060728;250883064812;4084;0,1,2;3;9;1;1;1
250883064812;250883065034;222;0,1,2;3;9;1;1;1
250883065034;250883068077;3043;0,1,2;3;9;1;1;1
250883068077;250883069286;1209;0,1,2;3;9;1;1;1
250883069286;250883073304;4018;0,1,2;3;9;1;1;1
250883073304;250883075227;1923;0,1,2;3;9;1;1;1
250883075227;250883078139;2912;0,1,2;3;9;1;1;1
250883078139;250883080836;2697;0,1,2;3;9;1;1;1
250883080836;250883084231;3395;0,1,2;3;9;1;1;1
250883084231;250883086553;2322;0,1,2;3;9;1;1;1
250883086553;250883087439;886;0,1,2;3;9;1;1;1
250883087439;250883088465;1026;0,1,2;3;9;1;1;1
250883088465;250883093974;5509;0,1,2;3;9;1;1;1
250883093974;250883095059;1085;0,1,2;3;9;1;1;1
250883095059;250883096501;1442;0,1,2;3;9;1;1;1
250883096501;250883097818;1317;0,1,2;3;9;1;1;1
250883097818;250883098037;219;0,1,2;3;9;1;1;1
250883098037;250883099493;1456;0,1,2;3;9;1;1;1
250883099493;250883104064;4571;0,1,2;3;9;1;1;1
250883104064;250883104923;859;0,1,2;3;9;1;1;1
250883104923;250883108755;3832;0,1,2;3;9;1;1;1
250883108755;250883110929;2174;0,1,2;3;9;1;1;1
250883110929;250883113260;2331;0,1,2;3;9;1;1;1
250883113260;250883114440;1180;0,1,2;3;9;1;1;1
250883114440;250883114483;43;0,1,2;3;9;1;1;1
250883114483;250883118513;4030;0,1,2;3;9;1;1;1
250883118513;250883119123;610;0,1,2;3;9;1;1;1
250883119123;250883123765;4642;0,1,2;3;9;1;1;1
250883123765;250883124526;761;0,1,2;3;9;1;1;1
250883124526;250883126221;1695;0,1,2;3;9;1;1;1
250883126221;250883126708;487;0,1,2;3;9;1;1;1
250883126708;250883126820;112;0,1,2;3;9;1;1;1
250883126820;250883126869;49;0,1,2;3;9;1;1;1
250883126869;250883127624;755;0,1,2;3;9;1;1;1
250883127624;250883129967;2343;0,1,2;3;9;1;1;1
250883129967;250883132842;2875;0,1,2;3;9;1;1;1
250883132842;250883134000;1158;0,1,2;3;9;1;1;1
250883134000;250883138381;4381;0,1,2;3;9;1;1;1
250883138381;250883139353;972;0,1,2;3;9;1;1;1
250883139353;250883139421;68;0,1,2;3;9;1;1;1
250883139421;250883142933;3512;0,1,2;3;9;1;1;1
250883142933;250883143628;695;0,1,2;3;9;1;1;1
250883143628;250883150454;6826;0,1,2;3;9;1;1;1
250883150454;250883150977;523;0,1,2;3;9;1;1;1
250883150977;250883151681;704;0,1,2;3;9;1;1;1
250883151681;250883153556;1875;0,1,2;3;9;1;1;1
250883153556;250883155172;1616;0,1,2;3;9;1;1;1
250883155172;250883156052;880;0,1,2;3;9;1;1;1
250883156052;250883156814;762;0,1,2;3;9;1;1;1
250883156814;250883157041;227;0,1,2;3;9;1;1;1
250883157041;250883163569;6528;0,1,2;3;9;1;1;1
250883163569;250883163849;280;0,1,2;3;9;1;1;1
250883163849;250883166223;2374;0,1,2;3;9;1;1;1
250883166223;250883166782;559;0,1,2;3;9;1;1;1
250883166782;250883166862;80;0,1,2;3;9;1;1;1
250883166862;250883167020;158;0,1,2;3;9;1;1;1
250883167020;250883167570;550;0,1,2;3;9;1;1;1
250883167570;250883169045;1475;0,1,2;3;9;1;1;1
250883169045;250883169217;172;0,1,2;3;9;1;1;1
250883169217;250883172121;2904;0,1,2;3;9;1;1;1
250883172121;250883172220;99;0,1,2;3;9;1;1;1
250883172220;250883175374;3154;0,1,2;3;9;1;1;1
250883175374;250883176521;1147;0,1,2;3;9;1;1;1
250883176521;250883176577;56;0,1,2;3;9;1;1;1
250883176577;250883177184;607;0,1,2;3;9;1;1;1
250883177184;250883177740;556;0,1,2;3;9;1;1;1
250883177740;250883180018;2278;0,1,2;3;9;1;1;1
250883180018;250883180713;695;0,1,2;3;9;1;1;1
250883180713;250883183578;2865;0,1,2;3;9;1;1;1
250883183578;250883184420;842;0,1,2;3;9;1;1;1
250883184420;250883188061;3641;0,1,2;3;9;1;1;1
250883188061;250883191013;2952;0,1,2;3;9;1;1;1
250883191013;250883192620;1607;0,1,2;3;9;1;1;1
250883192620;250883193210;590;0,1,2;3;9;1;1;1
250883193210;250883193627;417;0,1,2;3;9;1;1;1
250883193627;250883195855;2228;0,1,2;3;9;1;1;1
250883195855;250883196608;753;0,1,2;3;9;1;1;1
250883196608;250883198903;2295;0,1,2;3;9;1;1;1
250883198903;250883199060;157;0,1,2;3;9;1;1;1
250883199060;250883199934;874;0,1,2;3;9;1;1;1
250883199934;250883201151;1217;0,1,2;3;9;1;1;1
250883201151;250883201436;285;0,1,2;3;9;1;1;1
250883201436;250883202670;1234;0,1,2;3;9;1;1;1
250883202670;250883203530;860;0,1,2;3;9;1;1;1
250883203530;250883205059;1529;0,1,2;3;9;1;1;1
250883205059;250883205198;139;0,1,2;3;9;1;1;1
250883205198;250883206405;1207;0,1,2;3;9;1;1;1
250883206405;250883207020;615;0,1,2;3;9;1;1;1
250883207020;250883207930;910;0,1,2;3;9;1;1;1
250883207930;250883208715;785;0,1,2;3;9;1;1;1
250883208715;250883208864;149;0,1,2;3;9;1;1;1
250883208864;250883209524;660;0,1,2;3;9;1;1;1
250883209524;250883211802;2278;0,1,2;3;9;1;1;1
250883211802;250883217581;5779;0,1,2;3;9;1;1;1
250883217581;250883218964;1383;0,1,2;3;9;1;1;1
250883218964;250883219487;523;0,1,2;3;9;1;1;1
250883219487;250883228087;8600;0,1,2;3;9;1;1;1
250883228087;250883228580;493;0,1,2;3;9;1;1;1
250883228580;250883228744;164;0,1,2;3;9;1;1;1
250883228744;250883231590;2846;0,1,2;3;9;1;1;1
250883231590;250883236662;5072;0,1,2;3;9;1;1;1
250883236662;250883236718;56;0,1,2;3;9;1;1;1
250883236718;250883238509;1791;0,1,2;3;9;1;1;1
250883238509;250883238998;489;0,1,2;3;9;1;1;1
250883238998;250883239119;121;0,1,2;3;9;1;1;1
250883239119;250883240980;1861;0,1,2;3;9;1;1;1
250883240980;250883242900;1920;0,1,2;3;9;1;1;1
250883242900;250883245003;2103;0,1,2;3;9;1;1;1
250883245003;250883246874;1871;0,1,2;3;9;1;1;1
250883246874;250883247289;415;0,1,2;3;9;1;1;1
250883247289;250883250127;2838;0,1,2;3;9;1;1;1
250883250127;250883250593;466;0,1,2;3;9;1;1;1
250883250593;250883253121;2528;0,1,2;3;9;1;1;1
250883253121;250883255188;2067;0,1,2;3;9;1;1;1
250883255188;250883256275;1087;0,1,2;3;9;1;1;1
250883256275;250883258998;2723;0,1,2;3;9;1;1;1
250883258998;250883259963;965;0,1,2;3;9;1;1;1
250883259963;250883261935;1972;0,1,2;3;9;1;1;1
250883261935;250883264710;2775;0,1,2;3;9;1;1;1
250883264710;250883266071;1361;0,1,2;3;9;1;1;1
250883266071;250883266413;342;0,1,2;3;9;1;1;1
250883266413;250883267723;1310;0,1,2;3;9;1;1;1
250883267723;250883268315;592;0,1,2;3;9;1;1;1
250883268315;250883271290;2975;0,1,2;3;9;1;1;1
250883271290;250883271674;384;0,1,2;3;9;1;1;1
250883271674;250883271958;284;0,1,2;3;9;1;1;1
250883271958;250883277682;5724;0,1,2;3;9;1;1;1
250883277682;250883279554;1872;0,1,2;3;9;1;1;1
250883279554;250883282638;3084;0,1,2;3;9;1;1;1
250883282638;250883282679;41;0,1,2;3;9;1;1;1
250883282679;250883290256;7577;0,1,2;3;9;1;1;1
250883290256;250883292795;2539;0,1,2;3;9;1;1;1
250883292795;250883293360;565;0,1,2;3;9;1;1;1
250883293360;250883297811;4451;0,1,2;3;9;1;1;1
250883297811;250883303838;6027;0,1,2;3;9;1;1;1
250883303838;250883303871;33;0,1,2;3;9;1;1;1
250883303871;250883304073;202;0,1,2;3;9;1;1;1
250883304073;250883305866;1793;0,1,2;3;9;1;1;1
250883305866;250883309030;3164;0,1,2;3;9;1;1;1
250883309030;250883310668;1638;0,1,2;3;9;1;1;1
250883310668;250883310887;219;0,1,2;3;9;1;1;1
250883310887;250883311296;409;0,1,2;3;9;1;1;1
250883311296;250883311790;494;0,1,2;3;9;1;1;1
250883311790;250883315430;3640;0,1,2;3;9;1;1;1
250883315430;250883316676;1246;0,1,2;3;9;1;1;1
250883316676;250883318835;2159;0,1,2;3;9;1;1;1
250883318835;250883318963;128;0,1,2;3;9;1;1;1
250883318963;250883319296;333;0,1,2;3;9;1;1;1
250883319296;250883320680;1384;0,1,2;3;9;1;1;1
250883320680;250883322656;1976;0,1,2;3;9;1;1;1
250883322656;250883331527;8871;0,1,2;3;9;1;1;1
250883331527;250883332868;1341;0,1,2;3;9;1;1;1
250883332868;250883340357;7489;0,1,2;3;9;1;1;1
250883340357;250883340733;376;0,1,2;3;9;1;1;1
250883340733;250883343538;2805;0,1,2;3;9;1;1;1
250883343538;250883344608;1070;0,1,2;3;9;1;1;1
250883344608;250883348048;3440;0,1,2;3;9;1;1;1
250883348048;250883354059;6011;0,1,2;3;9;1;1;1
250883354059;250883354565;506;0,1,2;3;9;1;1;1
250883354565;250883355517;952;0,1,2;3;9;1;1;1
250883355517;250883356027;510;0,1,2;3;9;1;1;1
250883356027;250883356274;247;0,1,2;3;9;1;1;1
250883356274;250883358574;2300;0,1,2;3;9;1;1;1
250883358574;250883364130;5556;0,1,2;3;9;1;1;1
250883364130;250883368881;4751;0,1,2;3;9;1;1;1
250883368881;250883373101;4220;0,1,2;3;9;1;1;1
250883373101;250883373817;716;0,1,2;3;9;1;1;1
250883373817;250883374388;571;0,1,2;3;9;1;1;1
250883374388;250883374912;524;0,1,2;3;9;1;1;1
250883374912;250883375202;290;0,1,2;3;9;1;1;1
250883375202;250883378202;3000;0,1,2;3;9;1;1;1
250883378202;250883380323;2121;0,1,2;3;9;1;1;1
250883380323;250883384724;4401;0,1,2;3;9;1;1;1
250883384724;250883385290;566;0,1,2;3;9;1;1;1
250883385290;250883386327;1037;0,1,2;3;9;1;1;1
250883386327;250883386528;201;0,1,2;3;9;1;1;1
250883386528;250883388405;1877;0,1,2;3;9;1;1;1
250883388405;250883390124;1719;0,1,2;3;9;1;1;1
250883390124;250883390161;37;0,1,2;3;9;1;1;1
250883390161;250883390221;60;0,1,2;3;9;1;1;1
250883390221;250883396266;6045;0,1,2;3;9;1;1;1
250883396266;250883400738;4472;0,1,2;3;9;1;1;1
250883400738;250883401091;353;0,1,2;3;9;1;1;1
250883401091;250883405700;4609;0,1,2;3;9;1;1;1
250883405700;250883408172;2472;0,1,2;3;9;1;1;1
250883408172;250883409457;1285;0,1,2;3;9;1;1;1
250883409457;250883410814;1357;0,1,2;3;9;1;1;1
250883410814;250883412918;2104;0,1,2;3;9;1;1;1
250883412918;250883416786;3868;0,1,2;3;9;1;1;1
250883416786;250883417696;910;0,1,2;3;9;1;1;1
250883417696;250883425352;7656;0,1,2;3;9;1;1;1
250883425352;250883426374;1022;0,1,2;3;9;1;1;1
250883426374;250883431007;4633;0,1,2;3;9;1;1;1
250883431007;250883439013;8006;0,1,2;3;9;1;1;1
250883439013;250883439491;478;0,1,2;3;9;1;1;1
250883439491;250883442648;3157;0,1,2;3;9;1;1;1
250883442648;250883445103;2455;0,1,2;3;9;1;1;1
250883445103;250883446931;1828;0,1,2;3;9;1;1;1
250883446931;250883447311;380;0,1,2;3;9;1;1;1
250883447311;250883447882;571;0,1,2;3;9;1;1;1
250883447882;250883450222;2340;0,1,2;3;9;1;1;1
250883450222;250883454394;4172;0,1,2;3;9;1;1;1
250883454394;250883455113;719;0,1,2;3;9;1;1;1
250883455113;250883456792;1679;0,1,2;3;9;1;1;1
250883456792;250883458175;1383;0,1,2;3;9;1;1;1
250883458175;250883459899;1724;0,1,2;3;9;1;1;1
250883459899;250883460722;823;0,1,2;3;9;1;1;1
250883460722;250883465313;4591;0,1,2;3;9;1;1;1
250883465313;250883466759;1446;0,1,2;3;9;1;1;1
250883466759;250883468201;1442;0,1,2;3;9;1;1;1
250883468201;250883470412;2211;0,1,2;3;9;1;1;1
250883470412;250883472441;2029;0,1,2;3;9;1;1;1
250883472441;250883474048;1607;0,1,2;3;9;1;1;1
250883474048;250883477239;3191;0,1,2;3;9;1;1;1
250883477239;250883478274;1035;0,1,2;3;9;1;1;1
250883478274;250883478356;82;0,1,2;3;9;1;1;1
250883478356;250883480329;1973;0,1,2;3;9;1;1;1
250883480329;250883481256;927;0,1,2;3;9;1;1;1
250883481256;250883483547;2291;0,1,2;3;9;1;1;1
250883483547;250883483741;194;0,1,2;3;9;1;1;1
250883483741;250883485284;1543;0,1,2;3;9;1;1;1
250883485284;250883490398;5114;0,1,2;3;9;1;1;1
250883490398;250883491405;1007;0,1,2;3;9;1;1;1
250883491405;250883494571;3166;0,1,2;3;9;1;1;1
250883494571;250883502896;8325;0,1,2;3;9;1;1;1
250883502896;250883503092;196;0,1,2;3;9;1;1;1
250883503092;250883510961;7869;0,1,2;3;9;1;1;1
250883510961;250883516055;5094;0,1,2;3;9;1;1;1
250883516055;250883516772;717;0,1,2;3;9;1;1;1
250883516772;250883521559;4787;0,1,2;3;9;1;1;1
250883521559;250883526078;4519;0,1,2;3;9;1;1;1
250883526078;250883527609;1531;0,1,2;3;9;1;1;1
250883527609;250883527782;173;0,1,2;3;9;1;1;1
250883527782;250883534448;6666;0,1,2;3;9;1;1;1
250883534448;250883542726;8278;0,1,2;3;9;1;1;1
250883542726;250883544221;1495;0,1,2;3;9;1;1;1
250883544221;250883544828;607;0,1,2;3;9;1;1;1
250883544828;250883549876;5048;0,1,2;3;9;1;1;1
250883549876;250883551536;1660;0,1,2;3;9;1;1;1
250883551536;250883559287;7751;0,1,2;3;9;1;1;1
250883559287;250883562670;3383;0,1,2;3;9;1;1;1
250883562670;250883571190;8520;0,1,2;3;9;1;1;1
250883571190;250883572299;1109;0,1,2;3;9;1;1;1
250883572299;250883577345;5046;0,1,2;3;9;1;1;1
250883577345;250883583856;6511;0,1,2;3;9;1;1;1
250883583856;250883593847;9991;0,1,2;3;9;1;1;1
250883593847;250883596162;2315;0,1,2;3;9;1;1;1
250883596162;250883596677;515;0,1,2;3;9;1;1;1
250883596677;250883601228;4551;0,1,2;3;9;1;1;1
250883601228;250883603304;2076;0,1,2;3;9;1;1;1
250883603304;250883606460;3156;0,1,2;3;9;1;1;1
250883606460;250883607442;982;0,1,2;3;9;1;1;1
250883607442;250883608198;756;0,1,2;3;9;1;1;1
250883608198;250883612458;4260;0,1,2;3;9;1;1;1
250883612458;250883612848;390;0,1,2;3;9;1;1;1
250883612848;250883617557;4709;0,1,2;3;9;1;1;1
250883617557;250883620763;3206;0,1,2;3;9;1;1;1
250883620763;250883622500;1737;0,1,2;3;9;1;1;1
250883622500;250883623567;1067;0,1,2;3;9;1;1;1
250883623567;250883625540;1973;0,1,2;3;9;1;1;1
250883625540;250883627353;1813;0,1,2;3;9;1;1;1
250883627353;250883627999;646;0,1,2;3;9;1;1;1
250883627999;250883628645;646;0,1,2;3;9;1;1;1
250883628645;250883631092;2447;0,1,2;3;9;1;1;1
250883631092;250883637071;5979;0,1,2;3;9;1;1;1
250883637071;250883639718;2647;0,1,2;3;9;1;1;1
250883639718;250883639870;152;0,1,2;3;9;1;1;1
250883639870;250883646082;6212;0,1,2;3;9;1;1;1
250883646082;250883648846;2764;0,1,2;3;9;1;1;1
250883648846;250883648890;44;0,1,2;3;9;1;1;1
250883648890;250883649009;119;0,1,2;3;9;1;1;1
250883649009;250883649391;382;0,1,2;3;9;1;1;1
250883649391;250883651374;1983;0,1,2;3;9;1;1;1
250883651374;250883653560;2186;0,1,2;3;9;1;1;1
250883653560;250883654214;654;0,1,2;3;9;1;1;1
250883654214;250883661784;7570;0,1,2;3;9;1;1;1
250883661784;250883664550;2766;0,1,2;3;9;1;1;1
250883664550;250883666276;1726;0,1,2;3;9;1;1;1
250883666276;250883666646;370;0,1,2;3;9;1;1;1
250883666646;250883666701;55;0,1,2;3;9;1;1;1
250883666701;250883666707;6;0,1,2;3;9;1;1;1
250883666707;250883668286;1579;0,1,2;3;9;1;1;1
250883668286;250883668423;137;0,1,2;3;9;1;1;1
250883668423;250883668494;71;0,1,2;3;9;1;1;1
250883668494;250883669168;674;0,1,2;3;9;1;1;1
250883669168;250883669248;80;0,1,2;3;9;1;1;1
250883669248;250883669366;118;0,1,2;3;9;1;1;1
250883669366;250883671358;1992;0,1,2;3;9;1;1;1
250883671358;250883671380;22;0,1,2;3;9;1;1;1
250883671380;250883672739;1359;0,1,2;3;9;1;1;1
250883672739;250883674731;1992;0,1,2;3;9;1;1;1
250883674731;250883676469;1738;0,1,2;3;9;1;1;1
250883676469;250883677152;683;0,1,2;3;9;1;1;1
250883677152;250883678509;1357;0,1,2;3;9;1;1;1
250883678509;250883679053;544;0,1,2;3;9;1;1;1
250883679053;250883681331;2278;0,1,2;3;9;1;1;1
250883681331;250883681676;345;0,1,2;3;9;1;1;1
250883681676;250883682825;1149;0,1,2;3;9;1;1;1
250883682825;250883683525;700;0,1,2;3;9;1;1;1
250883683525;250883683561;36;0,1,2;3;9;1;1;1
250883683561;250883683593;32;0,1,2;3;9;1;1;1
250883683593;250883684231;638;0,1,2;3;9;1;1;1
250883684231;250883684429;198;0,1,2;3;9;1;1;1
250883684429;250883687242;2813;0,1,2;3;9;1;1;1
250883687242;250883687468;226;0,1,2;3;9;1;1;1
250883687468;250883688083;615;0,1,2;3;9;1;1;1
250883688083;250883689234;1151;0,1,2;3;9;1;1;1
250883689234;250883689587;353;0,1,2;3;9;1;1;1
250883689587;250883693056;3469;0,1,2;3;9;1;1;1
250883693056;250883698367;5311;0,1,2;3;9;1;1;1
250883698367;250883699450;1083;0,1,2;3;9;1;1;1
250883699450;250883702200;2750;0,1,2;3;9;1;1;1
250883702200;250883708797;6597;0,1,2;3;9;1;1;1
250883708797;250883710596;1799;0,1,2;3;9;1;1;1
250883710596;250883711869;1273;0,1,2;3;9;1;1;1
250883711869;250883712965;1096;0,1,2;3;9;1;1;1
250883712965;250883713722;757;0,1,2;3;9;1;1;1
250883713722;250883714828;1106;0,1,2;3;9;1;1;1
250883714828;250883715013;185;0,1,2;3;9;1;1;1
250883715013;250883718800;3787;0,1,2;3;9;1;1;1
250883718800;250883719633;833;0,1,2;3;9;1;1;1
250883719633;250883720064;431;0,1,2;3;9;1;1;1
250883720064;250883720251;187;0,1,2;3;9;1;1;1
250883720251;250883722371;2120;0,1,2;3;9;1;1;1
250883722371;250883723051;680;0,1,2;3;9;1;1;1
250883723051;250883725196;2145;0,1,2;3;9;1;1;1
250883725196;250883725626;430;0,1,2;3;9;1;1;1
250883725626;250883729945;4319;0,1,2;3;9;1;1;1
250883729945;250883730004;59;0,1,2;3;9;1;1;1
250883730004;250883733391;3387;0,1,2;3;9;1;1;1
250883733391;250883735009;1618;0,1,2;3;9;1;1;1
250883735009;250883735095;86;0,1,2;3;9;1;1;1
250883735095;250883735951;856;0,1,2;3;9;1;1;1
250883735951;250883736019;68;0,1,2;3;9;1;1;1
250883736019;250883738399;2380;0,1,2;3;9;1;1;1
250883738399;250883741606;3207;0,1,2;3;9;1;1;1
250883741606;250883741644;38;0,1,2;3;9;1;1;1
250883741644;250883742025;381;0,1,2;3;9;1;1;1
250883742025;250883745119;3094;0,1,2;3;9;1;1;1
250883745119;250883745946;827;0,1,2;3;9;1;1;1
250883745946;250883746487;541;0,1,2;3;9;1;1;1
250883746487;250883746997;510;0,1,2;3;9;1;1;1
250883746997;250883747186;189;0,1,2;3;9;1;1;1
250883747186;250883747209;23;0,1,2;3;9;1;1;1
250883747209;250883748371;1162;0,1,2;3;9;1;1;1
250883748371;250883748402;31;0,1,2;3;9;1;1;1
250883748402;250883748896;494;0,1,2;3;9;1;1;1
250883748896;250883749739;843;0,1,2;3;9;1;1;1
250883749739;250883750034;295;0,1,2;3;9;1;1;1
250883750034;250883752121;2087;0,1,2;3;9;1;1;1
250883752121;250883752947;826;0,1,2;3;9;1;1;1
250883752947;250883754076;1129;0,1,2;3;9;1;1;1
250883754076;250883754174;98;0,1,2;3;9;1;1;1
250883754174;250883755520;1346;0,1,2;3;9;1;1;1
250883755520;250883755573;53;0,1,2;3;9;1;1;1
250883755573;250883756425;852;0,1,2;3;9;1;1;1
250883756425;250883757517;1092;0,1,2;3;9;1;1;1
250883757517;250883761144;3627;0,1,2;3;9;1;1;1
250883761144;250883761179;35;0,1,2;3;9;1;1;1
250883761179;250883761493;314;0,1,2;3;9;1;1;1
250883761493;250883761872;379;0,1,2;3;9;1;1;1
250883761872;250883764324;2452;0,1,2;3;9;1;1;1
250883764324;250883764616;292;0,1,2;3;9;1;1;1
250883764616;250883766359;1743;0,1,2;3;9;1;1;1
250883766359;250883766846;487;0,1,2;3;9;1;1;1
250883766846;250883766973;127;0,1,2;3;9;1;1;1
250883766973;250883768018;1045;0,1,2;3;9;1;1;1
250883768018;250883768275;257;0,1,2;3;9;1;1;1
250883768275;250883768861;586;0,1,2;3;9;1;1;1
250883768861;250883769060;199;0,1,2;3;9;1;1;1
250883769060;250883771228;2168;0,1,2;3;9;1;1;1
250883771228;250883775114;3886;0,1,2;3;9;1;1;1
250883775114;250883778133;3019;0,1,2;3;9;1;1;1
250883778133;250883778202;69;0,1,2;3;9;1;1;1
250883778202;250883779489;1287;0,1,2;3;9;1;1;1
250883779489;250883779545;56;0,1,2;3;9;1;1;1
250883779545;250883779745;200;0,1,2;3;9;1;1;1
250883779745;250883780850;1105;0,1,2;3;9;1;1;1
250883780850;250883782514;1664;0,1,2;3;9;1;1;1
250883782514;250883785295;2781;0,1,2;3;9;1;1;1
250883785295;250883788531;3236;0,1,2;3;9;1;1;1
250883788531;250883789265;734;0,1,2;3;9;1;1;1
250883789265;250883789319;54;0,1,2;3;9;1;1;1
250883789319;250883796093;6774;0,1,2;3;9;1;1;1
250883796093;250883796374;281;0,1,2;3;9;1;1;1
250883796374;250883796694;320;0,1,2;3;9;1;1;1
250883796694;250883799185;2491;0,1,2;3;9;1;1;1
250883799185;250883800461;1276;0,1,2;3;9;1;1;1
250883800461;250883807233;6772;0,1,2;3;9;1;1;1
250883807233;250883809751;2518;0,1,2;3;9;1;1;1
250883809751;250883810459;708;0,1,2;3;9;1;1;1
250883810459;250883810612;153;0,1,2;3;9;1;1;1
250883810612;250883810803;191;0,1,2;3;9;1;1;1
250883810803;250883811385;582;0,1,2;3;9;1;1;1
250883811385;250883821603;10218;0,1,2;3;9;1;1;1
250883821603;250883822808;1205;0,1,2;3;9;1;1;1
250883822808;250883823450;642;0,1,2;3;9;1;1;1
250883823450;250883825562;2112;0,1,2;3;9;1;1;1
250883825562;250883825707;145;0,1,2;3;9;1;1;1
250883825707;250883826442;735;0,1,2;3;9;1;1;1
250883826442;250883835029;8587;0,1,2;3;9;1;1;1
250883835029;250883835767;738;0,1,2;3;9;1;1;1
250883835767;250883836741;974;0,1,2;3;9;1;1;1
250883836741;250883838675;1934;0,1,2;3;9;1;1;1
250883838675;250883841082;2407;0,1,2;3;9;1;1;1
250883841082;250883845897;4815;0,1,2;3;9;1;1;1
250883845897;250883849028;3131;0,1,2;3;9;1;1;1
250883849028;250883855882;6854;0,1,2;3;9;1;1;1
250883855882;250883856497;615;0,1,2;3;9;1;1;1
250883856497;250883868093;11596;0,1,2;3;9;1;1;1
250883868093;250883870208;2115;0,1,2;3;9;1;1;1
250883870208;250883883017;12809;0,1,2;3;9;1;1;1
250883883017;250883888648;5631;0,1,2;3;9;1;1;1
250883888648;250883899103;10455;0,1,2;3;9;1;1;1
250883899103;250883904087;4984;0,1,2;3;9;1;1;1
250883904087;250883934804;30717;0,1,2;3;9;1;1;1
250883934804;250883937304;2500;0,1,2;3;9;1;1;1
250883937304;250883938633;1329;0,1,2;3;9;1;1;1
250883938633;250883947163;8530;0,1,2;3;9;1;1;1
250883947163;250883947870;707;0,1,2;3;9;1;1;1
250883947870;250883952381;4511;0,1,2;3;9;1;1;1
250883952381;250883953598;1217;0,1,2;3;9;1;1;1
250883953598;250883961542;7944;0,1,2;3;9;1;1;1
250883961542;250883962946;1404;0,1,2;3;9;1;1;1
250883962946;250883963383;437;0,1,2;3;9;1;1;1
250883963383;250883980134;16751;0,1,2;3;9;1;1;1
250883980134;250883996139;16005;0,1,2;3;9;1;1;1
250883996139;250883997327;1188;0,1,2;3;9;1;1;1
250883997327;250884006798;9471;0,1,2;3;9;1;1;1
250884006798;250884007828;1030;0,1,2;3;9;1;1;1
250884007828;250884007922;94;0,1,2;3;9;1;1;1
250884007922;250884013905;5983;0,1,2;3;9;1;1;1
250884013905;250884014467;562;0,1,2;3;9;1;1;1
250884014467;250884015094;627;0,1,2;3;9;1;1;1
250884015094;250884017441;2347;0,1,2;3;9;1;1;1
250884017441;250884023463;6022;0,1,2;3;9;1;1;1
250884023463;250884026580;3117;0,1,2;3;9;1;1;1
250884026580;250884032115;5535;0,1,2;3;9;1;1;1
250884032115;250884038382;6267;0,1,2;3;9;1;1;1
250884038382;250884040406;2024;0,1,2;3;9;1;1;1
250884040406;250884044039;3633;0,1,2;3;9;1;1;1
250884044039;250884046617;2578;0,1,2;3;9;1;1;1
250884046617;250884055559;8942;0,1,2;3;9;1;1;1
250884055559;250884056940;1381;0,1,2;3;9;1;1;1
250884056940;250884058143;1203;0,1,2;3;9;1;1;1
250884058143;250884063888;5745;0,1,2;3;9;1;1;1
250884063888;250884067497;3609;0,1,2;3;9;1;1;1
250884067497;250884074614;7117;0,1,2;3;9;1;1;1
250884074614;250884077264;2650;0,1,2;3;9;1;1;1
250884077264;250884083914;6650;0,1,2;3;9;1;1;1
250884083914;250884085611;1697;0,1,2;3;9;1;1;1
250884085611;250884087075;1464;0,1,2;3;9;1;1;1
250884087075;250884098370;11295;0,1,2;3;9;1;1;1
250884098370;250884101002;2632;0,1,2;3;9;1;1;1
250884101002;250884106082;5080;0,1,2;3;9;1;1;1
250884106082;250884106563;481;0,1,2;3;9;1;1;1
250884106563;250884110318;3755;0,1,2;3;9;1;1;1
250884110318;250884111270;952;0,1,2;3;9;1;1;1
250884111270;250884115443;4173;0,1,2;3;9;1;1;1
250884115443;250884117789;2346;0,1,2;3;9;1;1;1
250884117789;250884119356;1567;0,1,2;3;9;1;1;1
250884119356;250884120657;1301;0,1,2;3;9;1;1;1
250884120657;250884123147;2490;0,1,2;3;9;1;1;1
250884123147;250884138982;15835;0,1,2;3;9;1;1;1
250884138982;250884148184;9202;0,1,2;3;9;1;1;1
250884148184;250884161704;13520;0,1,2;3;9;1;1;1
250884161704;250884162158;454;0,1,2;3;9;1;1;1
250884162158;250884172755;10597;0,1,2;3;9;1;1;1
250884172755;250884173010;255;0,1,2;3;9;1;1;1
250884173010;250884184866;11856;0,1,2;3;9;1;1;1
250884184866;250884184909;43;0,1,2;3;9;1;1;1
250884184909;250884185019;110;0,1,2;3;9;1;1;1
250884185019;250884198975;13956;0,1,2;3;9;1;1;1
250884198975;250884199071;96;0,1,2;3;9;1;1;1
250884199071;250884538084;339013;0,1,2;3;9;1;1;1
250884538084;250885185774;647690;0,1,2;3;9;1;1;1
250885185774;250885200830;15056;0,1,2;3;9;1;1;1
250885200830;250885276233;75403;0,1,2;3;9;1;1;1
250885276233;250885287595;11362;0,1,2;3;9;1;1;1
250885287595;250889250392;3962797;0,1,2;3;9;1;1;1
250889250392;250889379718;129326;0,1,2;3;9;1;1;1
250889379718;250889548047;168329;0,1,2;3;9;1;1;1
250889548047;250889587484;39437;0,1,2;3;9;1;1;1
250889587484;250889632949;45465;0,1,2;3;9;1;1;1
250889632949;250889650542;17593;0,1,2;3;9;1;1;1
250889650542;250889774816;124274;0,1,2;3;9;1;1;1
250889774816;250889799541;24725;0,1,2;3;9;1;1;1
250889799541;250889804901;5360;0,1,2;3;9;1;1;1
250889804901;250889834562;29661;0,1,2;3;9;1;1;1
250889834562;250889856985;22423;0,1,2;3;9;1;1;1
250889856985;250889865431;8446;0,1,2;3;9;1;1;1
250889865431;250889869631;4200;0,1,2;3;9;1;1;1
250889869631;250889872297;2666;0,1,2;3;9;1;1;1
250889872297;250889876249;3952;0,1,2;3;9;1;1;1
250889876249;250889876287;38;0,1,2;3;9;1;1;1
250889876287;250889902201;25914;0,1,2;3;9;1;1;1
250889902201;250889919834;17633;0,1,2;3;9;1;1;1
250889919834;250889922227;2393;0,1,2;3;9;1;1;1
250889922227;250889935513;13286;0,1,2;3;9;1;1;1
250889935513;250889935596;83;0,1,2;3;9;1;1;1
250889935596;250889953657;18061;0,1,2;3;9;1;1;1
250889953657;250889983622;29965;0,1,2;3;9;1;1;1
250889983622;250890017754;34132;0,1,2;3;9;1;1;1
250890017754;250890018350;596;0,1,2;3;9;1;1;1
250890018350;250890025673;7323;0,1,2;3;9;1;1;1
250890025673;250890030647;4974;0,1,2;3;9;1;1;1
250890030647;250890036283;5636;0,1,2;3;9;1;1;1
250890036283;250890039799;3516;0,1,2;3;9;1;1;1
250890039799;250890080742;40943;0,1,2;3;9;1;1;1
250890080742;250890080959;217;0,1,2;3;9;1;1;1
250890080959;250890139269;58310;0,1,2;3;9;1;1;1
250890139269;250890145020;5751;0,1,2;3;9;1;1;1
250890145020;250890145071;51;0,1,2;3;9;1;1;1
250890145071;250890146501;1430;0,1,2;3;9;1;1;1
250890146501;250890151050;4549;0,1,2;3;9;1;1;1
250890151050;250890166350;15300;0,1,2;3;9;1;1;1
250890166350;250890173569;7219;0,1,2;3;9;1;1;1
250890173569;250890176454;2885;0,1,2;3;9;1;1;1
250890176454;250890177549;1095;0,1,2;3;9;1;1;1
250890177549;250890178663;1114;0,1,2;3;9;1;1;1
250890178663;250890181187;2524;0,1,2;3;9;1;1;1
250890181187;250890194568;13381;0,1,2;3;9;1;1;1
250890194568;250890195610;1042;0,1,2;3;9;1;1;1
250890195610;250890210440;14830;0,1,2;3;9;1;1;1
250890210440;250890211519;1079;0,1,2;3;9;1;1;1
250890211519;250890223602;12083;0,1,2;3;9;1;1;1
250890223602;250890235065;11463;0,1,2;3;9;1;1;1
250890235065;250890271001;35936;0,1,2;3;9;1;1;1
250890271001;250890272365;1364;0,1,2;3;9;1;1;1
250890272365;250890273060;695;0,1,2;3;9;1;1;1
250890273060;250890284499;11439;0,1,2;3;9;1;1;1
250890284499;250890284565;66;0,1,2;3;9;1;1;1
250890284565;250890308509;23944;0,1,2;3;9;1;1;1
250890308509;250890319936;11427;0,1,2;3;9;1;1;1
250890319936;250890321486;1550;0,1,2;3;9;1;1;1
250890321486;250890324209;2723;0,1,2;3;9;1;1;1
250890324209;250890326909;2700;0,1,2;3;9;1;1;1
250890326909;250890327542;633;0,1,2;3;9;1;1;1
250890327542;250890329467;1925;0,1,2;3;9;1;1;1
250890329467;250890329509;42;0,1,2;3;9;1;1;1
250890329509;250890332000;2491;0,1,2;3;9;1;1;1
250890332000;250890332021;21;0,1,2;3;9;1;1;1
250890332021;250890333521;1500;0,1,2;3;9;1;1;1
250890333521;250890334317;796;0,1,2;3;9;1;1;1
250890334317;250890338657;4340;0,1,2;3;9;1;1;1
250890338657;250890338824;167;0,1,2;3;9;1;1;1
250890338824;250890338876;52;0,1,2;3;9;1;1;1
250890338876;250890341253;2377;0,1,2;3;9;1;1;1
250890341253;250890346461;5208;0,1,2;3;9;1;1;1
250890346461;250890348101;1640;0,1,2;3;9;1;1;1
250890348101;250890359170;11069;0,1,2;3;9;1;1;1
250890359170;250890361351;2181;0,1,2;3;9;1;1;1
250890361351;250890362824;1473;0,1,2;3;9;1;1;1
250890362824;250890367005;4181;0,1,2;3;9;1;1;1
250890367005;250890367693;688;0,1,2;3;9;1;1;1
250890367693;250890381345;13652;0,1,2;3;9;1;1;1
250890381345;250890383195;1850;0,1,2;3;9;1;1;1
250890383195;250890394031;10836;0,1,2;3;9;1;1;1
250890394031;250890401335;7304;0,1,2;3;9;1;1;1
250890401335;250890401735;400;0,1,2;3;9;1;1;1
250890401735;250890402589;854;0,1,2;3;9;1;1;1
250890402589;250890402907;318;0,1,2;3;9;1;1;1
250890402907;250890406505;3598;0,1,2;3;9;1;1;1
250890406505;250890419028;12523;0,1,2;3;9;1;1;1
250890419028;250890419167;139;0,1,2;3;9;1;1;1
250890419167;250890435671;16504;0,1,2;3;9;1;1;1
250890435671;250890438738;3067;0,1,2;3;9;1;1;1
250890438738;250890448583;9845;0,1,2;3;9;1;1;1
250890448583;250890461108;12525;0,1,2;3;9;1;1;1
250890461108;250890470357;9249;0,1,2;3;9;1;1;1
250890470357;250890474863;4506;0,1,2;3;9;1;1;1
250890474863;250890475232;369;0,1,2;3;9;1;1;1
250890475232;250890479030;3798;0,1,2;3;9;1;1;1
250890479030;250890480103;1073;0,1,2;3;9;1;1;1
250890480103;250890483484;3381;0,1,2;3;9;1;1;1
250890483484;250890483623;139;0,1,2;3;9;1;1;1
250890483623;250890486893;3270;0,1,2;3;9;1;1;1
250890486893;250890488348;1455;0,1,2;3;9;1;1;1
250890488348;250890488624;276;0,1,2;3;9;1;1;1
250890488624;250890492683;4059;0,1,2;3;9;1;1;1
250890492683;250890493976;1293;0,1,2;3;9;1;1;1
250890493976;250890497189;3213;0,1,2;3;9;1;1;1
250890497189;250890498138;949;0,1,2;3;9;1;1;1
250890498138;250890500086;1948;0,1,2;3;9;1;1;1
250890500086;250890500122;36;0,1,2;3;9;1;1;1
250890500122;250890505116;4994;0,1,2;3;9;1;1;1
250890505116;250890505229;113;0,1,2;3;9;1;1;1
250890505229;250890505854;625;0,1,2;3;9;1;1;1
250890505854;250890505944;90;0,1,2;3;9;1;1;1
250890505944;250890507769;1825;0,1,2;3;9;1;1;1
250890507769;250890508830;1061;0,1,2;3;9;1;1;1
250890508830;250890516795;7965;0,1,2;3;9;1;1;1
250890516795;250890520249;3454;0,1,2;3;9;1;1;1
250890520249;250890520488;239;0,1,2;3;9;1;1;1
250890520488;250890520790;302;0,1,2;3;9;1;1;1
250890520790;250890522688;1898;0,1,2;3;9;1;1;1
250890522688;250890522880;192;0,1,2;3;9;1;1;1
250890522880;250890523432;552;0,1,2;3;9;1;1;1
250890523432;250890524113;681;0,1,2;3;9;1;1;1
250890524113;250890525333;1220;0,1,2;3;9;1;1;1
250890525333;250890529948;4615;0,1,2;3;9;1;1;1
250890529948;250890533992;4044;0,1,2;3;9;1;1;1
250890533992;250890539266;5274;0,1,2;3;9;1;1;1
250890539266;250890539318;52;0,1,2;3;9;1;1;1
250890539318;250890549814;10496;0,1,2;3;9;1;1;1
250890549814;250890550961;1147;0,1,2;3;9;1;1;1
250890550961;250890553846;2885;0,1,2;3;9;1;1;1
250890553846;250890556040;2194;0,1,2;3;9;1;1;1
250890556040;250890559484;3444;0,1,2;3;9;1;1;1
250890559484;250890559973;489;0,1,2;3;9;1;1;1
250890559973;250890565486;5513;0,1,2;3;9;1;1;1
250890565486;250890567262;1776;0,1,2;3;9;1;1;1
250890567262;250890569408;2146;0,1,2;3;9;1;1;1
250890569408;250890575809;6401;0,1,2;3;9;1;1;1
250890575809;250890581682;5873;0,1,2;3;9;1;1;1
250890581682;250890582839;1157;0,1,2;3;9;1;1;1
250890582839;250890584352;1513;0,1,2;3;9;1;1;1
250890584352;250890585521;1169;0,1,2;3;9;1;1;1
250890585521;250890589912;4391;0,1,2;3;9;1;1;1
250890589912;250890592393;2481;0,1,2;3;9;1;1;1
250890592393;250890596776;4383;0,1,2;3;9;1;1;1
250890596776;250890602574;5798;0,1,2;3;9;1;1;1
250890602574;250890602598;24;0,1,2;3;9;1;1;1
250890602598;250890602875;277;0,1,2;3;9;1;1;1
250890602875;250890603915;1040;0,1,2;3;9;1;1;1
250890603915;250890610739;6824;0,1,2;3;9;1;1;1
250890610739;250890612613;1874;0,1,2;3;9;1;1;1
250890612613;250890616270;3657;0,1,2;3;9;1;1;1
250890616270;250890619013;2743;0,1,2;3;9;1;1;1
250890619013;250890621336;2323;0,1,2;3;9;1;1;1
250890621336;250890621727;391;0,1,2;3;9;1;1;1
250890621727;250890622225;498;0,1,2;3;9;1;1;1
250890622225;250890623993;1768;0,1,2;3;9;1;1;1
250890623993;250890624159;166;0,1,2;3;9;1;1;1
250890624159;250890626139;1980;0,1,2;3;9;1;1;1
250890626139;250890627149;1010;0,1,2;3;9;1;1;1
250890627149;250890639825;12676;0,1,2;3;9;1;1;1
250890639825;250890640259;434;0,1,2;3;9;1;1;1
250890640259;250890644108;3849;0,1,2;3;9;1;1;1
250890644108;250890644581;473;0,1,2;3;9;1;1;1
250890644581;250890648992;4411;0,1,2;3;9;1;1;1
250890648992;250890649540;548;0,1,2;3;9;1;1;1
250890649540;250890649743;203;0,1,2;3;9;1;1;1
250890649743;250890650519;776;0,1,2;3;9;1;1;1
250890650519;250890652812;2293;0,1,2;3;9;1;1;1
250890652812;250890652862;50;0,1,2;3;9;1;1;1
250890652862;250890654457;1595;0,1,2;3;9;1;1;1
250890654457;250890654506;49;0,1,2;3;9;1;1;1
250890654506;250890658577;4071;0,1,2;3;9;1;1;1
250890658577;250890661866;3289;0,1,2;3;9;1;1;1
250890661866;250890663192;1326;0,1,2;3;9;1;1;1
250890663192;250890663347;155;0,1,2;3;9;1;1;1
250890663347;250890675659;12312;0,1,2;3;9;1;1;1
250890675659;250890677052;1393;0,1,2;3;9;1;1;1
250890677052;250890686256;9204;0,1,2;3;9;1;1;1
250890686256;250890686787;531;0,1,2;3;9;1;1;1
250890686787;250890688307;1520;0,1,2;3;9;1;1;1
250890688307;250890690229;1922;0,1,2;3;9;1;1;1
250890690229;250890694036;3807;0,1,2;3;9;1;1;1
250890694036;250890694262;226;0,1,2;3;9;1;1;1
250890694262;250890695198;936;0,1,2;3;9;1;1;1
250890695198;250890697461;2263;0,1,2;3;9;1;1;1
250890697461;250890698207;746;0,1,2;3;9;1;1;1
250890698207;250890698447;240;0,1,2;3;9;1;1;1
250890698447;250890700324;1877;0,1,2;3;9;1;1;1
250890700324;250890703219;2895;0,1,2;3;9;1;1;1
250890703219;250890704900;1681;0,1,2;3;9;1;1;1
250890704900;250890706897;1997;0,1,2;3;9;1;1;1
250890706897;250890707389;492;0,1,2;3;9;1;1;1
250890707389;250890709588;2199;0,1,2;3;9;1;1;1
250890709588;250890712080;2492;0,1,2;3;9;1;1;1
250890712080;250890713426;1346;0,1,2;3;9;1;1;1
250890713426;250890713903;477;0,1,2;3;9;1;1;1
250890713903;250890714202;299;0,1,2;3;9;1;1;1
250890714202;250890715813;1611;0,1,2;3;9;1;1;1
250890715813;250890716219;406;0,1,2;3;9;1;1;1
250890716219;250890718243;2024;0,1,2;3;9;1;1;1
250890718243;250890720643;2400;0,1,2;3;9;1;1;1
250890720643;250890721035;392;0,1,2;3;9;1;1;1
250890721035;250890724928;3893;0,1,2;3;9;1;1;1
250890724928;250890727424;2496;0,1,2;3;9;1;1;1
250890727424;250890733562;6138;0,1,2;3;9;1;1;1
250890733562;250890734918;1356;0,1,2;3;9;1;1;1
250890734918;250890735297;379;0,1,2;3;9;1;1;1
250890735297;250890737088;1791;0,1,2;3;9;1;1;1
250890737088;250890739809;2721;0,1,2;3;9;1;1;1
250890739809;250890743924;4115;0,1,2;3;9;1;1;1
250890743924;250890744155;231;0,1,2;3;9;1;1;1
250890744155;250890747321;3166;0,1,2;3;9;1;1;1
250890747321;250890765974;18653;0,1,2;3;9;1;1;1
250890765974;250890769673;3699;0,1,2;3;9;1;1;1
250890769673;250890775266;5593;0,1,2;3;9;1;1;1
250890775266;250890779830;4564;0,1,2;3;9;1;1;1
250890779830;250890785555;5725;0,1,2;3;9;1;1;1
250890785555;250890786371;816;0,1,2;3;9;1;1;1
250890786371;250890786400;29;0,1,2;3;9;1;1;1
250890786400;250890786907;507;0,1,2;3;9;1;1;1
250890786907;250890788900;1993;0,1,2;3;9;1;1;1
250890788900;250890792194;3294;0,1,2;3;9;1;1;1
250890792194;250890806752;14558;0,1,2;3;9;1;1;1
250890806752;250890806817;65;0,1,2;3;9;1;1;1
250890806817;250890808332;1515;0,1,2;3;9;1;1;1
250890808332;250890809290;958;0,1,2;3;9;1;1;1
250890809290;250890809665;375;0,1,2;3;9;1;1;1
250890809665;250890810669;1004;0,1,2;3;9;1;1;1
250890810669;250890811970;1301;0,1,2;3;9;1;1;1
250890811970;250890811991;21;0,1,2;3;9;1;1;1
250890811991;250890812100;109;0,1,2;3;9;1;1;1
250890812100;250890812356;256;0,1,2;3;9;1;1;1
250890812356;250890815154;2798;0,1,2;3;9;1;1;1
250890815154;250890818624;3470;0,1,2;3;9;1;1;1
250890818624;250890821669;3045;0,1,2;3;9;1;1;1
250890821669;250890821729;60;0,1,2;3;9;1;1;1
250890821729;250890821777;48;0,1,2;3;9;1;1;1
250890821777;250890822258;481;0,1,2;3;9;1;1;1
250890822258;250890823859;1601;0,1,2;3;9;1;1;1
250890823859;250890825526;1667;0,1,2;3;9;1;1;1
250890825526;250890826986;1460;0,1,2;3;9;1;1;1
250890826986;250890827693;707;0,1,2;3;9;1;1;1
250890827693;250890833940;6247;0,1,2;3;9;1;1;1
250890833940;250890835537;1597;0,1,2;3;9;1;1;1
250890835537;250890835755;218;0,1,2;3;9;1;1;1
250890835755;250890842740;6985;0,1,2;3;9;1;1;1
250890842740;250890847388;4648;0,1,2;3;9;1;1;1
250890847388;250890848346;958;0,1,2;3;9;1;1;1
250890848346;250890853470;5124;0,1,2;3;9;1;1;1
250890853470;250890854292;822;0,1,2;3;9;1;1;1
250890854292;250890854349;57;0,1,2;3;9;1;1;1
250890854349;250890860247;5898;0,1,2;3;9;1;1;1
250890860247;250890860849;602;0,1,2;3;9;1;1;1
250890860849;250890861337;488;0,1,2;3;9;1;1;1
250890861337;250890863739;2402;0,1,2;3;9;1;1;1
250890863739;250890864000;261;0,1,2;3;9;1;1;1
250890864000;250890870254;6254;0,1,2;3;9;1;1;1
250890870254;250890873020;2766;0,1,2;3;9;1;1;1
250890873020;250890877012;3992;0,1,2;3;9;1;1;1
250890877012;250890877833;821;0,1,2;3;9;1;1;1
250890877833;250890882279;4446;0,1,2;3;9;1;1;1
250890882279;250890882535;256;0,1,2;3;9;1;1;1
250890882535;250890883140;605;0,1,2;3;9;1;1;1
250890883140;250890883403;263;0,1,2;3;9;1;1;1
250890883403;250890885596;2193;0,1,2;3;9;1;1;1
250890885596;250890885897;301;0,1,2;3;9;1;1;1
250890885897;250890887907;2010;0,1,2;3;9;1;1;1
250890887907;250890890378;2471;0,1,2;3;9;1;1;1
250890890378;250890891251;873;0,1,2;3;9;1;1;1
250890891251;250890891812;561;0,1,2;3;9;1;1;1
250890891812;250890897860;6048;0,1,2;3;9;1;1;1
250890897860;250890902050;4190;0,1,2;3;9;1;1;1
250890902050;250890903985;1935;0,1,2;3;9;1;1;1
250890903985;250890905697;1712;0,1,2;3;9;1;1;1
250890905697;250890908201;2504;0,1,2;3;9;1;1;1
250890908201;250890910308;2107;0,1,2;3;9;1;1;1
250890910308;250890912752;2444;0,1,2;3;9;1;1;1
250890912752;250890914760;2008;0,1,2;3;9;1;1;1
250890914760;250890920588;5828;0,1,2;3;9;1;1;1
250890920588;250890920683;95;0,1,2;3;9;1;1;1
250890920683;250890923495;2812;0,1,2;3;9;1;1;1
250890923495;250890924561;1066;0,1,2;3;9;1;1;1
250890924561;250890926231;1670;0,1,2;3;9;1;1;1
250890926231;250890927457;1226;0,1,2;3;9;1;1;1
250890927457;250890928062;605;0,1,2;3;9;1;1;1
250890928062;250890931325;3263;0,1,2;3;9;1;1;1
250890931325;250890932591;1266;0,1,2;3;9;1;1;1
250890932591;250890933235;644;0,1,2;3;9;1;1;1
250890933235;250890933458;223;0,1,2;3;9;1;1;1
250890933458;250890938801;5343;0,1,2;3;9;1;1;1
250890938801;250890940502;1701;0,1,2;3;9;1;1;1
250890940502;250890945940;5438;0,1,2;3;9;1;1;1
250890945940;250890947168;1228;0,1,2;3;9;1;1;1
250890947168;250890949167;1999;0,1,2;3;9;1;1;1
250890949167;250890953736;4569;0,1,2;3;9;1;1;1
250890953736;250890955346;1610;0,1,2;3;9;1;1;1
250890955346;250890955971;625;0,1,2;3;9;1;1;1
250890955971;250890957560;1589;0,1,2;3;9;1;1;1
250890957560;250890960581;3021;0,1,2;3;9;1;1;1
250890960581;250890961319;738;0,1,2;3;9;1;1;1
250890961319;250890962692;1373;0,1,2;3;9;1;1;1
250890962692;250890965325;2633;0,1,2;3;9;1;1;1
250890965325;250890970048;4723;0,1,2;3;9;1;1;1
250890970048;250890970466;418;0,1,2;3;9;1;1;1
250890970466;250890972242;1776;0,1,2;3;9;1;1;1
250890972242;250890979403;7161;0,1,2;3;9;1;1;1
250890979403;250890980321;918;0,1,2;3;9;1;1;1
250890980321;250890980342;21;0,1,2;3;9;1;1;1
250890980342;250890981233;891;0,1,2;3;9;1;1;1
250890981233;250890981935;702;0,1,2;3;9;1;1;1
250890981935;250890983360;1425;0,1,2;3;9;1;1;1
250890983360;250890984701;1341;0,1,2;3;9;1;1;1
250890984701;250890985940;1239;0,1,2;3;9;1;1;1
250890985940;250890986085;145;0,1,2;3;9;1;1;1
250890986085;250890987078;993;0,1,2;3;9;1;1;1
250890987078;250890990685;3607;0,1,2;3;9;1;1;1
250890990685;250890992315;1630;0,1,2;3;9;1;1;1
250890992315;250890992521;206;0,1,2;3;9;1;1;1
250890992521;250890994597;2076;0,1,2;3;9;1;1;1
250890994597;250890998234;3637;0,1,2;3;9;1;1;1
250890998234;250890998300;66;0,1,2;3;9;1;1;1
250890998300;250890998462;162;0,1,2;3;9;1;1;1
250890998462;250891000978;2516;0,1,2;3;9;1;1;1
250891000978;250891001507;529;0,1,2;3;9;1;1;1
250891001507;250891003269;1762;0,1,2;3;9;1;1;1
250891003269;250891004332;1063;0,1,2;3;9;1;1;1
250891004332;250891006022;1690;0,1,2;3;9;1;1;1
250891006022;250891007598;1576;0,1,2;3;9;1;1;1
250891007598;250891009435;1837;0,1,2;3;9;1;1;1
250891009435;250891010171;736;0,1,2;3;9;1;1;1
250891010171;250891011445;1274;0,1,2;3;9;1;1;1
250891011445;250891015035;3590;0,1,2;3;9;1;1;1
250891015035;250891016176;1141;0,1,2;3;9;1;1;1
250891016176;250891016811;635;0,1,2;3;9;1;1;1
250891016811;250891019664;2853;0,1,2;3;9;1;1;1
250891019664;250891019856;192;0,1,2;3;9;1;1;1
250891019856;250891019878;22;0,1,2;3;9;1;1;1
250891019878;250891019935;57;0,1,2;3;9;1;1;1
250891019935;250891019989;54;0,1,2;3;9;1;1;1
250891019989;250891020858;869;0,1,2;3;9;1;1;1
250891020858;250891021154;296;0,1,2;3;9;1;1;1
250891021154;250891023229;2075;0,1,2;3;9;1;1;1
250891023229;250891025850;2621;0,1,2;3;9;1;1;1
250891025850;250891027352;1502;0,1,2;3;9;1;1;1
250891027352;250891028247;895;0,1,2;3;9;1;1;1
250891028247;250891031728;3481;0,1,2;3;9;1;1;1
250891031728;250891032692;964;0,1,2;3;9;1;1;1
250891032692;250891033570;878;0,1,2;3;9;1;1;1
250891033570;250891035250;1680;0,1,2;3;9;1;1;1
250891035250;250891039775;4525;0,1,2;3;9;1;1;1
250891039775;250891049876;10101;0,1,2;3;9;1;1;1
250891049876;250891050105;229;0,1,2;3;9;1;1;1
250891050105;250891052291;2186;0,1,2;3;9;1;1;1
250891052291;250891055152;2861;0,1,2;3;9;1;1;1
250891055152;250891055460;308;0,1,2;3;9;1;1;1
250891055460;250891055673;213;0,1,2;3;9;1;1;1
250891055673;250891058177;2504;0,1,2;3;9;1;1;1
250891058177;250891058743;566;0,1,2;3;9;1;1;1
250891058743;250891059957;1214;0,1,2;3;9;1;1;1
250891059957;250891063327;3370;0,1,2;3;9;1;1;1
250891063327;250891063509;182;0,1,2;3;9;1;1;1
250891063509;250891066970;3461;0,1,2;3;9;1;1;1
250891066970;250891067499;529;0,1,2;3;9;1;1;1
250891067499;250891067833;334;0,1,2;3;9;1;1;1
250891067833;250891068493;660;0,1,2;3;9;1;1;1
250891068493;250891070615;2122;0,1,2;3;9;1;1;1
250891070615;250891070724;109;0,1,2;3;9;1;1;1
250891070724;250891071200;476;0,1,2;3;9;1;1;1
250891071200;250891072586;1386;0,1,2;3;9;1;1;1
250891072586;250891073653;1067;0,1,2;3;9;1;1;1
250891073653;250891073681;28;0,1,2;3;9;1;1;1
250891073681;250891073709;28;0,1,2;3;9;1;1;1
250891073709;250891075321;1612;0,1,2;3;9;1;1;1
250891075321;250891077002;1681;0,1,2;3;9;1;1;1
250891077002;250891077829;827;0,1,2;3;9;1;1;1
250891077829;250891077872;43;0,1,2;3;9;1;1;1
250891077872;250891078367;495;0,1,2;3;9;1;1;1
250891078367;250891081341;2974;0,1,2;3;9;1;1;1
250891081341;250891082439;1098;0,1,2;3;9;1;1;1
250891082439;250891085693;3254;0,1,2;3;9;1;1;1
250891085693;250891085707;14;0,1,2;3;9;1;1;1
250891085707;250891087505;1798;0,1,2;3;9;1;1;1
250891087505;250891089603;2098;0,1,2;3;9;1;1;1
250891089603;250891092705;3102;0,1,2;3;9;1;1;1
250891092705;250891093638;933;0,1,2;3;9;1;1;1
250891093638;250891094118;480;0,1,2;3;9;1;1;1
250891094118;250891094613;495;0,1,2;3;9;1;1;1
250891094613;250891097874;3261;0,1,2;3;9;1;1;1
250891097874;250891100250;2376;0,1,2;3;9;1;1;1
250891100250;250891100850;600;0,1,2;3;9;1;1;1
250891100850;250891100892;42;0,1,2;3;9;1;1;1
250891100892;250891102857;1965;0,1,2;3;9;1;1;1
250891102857;250891103455;598;0,1,2;3;9;1;1;1
250891103455;250891103671;216;0,1,2;3;9;1;1;1
250891103671;250891103860;189;0,1,2;3;9;1;1;1
250891103860;250891106533;2673;0,1,2;3;9;1;1;1
250891106533;250891108649;2116;0,1,2;3;9;1;1;1
250891108649;250891110645;1996;0,1,2;3;9;1;1;1
250891110645;250891112322;1677;0,1,2;3;9;1;1;1
250891112322;250891112594;272;0,1,2;3;9;1;1;1
250891112594;250891112702;108;0,1,2;3;9;1;1;1
250891112702;250891112938;236;0,1,2;3;9;1;1;1
250891112938;250891113185;247;0,1,2;3;9;1;1;1
250891113185;250891114051;866;0,1,2;3;9;1;1;1
250891114051;250891114500;449;0,1,2;3;9;1;1;1
250891114500;250891114759;259;0,1,2;3;9;1;1;1
250891114759;250891117349;2590;0,1,2;3;9;1;1;1
250891117349;250891118733;1384;0,1,2;3;9;1;1;1
250891118733;250891122627;3894;0,1,2;3;9;1;1;1
250891122627;250891122805;178;0,1,2;3;9;1;1;1
250891122805;250891125245;2440;0,1,2;3;9;1;1;1
250891125245;250891125837;592;0,1,2;3;9;1;1;1
250891125837;250891125839;2;0,1,2;3;9;1;1;1
250891125839;250891126722;883;0,1,2;3;9;1;1;1
250891126722;250891127837;1115;0,1,2;3;9;1;1;1
250891127837;250891128512;675;0,1,2;3;9;1;1;1
250891128512;250891133478;4966;0,1,2;3;9;1;1;1
250891133478;250891133512;34;0,1,2;3;9;1;1;1
250891133512;250891136381;2869;0,1,2;3;9;1;1;1
250891136381;250891137737;1356;0,1,2;3;9;1;1;1
250891137737;250891138938;1201;0,1,2;3;9;1;1;1
250891138938;250891139073;135;0,1,2;3;9;1;1;1
250891139073;250891140443;1370;0,1,2;3;9;1;1;1
250891140443;250891140495;52;0,1,2;3;9;1;1;1
250891140495;250891140966;471;0,1,2;3;9;1;1;1
250891140966;250891141063;97;0,1,2;3;9;1;1;1
250891141063;250891142609;1546;0,1,2;3;9;1;1;1
250891142609;250891145702;3093;0,1,2;3;9;1;1;1
250891145702;250891145939;237;0,1,2;3;9;1;1;1
250891145939;250891146468;529;0,1,2;3;9;1;1;1
250891146468;250891146671;203;0,1,2;3;9;1;1;1
250891146671;250891150661;3990;0,1,2;3;9;1;1;1
250891150661;250891151360;699;0,1,2;3;9;1;1;1
250891151360;250891152076;716;0,1,2;3;9;1;1;1
250891152076;250891152809;733;0,1,2;3;9;1;1;1
250891152809;250891152886;77;0,1,2;3;9;1;1;1
250891152886;250891159303;6417;0,1,2;3;9;1;1;1
250891159303;250891160948;1645;0,1,2;3;9;1;1;1
250891160948;250891161423;475;0,1,2;3;9;1;1;1
250891161423;250891161473;50;0,1,2;3;9;1;1;1
250891161473;250891161932;459;0,1,2;3;9;1;1;1
250891161932;250891162268;336;0,1,2;3;9;1;1;1
250891162268;250891163080;812;0,1,2;3;9;1;1;1
250891163080;250891164245;1165;0,1,2;3;9;1;1;1
250891164245;250891164886;641;0,1,2;3;9;1;1;1
250891164886;250891166300;1414;0,1,2;3;9;1;1;1
250891166300;250891166525;225;0,1,2;3;9;1;1;1
250891166525;250891167339;814;0,1,2;3;9;1;1;1
250891167339;250891171469;4130;0,1,2;3;9;1;1;1
250891171469;250891173887;2418;0,1,2;3;9;1;1;1
250891173887;250891174847;960;0,1,2;3;9;1;1;1
250891174847;250891175445;598;0,1,2;3;9;1;1;1
250891175445;250891176305;860;0,1,2;3;9;1;1;1
250891176305;250891176678;373;0,1,2;3;9;1;1;1
250891176678;250891177855;1177;0,1,2;3;9;1;1;1
250891177855;250891178213;358;0,1,2;3;9;1;1;1
250891178213;250891180938;2725;0,1,2;3;9;1;1;1
250891180938;250891181359;421;0,1,2;3;9;1;1;1
250891181359;250891182518;1159;0,1,2;3;9;1;1;1
250891182518;250891182759;241;0,1,2;3;9;1;1;1
250891182759;250891184677;1918;0,1,2;3;9;1;1;1
250891184677;250891185120;443;0,1,2;3;9;1;1;1
250891185120;250891185442;322;0,1,2;3;9;1;1;1
250891185442;250891186288;846;0,1,2;3;9;1;1;1
250891186288;250891186310;22;0,1,2;3;9;1;1;1
250891186310;250891186363;53;0,1,2;3;9;1;1;1
250891186363;250891190974;4611;0,1,2;3;9;1;1;1
250891190974;250891191071;97;0,1,2;3;9;1;1;1
250891191071;250891192389;1318;0,1,2;3;9;1;1;1
250891192389;250891192474;85;0,1,2;3;9;1;1;1
250891192474;250891192508;34;0,1,2;3;9;1;1;1
250891192508;250891192606;98;0,1,2;3;9;1;1;1
250891192606;250891194613;2007;0,1,2;3;9;1;1;1
250891194613;250891196484;1871;0,1,2;3;9;1;1;1
250891196484;250891198336;1852;0,1,2;3;9;1;1;1
250891198336;250891200315;1979;0,1,2;3;9;1;1;1
250891200315;250891202266;1951;0,1,2;3;9;1;1;1
250891202266;250891203444;1178;0,1,2;3;9;1;1;1
250891203444;250891203466;22;0,1,2;3;9;1;1;1
250891203466;250891203494;28;0,1,2;3;9;1;1;1
250891203494;250891208699;5205;0,1,2;3;9;1;1;1
250891208699;250891208790;91;0,1,2;3;9;1;1;1
250891208790;250891208862;72;0,1,2;3;9;1;1;1
250891208862;250891210668;1806;0,1,2;3;9;1;1;1
250891210668;250891212225;1557;0,1,2;3;9;1;1;1
250891212225;250891212784;559;0,1,2;3;9;1;1;1
250891212784;250891212843;59;0,1,2;3;9;1;1;1
250891212843;250891213580;737;0,1,2;3;9;1;1;1
250891213580;250891215747;2167;0,1,2;3;9;1;1;1
250891215747;250891218651;2904;0,1,2;3;9;1;1;1
250891218651;250891218805;154;0,1,2;3;9;1;1;1
250891218805;250891219110;305;0,1,2;3;9;1;1;1
250891219110;250891219324;214;0,1,2;3;9;1;1;1
250891219324;250891220922;1598;0,1,2;3;9;1;1;1
250891220922;250891221453;531;0,1,2;3;9;1;1;1
250891221453;250891222021;568;0,1,2;3;9;1;1;1
250891222021;250891222999;978;0,1,2;3;9;1;1;1
250891222999;250891223623;624;0,1,2;3;9;1;1;1
250891223623;250891223699;76;0,1,2;3;9;1;1;1
250891223699;250891223758;59;0,1,2;3;9;1;1;1
250891223758;250891224553;795;0,1,2;3;9;1;1;1
250891224553;250891227244;2691;0,1,2;3;9;1;1;1
250891227244;250891229916;2672;0,1,2;3;9;1;1;1
250891229916;250891231199;1283;0,1,2;3;9;1;1;1
250891231199;250891232577;1378;0,1,2;3;9;1;1;1
250891232577;250891233531;954;0,1,2;3;9;1;1;1
250891233531;250891233999;468;0,1,2;3;9;1;1;1
250891233999;250891234084;85;0,1,2;3;9;1;1;1
250891234084;250891239067;4983;0,1,2;3;9;1;1;1
250891239067;250891241227;2160;0,1,2;3;9;1;1;1
250891241227;250891241265;38;0,1,2;3;9;1;1;1
250891241265;250891242108;843;0,1,2;3;9;1;1;1
250891242108;250891242659;551;0,1,2;3;9;1;1;1
250891242659;250891246237;3578;0,1,2;3;9;1;1;1
250891246237;250891249098;2861;0,1,2;3;9;1;1;1
250891249098;250891250969;1871;0,1,2;3;9;1;1;1
250891250969;250891251399;430;0,1,2;3;9;1;1;1
250891251399;250891251955;556;0,1,2;3;9;1;1;1
250891251955;250891252836;881;0,1,2;3;9;1;1;1
250891252836;250891253339;503;0,1,2;3;9;1;1;1
250891253339;250891253501;162;0,1,2;3;9;1;1;1
250891253501;250891253575;74;0,1,2;3;9;1;1;1
250891253575;250891254088;513;0,1,2;3;9;1;1;1
250891254088;250891254329;241;0,1,2;3;9;1;1;1
250891254329;250891254800;471;0,1,2;3;9;1;1;1
250891254800;250891255442;642;0,1,2;3;9;1;1;1
250891255442;250891255482;40;0,1,2;3;9;1;1;1
250891255482;250891255874;392;0,1,2;3;9;1;1;1
250891255874;250891256408;534;0,1,2;3;9;1;1;1
250891256408;250891257228;820;0,1,2;3;9;1;1;1
250891257228;250891257467;239;0,1,2;3;9;1;1;1
250891257467;250891259476;2009;0,1,2;3;9;1;1;1
250891259476;250891260132;656;0,1,2;3;9;1;1;1
250891260132;250891260748;616;0,1,2;3;9;1;1;1
250891260748;250891261511;763;0,1,2;3;9;1;1;1
250891261511;250891263170;1659;0,1,2;3;9;1;1;1
250891263170;250891264107;937;0,1,2;3;9;1;1;1
250891264107;250891264141;34;0,1,2;3;9;1;1;1
250891264141;250891264179;38;0,1,2;3;9;1;1;1
250891264179;250891264226;47;0,1,2;3;9;1;1;1
250891264226;250891264409;183;0,1,2;3;9;1;1;1
250891264409;250891266921;2512;0,1,2;3;9;1;1;1
250891266921;250891267565;644;0,1,2;3;9;1;1;1
250891267565;250891267737;172;0,1,2;3;9;1;1;1
250891267737;250891268128;391;0,1,2;3;9;1;1;1
250891268128;250891268174;46;0,1,2;3;9;1;1;1
250891268174;250891269572;1398;0,1,2;3;9;1;1;1
250891269572;250891269753;181;0,1,2;3;9;1;1;1
250891269753;250891272193;2440;0,1,2;3;9;1;1;1
250891272193;250891276263;4070;0,1,2;3;9;1;1;1
250891276263;250891277805;1542;0,1,2;3;9;1;1;1
250891277805;250891281933;4128;0,1,2;3;9;1;1;1
250891281933;250891282246;313;0,1,2;3;9;1;1;1
250891282246;250891284240;1994;0,1,2;3;9;1;1;1
250891284240;250891288930;4690;0,1,2;3;9;1;1;1
250891288930;250891291975;3045;0,1,2;3;9;1;1;1
250891291975;250891292162;187;0,1,2;3;9;1;1;1
250891292162;250891295625;3463;0,1,2;3;9;1;1;1
250891295625;250891298705;3080;0,1,2;3;9;1;1;1
250891298705;250891299123;418;0,1,2;3;9;1;1;1
250891299123;250891299329;206;0,1,2;3;9;1;1;1
250891299329;250891300062;733;0,1,2;3;9;1;1;1
250891300062;250891300699;637;0,1,2;3;9;1;1;1
250891300699;250891302422;1723;0,1,2;3;9;1;1;1
250891302422;250891305313;2891;0,1,2;3;9;1;1;1
250891305313;250891306150;837;0,1,2;3;9;1;1;1
250891306150;250891308816;2666;0,1,2;3;9;1;1;1
250891308816;250891312491;3675;0,1,2;3;9;1;1;1
250891312491;250891313246;755;0,1,2;3;9;1;1;1
250891313246;250891314449;1203;0,1,2;3;9;1;1;1
250891314449;250891314451;2;0,1,2;3;9;1;1;1
250891314451;250891315644;1193;0,1,2;3;9;1;1;1
250891315644;250891317572;1928;0,1,2;3;9;1;1;1
250891317572;250891318348;776;0,1,2;3;9;1;1;1
250891318348;250891319076;728;0,1,2;3;9;1;1;1
250891319076;250891319194;118;0,1,2;3;9;1;1;1
250891319194;250891324504;5310;0,1,2;3;9;1;1;1
250891324504;250891325232;728;0,1,2;3;9;1;1;1
250891325232;250891327196;1964;0,1,2;3;9;1;1;1
250891327196;250891328631;1435;0,1,2;3;9;1;1;1
250891328631;250891329177;546;0,1,2;3;9;1;1;1
250891329177;250891331635;2458;0,1,2;3;9;1;1;1
250891331635;250891333755;2120;0,1,2;3;9;1;1;1
250891333755;250891333860;105;0,1,2;3;9;1;1;1
250891333860;250891335339;1479;0,1,2;3;9;1;1;1
250891335339;250891336567;1228;0,1,2;3;9;1;1;1
250891336567;250891337906;1339;0,1,2;3;9;1;1;1
250891337906;250891338236;330;0,1,2;3;9;1;1;1
250891338236;250891339410;1174;0,1,2;3;9;1;1;1
250891339410;250891339694;284;0,1,2;3;9;1;1;1
250891339694;250891339916;222;0,1,2;3;9;1;1;1
250891339916;250891339946;30;0,1,2;3;9;1;1;1
250891339946;250891340532;586;0,1,2;3;9;1;1;1
250891340532;250891340728;196;0,1,2;3;9;1;1;1
250891340728;250891341046;318;0,1,2;3;9;1;1;1
250891341046;250891342450;1404;0,1,2;3;9;1;1;1
250891342450;250891344511;2061;0,1,2;3;9;1;1;1
250891344511;250891344809;298;0,1,2;3;9;1;1;1
250891344809;250891349102;4293;0,1,2;3;9;1;1;1
250891349102;250891350882;1780;0,1,2;3;9;1;1;1
250891350882;250891352359;1477;0,1,2;3;9;1;1;1
250891352359;250891352392;33;0,1,2;3;9;1;1;1
250891352392;250891354762;2370;0,1,2;3;9;1;1;1
250891354762;250891354995;233;0,1,2;3;9;1;1;1
250891354995;250891356085;1090;0,1,2;3;9;1;1;1
250891356085;250891356235;150;0,1,2;3;9;1;1;1
250891356235;250891356552;317;0,1,2;3;9;1;1;1
250891356552;250891356574;22;0,1,2;3;9;1;1;1
250891356574;250891356598;24;0,1,2;3;9;1;1;1
250891356598;250891357626;1028;0,1,2;3;9;1;1;1
250891357626;250891357695;69;0,1,2;3;9;1;1;1
250891357695;250891358146;451;0,1,2;3;9;1;1;1
250891358146;250891358322;176;0,1,2;3;9;1;1;1
250891358322;250891358416;94;0,1,2;3;9;1;1;1
250891358416;250891360444;2028;0,1,2;3;9;1;1;1
250891360444;250891361364;920;0,1,2;3;9;1;1;1
250891361364;250891361480;116;0,1,2;3;9;1;1;1
250891361480;250891362812;1332;0,1,2;3;9;1;1;1
250891362812;250891364421;1609;0,1,2;3;9;1;1;1
250891364421;250891366361;1940;0,1,2;3;9;1;1;1
250891366361;250891366604;243;0,1,2;3;9;1;1;1
250891366604;250891366731;127;0,1,2;3;9;1;1;1
250891366731;250891366779;48;0,1,2;3;9;1;1;1
250891366779;250891367007;228;0,1,2;3;9;1;1;1
250891367007;250891368911;1904;0,1,2;3;9;1;1;1
250891368911;250891369111;200;0,1,2;3;9;1;1;1
250891369111;250891369263;152;0,1,2;3;9;1;1;1
250891369263;250891369312;49;0,1,2;3;9;1;1;1
250891369312;250891370826;1514;0,1,2;3;9;1;1;1
250891370826;250891370979;153;0,1,2;3;9;1;1;1
250891370979;250891371291;312;0,1,2;3;9;1;1;1
250891371291;250891371355;64;0,1,2;3;9;1;1;1
250891371355;250891374763;3408;0,1,2;3;9;1;1;1
250891374763;250891375059;296;0,1,2;3;9;1;1;1
250891375059;250891375430;371;0,1,2;3;9;1;1;1
250891375430;250891376698;1268;0,1,2;3;9;1;1;1
250891376698;250891378786;2088;0,1,2;3;9;1;1;1
250891378786;250891380842;2056;0,1,2;3;9;1;1;1
250891380842;250891381330;488;0,1,2;3;9;1;1;1
250891381330;250891381500;170;0,1,2;3;9;1;1;1
250891381500;250891381695;195;0,1,2;3;9;1;1;1
250891381695;250891382320;625;0,1,2;3;9;1;1;1
250891382320;250891382551;231;0,1,2;3;9;1;1;1
250891382551;250891383221;670;0,1,2;3;9;1;1;1
250891383221;250891386019;2798;0,1,2;3;9;1;1;1
250891386019;250891386362;343;0,1,2;3;9;1;1;1
250891386362;250891386516;154;0,1,2;3;9;1;1;1
250891386516;250891390351;3835;0,1,2;3;9;1;1;1
250891390351;250891393247;2896;0,1,2;3;9;1;1;1
250891393247;250891396419;3172;0,1,2;3;9;1;1;1
250891396419;250891396569;150;0,1,2;3;9;1;1;1
250891396569;250891396672;103;0,1,2;3;9;1;1;1
250891396672;250891397570;898;0,1,2;3;9;1;1;1
250891397570;250891398178;608;0,1,2;3;9;1;1;1
250891398178;250891398459;281;0,1,2;3;9;1;1;1
250891398459;250891398587;128;0,1,2;3;9;1;1;1
250891398587;250891398749;162;0,1,2;3;9;1;1;1
250891398749;250891399196;447;0,1,2;3;9;1;1;1
250891399196;250891399393;197;0,1,2;3;9;1;1;1
250891399393;250891401189;1796;0,1,2;3;9;1;1;1
250891401189;250891403073;1884;0,1,2;3;9;1;1;1
250891403073;250891403608;535;0,1,2;3;9;1;1;1
250891403608;250891403849;241;0,1,2;3;9;1;1;1
250891403849;250891403893;44;0,1,2;3;9;1;1;1
250891403893;250891403909;16;0,1,2;3;9;1;1;1
250891403909;250891406797;2888;0,1,2;3;9;1;1;1
250891406797;250891407307;510;0,1,2;3;9;1;1;1
250891407307;250891407362;55;0,1,2;3;9;1;1;1
250891407362;250891408452;1090;0,1,2;3;9;1;1;1
250891408452;250891409042;590;0,1,2;3;9;1;1;1
250891409042;250891409493;451;0,1,2;3;9;1;1;1
250891409493;250891410113;620;0,1,2;3;9;1;1;1
250891410113;250891410215;102;0,1,2;3;9;1;1;1
250891410215;250891410306;91;0,1,2;3;9;1;1;1
250891410306;250891410596;290;0,1,2;3;9;1;1;1
250891410596;250891411402;806;0,1,2;3;9;1;1;1
250891411402;250891412596;1194;0,1,2;3;9;1;1;1
250891412596;250891414132;1536;0,1,2;3;9;1;1;1
250891414132;250891414301;169;0,1,2;3;9;1;1;1
250891414301;250891414417;116;0,1,2;3;9;1;1;1
250891414417;250891418240;3823;0,1,2;3;9;1;1;1
250891418240;250891421359;3119;0,1,2;3;9;1;1;1
250891421359;250891423957;2598;0,1,2;3;9;1;1;1
250891423957;250891424026;69;0,1,2;3;9;1;1;1
250891424026;250891424429;403;0,1,2;3;9;1;1;1
250891424429;250891424798;369;0,1,2;3;9;1;1;1
250891424798;250891425180;382;0,1,2;3;9;1;1;1
250891425180;250891425584;404;0,1,2;3;9;1;1;1
250891425584;250891425648;64;0,1,2;3;9;1;1;1
250891425648;250891425691;43;0,1,2;3;9;1;1;1
250891425691;250891431126;5435;0,1,2;3;9;1;1;1
250891431126;250891431571;445;0,1,2;3;9;1;1;1
250891431571;250891432641;1070;0,1,2;3;9;1;1;1
250891432641;250891432735;94;0,1,2;3;9;1;1;1
250891432735;250891436783;4048;0,1,2;3;9;1;1;1
250891436783;250891438079;1296;0,1,2;3;9;1;1;1
250891438079;250891438821;742;0,1,2;3;9;1;1;1
250891438821;250891439038;217;0,1,2;3;9;1;1;1
250891439038;250891440736;1698;0,1,2;3;9;1;1;1
250891440736;250891442575;1839;0,1,2;3;9;1;1;1
250891442575;250891443320;745;0,1,2;3;9;1;1;1
250891443320;250891443994;674;0,1,2;3;9;1;1;1
250891443994;250891444061;67;0,1,2;3;9;1;1;1
250891444061;250891444409;348;0,1,2;3;9;1;1;1
250891444409;250891444517;108;0,1,2;3;9;1;1;1
250891444517;250891444564;47;0,1,2;3;9;1;1;1
250891444564;250891444745;181;0,1,2;3;9;1;1;1
250891444745;250891444836;91;0,1,2;3;9;1;1;1
250891444836;250891444865;29;0,1,2;3;9;1;1;1
250891444865;250891445136;271;0,1,2;3;9;1;1;1
250891445136;250891445251;115;0,1,2;3;9;1;1;1
250891445251;250891445827;576;0,1,2;3;9;1;1;1
250891445827;250891446690;863;0,1,2;3;9;1;1;1
250891446690;250891446849;159;0,1,2;3;9;1;1;1
250891446849;250891447537;688;0,1,2;3;9;1;1;1
250891447537;250891451701;4164;0,1,2;3;9;1;1;1
250891451701;250891453983;2282;0,1,2;3;9;1;1;1
250891453983;250891454048;65;0,1,2;3;9;1;1;1
250891454048;250891454140;92;0,1,2;3;9;1;1;1
250891454140;250891455204;1064;0,1,2;3;9;1;1;1
250891455204;250891455605;401;0,1,2;3;9;1;1;1
250891455605;250891457241;1636;0,1,2;3;9;1;1;1
250891457241;250891457710;469;0,1,2;3;9;1;1;1
250891457710;250891458083;373;0,1,2;3;9;1;1;1
250891458083;250891458139;56;0,1,2;3;9;1;1;1
250891458139;250891459117;978;0,1,2;3;9;1;1;1
250891459117;250891459180;63;0,1,2;3;9;1;1;1
250891459180;250891459212;32;0,1,2;3;9;1;1;1
250891459212;250891459299;87;0,1,2;3;9;1;1;1
250891459299;250891459929;630;0,1,2;3;9;1;1;1
250891459929;250891462147;2218;0,1,2;3;9;1;1;1
250891462147;250891463772;1625;0,1,2;3;9;1;1;1
250891463772;250891464175;403;0,1,2;3;9;1;1;1
250891464175;250891464422;247;0,1,2;3;9;1;1;1
250891464422;250891465979;1557;0,1,2;3;9;1;1;1
250891465979;250891467279;1300;0,1,2;3;9;1;1;1
250891467279;250891467294;15;0,1,2;3;9;1;1;1
250891467294;250891468791;1497;0,1,2;3;9;1;1;1
250891468791;250891469786;995;0,1,2;3;9;1;1;1
250891469786;250891470322;536;0,1,2;3;9;1;1;1
250891470322;250891470358;36;0,1,2;3;9;1;1;1
250891470358;250891471425;1067;0,1,2;3;9;1;1;1
250891471425;250891472245;820;0,1,2;3;9;1;1;1
250891472245;250891473483;1238;0,1,2;3;9;1;1;1
250891473483;250891473519;36;0,1,2;3;9;1;1;1
250891473519;250891473803;284;0,1,2;3;9;1;1;1
250891473803;250891475399;1596;0,1,2;3;9;1;1;1
250891475399;250891475494;95;0,1,2;3;9;1;1;1
250891475494;250891476058;564;0,1,2;3;9;1;1;1
250891476058;250891476439;381;0,1,2;3;9;1;1;1
250891476439;250891477054;615;0,1,2;3;9;1;1;1
250891477054;250891477777;723;0,1,2;3;9;1;1;1
250891477777;250891481070;3293;0,1,2;3;9;1;1;1
250891481070;250891481508;438;0,1,2;3;9;1;1;1
250891481508;250891482379;871;0,1,2;3;9;1;1;1
250891482379;250891482531;152;0,1,2;3;9;1;1;1
250891482531;250891482824;293;0,1,2;3;9;1;1;1
250891482824;250891482929;105;0,1,2;3;9;1;1;1
250891482929;250891483794;865;0,1,2;3;9;1;1;1
250891483794;250891484159;365;0,1,2;3;9;1;1;1
250891484159;250891484201;42;0,1,2;3;9;1;1;1
250891484201;250891484239;38;0,1,2;3;9;1;1;1
250891484239;250891484998;759;0,1,2;3;9;1;1;1
250891484998;250891485130;132;0,1,2;3;9;1;1;1
250891485130;250891485887;757;0,1,2;3;9;1;1;1
250891485887;250891486164;277;0,1,2;3;9;1;1;1
250891486164;250891486178;14;0,1,2;3;9;1;1;1
250891486178;250891486239;61;0,1,2;3;9;1;1;1
250891486239;250891486268;29;0,1,2;3;9;1;1;1
250891486268;250891486417;149;0,1,2;3;9;1;1;1
250891486417;250891486993;576;0,1,2;3;9;1;1;1
250891486993;250891487584;591;0,1,2;3;9;1;1;1
250891487584;250891488798;1214;0,1,2;3;9;1;1;1
250891488798;250891488955;157;0,1,2;3;9;1;1;1
250891488955;250891492450;3495;0,1,2;3;9;1;1;1
250891492450;250891496436;3986;0,1,2;3;9;1;1;1
250891496436;250891496955;519;0,1,2;3;9;1;1;1
250891496955;250891497499;544;0,1,2;3;9;1;1;1
250891497499;250891498560;1061;0,1,2;3;9;1;1;1
250891498560;250891500240;1680;0,1,2;3;9;1;1;1
250891500240;250891501015;775;0,1,2;3;9;1;1;1
250891501015;250891502441;1426;0,1,2;3;9;1;1;1
250891502441;250891504095;1654;0,1,2;3;9;1;1;1
250891504095;250891504156;61;0,1,2;3;9;1;1;1
250891504156;250891504899;743;0,1,2;3;9;1;1;1
250891504899;250891504992;93;0,1,2;3;9;1;1;1
250891504992;250891505179;187;0,1,2;3;9;1;1;1
250891505179;250891505564;385;0,1,2;3;9;1;1;1
250891505564;250891506138;574;0,1,2;3;9;1;1;1
250891506138;250891507472;1334;0,1,2;3;9;1;1;1
250891507472;250891507998;526;0,1,2;3;9;1;1;1
250891507998;250891510277;2279;0,1,2;3;9;1;1;1
250891510277;250891511737;1460;0,1,2;3;9;1;1;1
250891511737;250891512045;308;0,1,2;3;9;1;1;1
250891512045;250891512311;266;0,1,2;3;9;1;1;1
250891512311;250891514673;2362;0,1,2;3;9;1;1;1
250891514673;250891515279;606;0,1,2;3;9;1;1;1
250891515279;250891515921;642;0,1,2;3;9;1;1;1
250891515921;250891518462;2541;0,1,2;3;9;1;1;1
250891518462;250891518642;180;0,1,2;3;9;1;1;1
250891518642;250891521083;2441;0,1,2;3;9;1;1;1
250891521083;250891522989;1906;0,1,2;3;9;1;1;1
250891522989;250891523007;18;0,1,2;3;9;1;1;1
250891523007;250891523923;916;0,1,2;3;9;1;1;1
250891523923;250891524934;1011;0,1,2;3;9;1;1;1
250891524934;250891524957;23;0,1,2;3;9;1;1;1
250891524957;250891525803;846;0,1,2;3;9;1;1;1
250891525803;250891526904;1101;0,1,2;3;9;1;1;1
250891526904;250891527058;154;0,1,2;3;9;1;1;1
250891527058;250891528064;1006;0,1,2;3;9;1;1;1
250891528064;250891528255;191;0,1,2;3;9;1;1;1
250891528255;250891530677;2422;0,1,2;3;9;1;1;1
250891530677;250891532259;1582;0,1,2;3;9;1;1;1
250891532259;250891534344;2085;0,1,2;3;9;1;1;1
250891534344;250891535461;1117;0,1,2;3;9;1;1;1
250891535461;250891536052;591;0,1,2;3;9;1;1;1
250891536052;250891536376;324;0,1,2;3;9;1;1;1
250891536376;250891536505;129;0,1,2;3;9;1;1;1
250891536505;250891536707;202;0,1,2;3;9;1;1;1
250891536707;250891538306;1599;0,1,2;3;9;1;1;1
250891538306;250891538996;690;0,1,2;3;9;1;1;1
250891538996;250891539732;736;0,1,2;3;9;1;1;1
250891539732;250891540476;744;0,1,2;3;9;1;1;1
250891540476;250891540477;1;0,1,2;3;9;1;1;1
250891540477;250891540666;189;0,1,2;3;9;1;1;1
250891540666;250891542195;1529;0,1,2;3;9;1;1;1
250891542195;250891542300;105;0,1,2;3;9;1;1;1
250891542300;250891542448;148;0,1,2;3;9;1;1;1
250891542448;250891543146;698;0,1,2;3;9;1;1;1
250891543146;250891543704;558;0,1,2;3;9;1;1;1
250891543704;250891545777;2073;0,1,2;3;9;1;1;1
250891545777;250891545852;75;0,1,2;3;9;1;1;1
250891545852;250891546422;570;0,1,2;3;9;1;1;1
250891546422;250891546642;220;0,1,2;3;9;1;1;1
250891546642;250891547761;1119;0,1,2;3;9;1;1;1
250891547761;250891547912;151;0,1,2;3;9;1;1;1
250891547912;250891550578;2666;0,1,2;3;9;1;1;1
250891550578;250891550748;170;0,1,2;3;9;1;1;1
250891550748;250891552152;1404;0,1,2;3;9;1;1;1
250891552152;250891552439;287;0,1,2;3;9;1;1;1
250891552439;250891553208;769;0,1,2;3;9;1;1;1
250891553208;250891553681;473;0,1,2;3;9;1;1;1
250891553681;250891555562;1881;0,1,2;3;9;1;1;1
250891555562;250891555777;215;0,1,2;3;9;1;1;1
250891555777;250891557230;1453;0,1,2;3;9;1;1;1
250891557230;250891559459;2229;0,1,2;3;9;1;1;1
250891559459;250891561299;1840;0,1,2;3;9;1;1;1
250891561299;250891561927;628;0,1,2;3;9;1;1;1
250891561927;250891563701;1774;0,1,2;3;9;1;1;1
250891563701;250891563820;119;0,1,2;3;9;1;1;1
250891563820;250891563844;24;0,1,2;3;9;1;1;1
250891563844;250891565554;1710;0,1,2;3;9;1;1;1
250891565554;250891568639;3085;0,1,2;3;9;1;1;1
250891568639;250891568936;297;0,1,2;3;9;1;1;1
250891568936;250891569386;450;0,1,2;3;9;1;1;1
250891569386;250891569499;113;0,1,2;3;9;1;1;1
250891569499;250891570394;895;0,1,2;3;9;1;1;1
250891570394;250891571424;1030;0,1,2;3;9;1;1;1
250891571424;250891572295;871;0,1,2;3;9;1;1;1
250891572295;250891573544;1249;0,1,2;3;9;1;1;1
250891573544;250891575092;1548;0,1,2;3;9;1;1;1
250891575092;250891575216;124;0,1,2;3;9;1;1;1
250891575216;250891575288;72;0,1,2;3;9;1;1;1
250891575288;250891576033;745;0,1,2;3;9;1;1;1
250891576033;250891577223;1190;0,1,2;3;9;1;1;1
250891577223;250891577881;658;0,1,2;3;9;1;1;1
250891577881;250891578588;707;0,1,2;3;9;1;1;1
250891578588;250891579676;1088;0,1,2;3;9;1;1;1
250891579676;250891580331;655;0,1,2;3;9;1;1;1
250891580331;250891580722;391;0,1,2;3;9;1;1;1
250891580722;250891580743;21;0,1,2;3;9;1;1;1
250891580743;250891580778;35;0,1,2;3;9;1;1;1
250891580778;250891581190;412;0,1,2;3;9;1;1;1
250891581190;250891581720;530;0,1,2;3;9;1;1;1
250891581720;250891582293;573;0,1,2;3;9;1;1;1
250891582293;250891582567;274;0,1,2;3;9;1;1;1
250891582567;250891582879;312;0,1,2;3;9;1;1;1
250891582879;250891583329;450;0,1,2;3;9;1;1;1
250891583329;250891586938;3609;0,1,2;3;9;1;1;1
250891586938;250891588191;1253;0,1,2;3;9;1;1;1
250891588191;250891588252;61;0,1,2;3;9;1;1;1
250891588252;250891588883;631;0,1,2;3;9;1;1;1
250891588883;250891589037;154;0,1,2;3;9;1;1;1
250891589037;250891591324;2287;0,1,2;3;9;1;1;1
250891591324;250891591848;524;0,1,2;3;9;1;1;1
250891591848;250891592092;244;0,1,2;3;9;1;1;1
250891592092;250891592720;628;0,1,2;3;9;1;1;1
250891592720;250891592957;237;0,1,2;3;9;1;1;1
250891592957;250891593374;417;0,1,2;3;9;1;1;1
250891593374;250891596829;3455;0,1,2;3;9;1;1;1
250891596829;250891598360;1531;0,1,2;3;9;1;1;1
250891598360;250891598859;499;0,1,2;3;9;1;1;1
250891598859;250891599041;182;0,1,2;3;9;1;1;1
250891599041;250891599088;47;0,1,2;3;9;1;1;1
250891599088;250891600099;1011;0,1,2;3;9;1;1;1
250891600099;250891601759;1660;0,1,2;3;9;1;1;1
250891601759;250891603533;1774;0,1,2;3;9;1;1;1
250891603533;250891603547;14;0,1,2;3;9;1;1;1
250891603547;250891604093;546;0,1,2;3;9;1;1;1
250891604093;250891604261;168;0,1,2;3;9;1;1;1
250891604261;250891604878;617;0,1,2;3;9;1;1;1
250891604878;250891605584;706;0,1,2;3;9;1;1;1
250891605584;250891606333;749;0,1,2;3;9;1;1;1
250891606333;250891606511;178;0,1,2;3;9;1;1;1
250891606511;250891607817;1306;0,1,2;3;9;1;1;1
250891607817;250891608329;512;0,1,2;3;9;1;1;1
250891608329;250891608389;60;0,1,2;3;9;1;1;1
250891608389;250891608662;273;0,1,2;3;9;1;1;1
250891608662;250891608780;118;0,1,2;3;9;1;1;1
250891608780;250891608832;52;0,1,2;3;9;1;1;1
250891608832;250891610882;2050;0,1,2;3;9;1;1;1
250891610882;250891611112;230;0,1,2;3;9;1;1;1
250891611112;250891612244;1132;0,1,2;3;9;1;1;1
250891612244;250891613186;942;0,1,2;3;9;1;1;1
250891613186;250891613917;731;0,1,2;3;9;1;1;1
250891613917;250891620850;6933;0,1,2;3;9;1;1;1
250891620850;250891621585;735;0,1,2;3;9;1;1;1
250891621585;250891621715;130;0,1,2;3;9;1;1;1
250891621715;250891621887;172;0,1,2;3;9;1;1;1
250891621887;250891621963;76;0,1,2;3;9;1;1;1
250891621963;250891622036;73;0,1,2;3;9;1;1;1
250891622036;250891622365;329;0,1,2;3;9;1;1;1
250891622365;250891622516;151;0,1,2;3;9;1;1;1
250891622516;250891622793;277;0,1,2;3;9;1;1;1
250891622793;250891624832;2039;0,1,2;3;9;1;1;1
250891624832;250891625041;209;0,1,2;3;9;1;1;1
250891625041;250891625976;935;0,1,2;3;9;1;1;1
250891625976;250891626254;278;0,1,2;3;9;1;1;1
250891626254;250891630599;4345;0,1,2;3;9;1;1;1
250891630599;250891630769;170;0,1,2;3;9;1;1;1
250891630769;250891633208;2439;0,1,2;3;9;1;1;1
250891633208;250891633396;188;0,1,2;3;9;1;1;1
250891633396;250891633480;84;0,1,2;3;9;1;1;1
250891633480;250891633639;159;0,1,2;3;9;1;1;1
250891633639;250891633970;331;0,1,2;3;9;1;1;1
250891633970;250891634094;124;0,1,2;3;9;1;1;1
250891634094;250891634221;127;0,1,2;3;9;1;1;1
250891634221;250891634500;279;0,1,2;3;9;1;1;1
250891634500;250891634545;45;0,1,2;3;9;1;1;1
250891634545;250891638200;3655;0,1,2;3;9;1;1;1
250891638200;250891638938;738;0,1,2;3;9;1;1;1
250891638938;250891640137;1199;0,1,2;3;9;1;1;1
250891640137;250891640160;23;0,1,2;3;9;1;1;1
250891640160;250891640507;347;0,1,2;3;9;1;1;1
250891640507;250891640579;72;0,1,2;3;9;1;1;1
250891640579;250891641226;647;0,1,2;3;9;1;1;1
250891641226;250891643172;1946;0,1,2;3;9;1;1;1
250891643172;250891643240;68;0,1,2;3;9;1;1;1
250891643240;250891643472;232;0,1,2;3;9;1;1;1
250891643472;250891643670;198;0,1,2;3;9;1;1;1
250891643670;250891645660;1990;0,1,2;3;9;1;1;1
250891645660;250891646061;401;0,1,2;3;9;1;1;1
250891646061;250891646236;175;0,1,2;3;9;1;1;1
250891646236;250891646418;182;0,1,2;3;9;1;1;1
250891646418;250891646505;87;0,1,2;3;9;1;1;1
250891646505;250891646929;424;0,1,2;3;9;1;1;1
250891646929;250891647022;93;0,1,2;3;9;1;1;1
250891647022;250891648194;1172;0,1,2;3;9;1;1;1
250891648194;250891648322;128;0,1,2;3;9;1;1;1
250891648322;250891648403;81;0,1,2;3;9;1;1;1
250891648403;250891649319;916;0,1,2;3;9;1;1;1
250891649319;250891650065;746;0,1,2;3;9;1;1;1
250891650065;250891650284;219;0,1,2;3;9;1;1;1
250891650284;250891651224;940;0,1,2;3;9;1;1;1
250891651224;250891651415;191;0,1,2;3;9;1;1;1
250891651415;250891653391;1976;0,1,2;3;9;1;1;1
250891653391;250891654177;786;0,1,2;3;9;1;1;1
250891654177;250891655009;832;0,1,2;3;9;1;1;1
250891655009;250891656205;1196;0,1,2;3;9;1;1;1
250891656205;250891657567;1362;0,1,2;3;9;1;1;1
250891657567;250891658738;1171;0,1,2;3;9;1;1;1
250891658738;250891658939;201;0,1,2;3;9;1;1;1
250891658939;250891661670;2731;0,1,2;3;9;1;1;1
250891661670;250891661725;55;0,1,2;3;9;1;1;1
250891661725;250891662081;356;0,1,2;3;9;1;1;1
250891662081;250891662165;84;0,1,2;3;9;1;1;1
250891662165;250891664915;2750;0,1,2;3;9;1;1;1
250891664915;250891665862;947;0,1,2;3;9;1;1;1
250891665862;250891666186;324;0,1,2;3;9;1;1;1
250891666186;250891667505;1319;0,1,2;3;9;1;1;1
250891667505;250891667666;161;0,1,2;3;9;1;1;1
250891667666;250891667942;276;0,1,2;3;9;1;1;1
250891667942;250891671257;3315;0,1,2;3;9;1;1;1
250891671257;250891673050;1793;0,1,2;3;9;1;1;1
250891673050;250891673510;460;0,1,2;3;9;1;1;1
250891673510;250891676522;3012;0,1,2;3;9;1;1;1
250891676522;250891678455;1933;0,1,2;3;9;1;1;1
250891678455;250891679707;1252;0,1,2;3;9;1;1;1
250891679707;250891680217;510;0,1,2;3;9;1;1;1
250891680217;250891681355;1138;0,1,2;3;9;1;1;1
250891681355;250891682737;1382;0,1,2;3;9;1;1;1
250891682737;250891683225;488;0,1,2;3;9;1;1;1
250891683225;250891683286;61;0,1,2;3;9;1;1;1
250891683286;250891684021;735;0,1,2;3;9;1;1;1
250891684021;250891684910;889;0,1,2;3;9;1;1;1
250891684910;250891686127;1217;0,1,2;3;9;1;1;1
250891686127;250891686236;109;0,1,2;3;9;1;1;1
250891686236;250891688197;1961;0,1,2;3;9;1;1;1
250891688197;250891688791;594;0,1,2;3;9;1;1;1
250891688791;250891690039;1248;0,1,2;3;9;1;1;1
250891690039;250891690095;56;0,1,2;3;9;1;1;1
250891690095;250891690134;39;0,1,2;3;9;1;1;1
250891690134;250891692808;2674;0,1,2;3;9;1;1;1
250891692808;250891693586;778;0,1,2;3;9;1;1;1
250891693586;250891694910;1324;0,1,2;3;9;1;1;1
250891694910;250891695225;315;0,1,2;3;9;1;1;1
250891695225;250891695470;245;0,1,2;3;9;1;1;1
250891695470;250891695796;326;0,1,2;3;9;1;1;1
250891695796;250891696774;978;0,1,2;3;9;1;1;1
250891696774;250891697570;796;0,1,2;3;9;1;1;1
250891697570;250891697833;263;0,1,2;3;9;1;1;1
250891697833;250891698355;522;0,1,2;3;9;1;1;1
250891698355;250891701598;3243;0,1,2;3;9;1;1;1
250891701598;250891702402;804;0,1,2;3;9;1;1;1
250891702402;250891704629;2227;0,1,2;3;9;1;1;1
250891704629;250891704704;75;0,1,2;3;9;1;1;1
250891704704;250891704752;48;0,1,2;3;9;1;1;1
250891704752;250891704834;82;0,1,2;3;9;1;1;1
250891704834;250891705009;175;0,1,2;3;9;1;1;1
250891705009;250891705075;66;0,1,2;3;9;1;1;1
250891705075;250891705855;780;0,1,2;3;9;1;1;1
250891705855;250891706208;353;0,1,2;3;9;1;1;1
250891706208;250891706268;60;0,1,2;3;9;1;1;1
250891706268;250891706820;552;0,1,2;3;9;1;1;1
250891706820;250891707128;308;0,1,2;3;9;1;1;1
250891707128;250891707561;433;0,1,2;3;9;1;1;1
250891707561;250891708129;568;0,1,2;3;9;1;1;1
250891708129;250891708222;93;0,1,2;3;9;1;1;1
250891708222;250891711578;3356;0,1,2;3;9;1;1;1
250891711578;250891711689;111;0,1,2;3;9;1;1;1
250891711689;250891711915;226;0,1,2;3;9;1;1;1
250891711915;250891712655;740;0,1,2;3;9;1;1;1
250891712655;250891713848;1193;0,1,2;3;9;1;1;1
250891713848;250891714496;648;0,1,2;3;9;1;1;1
250891714496;250891716407;1911;0,1,2;3;9;1;1;1
250891716407;250891716486;79;0,1,2;3;9;1;1;1
250891716486;250891716599;113;0,1,2;3;9;1;1;1
250891716599;250891716856;257;0,1,2;3;9;1;1;1
250891716856;250891716911;55;0,1,2;3;9;1;1;1
250891716911;250891717181;270;0,1,2;3;9;1;1;1
250891717181;250891717390;209;0,1,2;3;9;1;1;1
250891717390;250891717568;178;0,1,2;3;9;1;1;1
250891717568;250891718227;659;0,1,2;3;9;1;1;1
250891718227;250891718404;177;0,1,2;3;9;1;1;1
250891718404;250891718564;160;0,1,2;3;9;1;1;1
250891718564;250891718619;55;0,1,2;3;9;1;1;1
250891718619;250891718882;263;0,1,2;3;9;1;1;1
250891718882;250891719108;226;0,1,2;3;9;1;1;1
250891719108;250891719759;651;0,1,2;3;9;1;1;1
250891719759;250891719947;188;0,1,2;3;9;1;1;1
250891719947;250891720445;498;0,1,2;3;9;1;1;1
250891720445;250891722022;1577;0,1,2;3;9;1;1;1
250891722022;250891722984;962;0,1,2;3;9;1;1;1
250891722984;250891724984;2000;0,1,2;3;9;1;1;1
250891724984;250891726064;1080;0,1,2;3;9;1;1;1
250891726064;250891726809;745;0,1,2;3;9;1;1;1
250891726809;250891727084;275;0,1,2;3;9;1;1;1
250891727084;250891727989;905;0,1,2;3;9;1;1;1
250891727989;250891729778;1789;0,1,2;3;9;1;1;1
250891729778;250891730069;291;0,1,2;3;9;1;1;1
250891730069;250891730098;29;0,1,2;3;9;1;1;1
250891730098;250891731808;1710;0,1,2;3;9;1;1;1
250891731808;250891732095;287;0,1,2;3;9;1;1;1
250891732095;250891735078;2983;0,1,2;3;9;1;1;1
250891735078;250891735247;169;0,1,2;3;9;1;1;1
250891735247;250891735717;470;0,1,2;3;9;1;1;1
250891735717;250891736898;1181;0,1,2;3;9;1;1;1
250891736898;250891737371;473;0,1,2;3;9;1;1;1
250891737371;250891740803;3432;0,1,2;3;9;1;1;1
250891740803;250891741637;834;0,1,2;3;9;1;1;1
250891741637;250891743277;1640;0,1,2;3;9;1;1;1
250891743277;250891745127;1850;0,1,2;3;9;1;1;1
250891745127;250891745159;32;0,1,2;3;9;1;1;1
250891745159;250891747440;2281;0,1,2;3;9;1;1;1
250891747440;250891748277;837;0,1,2;3;9;1;1;1
250891748277;250891748348;71;0,1,2;3;9;1;1;1
250891748348;250891748686;338;0,1,2;3;9;1;1;1
250891748686;250891748783;97;0,1,2;3;9;1;1;1
250891748783;250891749103;320;0,1,2;3;9;1;1;1
250891749103;250891749171;68;0,1,2;3;9;1;1;1
250891749171;250891750316;1145;0,1,2;3;9;1;1;1
250891750316;250891751033;717;0,1,2;3;9;1;1;1
250891751033;250891751343;310;0,1,2;3;9;1;1;1
250891751343;250891752662;1319;0,1,2;3;9;1;1;1
250891752662;250891754208;1546;0,1,2;3;9;1;1;1
250891754208;250891754401;193;0,1,2;3;9;1;1;1
250891754401;250891755441;1040;0,1,2;3;9;1;1;1
250891755441;250891755905;464;0,1,2;3;9;1;1;1
250891755905;250891756234;329;0,1,2;3;9;1;1;1
250891756234;250891756893;659;0,1,2;3;9;1;1;1
250891756893;250891757264;371;0,1,2;3;9;1;1;1
250891757264;250891757483;219;0,1,2;3;9;1;1;1
250891757483;250891757649;166;0,1,2;3;9;1;1;1
250891757649;250891758398;749;0,1,2;3;9;1;1;1
250891758398;250891758621;223;0,1,2;3;9;1;1;1
250891758621;250891760739;2118;0,1,2;3;9;1;1;1
250891760739;250891760936;197;0,1,2;3;9;1;1;1
250891760936;250891761021;85;0,1,2;3;9;1;1;1
250891761021;250891762379;1358;0,1,2;3;9;1;1;1
250891762379;250891762421;42;0,1,2;3;9;1;1;1
250891762421;250891763107;686;0,1,2;3;9;1;1;1
250891763107;250891766106;2999;0,1,2;3;9;1;1;1
250891766106;250891767150;1044;0,1,2;3;9;1;1;1
250891767150;250891768204;1054;0,1,2;3;9;1;1;1
250891768204;250891768576;372;0,1,2;3;9;1;1;1
250891768576;250891769121;545;0,1,2;3;9;1;1;1
250891769121;250891769206;85;0,1,2;3;9;1;1;1
250891769206;250891769417;211;0,1,2;3;9;1;1;1
250891769417;250891769841;424;0,1,2;3;9;1;1;1
250891769841;250891770721;880;0,1,2;3;9;1;1;1
250891770721;250891771377;656;0,1,2;3;9;1;1;1
250891771377;250891771383;6;0,1,2;3;9;1;1;1
250891771383;250891771842;459;0,1,2;3;9;1;1;1
250891771842;250891772812;970;0,1,2;3;9;1;1;1
250891772812;250891774492;1680;0,1,2;3;9;1;1;1
250891774492;250891774940;448;0,1,2;3;9;1;1;1
250891774940;250891775268;328;0,1,2;3;9;1;1;1
250891775268;250891775292;24;0,1,2;3;9;1;1;1
250891775292;250891776428;1136;0,1,2;3;9;1;1;1
250891776428;250891777351;923;0,1,2;3;9;1;1;1
250891777351;250891777783;432;0,1,2;3;9;1;1;1
250891777783;250891778696;913;0,1,2;3;9;1;1;1
250891778696;250891778704;8;0,1,2;3;9;1;1;1
250891778704;250891778851;147;0,1,2;3;9;1;1;1
250891778851;250891778982;131;0,1,2;3;9;1;1;1
250891778982;250891779832;850;0,1,2;3;9;1;1;1
250891779832;250891780763;931;0,1,2;3;9;1;1;1
250891780763;250891781729;966;0,1,2;3;9;1;1;1
250891781729;250891781775;46;0,1,2;3;9;1;1;1
250891781775;250891781856;81;0,1,2;3;9;1;1;1
250891781856;250891783125;1269;0,1,2;3;9;1;1;1
250891783125;250891783677;552;0,1,2;3;9;1;1;1
250891783677;250891784461;784;0,1,2;3;9;1;1;1
250891784461;250891784625;164;0,1,2;3;9;1;1;1
250891784625;250891784651;26;0,1,2;3;9;1;1;1
250891784651;250891785424;773;0,1,2;3;9;1;1;1
250891785424;250891785482;58;0,1,2;3;9;1;1;1
250891785482;250891785636;154;0,1,2;3;9;1;1;1
250891785636;250891786605;969;0,1,2;3;9;1;1;1
250891786605;250891788415;1810;0,1,2;3;9;1;1;1
250891788415;250891788662;247;0,1,2;3;9;1;1;1
250891788662;250891788814;152;0,1,2;3;9;1;1;1
250891788814;250891789081;267;0,1,2;3;9;1;1;1
250891789081;250891790033;952;0,1,2;3;9;1;1;1
250891790033;250891790290;257;0,1,2;3;9;1;1;1
250891790290;250891790995;705;0,1,2;3;9;1;1;1
250891790995;250891792141;1146;0,1,2;3;9;1;1;1
250891792141;250891793056;915;0,1,2;3;9;1;1;1
250891793056;250891793668;612;0,1,2;3;9;1;1;1
250891793668;250891794020;352;0,1,2;3;9;1;1;1
250891794020;250891794715;695;0,1,2;3;9;1;1;1
250891794715;250891795702;987;0,1,2;3;9;1;1;1
250891795702;250891795778;76;0,1,2;3;9;1;1;1
250891795778;250891795836;58;0,1,2;3;9;1;1;1
250891795836;250891799682;3846;0,1,2;3;9;1;1;1
250891799682;250891801738;2056;0,1,2;3;9;1;1;1
250891801738;250891801862;124;0,1,2;3;9;1;1;1
250891801862;250891802488;626;0,1,2;3;9;1;1;1
250891802488;250891803919;1431;0,1,2;3;9;1;1;1
250891803919;250891805832;1913;0,1,2;3;9;1;1;1
250891805832;250891806397;565;0,1,2;3;9;1;1;1
250891806397;250891806880;483;0,1,2;3;9;1;1;1
250891806880;250891807191;311;0,1,2;3;9;1;1;1
250891807191;250891807659;468;0,1,2;3;9;1;1;1
250891807659;250891807709;50;0,1,2;3;9;1;1;1
250891807709;250891807837;128;0,1,2;3;9;1;1;1
250891807837;250891808639;802;0,1,2;3;9;1;1;1
250891808639;250891809775;1136;0,1,2;3;9;1;1;1
250891809775;250891810088;313;0,1,2;3;9;1;1;1
250891810088;250891810803;715;0,1,2;3;9;1;1;1
250891810803;250891810920;117;0,1,2;3;9;1;1;1
250891810920;250891811037;117;0,1,2;3;9;1;1;1
250891811037;250891811111;74;0,1,2;3;9;1;1;1
250891811111;250891811340;229;0,1,2;3;9;1;1;1
250891811340;250891811396;56;0,1,2;3;9;1;1;1
250891811396;250891812307;911;0,1,2;3;9;1;1;1
250891812307;250891814094;1787;0,1,2;3;9;1;1;1
250891814094;250891814174;80;0,1,2;3;9;1;1;1
250891814174;250891814226;52;0,1,2;3;9;1;1;1
250891814226;250891814444;218;0,1,2;3;9;1;1;1
250891814444;250891815166;722;0,1,2;3;9;1;1;1
250891815166;250891815388;222;0,1,2;3;9;1;1;1
250891815388;250891818081;2693;0,1,2;3;9;1;1;1
250891818081;250891818313;232;0,1,2;3;9;1;1;1
250891818313;250891818340;27;0,1,2;3;9;1;1;1
250891818340;250891819158;818;0,1,2;3;9;1;1;1
250891819158;250891819578;420;0,1,2;3;9;1;1;1
250891819578;250891819932;354;0,1,2;3;9;1;1;1
250891819932;250891821942;2010;0,1,2;3;9;1;1;1
250891821942;250891823840;1898;0,1,2;3;9;1;1;1
250891823840;250891824593;753;0,1,2;3;9;1;1;1
250891824593;250891824829;236;0,1,2;3;9;1;1;1
250891824829;250891825012;183;0,1,2;3;9;1;1;1
250891825012;250891825241;229;0,1,2;3;9;1;1;1
250891825241;250891826962;1721;0,1,2;3;9;1;1;1
250891826962;250891827017;55;0,1,2;3;9;1;1;1
250891827017;250891828409;1392;0,1,2;3;9;1;1;1
250891828409;250891828501;92;0,1,2;3;9;1;1;1
250891828501;250891829076;575;0,1,2;3;9;1;1;1
250891829076;250891829577;501;0,1,2;3;9;1;1;1
250891829577;250891829912;335;0,1,2;3;9;1;1;1
250891829912;250891832321;2409;0,1,2;3;9;1;1;1
250891832321;250891833201;880;0,1,2;3;9;1;1;1
250891833201;250891834561;1360;0,1,2;3;9;1;1;1
250891834561;250891837160;2599;0,1,2;3;9;1;1;1
250891837160;250891837815;655;0,1,2;3;9;1;1;1
250891837815;250891838338;523;0,1,2;3;9;1;1;1
250891838338;250891840121;1783;0,1,2;3;9;1;1;1
250891840121;250891840560;439;0,1,2;3;9;1;1;1
250891840560;250891840657;97;0,1,2;3;9;1;1;1
250891840657;250891841372;715;0,1,2;3;9;1;1;1
250891841372;250891842505;1133;0,1,2;3;9;1;1;1
250891842505;250891844105;1600;0,1,2;3;9;1;1;1
250891844105;250891844962;857;0,1,2;3;9;1;1;1
250891844962;250891845469;507;0,1,2;3;9;1;1;1
250891845469;250891846644;1175;0,1,2;3;9;1;1;1
250891846644;250891847169;525;0,1,2;3;9;1;1;1
250891847169;250891847838;669;0,1,2;3;9;1;1;1
250891847838;250891848502;664;0,1,2;3;9;1;1;1
250891848502;250891848525;23;0,1,2;3;9;1;1;1
250891848525;250891848558;33;0,1,2;3;9;1;1;1
250891848558;250891851965;3407;0,1,2;3;9;1;1;1
250891851965;250891852769;804;0,1,2;3;9;1;1;1
250891852769;250891853884;1115;0,1,2;3;9;1;1;1
250891853884;250891853932;48;0,1,2;3;9;1;1;1
250891853932;250891855182;1250;0,1,2;3;9;1;1;1
250891855182;250891856840;1658;0,1,2;3;9;1;1;1
250891856840;250891857921;1081;0,1,2;3;9;1;1;1
250891857921;250891858518;597;0,1,2;3;9;1;1;1
250891858518;250891860059;1541;0,1,2;3;9;1;1;1
250891860059;250891860971;912;0,1,2;3;9;1;1;1
250891860971;250891861807;836;0,1,2;3;9;1;1;1
250891861807;250891862190;383;0,1,2;3;9;1;1;1
250891862190;250891862432;242;0,1,2;3;9;1;1;1
250891862432;250891865152;2720;0,1,2;3;9;1;1;1
250891865152;250891866113;961;0,1,2;3;9;1;1;1
250891866113;250891866803;690;0,1,2;3;9;1;1;1
250891866803;250891867808;1005;0,1,2;3;9;1;1;1
250891867808;250891867862;54;0,1,2;3;9;1;1;1
250891867862;250891867905;43;0,1,2;3;9;1;1;1
250891867905;250891869031;1126;0,1,2;3;9;1;1;1
250891869031;250891869393;362;0,1,2;3;9;1;1;1
250891869393;250891869605;212;0,1,2;3;9;1;1;1
250891869605;250891869993;388;0,1,2;3;9;1;1;1
250891869993;250891870081;88;0,1,2;3;9;1;1;1
250891870081;250891870088;7;0,1,2;3;9;1;1;1
250891870088;250891872059;1971;0,1,2;3;9;1;1;1
250891872059;250891872144;85;0,1,2;3;9;1;1;1
250891872144;250891872528;384;0,1,2;3;9;1;1;1
250891872528;250891872765;237;0,1,2;3;9;1;1;1
250891872765;250891872802;37;0,1,2;3;9;1;1;1
250891872802;250891875117;2315;0,1,2;3;9;1;1;1
250891875117;250891875901;784;0,1,2;3;9;1;1;1
250891875901;250891876157;256;0,1,2;3;9;1;1;1
250891876157;250891876767;610;0,1,2;3;9;1;1;1
250891876767;250891876959;192;0,1,2;3;9;1;1;1
250891876959;250891877139;180;0,1,2;3;9;1;1;1
250891877139;250891877683;544;0,1,2;3;9;1;1;1
250891877683;250891877996;313;0,1,2;3;9;1;1;1
250891877996;250891878074;78;0,1,2;3;9;1;1;1
250891878074;250891878218;144;0,1,2;3;9;1;1;1
250891878218;250891878839;621;0,1,2;3;9;1;1;1
250891878839;250891879430;591;0,1,2;3;9;1;1;1
250891879430;250891879490;60;0,1,2;3;9;1;1;1
250891879490;250891880240;750;0,1,2;3;9;1;1;1
250891880240;250891880331;91;0,1,2;3;9;1;1;1
250891880331;250891880729;398;0,1,2;3;9;1;1;1
250891880729;250891882928;2199;0,1,2;3;9;1;1;1
250891882928;250891883230;302;0,1,2;3;9;1;1;1
250891883230;250891884957;1727;0,1,2;3;9;1;1;1
250891884957;250891885972;1015;0,1,2;3;9;1;1;1
250891885972;250891889568;3596;0,1,2;3;9;1;1;1
250891889568;250891889755;187;0,1,2;3;9;1;1;1
250891889755;250891890611;856;0,1,2;3;9;1;1;1
250891890611;250891891228;617;0,1,2;3;9;1;1;1
250891891228;250891892254;1026;0,1,2;3;9;1;1;1
250891892254;250891892773;519;0,1,2;3;9;1;1;1
250891892773;250891893450;677;0,1,2;3;9;1;1;1
250891893450;250891894529;1079;0,1,2;3;9;1;1;1
250891894529;250891895423;894;0,1,2;3;9;1;1;1
250891895423;250891898113;2690;0,1,2;3;9;1;1;1
250891898113;250891899275;1162;0,1,2;3;9;1;1;1
250891899275;250891900716;1441;0,1,2;3;9;1;1;1
250891900716;250891900867;151;0,1,2;3;9;1;1;1
250891900867;250891900914;47;0,1,2;3;9;1;1;1
250891900914;250891901080;166;0,1,2;3;9;1;1;1
250891901080;250891901948;868;0,1,2;3;9;1;1;1
250891901948;250891902073;125;0,1,2;3;9;1;1;1
250891902073;250891902324;251;0,1,2;3;9;1;1;1
250891902324;250891902568;244;0,1,2;3;9;1;1;1
250891902568;250891902589;21;0,1,2;3;9;1;1;1
250891902589;250891904535;1946;0,1,2;3;9;1;1;1
250891904535;250891904545;10;0,1,2;3;9;1;1;1
250891904545;250891904937;392;0,1,2;3;9;1;1;1
250891904937;250891905638;701;0,1,2;3;9;1;1;1
250891905638;250891906128;490;0,1,2;3;9;1;1;1
250891906128;250891906526;398;0,1,2;3;9;1;1;1
250891906526;250891908163;1637;0,1,2;3;9;1;1;1
250891908163;250891908404;241;0,1,2;3;9;1;1;1
250891908404;250891909432;1028;0,1,2;3;9;1;1;1
250891909432;250891910541;1109;0,1,2;3;9;1;1;1
250891910541;250891912560;2019;0,1,2;3;9;1;1;1
250891912560;250891913155;595;0,1,2;3;9;1;1;1
250891913155;250891913493;338;0,1,2;3;9;1;1;1
250891913493;250891916790;3297;0,1,2;3;9;1;1;1
250891916790;250891917148;358;0,1,2;3;9;1;1;1
250891917148;250891917508;360;0,1,2;3;9;1;1;1
250891917508;250891917711;203;0,1,2;3;9;1;1;1
250891917711;250891918566;855;0,1,2;3;9;1;1;1
250891918566;250891918643;77;0,1,2;3;9;1;1;1
250891918643;250891918937;294;0,1,2;3;9;1;1;1
250891918937;250891919301;364;0,1,2;3;9;1;1;1
250891919301;250891919786;485;0,1,2;3;9;1;1;1
250891919786;250891920336;550;0,1,2;3;9;1;1;1
250891920336;250891920513;177;0,1,2;3;9;1;1;1
250891920513;250891921183;670;0,1,2;3;9;1;1;1
250891921183;250891922350;1167;0,1,2;3;9;1;1;1
250891922350;250891922837;487;0,1,2;3;9;1;1;1
250891922837;250891922911;74;0,1,2;3;9;1;1;1
250891922911;250891923100;189;0,1,2;3;9;1;1;1
250891923100;250891923174;74;0,1,2;3;9;1;1;1
250891923174;250891923733;559;0,1,2;3;9;1;1;1
250891923733;250891924308;575;0,1,2;3;9;1;1;1
250891924308;250891924560;252;0,1,2;3;9;1;1;1
250891924560;250891925433;873;0,1,2;3;9;1;1;1
250891925433;250891925681;248;0,1,2;3;9;1;1;1
250891925681;250891926317;636;0,1,2;3;9;1;1;1
250891926317;250891926558;241;0,1,2;3;9;1;1;1
250891926558;250891926822;264;0,1,2;3;9;1;1;1
250891926822;250891926833;11;0,1,2;3;9;1;1;1
250891926833;250891927212;379;0,1,2;3;9;1;1;1
250891927212;250891927553;341;0,1,2;3;9;1;1;1
250891927553;250891927885;332;0,1,2;3;9;1;1;1
250891927885;250891927916;31;0,1,2;3;9;1;1;1
250891927916;250891929066;1150;0,1,2;3;9;1;1;1
250891929066;250891929572;506;0,1,2;3;9;1;1;1
250891929572;250891929659;87;0,1,2;3;9;1;1;1
250891929659;250891930890;1231;0,1,2;3;9;1;1;1
250891930890;250891934136;3246;0,1,2;3;9;1;1;1
250891934136;250891934940;804;0,1,2;3;9;1;1;1
250891934940;250891935351;411;0,1,2;3;9;1;1;1
250891935351;250891935987;636;0,1,2;3;9;1;1;1
250891935987;250891938217;2230;0,1,2;3;9;1;1;1
250891938217;250891938518;301;0,1,2;3;9;1;1;1
250891938518;250891938561;43;0,1,2;3;9;1;1;1
250891938561;250891938930;369;0,1,2;3;9;1;1;1
250891938930;250891939011;81;0,1,2;3;9;1;1;1
250891939011;250891939035;24;0,1,2;3;9;1;1;1
250891939035;250891939578;543;0,1,2;3;9;1;1;1
250891939578;250891940831;1253;0,1,2;3;9;1;1;1
250891940831;250891941087;256;0,1,2;3;9;1;1;1
250891941087;250891941984;897;0,1,2;3;9;1;1;1
250891941984;250891942965;981;0,1,2;3;9;1;1;1
250891942965;250891945315;2350;0,1,2;3;9;1;1;1
250891945315;250891945471;156;0,1,2;3;9;1;1;1
250891945471;250891945921;450;0,1,2;3;9;1;1;1
250891945921;250891947254;1333;0,1,2;3;9;1;1;1
250891947254;250891947469;215;0,1,2;3;9;1;1;1
250891947469;250891947563;94;0,1,2;3;9;1;1;1
250891947563;250891947660;97;0,1,2;3;9;1;1;1
250891947660;250891947885;225;0,1,2;3;9;1;1;1
250891947885;250891947917;32;0,1,2;3;9;1;1;1
250891947917;250891948020;103;0,1,2;3;9;1;1;1
250891948020;250891948195;175;0,1,2;3;9;1;1;1
250891948195;250891949125;930;0,1,2;3;9;1;1;1
250891949125;250891949291;166;0,1,2;3;9;1;1;1
250891949291;250891949501;210;0,1,2;3;9;1;1;1
250891949501;250891950815;1314;0,1,2;3;9;1;1;1
250891950815;250891951090;275;0,1,2;3;9;1;1;1
250891951090;250891951127;37;0,1,2;3;9;1;1;1
250891951127;250891951621;494;0,1,2;3;9;1;1;1
250891951621;250891951660;39;0,1,2;3;9;1;1;1
250891951660;250891952472;812;0,1,2;3;9;1;1;1
250891952472;250891953194;722;0,1,2;3;9;1;1;1
250891953194;250891953221;27;0,1,2;3;9;1;1;1
250891953221;250891953470;249;0,1,2;3;9;1;1;1
250891953470;250891954523;1053;0,1,2;3;9;1;1;1
250891954523;250891954857;334;0,1,2;3;9;1;1;1
250891954857;250891955076;219;0,1,2;3;9;1;1;1
250891955076;250891956203;1127;0,1,2;3;9;1;1;1
250891956203;250891956738;535;0,1,2;3;9;1;1;1
250891956738;250891956812;74;0,1,2;3;9;1;1;1
250891956812;250891957578;766;0,1,2;3;9;1;1;1
250891957578;250891958284;706;0,1,2;3;9;1;1;1
250891958284;250891958308;24;0,1,2;3;9;1;1;1
250891958308;250891958821;513;0,1,2;3;9;1;1;1
250891958821;250891959445;624;0,1,2;3;9;1;1;1
250891959445;250891959865;420;0,1,2;3;9;1;1;1
250891959865;250891960442;577;0,1,2;3;9;1;1;1
250891960442;250891960671;229;0,1,2;3;9;1;1;1
250891960671;250891961400;729;0,1,2;3;9;1;1;1
250891961400;250891962564;1164;0,1,2;3;9;1;1;1
250891962564;250891962649;85;0,1,2;3;9;1;1;1
250891962649;250891964654;2005;0,1,2;3;9;1;1;1
250891964654;250891965892;1238;0,1,2;3;9;1;1;1
250891965892;250891966478;586;0,1,2;3;9;1;1;1
250891966478;250891967026;548;0,1,2;3;9;1;1;1
250891967026;250891968073;1047;0,1,2;3;9;1;1;1
250891968073;250891968337;264;0,1,2;3;9;1;1;1
250891968337;250891969543;1206;0,1,2;3;9;1;1;1
250891969543;250891969712;169;0,1,2;3;9;1;1;1
250891969712;250891969972;260;0,1,2;3;9;1;1;1
250891969972;250891970741;769;0,1,2;3;9;1;1;1
250891970741;250891971650;909;0,1,2;3;9;1;1;1
250891971650;250891972931;1281;0,1,2;3;9;1;1;1
250891972931;250891973654;723;0,1,2;3;9;1;1;1
250891973654;250891974354;700;0,1,2;3;9;1;1;1
250891974354;250891975116;762;0,1,2;3;9;1;1;1
250891975116;250891975122;6;0,1,2;3;9;1;1;1
250891975122;250891975183;61;0,1,2;3;9;1;1;1
250891975183;250891975450;267;0,1,2;3;9;1;1;1
250891975450;250891976286;836;0,1,2;3;9;1;1;1
250891976286;250891976596;310;0,1,2;3;9;1;1;1
250891976596;250891977189;593;0,1,2;3;9;1;1;1
250891977189;250891977274;85;0,1,2;3;9;1;1;1
250891977274;250891977884;610;0,1,2;3;9;1;1;1
250891977884;250891978184;300;0,1,2;3;9;1;1;1
250891978184;250891978271;87;0,1,2;3;9;1;1;1
250891978271;250891978494;223;0,1,2;3;9;1;1;1
250891978494;250891979608;1114;0,1,2;3;9;1;1;1
250891979608;250891981281;1673;0,1,2;3;9;1;1;1
250891981281;250891982698;1417;0,1,2;3;9;1;1;1
250891982698;250891983174;476;0,1,2;3;9;1;1;1
250891983174;250891983368;194;0,1,2;3;9;1;1;1
250891983368;250891983766;398;0,1,2;3;9;1;1;1
250891983766;250891983813;47;0,1,2;3;9;1;1;1
250891983813;250891984355;542;0,1,2;3;9;1;1;1
250891984355;250891986968;2613;0,1,2;3;9;1;1;1
250891986968;250891987090;122;0,1,2;3;9;1;1;1
250891987090;250891987566;476;0,1,2;3;9;1;1;1
250891987566;250891989669;2103;0,1,2;3;9;1;1;1
250891989669;250891989846;177;0,1,2;3;9;1;1;1
250891989846;250891992074;2228;0,1,2;3;9;1;1;1
250891992074;250891992578;504;0,1,2;3;9;1;1;1
250891992578;250891994140;1562;0,1,2;3;9;1;1;1
250891994140;250891995320;1180;0,1,2;3;9;1;1;1
250891995320;250891996689;1369;0,1,2;3;9;1;1;1
250891996689;250891996934;245;0,1,2;3;9;1;1;1
250891996934;250891999178;2244;0,1,2;3;9;1;1;1
250891999178;250892000905;1727;0,1,2;3;9;1;1;1
250892000905;250892001337;432;0,1,2;3;9;1;1;1
250892001337;250892001763;426;0,1,2;3;9;1;1;1
250892001763;250892001880;117;0,1,2;3;9;1;1;1
250892001880;250892004121;2241;0,1,2;3;9;1;1;1
250892004121;250892004171;50;0,1,2;3;9;1;1;1
250892004171;250892004527;356;0,1,2;3;9;1;1;1
250892004527;250892004826;299;0,1,2;3;9;1;1;1
250892004826;250892006350;1524;0,1,2;3;9;1;1;1
250892006350;250892006988;638;0,1,2;3;9;1;1;1
250892006988;250892007308;320;0,1,2;3;9;1;1;1
250892007308;250892007404;96;0,1,2;3;9;1;1;1
250892007404;250892007466;62;0,1,2;3;9;1;1;1
250892007466;250892007550;84;0,1,2;3;9;1;1;1
250892007550;250892007725;175;0,1,2;3;9;1;1;1
250892007725;250892008538;813;0,1,2;3;9;1;1;1
250892008538;250892009040;502;0,1,2;3;9;1;1;1
250892009040;250892010606;1566;0,1,2;3;9;1;1;1
250892010606;250892012392;1786;0,1,2;3;9;1;1;1
250892012392;250892012515;123;0,1,2;3;9;1;1;1
250892012515;250892012566;51;0,1,2;3;9;1;1;1
250892012566;250892012928;362;0,1,2;3;9;1;1;1
250892012928;250892014074;1146;0,1,2;3;9;1;1;1
250892014074;250892014363;289;0,1,2;3;9;1;1;1
250892014363;250892014394;31;0,1,2;3;9;1;1;1
250892014394;250892014723;329;0,1,2;3;9;1;1;1
250892014723;250892014904;181;0,1,2;3;9;1;1;1
250892014904;250892015963;1059;0,1,2;3;9;1;1;1
250892015963;250892016132;169;0,1,2;3;9;1;1;1
250892016132;250892016169;37;0,1,2;3;9;1;1;1
250892016169;250892016300;131;0,1,2;3;9;1;1;1
250892016300;250892017422;1122;0,1,2;3;9;1;1;1
250892017422;250892017464;42;0,1,2;3;9;1;1;1
250892017464;250892017487;23;0,1,2;3;9;1;1;1
250892017487;250892017624;137;0,1,2;3;9;1;1;1
250892017624;250892018116;492;0,1,2;3;9;1;1;1
250892018116;250892019483;1367;0,1,2;3;9;1;1;1
250892019483;250892020641;1158;0,1,2;3;9;1;1;1
250892020641;250892020880;239;0,1,2;3;9;1;1;1
250892020880;250892020976;96;0,1,2;3;9;1;1;1
250892020976;250892021915;939;0,1,2;3;9;1;1;1
250892021915;250892021954;39;0,1,2;3;9;1;1;1
250892021954;250892022906;952;0,1,2;3;9;1;1;1
250892022906;250892023012;106;0,1,2;3;9;1;1;1
250892023012;250892023396;384;0,1,2;3;9;1;1;1
250892023396;250892024264;868;0,1,2;3;9;1;1;1
250892024264;250892024833;569;0,1,2;3;9;1;1;1
250892024833;250892025172;339;0,1,2;3;9;1;1;1
250892025172;250892026198;1026;0,1,2;3;9;1;1;1
250892026198;250892027613;1415;0,1,2;3;9;1;1;1
250892027613;250892027903;290;0,1,2;3;9;1;1;1
250892027903;250892028023;120;0,1,2;3;9;1;1;1
250892028023;250892028598;575;0,1,2;3;9;1;1;1
250892028598;250892028710;112;0,1,2;3;9;1;1;1
250892028710;250892028932;222;0,1,2;3;9;1;1;1
250892028932;250892029426;494;0,1,2;3;9;1;1;1
250892029426;250892030474;1048;0,1,2;3;9;1;1;1
250892030474;250892031640;1166;0,1,2;3;9;1;1;1
250892031640;250892033843;2203;0,1,2;3;9;1;1;1
250892033843;250892035766;1923;0,1,2;3;9;1;1;1
250892035766;250892035883;117;0,1,2;3;9;1;1;1
250892035883;250892036095;212;0,1,2;3;9;1;1;1
250892036095;250892036976;881;0,1,2;3;9;1;1;1
250892036976;250892037572;596;0,1,2;3;9;1;1;1
250892037572;250892038866;1294;0,1,2;3;9;1;1;1
250892038866;250892038917;51;0,1,2;3;9;1;1;1
250892038917;250892038984;67;0,1,2;3;9;1;1;1
250892038984;250892039180;196;0,1,2;3;9;1;1;1
250892039180;250892039366;186;0,1,2;3;9;1;1;1
250892039366;250892039421;55;0,1,2;3;9;1;1;1
250892039421;250892039474;53;0,1,2;3;9;1;1;1
250892039474;250892040682;1208;0,1,2;3;9;1;1;1
250892040682;250892041261;579;0,1,2;3;9;1;1;1
250892041261;250892041531;270;0,1,2;3;9;1;1;1
250892041531;250892041787;256;0,1,2;3;9;1;1;1
250892041787;250892041835;48;0,1,2;3;9;1;1;1
250892041835;250892043091;1256;0,1,2;3;9;1;1;1
250892043091;250892043149;58;0,1,2;3;9;1;1;1
250892043149;250892043518;369;0,1,2;3;9;1;1;1
250892043518;250892043533;15;0,1,2;3;9;1;1;1
250892043533;250892044521;988;0,1,2;3;9;1;1;1
250892044521;250892044866;345;0,1,2;3;9;1;1;1
250892044866;250892044940;74;0,1,2;3;9;1;1;1
250892044940;250892046303;1363;0,1,2;3;9;1;1;1
250892046303;250892046444;141;0,1,2;3;9;1;1;1
250892046444;250892047531;1087;0,1,2;3;9;1;1;1
250892047531;250892048658;1127;0,1,2;3;9;1;1;1
250892048658;250892048790;132;0,1,2;3;9;1;1;1
250892048790;250892049111;321;0,1,2;3;9;1;1;1
250892049111;250892049839;728;0,1,2;3;9;1;1;1
250892049839;250892050389;550;0,1,2;3;9;1;1;1
250892050389;250892050780;391;0,1,2;3;9;1;1;1
250892050780;250892050988;208;0,1,2;3;9;1;1;1
250892050988;250892051491;503;0,1,2;3;9;1;1;1
250892051491;250892051769;278;0,1,2;3;9;1;1;1
250892051769;250892051828;59;0,1,2;3;9;1;1;1
250892051828;250892052182;354;0,1,2;3;9;1;1;1
250892052182;250892052474;292;0,1,2;3;9;1;1;1
250892052474;250892052951;477;0,1,2;3;9;1;1;1
250892052951;250892053744;793;0,1,2;3;9;1;1;1
250892053744;250892053981;237;0,1,2;3;9;1;1;1
250892053981;250892054515;534;0,1,2;3;9;1;1;1
250892054515;250892054608;93;0,1,2;3;9;1;1;1
250892054608;250892054706;98;0,1,2;3;9;1;1;1
250892054706;250892054795;89;0,1,2;3;9;1;1;1
250892054795;250892055843;1048;0,1,2;3;9;1;1;1
250892055843;250892056027;184;0,1,2;3;9;1;1;1
250892056027;250892056279;252;0,1,2;3;9;1;1;1
250892056279;250892056395;116;0,1,2;3;9;1;1;1
250892056395;250892056803;408;0,1,2;3;9;1;1;1
250892056803;250892056859;56;0,1,2;3;9;1;1;1
250892056859;250892057317;458;0,1,2;3;9;1;1;1
250892057317;250892058032;715;0,1,2;3;9;1;1;1
250892058032;250892058247;215;0,1,2;3;9;1;1;1
250892058247;250892058591;344;0,1,2;3;9;1;1;1
250892058591;250892058707;116;0,1,2;3;9;1;1;1
250892058707;250892058732;25;0,1,2;3;9;1;1;1
250892058732;250892058931;199;0,1,2;3;9;1;1;1
250892058931;250892059154;223;0,1,2;3;9;1;1;1
250892059154;250892060400;1246;0,1,2;3;9;1;1;1
250892060400;250892060467;67;0,1,2;3;9;1;1;1
250892060467;250892061101;634;0,1,2;3;9;1;1;1
250892061101;250892061218;117;0,1,2;3;9;1;1;1
250892061218;250892061441;223;0,1,2;3;9;1;1;1
250892061441;250892061580;139;0,1,2;3;9;1;1;1
250892061580;250892061895;315;0,1,2;3;9;1;1;1
250892061895;250892062525;630;0,1,2;3;9;1;1;1
250892062525;250892062944;419;0,1,2;3;9;1;1;1
250892062944;250892063625;681;0,1,2;3;9;1;1;1
250892063625;250892063655;30;0,1,2;3;9;1;1;1
250892063655;250892064226;571;0,1,2;3;9;1;1;1
250892064226;250892065487;1261;0,1,2;3;9;1;1;1
250892065487;250892065541;54;0,1,2;3;9;1;1;1
250892065541;250892066363;822;0,1,2;3;9;1;1;1
250892066363;250892066545;182;0,1,2;3;9;1;1;1
250892066545;250892069295;2750;0,1,2;3;9;1;1;1
250892069295;250892070054;759;0,1,2;3;9;1;1;1
250892070054;250892071591;1537;0,1,2;3;9;1;1;1
250892071591;250892071992;401;0,1,2;3;9;1;1;1
250892071992;250892072020;28;0,1,2;3;9;1;1;1
250892072020;250892072048;28;0,1,2;3;9;1;1;1
250892072048;250892072473;425;0,1,2;3;9;1;1;1
250892072473;250892072569;96;0,1,2;3;9;1;1;1
250892072569;250892073178;609;0,1,2;3;9;1;1;1
250892073178;250892073952;774;0,1,2;3;9;1;1;1
250892073952;250892074086;134;0,1,2;3;9;1;1;1
250892074086;250892075082;996;0,1,2;3;9;1;1;1
250892075082;250892075992;910;0,1,2;3;9;1;1;1
250892075992;250892076070;78;0,1,2;3;9;1;1;1
250892076070;250892076152;82;0,1,2;3;9;1;1;1
250892076152;250892076272;120;0,1,2;3;9;1;1;1
250892076272;250892076932;660;0,1,2;3;9;1;1;1
250892076932;250892077988;1056;0,1,2;3;9;1;1;1
250892077988;250892079498;1510;0,1,2;3;9;1;1;1
250892079498;250892079841;343;0,1,2;3;9;1;1;1
250892079841;250892080580;739;0,1,2;3;9;1;1;1
250892080580;250892080755;175;0,1,2;3;9;1;1;1
250892080755;250892081049;294;0,1,2;3;9;1;1;1
250892081049;250892081678;629;0,1,2;3;9;1;1;1
250892081678;250892082247;569;0,1,2;3;9;1;1;1
250892082247;250892082303;56;0,1,2;3;9;1;1;1
250892082303;250892083322;1019;0,1,2;3;9;1;1;1
250892083322;250892083345;23;0,1,2;3;9;1;1;1
250892083345;250892083356;11;0,1,2;3;9;1;1;1
250892083356;250892084610;1254;0,1,2;3;9;1;1;1
250892084610;250892084701;91;0,1,2;3;9;1;1;1
250892084701;250892085137;436;0,1,2;3;9;1;1;1
250892085137;250892085278;141;0,1,2;3;9;1;1;1
250892085278;250892085388;110;0,1,2;3;9;1;1;1
250892085388;250892085421;33;0,1,2;3;9;1;1;1
250892085421;250892086277;856;0,1,2;3;9;1;1;1
250892086277;250892086736;459;0,1,2;3;9;1;1;1
250892086736;250892086884;148;0,1,2;3;9;1;1;1
250892086884;250892087183;299;0,1,2;3;9;1;1;1
250892087183;250892087238;55;0,1,2;3;9;1;1;1
250892087238;250892087455;217;0,1,2;3;9;1;1;1
250892087455;250892087471;16;0,1,2;3;9;1;1;1
250892087471;250892087951;480;0,1,2;3;9;1;1;1
250892087951;250892088079;128;0,1,2;3;9;1;1;1
250892088079;250892088648;569;0,1,2;3;9;1;1;1
250892088648;250892088727;79;0,1,2;3;9;1;1;1
250892088727;250892089017;290;0,1,2;3;9;1;1;1
250892089017;250892089079;62;0,1,2;3;9;1;1;1
250892089079;250892089315;236;0,1,2;3;9;1;1;1
250892089315;250892090129;814;0,1,2;3;9;1;1;1
250892090129;250892091000;871;0,1,2;3;9;1;1;1
250892091000;250892091542;542;0,1,2;3;9;1;1;1
250892091542;250892091707;165;0,1,2;3;9;1;1;1
250892091707;250892091944;237;0,1,2;3;9;1;1;1
250892091944;250892093371;1427;0,1,2;3;9;1;1;1
250892093371;250892093434;63;0,1,2;3;9;1;1;1
250892093434;250892093695;261;0,1,2;3;9;1;1;1
250892093695;250892093752;57;0,1,2;3;9;1;1;1
250892093752;250892094565;813;0,1,2;3;9;1;1;1
250892094565;250892094656;91;0,1,2;3;9;1;1;1
250892094656;250892095505;849;0,1,2;3;9;1;1;1
250892095505;250892096175;670;0,1,2;3;9;1;1;1
250892096175;250892096231;56;0,1,2;3;9;1;1;1
250892096231;250892096468;237;0,1,2;3;9;1;1;1
250892096468;250892097419;951;0,1,2;3;9;1;1;1
250892097419;250892097705;286;0,1,2;3;9;1;1;1
250892097705;250892099133;1428;0,1,2;3;9;1;1;1
250892099133;250892100043;910;0,1,2;3;9;1;1;1
250892100043;250892101141;1098;0,1,2;3;9;1;1;1
250892101141;250892101199;58;0,1,2;3;9;1;1;1
250892101199;250892101232;33;0,1,2;3;9;1;1;1
250892101232;250892101614;382;0,1,2;3;9;1;1;1
250892101614;250892102041;427;0,1,2;3;9;1;1;1
250892102041;250892102622;581;0,1,2;3;9;1;1;1
250892102622;250892103694;1072;0,1,2;3;9;1;1;1
250892103694;250892104110;416;0,1,2;3;9;1;1;1
250892104110;250892104133;23;0,1,2;3;9;1;1;1
250892104133;250892106413;2280;0,1,2;3;9;1;1;1
250892106413;250892106613;200;0,1,2;3;9;1;1;1
250892106613;250892106650;37;0,1,2;3;9;1;1;1
250892106650;250892108684;2034;0,1,2;3;9;1;1;1
250892108684;250892108822;138;0,1,2;3;9;1;1;1
250892108822;250892108960;138;0,1,2;3;9;1;1;1
250892108960;250892109888;928;0,1,2;3;9;1;1;1
250892109888;250892110779;891;0,1,2;3;9;1;1;1
250892110779;250892111458;679;0,1,2;3;9;1;1;1
250892111458;250892112524;1066;0,1,2;3;9;1;1;1
250892112524;250892112652;128;0,1,2;3;9;1;1;1
250892112652;250892114148;1496;0,1,2;3;9;1;1;1
250892114148;250892115047;899;0,1,2;3;9;1;1;1
250892115047;250892116254;1207;0,1,2;3;9;1;1;1
250892116254;250892116813;559;0,1,2;3;9;1;1;1
250892116813;250892117175;362;0,1,2;3;9;1;1;1
250892117175;250892117618;443;0,1,2;3;9;1;1;1
250892117618;250892117869;251;0,1,2;3;9;1;1;1
250892117869;250892118067;198;0,1,2;3;9;1;1;1
250892118067;250892120162;2095;0,1,2;3;9;1;1;1
250892120162;250892122138;1976;0,1,2;3;9;1;1;1
250892122138;250892123085;947;0,1,2;3;9;1;1;1
250892123085;250892123349;264;0,1,2;3;9;1;1;1
250892123349;250892123688;339;0,1,2;3;9;1;1;1
250892123688;250892123713;25;0,1,2;3;9;1;1;1
250892123713;250892123743;30;0,1,2;3;9;1;1;1
250892123743;250892124034;291;0,1,2;3;9;1;1;1
250892124034;250892124136;102;0,1,2;3;9;1;1;1
250892124136;250892124241;105;0,1,2;3;9;1;1;1
250892124241;250892124347;106;0,1,2;3;9;1;1;1
250892124347;250892124821;474;0,1,2;3;9;1;1;1
250892124821;250892125097;276;0,1,2;3;9;1;1;1
250892125097;250892125110;13;0,1,2;3;9;1;1;1
250892125110;250892125140;30;0,1,2;3;9;1;1;1
250892125140;250892125592;452;0,1,2;3;9;1;1;1
250892125592;250892125642;50;0,1,2;3;9;1;1;1
250892125642;250892125781;139;0,1,2;3;9;1;1;1
250892125781;250892126119;338;0,1,2;3;9;1;1;1
250892126119;250892126363;244;0,1,2;3;9;1;1;1
250892126363;250892126810;447;0,1,2;3;9;1;1;1
250892126810;250892126951;141;0,1,2;3;9;1;1;1
250892126951;250892127282;331;0,1,2;3;9;1;1;1
250892127282;250892127712;430;0,1,2;3;9;1;1;1
250892127712;250892127945;233;0,1,2;3;9;1;1;1
250892127945;250892128332;387;0,1,2;3;9;1;1;1
250892128332;250892128394;62;0,1,2;3;9;1;1;1
250892128394;250892128804;410;0,1,2;3;9;1;1;1
250892128804;250892128951;147;0,1,2;3;9;1;1;1
250892128951;250892129617;666;0,1,2;3;9;1;1;1
250892129617;250892129730;113;0,1,2;3;9;1;1;1
250892129730;250892129782;52;0,1,2;3;9;1;1;1
250892129782;250892129979;197;0,1,2;3;9;1;1;1
250892129979;250892130022;43;0,1,2;3;9;1;1;1
250892130022;250892130057;35;0,1,2;3;9;1;1;1
250892130057;250892130682;625;0,1,2;3;9;1;1;1
250892130682;250892130729;47;0,1,2;3;9;1;1;1
250892130729;250892131040;311;0,1,2;3;9;1;1;1
250892131040;250892131584;544;0,1,2;3;9;1;1;1
250892131584;250892132158;574;0,1,2;3;9;1;1;1
250892132158;250892132347;189;0,1,2;3;9;1;1;1
250892132347;250892132548;201;0,1,2;3;9;1;1;1
250892132548;250892132792;244;0,1,2;3;9;1;1;1
250892132792;250892133096;304;0,1,2;3;9;1;1;1
250892133096;250892133314;218;0,1,2;3;9;1;1;1
250892133314;250892133399;85;0,1,2;3;9;1;1;1
250892133399;250892133690;291;0,1,2;3;9;1;1;1
250892133690;250892134732;1042;0,1,2;3;9;1;1;1
250892134732;250892135248;516;0,1,2;3;9;1;1;1
250892135248;250892135433;185;0,1,2;3;9;1;1;1
250892135433;250892135483;50;0,1,2;3;9;1;1;1
250892135483;250892135571;88;0,1,2;3;9;1;1;1
250892135571;250892135774;203;0,1,2;3;9;1;1;1
250892135774;250892136804;1030;0,1,2;3;9;1;1;1
250892136804;250892137089;285;0,1,2;3;9;1;1;1
250892137089;250892137551;462;0,1,2;3;9;1;1;1
250892137551;250892137579;28;0,1,2;3;9;1;1;1
250892137579;250892137612;33;0,1,2;3;9;1;1;1
250892137612;250892138148;536;0,1,2;3;9;1;1;1
250892138148;250892139271;1123;0,1,2;3;9;1;1;1
250892139271;250892139411;140;0,1,2;3;9;1;1;1
250892139411;250892139861;450;0,1,2;3;9;1;1;1
250892139861;250892139937;76;0,1,2;3;9;1;1;1
250892139937;250892140627;690;0,1,2;3;9;1;1;1
250892140627;250892140861;234;0,1,2;3;9;1;1;1
250892140861;250892140878;17;0,1,2;3;9;1;1;1
250892140878;250892140914;36;0,1,2;3;9;1;1;1
250892140914;250892140988;74;0,1,2;3;9;1;1;1
250892140988;250892141219;231;0,1,2;3;9;1;1;1
250892141219;250892142481;1262;0,1,2;3;9;1;1;1
250892142481;250892142840;359;0,1,2;3;9;1;1;1
250892142840;250892142884;44;0,1,2;3;9;1;1;1
250892142884;250892143113;229;0,1,2;3;9;1;1;1
250892143113;250892143613;500;0,1,2;3;9;1;1;1
250892143613;250892144359;746;0,1,2;3;9;1;1;1
250892144359;250892144629;270;0,1,2;3;9;1;1;1
250892144629;250892144796;167;0,1,2;3;9;1;1;1
250892144796;250892144970;174;0,1,2;3;9;1;1;1
250892144970;250892146555;1585;0,1,2;3;9;1;1;1
250892146555;250892147778;1223;0,1,2;3;9;1;1;1
250892147778;250892148004;226;0,1,2;3;9;1;1;1
250892148004;250892148056;52;0,1,2;3;9;1;1;1
250892148056;250892148273;217;0,1,2;3;9;1;1;1
250892148273;250892148738;465;0,1,2;3;9;1;1;1
250892148738;250892148832;94;0,1,2;3;9;1;1;1
250892148832;250892150038;1206;0,1,2;3;9;1;1;1
250892150038;250892150058;20;0,1,2;3;9;1;1;1
250892150058;250892150809;751;0,1,2;3;9;1;1;1
250892150809;250892151249;440;0,1,2;3;9;1;1;1
250892151249;250892151438;189;0,1,2;3;9;1;1;1
250892151438;250892152250;812;0,1,2;3;9;1;1;1
250892152250;250892152561;311;0,1,2;3;9;1;1;1
250892152561;250892153234;673;0,1,2;3;9;1;1;1
250892153234;250892154129;895;0,1,2;3;9;1;1;1
250892154129;250892154140;11;0,1,2;3;9;1;1;1
250892154140;250892155459;1319;0,1,2;3;9;1;1;1
250892155459;250892155770;311;0,1,2;3;9;1;1;1
250892155770;250892155815;45;0,1,2;3;9;1;1;1
250892155815;250892158134;2319;0,1,2;3;9;1;1;1
250892158134;250892158395;261;0,1,2;3;9;1;1;1
250892158395;250892158614;219;0,1,2;3;9;1;1;1
250892158614;250892159057;443;0,1,2;3;9;1;1;1
250892159057;250892159157;100;0,1,2;3;9;1;1;1
250892159157;250892159351;194;0,1,2;3;9;1;1;1
250892159351;250892159766;415;0,1,2;3;9;1;1;1
250892159766;250892160095;329;0,1,2;3;9;1;1;1
250892160095;250892160316;221;0,1,2;3;9;1;1;1
250892160316;250892161810;1494;0,1,2;3;9;1;1;1
250892161810;250892164533;2723;0,1,2;3;9;1;1;1
250892164533;250892164734;201;0,1,2;3;9;1;1;1
250892164734;250892166027;1293;0,1,2;3;9;1;1;1
250892166027;250892166268;241;0,1,2;3;9;1;1;1
250892166268;250892166336;68;0,1,2;3;9;1;1;1
250892166336;250892167021;685;0,1,2;3;9;1;1;1
250892167021;250892168157;1136;0,1,2;3;9;1;1;1
250892168157;250892168165;8;0,1,2;3;9;1;1;1
250892168165;250892168868;703;0,1,2;3;9;1;1;1
250892168868;250892169741;873;0,1,2;3;9;1;1;1
250892169741;250892170614;873;0,1,2;3;9;1;1;1
250892170614;250892170666;52;0,1,2;3;9;1;1;1
250892170666;250892170993;327;0,1,2;3;9;1;1;1
250892170993;250892171135;142;0,1,2;3;9;1;1;1
250892171135;250892171380;245;0,1,2;3;9;1;1;1
250892171380;250892171675;295;0,1,2;3;9;1;1;1
250892171675;250892171856;181;0,1,2;3;9;1;1;1
250892171856;250892171869;13;0,1,2;3;9;1;1;1
250892171869;250892171919;50;0,1,2;3;9;1;1;1
250892171919;250892172311;392;0,1,2;3;9;1;1;1
250892172311;250892173632;1321;0,1,2;3;9;1;1;1
250892173632;250892173653;21;0,1,2;3;9;1;1;1
250892173653;250892173809;156;0,1,2;3;9;1;1;1
250892173809;250892174283;474;0,1,2;3;9;1;1;1
250892174283;250892174489;206;0,1,2;3;9;1;1;1
250892174489;250892174594;105;0,1,2;3;9;1;1;1
250892174594;250892174715;121;0,1,2;3;9;1;1;1
250892174715;250892174858;143;0,1,2;3;9;1;1;1
250892174858;250892175330;472;0,1,2;3;9;1;1;1
250892175330;250892175334;4;0,1,2;3;9;1;1;1
250892175334;250892175866;532;0,1,2;3;9;1;1;1
250892175866;250892177493;1627;0,1,2;3;9;1;1;1
250892177493;250892177643;150;0,1,2;3;9;1;1;1
250892177643;250892177894;251;0,1,2;3;9;1;1;1
250892177894;250892177994;100;0,1,2;3;9;1;1;1
250892177994;250892178328;334;0,1,2;3;9;1;1;1
250892178328;250892179405;1077;0,1,2;3;9;1;1;1
250892179405;250892179632;227;0,1,2;3;9;1;1;1
250892179632;250892179638;6;0,1,2;3;9;1;1;1
250892179638;250892179861;223;0,1,2;3;9;1;1;1
250892179861;250892180071;210;0,1,2;3;9;1;1;1
250892180071;250892180166;95;0,1,2;3;9;1;1;1
250892180166;250892180756;590;0,1,2;3;9;1;1;1
250892180756;250892181392;636;0,1,2;3;9;1;1;1
250892181392;250892181447;55;0,1,2;3;9;1;1;1
250892181447;250892182324;877;0,1,2;3;9;1;1;1
250892182324;250892182854;530;0,1,2;3;9;1;1;1
250892182854;250892182924;70;0,1,2;3;9;1;1;1
250892182924;250892183032;108;0,1,2;3;9;1;1;1
250892183032;250892183235;203;0,1,2;3;9;1;1;1
250892183235;250892183623;388;0,1,2;3;9;1;1;1
250892183623;250892185628;2005;0,1,2;3;9;1;1;1
250892185628;250892185838;210;0,1,2;3;9;1;1;1
250892185838;250892185867;29;0,1,2;3;9;1;1;1
250892185867;250892186434;567;0,1,2;3;9;1;1;1
250892186434;250892187317;883;0,1,2;3;9;1;1;1
250892187317;250892187391;74;0,1,2;3;9;1;1;1
250892187391;250892187399;8;0,1,2;3;9;1;1;1
250892187399;250892187610;211;0,1,2;3;9;1;1;1
250892187610;250892187922;312;0,1,2;3;9;1;1;1
250892187922;250892188007;85;0,1,2;3;9;1;1;1
250892188007;250892188043;36;0,1,2;3;9;1;1;1
250892188043;250892189124;1081;0,1,2;3;9;1;1;1
250892189124;250892189309;185;0,1,2;3;9;1;1;1
250892189309;250892189345;36;0,1,2;3;9;1;1;1
250892189345;250892190111;766;0,1,2;3;9;1;1;1
250892190111;250892190512;401;0,1,2;3;9;1;1;1
250892190512;250892192455;1943;0,1,2;3;9;1;1;1
250892192455;250892193466;1011;0,1,2;3;9;1;1;1
250892193466;250892194332;866;0,1,2;3;9;1;1;1
250892194332;250892195050;718;0,1,2;3;9;1;1;1
250892195050;250892195147;97;0,1,2;3;9;1;1;1
250892195147;250892195441;294;0,1,2;3;9;1;1;1
250892195441;250892195738;297;0,1,2;3;9;1;1;1
250892195738;250892195794;56;0,1,2;3;9;1;1;1
250892195794;250892196265;471;0,1,2;3;9;1;1;1
250892196265;250892196530;265;0,1,2;3;9;1;1;1
250892196530;250892197578;1048;0,1,2;3;9;1;1;1
250892197578;250892198011;433;0,1,2;3;9;1;1;1
250892198011;250892198910;899;0,1,2;3;9;1;1;1
250892198910;250892199031;121;0,1,2;3;9;1;1;1
250892199031;250892199160;129;0,1,2;3;9;1;1;1
250892199160;250892199603;443;0,1,2;3;9;1;1;1
250892199603;250892200233;630;0,1,2;3;9;1;1;1
250892200233;250892200277;44;0,1,2;3;9;1;1;1
250892200277;250892200757;480;0,1,2;3;9;1;1;1
250892200757;250892201125;368;0,1,2;3;9;1;1;1
250892201125;250892201513;388;0,1,2;3;9;1;1;1
250892201513;250892202347;834;0,1,2;3;9;1;1;1
250892202347;250892202664;317;0,1,2;3;9;1;1;1
250892202664;250892203006;342;0,1,2;3;9;1;1;1
250892203006;250892203542;536;0,1,2;3;9;1;1;1
250892203542;250892204794;1252;0,1,2;3;9;1;1;1
250892204794;250892204842;48;0,1,2;3;9;1;1;1
250892204842;250892207689;2847;0,1,2;3;9;1;1;1
250892207689;250892207897;208;0,1,2;3;9;1;1;1
250892207897;250892207936;39;0,1,2;3;9;1;1;1
250892207936;250892208001;65;0,1,2;3;9;1;1;1
250892208001;250892208087;86;0,1,2;3;9;1;1;1
250892208087;250892208200;113;0,1,2;3;9;1;1;1
250892208200;250892208442;242;0,1,2;3;9;1;1;1
250892208442;250892208496;54;0,1,2;3;9;1;1;1
250892208496;250892210514;2018;0,1,2;3;9;1;1;1
250892210514;250892210705;191;0,1,2;3;9;1;1;1
250892210705;250892211335;630;0,1,2;3;9;1;1;1
250892211335;250892212145;810;0,1,2;3;9;1;1;1
250892212145;250892212474;329;0,1,2;3;9;1;1;1
250892212474;250892212995;521;0,1,2;3;9;1;1;1
250892212995;250892213753;758;0,1,2;3;9;1;1;1
250892213753;250892213773;20;0,1,2;3;9;1;1;1
250892213773;250892213892;119;0,1,2;3;9;1;1;1
250892213892;250892213997;105;0,1,2;3;9;1;1;1
250892213997;250892214137;140;0,1,2;3;9;1;1;1
250892214137;250892215970;1833;0,1,2;3;9;1;1;1
250892215970;250892216985;1015;0,1,2;3;9;1;1;1
250892216985;250892217054;69;0,1,2;3;9;1;1;1
250892217054;250892217288;234;0,1,2;3;9;1;1;1
250892217288;250892217604;316;0,1,2;3;9;1;1;1
250892217604;250892218432;828;0,1,2;3;9;1;1;1
250892218432;250892218444;12;0,1,2;3;9;1;1;1
250892218444;250892218485;41;0,1,2;3;9;1;1;1
250892218485;250892218622;137;0,1,2;3;9;1;1;1
250892218622;250892218987;365;0,1,2;3;9;1;1;1
250892218987;250892219079;92;0,1,2;3;9;1;1;1
250892219079;250892219114;35;0,1,2;3;9;1;1;1
250892219114;250892220169;1055;0,1,2;3;9;1;1;1
250892220169;250892220183;14;0,1,2;3;9;1;1;1
250892220183;250892220439;256;0,1,2;3;9;1;1;1
250892220439;250892220568;129;0,1,2;3;9;1;1;1
250892220568;250892220713;145;0,1,2;3;9;1;1;1
250892220713;250892221580;867;0,1,2;3;9;1;1;1
250892221580;250892221935;355;0,1,2;3;9;1;1;1
250892221935;250892222552;617;0,1,2;3;9;1;1;1
250892222552;250892222849;297;0,1,2;3;9;1;1;1
250892222849;250892223734;885;0,1,2;3;9;1;1;1
250892223734;250892224379;645;0,1,2;3;9;1;1;1
250892224379;250892224723;344;0,1,2;3;9;1;1;1
250892224723;250892224957;234;0,1,2;3;9;1;1;1
250892224957;250892225364;407;0,1,2;3;9;1;1;1
250892225364;250892225404;40;0,1,2;3;9;1;1;1
250892225404;250892225976;572;0,1,2;3;9;1;1;1
250892225976;250892226143;167;0,1,2;3;9;1;1;1
250892226143;250892226206;63;0,1,2;3;9;1;1;1
250892226206;250892226261;55;0,1,2;3;9;1;1;1
250892226261;250892226297;36;0,1,2;3;9;1;1;1
250892226297;250892226828;531;0,1,2;3;9;1;1;1
250892226828;250892226902;74;0,1,2;3;9;1;1;1
250892226902;250892227055;153;0,1,2;3;9;1;1;1
250892227055;250892227151;96;0,1,2;3;9;1;1;1
250892227151;250892227989;838;0,1,2;3;9;1;1;1
250892227989;250892228201;212;0,1,2;3;9;1;1;1
250892228201;250892228440;239;0,1,2;3;9;1;1;1
250892228440;250892228630;190;0,1,2;3;9;1;1;1
250892228630;250892228685;55;0,1,2;3;9;1;1;1
250892228685;250892228708;23;0,1,2;3;9;1;1;1
250892228708;250892228991;283;0,1,2;3;9;1;1;1
250892228991;250892229453;462;0,1,2;3;9;1;1;1
250892229453;250892229896;443;0,1,2;3;9;1;1;1
250892229896;250892230023;127;0,1,2;3;9;1;1;1
250892230023;250892230026;3;0,1,2;3;9;1;1;1
250892230026;250892230387;361;0,1,2;3;9;1;1;1
250892230387;250892230621;234;0,1,2;3;9;1;1;1
250892230621;250892230767;146;0,1,2;3;9;1;1;1
250892230767;250892231539;772;0,1,2;3;9;1;1;1
250892231539;250892232000;461;0,1,2;3;9;1;1;1
250892232000;250892232401;401;0,1,2;3;9;1;1;1
250892232401;250892232593;192;0,1,2;3;9;1;1;1
250892232593;250892232605;12;0,1,2;3;9;1;1;1
250892232605;250892233015;410;0,1,2;3;9;1;1;1
250892233015;250892233078;63;0,1,2;3;9;1;1;1
250892233078;250892233250;172;0,1,2;3;9;1;1;1
250892233250;250892233548;298;0,1,2;3;9;1;1;1
250892233548;250892233562;14;0,1,2;3;9;1;1;1
250892233562;250892233916;354;0,1,2;3;9;1;1;1
250892233916;250892234104;188;0,1,2;3;9;1;1;1
250892234104;250892234404;300;0,1,2;3;9;1;1;1
250892234404;250892234662;258;0,1,2;3;9;1;1;1
250892234662;250892234884;222;0,1,2;3;9;1;1;1
250892234884;250892235066;182;0,1,2;3;9;1;1;1
250892235066;250892235076;10;0,1,2;3;9;1;1;1
250892235076;250892236701;1625;0,1,2;3;9;1;1;1
250892236701;250892237019;318;0,1,2;3;9;1;1;1
250892237019;250892237063;44;0,1,2;3;9;1;1;1
250892237063;250892237457;394;0,1,2;3;9;1;1;1
250892237457;250892237551;94;0,1,2;3;9;1;1;1
250892237551;250892237797;246;0,1,2;3;9;1;1;1
250892237797;250892237848;51;0,1,2;3;9;1;1;1
250892237848;250892238391;543;0,1,2;3;9;1;1;1
250892238391;250892238447;56;0,1,2;3;9;1;1;1
250892238447;250892238949;502;0,1,2;3;9;1;1;1
250892238949;250892239335;386;0,1,2;3;9;1;1;1
250892239335;250892239387;52;0,1,2;3;9;1;1;1
250892239387;250892240152;765;0,1,2;3;9;1;1;1
250892240152;250892240215;63;0,1,2;3;9;1;1;1
250892240215;250892240458;243;0,1,2;3;9;1;1;1
250892240458;250892240573;115;0,1,2;3;9;1;1;1
250892240573;250892241029;456;0,1,2;3;9;1;1;1
250892241029;250892241169;140;0,1,2;3;9;1;1;1
250892241169;250892241294;125;0,1,2;3;9;1;1;1
250892241294;250892241506;212;0,1,2;3;9;1;1;1
250892241506;250892241773;267;0,1,2;3;9;1;1;1
250892241773;250892241809;36;0,1,2;3;9;1;1;1
250892241809;250892242167;358;0,1,2;3;9;1;1;1
250892242167;250892242568;401;0,1,2;3;9;1;1;1
250892242568;250892242613;45;0,1,2;3;9;1;1;1
250892242613;250892242933;320;0,1,2;3;9;1;1;1
250892242933;250892243528;595;0,1,2;3;9;1;1;1
250892243528;250892243560;32;0,1,2;3;9;1;1;1
250892243560;250892243724;164;0,1,2;3;9;1;1;1
250892243724;250892244409;685;0,1,2;3;9;1;1;1
250892244409;250892244581;172;0,1,2;3;9;1;1;1
250892244581;250892244911;330;0,1,2;3;9;1;1;1
250892244911;250892244984;73;0,1,2;3;9;1;1;1
250892244984;250892245146;162;0,1,2;3;9;1;1;1
250892245146;250892245345;199;0,1,2;3;9;1;1;1
250892245345;250892246085;740;0,1,2;3;9;1;1;1
250892246085;250892246219;134;0,1,2;3;9;1;1;1
250892246219;250892246326;107;0,1,2;3;9;1;1;1
250892246326;250892246639;313;0,1,2;3;9;1;1;1
250892246639;250892247301;662;0,1,2;3;9;1;1;1
250892247301;250892247455;154;0,1,2;3;9;1;1;1
250892247455;250892248351;896;0,1,2;3;9;1;1;1
250892248351;250892248391;40;0,1,2;3;9;1;1;1
250892248391;250892248989;598;0,1,2;3;9;1;1;1
250892248989;250892249342;353;0,1,2;3;9;1;1;1
250892249342;250892251909;2567;0,1,2;3;9;1;1;1
250892251909;250892252364;455;0,1,2;3;9;1;1;1
250892252364;250892252792;428;0,1,2;3;9;1;1;1
250892252792;250892254150;1358;0,1,2;3;9;1;1;1
250892254150;250892254954;804;0,1,2;3;9;1;1;1
250892254954;250892255004;50;0,1,2;3;9;1;1;1
250892255004;250892255011;7;0,1,2;3;9;1;1;1
250892255011;250892255053;42;0,1,2;3;9;1;1;1
250892255053;250892255238;185;0,1,2;3;9;1;1;1
250892255238;250892255662;424;0,1,2;3;9;1;1;1
250892255662;250892258381;2719;0,1,2;3;9;1;1;1
250892258381;250892258422;41;0,1,2;3;9;1;1;1
250892258422;250892259562;1140;0,1,2;3;9;1;1;1
250892259562;250892259839;277;0,1,2;3;9;1;1;1
250892259839;250892260162;323;0,1,2;3;9;1;1;1
250892260162;250892260331;169;0,1,2;3;9;1;1;1
250892260331;250892261209;878;0,1,2;3;9;1;1;1
250892261209;250892263359;2150;0,1,2;3;9;1;1;1
250892263359;250892263432;73;0,1,2;3;9;1;1;1
250892263432;250892266904;3472;0,1,2;3;9;1;1;1
250892266904;250892266999;95;0,1,2;3;9;1;1;1
250892266999;250892267006;7;0,1,2;3;9;1;1;1
250892267006;250892268204;1198;0,1,2;3;9;1;1;1
250892268204;250892268557;353;0,1,2;3;9;1;1;1
250892268557;250892268910;353;0,1,2;3;9;1;1;1
250892268910;250892269101;191;0,1,2;3;9;1;1;1
250892269101;250892269203;102;0,1,2;3;9;1;1;1
250892269203;250892269558;355;0,1,2;3;9;1;1;1
250892269558;250892269716;158;0,1,2;3;9;1;1;1
250892269716;250892270309;593;0,1,2;3;9;1;1;1
250892270309;250892270468;159;0,1,2;3;9;1;1;1
250892270468;250892270793;325;0,1,2;3;9;1;1;1
250892270793;250892270860;67;0,1,2;3;9;1;1;1
250892270860;250892270951;91;0,1,2;3;9;1;1;1
250892270951;250892271737;786;0,1,2;3;9;1;1;1
250892271737;250892271771;34;0,1,2;3;9;1;1;1
250892271771;250892272520;749;0,1,2;3;9;1;1;1
250892272520;250892273693;1173;0,1,2;3;9;1;1;1
250892273693;250892274247;554;0,1,2;3;9;1;1;1
250892274247;250892274301;54;0,1,2;3;9;1;1;1
250892274301;250892274509;208;0,1,2;3;9;1;1;1
250892274509;250892275004;495;0,1,2;3;9;1;1;1
250892275004;250892275070;66;0,1,2;3;9;1;1;1
250892275070;250892277733;2663;0,1,2;3;9;1;1;1
250892277733;250892278140;407;0,1,2;3;9;1;1;1
250892278140;250892278203;63;0,1,2;3;9;1;1;1
250892278203;250892278378;175;0,1,2;3;9;1;1;1
250892278378;250892279519;1141;0,1,2;3;9;1;1;1
250892279519;250892279698;179;0,1,2;3;9;1;1;1
250892279698;250892279805;107;0,1,2;3;9;1;1;1
250892279805;250892279882;77;0,1,2;3;9;1;1;1
250892279882;250892280216;334;0,1,2;3;9;1;1;1
250892280216;250892280351;135;0,1,2;3;9;1;1;1
250892280351;250892280583;232;0,1,2;3;9;1;1;1
250892280583;250892280895;312;0,1,2;3;9;1;1;1
250892280895;250892281353;458;0,1,2;3;9;1;1;1
250892281353;250892281666;313;0,1,2;3;9;1;1;1
250892281666;250892282099;433;0,1,2;3;9;1;1;1
250892282099;250892283001;902;0,1,2;3;9;1;1;1
250892283001;250892283025;24;0,1,2;3;9;1;1;1
250892283025;250892283244;219;0,1,2;3;9;1;1;1
250892283244;250892283951;707;0,1,2;3;9;1;1;1
250892283951;250892284311;360;0,1,2;3;9;1;1;1
250892284311;250892284490;179;0,1,2;3;9;1;1;1
250892284490;250892284587;97;0,1,2;3;9;1;1;1
250892284587;250892284717;130;0,1,2;3;9;1;1;1
250892284717;250892285246;529;0,1,2;3;9;1;1;1
250892285246;250892286066;820;0,1,2;3;9;1;1;1
250892286066;250892286370;304;0,1,2;3;9;1;1;1
250892286370;250892286476;106;0,1,2;3;9;1;1;1
250892286476;250892286690;214;0,1,2;3;9;1;1;1
250892286690;250892286895;205;0,1,2;3;9;1;1;1
250892286895;250892287398;503;0,1,2;3;9;1;1;1
250892287398;250892287950;552;0,1,2;3;9;1;1;1
250892287950;250892288084;134;0,1,2;3;9;1;1;1
250892288084;250892288139;55;0,1,2;3;9;1;1;1
250892288139;250892288320;181;0,1,2;3;9;1;1;1
250892288320;250892288664;344;0,1,2;3;9;1;1;1
250892288664;250892288769;105;0,1,2;3;9;1;1;1
250892288769;250892288851;82;0,1,2;3;9;1;1;1
250892288851;250892289110;259;0,1,2;3;9;1;1;1
250892289110;250892289197;87;0,1,2;3;9;1;1;1
250892289197;250892290701;1504;0,1,2;3;9;1;1;1
250892290701;250892291016;315;0,1,2;3;9;1;1;1
250892291016;250892291061;45;0,1,2;3;9;1;1;1
250892291061;250892291278;217;0,1,2;3;9;1;1;1
250892291278;250892291767;489;0,1,2;3;9;1;1;1
250892291767;250892293376;1609;0,1,2;3;9;1;1;1
250892293376;250892293401;25;0,1,2;3;9;1;1;1
250892293401;250892293919;518;0,1,2;3;9;1;1;1
250892293919;250892294174;255;0,1,2;3;9;1;1;1
250892294174;250892294948;774;0,1,2;3;9;1;1;1
250892294948;250892295077;129;0,1,2;3;9;1;1;1
250892295077;250892295138;61;0,1,2;3;9;1;1;1
250892295138;250892296196;1058;0,1,2;3;9;1;1;1
250892296196;250892296363;167;0,1,2;3;9;1;1;1
250892296363;250892296819;456;0,1,2;3;9;1;1;1
250892296819;250892296950;131;0,1,2;3;9;1;1;1
250892296950;250892297239;289;0,1,2;3;9;1;1;1
250892297239;250892299090;1851;0,1,2;3;9;1;1;1
250892299090;250892299262;172;0,1,2;3;9;1;1;1
250892299262;250892299313;51;0,1,2;3;9;1;1;1
250892299313;250892299385;72;0,1,2;3;9;1;1;1
250892299385;250892300924;1539;0,1,2;3;9;1;1;1
250892300924;250892301024;100;0,1,2;3;9;1;1;1
250892301024;250892302010;986;0,1,2;3;9;1;1;1
250892302010;250892303509;1499;0,1,2;3;9;1;1;1
250892303509;250892303620;111;0,1,2;3;9;1;1;1
250892303620;250892304896;1276;0,1,2;3;9;1;1;1
250892304896;250892306219;1323;0,1,2;3;9;1;1;1
250892306219;250892306783;564;0,1,2;3;9;1;1;1
250892306783;250892309003;2220;0,1,2;3;9;1;1;1
250892309003;250892309435;432;0,1,2;3;9;1;1;1
250892309435;250892309597;162;0,1,2;3;9;1;1;1
250892309597;250892309801;204;0,1,2;3;9;1;1;1
250892309801;250892310084;283;0,1,2;3;9;1;1;1
250892310084;250892310176;92;0,1,2;3;9;1;1;1
250892310176;250892310539;363;0,1,2;3;9;1;1;1
250892310539;250892311353;814;0,1,2;3;9;1;1;1
250892311353;250892311375;22;0,1,2;3;9;1;1;1
250892311375;250892312388;1013;0,1,2;3;9;1;1;1
250892312388;250892313093;705;0,1,2;3;9;1;1;1
250892313093;250892315491;2398;0,1,2;3;9;1;1;1
250892315491;250892315678;187;0,1,2;3;9;1;1;1
250892315678;250892316801;1123;0,1,2;3;9;1;1;1
250892316801;250892317127;326;0,1,2;3;9;1;1;1
250892317127;250892318232;1105;0,1,2;3;9;1;1;1
250892318232;250892319203;971;0,1,2;3;9;1;1;1
250892319203;250892319471;268;0,1,2;3;9;1;1;1
250892319471;250892320910;1439;0,1,2;3;9;1;1;1
250892320910;250892322150;1240;0,1,2;3;9;1;1;1
250892322150;250892322285;135;0,1,2;3;9;1;1;1
250892322285;250892322557;272;0,1,2;3;9;1;1;1
250892322557;250892322658;101;0,1,2;3;9;1;1;1
250892322658;250892323615;957;0,1,2;3;9;1;1;1
250892323615;250892324450;835;0,1,2;3;9;1;1;1
250892324450;250892324847;397;0,1,2;3;9;1;1;1
250892324847;250892325395;548;0,1,2;3;9;1;1;1
250892325395;250892325543;148;0,1,2;3;9;1;1;1
250892325543;250892327231;1688;0,1,2;3;9;1;1;1
250892327231;250892329223;1992;0,1,2;3;9;1;1;1
250892329223;250892331752;2529;0,1,2;3;9;1;1;1
250892331752;250892331948;196;0,1,2;3;9;1;1;1
250892331948;250892333420;1472;0,1,2;3;9;1;1;1
250892333420;250892335995;2575;0,1,2;3;9;1;1;1
250892335995;250892337018;1023;0,1,2;3;9;1;1;1
250892337018;250892338043;1025;0,1,2;3;9;1;1;1
250892338043;250892338833;790;0,1,2;3;9;1;1;1
250892338833;250892338860;27;0,1,2;3;9;1;1;1
250892338860;250892339088;228;0,1,2;3;9;1;1;1
250892339088;250892339530;442;0,1,2;3;9;1;1;1
250892339530;250892339941;411;0,1,2;3;9;1;1;1
250892339941;250892340112;171;0,1,2;3;9;1;1;1
250892340112;250892340472;360;0,1,2;3;9;1;1;1
250892340472;250892340645;173;0,1,2;3;9;1;1;1
250892340645;250892341397;752;0,1,2;3;9;1;1;1
250892341397;250892342273;876;0,1,2;3;9;1;1;1
250892342273;250892342576;303;0,1,2;3;9;1;1;1
250892342576;250892343299;723;0,1,2;3;9;1;1;1
250892343299;250892343690;391;0,1,2;3;9;1;1;1
250892343690;250892344827;1137;0,1,2;3;9;1;1;1
250892344827;250892345160;333;0,1,2;3;9;1;1;1
250892345160;250892345567;407;0,1,2;3;9;1;1;1
250892345567;250892345916;349;0,1,2;3;9;1;1;1
250892345916;250892345960;44;0,1,2;3;9;1;1;1
250892345960;250892346024;64;0,1,2;3;9;1;1;1
250892346024;250892346555;531;0,1,2;3;9;1;1;1
250892346555;250892346598;43;0,1,2;3;9;1;1;1
250892346598;250892346693;95;0,1,2;3;9;1;1;1
250892346693;250892346926;233;0,1,2;3;9;1;1;1
250892346926;250892348043;1117;0,1,2;3;9;1;1;1
250892348043;250892349400;1357;0,1,2;3;9;1;1;1
250892349400;250892349446;46;0,1,2;3;9;1;1;1
250892349446;250892349571;125;0,1,2;3;9;1;1;1
250892349571;250892349870;299;0,1,2;3;9;1;1;1
250892349870;250892350243;373;0,1,2;3;9;1;1;1
250892350243;250892350485;242;0,1,2;3;9;1;1;1
250892350485;250892350684;199;0,1,2;3;9;1;1;1
250892350684;250892350964;280;0,1,2;3;9;1;1;1
250892350964;250892351762;798;0,1,2;3;9;1;1;1
250892351762;250892351902;140;0,1,2;3;9;1;1;1
250892351902;250892351932;30;0,1,2;3;9;1;1;1
250892351932;250892353031;1099;0,1,2;3;9;1;1;1
250892353031;250892356251;3220;0,1,2;3;9;1;1;1
250892356251;250892356780;529;0,1,2;3;9;1;1;1
250892356780;250892357501;721;0,1,2;3;9;1;1;1
250892357501;250892357639;138;0,1,2;3;9;1;1;1
250892357639;250892357742;103;0,1,2;3;9;1;1;1
250892357742;250892357871;129;0,1,2;3;9;1;1;1
250892357871;250892358233;362;0,1,2;3;9;1;1;1
250892358233;250892358346;113;0,1,2;3;9;1;1;1
250892358346;250892358627;281;0,1,2;3;9;1;1;1
250892358627;250892359858;1231;0,1,2;3;9;1;1;1
250892359858;250892360138;280;0,1,2;3;9;1;1;1
250892360138;250892361758;1620;0,1,2;3;9;1;1;1
250892361758;250892362400;642;0,1,2;3;9;1;1;1
250892362400;250892363983;1583;0,1,2;3;9;1;1;1
250892363983;250892363987;4;0,1,2;3;9;1;1;1
250892363987;250892364055;68;0,1,2;3;9;1;1;1
250892364055;250892364060;5;0,1,2;3;9;1;1;1
250892364060;250892364373;313;0,1,2;3;9;1;1;1
250892364373;250892364514;141;0,1,2;3;9;1;1;1
250892364514;250892364551;37;0,1,2;3;9;1;1;1
250892364551;250892364555;4;0,1,2;3;9;1;1;1
250892364555;250892364678;123;0,1,2;3;9;1;1;1
250892364678;250892365458;780;0,1,2;3;9;1;1;1
250892365458;250892366422;964;0,1,2;3;9;1;1;1
250892366422;250892366749;327;0,1,2;3;9;1;1;1
250892366749;250892366995;246;0,1,2;3;9;1;1;1
250892366995;250892367057;62;0,1,2;3;9;1;1;1
250892367057;250892367246;189;0,1,2;3;9;1;1;1
250892367246;250892367272;26;0,1,2;3;9;1;1;1
250892367272;250892367455;183;0,1,2;3;9;1;1;1
250892367455;250892367670;215;0,1,2;3;9;1;1;1
250892367670;250892368012;342;0,1,2;3;9;1;1;1
250892368012;250892368048;36;0,1,2;3;9;1;1;1
250892368048;250892369092;1044;0,1,2;3;9;1;1;1
250892369092;250892369343;251;0,1,2;3;9;1;1;1
250892369343;250892369448;105;0,1,2;3;9;1;1;1
250892369448;250892369692;244;0,1,2;3;9;1;1;1
250892369692;250892370198;506;0,1,2;3;9;1;1;1
250892370198;250892370726;528;0,1,2;3;9;1;1;1
250892370726;250892370754;28;0,1,2;3;9;1;1;1
250892370754;250892371150;396;0,1,2;3;9;1;1;1
250892371150;250892371623;473;0,1,2;3;9;1;1;1
250892371623;250892371822;199;0,1,2;3;9;1;1;1
250892371822;250892371929;107;0,1,2;3;9;1;1;1
250892371929;250892372503;574;0,1,2;3;9;1;1;1
250892372503;250892372590;87;0,1,2;3;9;1;1;1
250892372590;250892374019;1429;0,1,2;3;9;1;1;1
250892374019;250892374078;59;0,1,2;3;9;1;1;1
250892374078;250892375648;1570;0,1,2;3;9;1;1;1
250892375648;250892375709;61;0,1,2;3;9;1;1;1
250892375709;250892375923;214;0,1,2;3;9;1;1;1
250892375923;250892376069;146;0,1,2;3;9;1;1;1
250892376069;250892376395;326;0,1,2;3;9;1;1;1
250892376395;250892377234;839;0,1,2;3;9;1;1;1
250892377234;250892377277;43;0,1,2;3;9;1;1;1
250892377277;250892377434;157;0,1,2;3;9;1;1;1
250892377434;250892377693;259;0,1,2;3;9;1;1;1
250892377693;250892377720;27;0,1,2;3;9;1;1;1
250892377720;250892377935;215;0,1,2;3;9;1;1;1
250892377935;250892378128;193;0,1,2;3;9;1;1;1
250892378128;250892378181;53;0,1,2;3;9;1;1;1
250892378181;250892378201;20;0,1,2;3;9;1;1;1
250892378201;250892378732;531;0,1,2;3;9;1;1;1
250892378732;250892380654;1922;0,1,2;3;9;1;1;1
250892380654;250892380672;18;0,1,2;3;9;1;1;1
250892380672;250892380826;154;0,1,2;3;9;1;1;1
250892380826;250892380879;53;0,1,2;3;9;1;1;1
250892380879;250892380987;108;0,1,2;3;9;1;1;1
250892380987;250892381149;162;0,1,2;3;9;1;1;1
250892381149;250892381820;671;0,1,2;3;9;1;1;1
250892381820;250892381957;137;0,1,2;3;9;1;1;1
250892381957;250892382138;181;0,1,2;3;9;1;1;1
250892382138;250892382721;583;0,1,2;3;9;1;1;1
250892382721;250892383037;316;0,1,2;3;9;1;1;1
250892383037;250892383302;265;0,1,2;3;9;1;1;1
250892383302;250892383368;66;0,1,2;3;9;1;1;1
250892383368;250892383756;388;0,1,2;3;9;1;1;1
250892383756;250892384228;472;0,1,2;3;9;1;1;1
250892384228;250892384273;45;0,1,2;3;9;1;1;1
250892384273;250892384424;151;0,1,2;3;9;1;1;1
250892384424;250892384571;147;0,1,2;3;9;1;1;1
250892384571;250892384735;164;0,1,2;3;9;1;1;1
250892384735;250892384856;121;0,1,2;3;9;1;1;1
250892384856;250892384908;52;0,1,2;3;9;1;1;1
250892384908;250892385476;568;0,1,2;3;9;1;1;1
250892385476;250892385976;500;0,1,2;3;9;1;1;1
250892385976;250892386202;226;0,1,2;3;9;1;1;1
250892386202;250892387137;935;0,1,2;3;9;1;1;1
250892387137;250892388279;1142;0,1,2;3;9;1;1;1
250892388279;250892388608;329;0,1,2;3;9;1;1;1
250892388608;250892389064;456;0,1,2;3;9;1;1;1
250892389064;250892389710;646;0,1,2;3;9;1;1;1
250892389710;250892389997;287;0,1,2;3;9;1;1;1
250892389997;250892391687;1690;0,1,2;3;9;1;1;1
250892391687;250892392176;489;0,1,2;3;9;1;1;1
250892392176;250892392337;161;0,1,2;3;9;1;1;1
250892392337;250892392432;95;0,1,2;3;9;1;1;1
250892392432;250892392782;350;0,1,2;3;9;1;1;1
250892392782;250892393281;499;0,1,2;3;9;1;1;1
250892393281;250892393803;522;0,1,2;3;9;1;1;1
250892393803;250892394044;241;0,1,2;3;9;1;1;1
250892394044;250892394242;198;0,1,2;3;9;1;1;1
250892394242;250892394252;10;0,1,2;3;9;1;1;1
250892394252;250892394412;160;0,1,2;3;9;1;1;1
250892394412;250892394580;168;0,1,2;3;9;1;1;1
250892394580;250892395470;890;0,1,2;3;9;1;1;1
250892395470;250892396766;1296;0,1,2;3;9;1;1;1
250892396766;250892396833;67;0,1,2;3;9;1;1;1
250892396833;250892397008;175;0,1,2;3;9;1;1;1
250892397008;250892397422;414;0,1,2;3;9;1;1;1
250892397422;250892399525;2103;0,1,2;3;9;1;1;1
250892399525;250892399688;163;0,1,2;3;9;1;1;1
250892399688;250892399899;211;0,1,2;3;9;1;1;1
250892399899;250892399954;55;0,1,2;3;9;1;1;1
250892399954;250892400681;727;0,1,2;3;9;1;1;1
250892400681;250892401106;425;0,1,2;3;9;1;1;1
250892401106;250892403637;2531;0,1,2;3;9;1;1;1
250892403637;250892404397;760;0,1,2;3;9;1;1;1
250892404397;250892404649;252;0,1,2;3;9;1;1;1
250892404649;250892404918;269;0,1,2;3;9;1;1;1
250892404918;250892405767;849;0,1,2;3;9;1;1;1
250892405767;250892407447;1680;0,1,2;3;9;1;1;1
250892407447;250892407685;238;0,1,2;3;9;1;1;1
250892407685;250892407865;180;0,1,2;3;9;1;1;1
250892407865;250892408751;886;0,1,2;3;9;1;1;1
250892408751;250892409628;877;0,1,2;3;9;1;1;1
250892409628;250892409647;19;0,1,2;3;9;1;1;1
250892409647;250892410601;954;0,1,2;3;9;1;1;1
250892410601;250892411165;564;0,1,2;3;9;1;1;1
250892411165;250892411292;127;0,1,2;3;9;1;1;1
250892411292;250892411591;299;0,1,2;3;9;1;1;1
250892411591;250892411797;206;0,1,2;3;9;1;1;1
250892411797;250892412176;379;0,1,2;3;9;1;1;1
250892412176;250892412573;397;0,1,2;3;9;1;1;1
250892412573;250892412858;285;0,1,2;3;9;1;1;1
250892412858;250892414866;2008;0,1,2;3;9;1;1;1
250892414866;250892415759;893;0,1,2;3;9;1;1;1
250892415759;250892415892;133;0,1,2;3;9;1;1;1
250892415892;250892416051;159;0,1,2;3;9;1;1;1
250892416051;250892416378;327;0,1,2;3;9;1;1;1
250892416378;250892417385;1007;0,1,2;3;9;1;1;1
250892417385;250892417598;213;0,1,2;3;9;1;1;1
250892417598;250892418459;861;0,1,2;3;9;1;1;1
250892418459;250892419624;1165;0,1,2;3;9;1;1;1
250892419624;250892420283;659;0,1,2;3;9;1;1;1
250892420283;250892420340;57;0,1,2;3;9;1;1;1
250892420340;250892420394;54;0,1,2;3;9;1;1;1
250892420394;250892420963;569;0,1,2;3;9;1;1;1
250892420963;250892421221;258;0,1,2;3;9;1;1;1
250892421221;250892421961;740;0,1,2;3;9;1;1;1
250892421961;250892422562;601;0,1,2;3;9;1;1;1
250892422562;250892423365;803;0,1,2;3;9;1;1;1
250892423365;250892424252;887;0,1,2;3;9;1;1;1
250892424252;250892424488;236;0,1,2;3;9;1;1;1
250892424488;250892425253;765;0,1,2;3;9;1;1;1
250892425253;250892425485;232;0,1,2;3;9;1;1;1
250892425485;250892425495;10;0,1,2;3;9;1;1;1
250892425495;250892426885;1390;0,1,2;3;9;1;1;1
250892426885;250892426903;18;0,1,2;3;9;1;1;1
250892426903;250892427375;472;0,1,2;3;9;1;1;1
250892427375;250892427415;40;0,1,2;3;9;1;1;1
250892427415;250892427938;523;0,1,2;3;9;1;1;1
250892427938;250892428006;68;0,1,2;3;9;1;1;1
250892428006;250892428157;151;0,1,2;3;9;1;1;1
250892428157;250892428523;366;0,1,2;3;9;1;1;1
250892428523;250892429209;686;0,1,2;3;9;1;1;1
250892429209;250892430475;1266;0,1,2;3;9;1;1;1
250892430475;250892430593;118;0,1,2;3;9;1;1;1
250892430593;250892431340;747;0,1,2;3;9;1;1;1
250892431340;250892431582;242;0,1,2;3;9;1;1;1
250892431582;250892432327;745;0,1,2;3;9;1;1;1
250892432327;250892432485;158;0,1,2;3;9;1;1;1
250892432485;250892432764;279;0,1,2;3;9;1;1;1
250892432764;250892432992;228;0,1,2;3;9;1;1;1
250892432992;250892433006;14;0,1,2;3;9;1;1;1
250892433006;250892433185;179;0,1,2;3;9;1;1;1
250892433185;250892433362;177;0,1,2;3;9;1;1;1
250892433362;250892433666;304;0,1,2;3;9;1;1;1
250892433666;250892434064;398;0,1,2;3;9;1;1;1
250892434064;250892434417;353;0,1,2;3;9;1;1;1
250892434417;250892434466;49;0,1,2;3;9;1;1;1
250892434466;250892434480;14;0,1,2;3;9;1;1;1
250892434480;250892434642;162;0,1,2;3;9;1;1;1
250892434642;250892435737;1095;0,1,2;3;9;1;1;1
250892435737;250892435795;58;0,1,2;3;9;1;1;1
250892435795;250892435798;3;0,1,2;3;9;1;1;1
250892435798;250892436109;311;0,1,2;3;9;1;1;1
250892436109;250892436698;589;0,1,2;3;9;1;1;1
250892436698;250892436804;106;0,1,2;3;9;1;1;1
250892436804;250892437280;476;0,1,2;3;9;1;1;1
250892437280;250892437942;662;0,1,2;3;9;1;1;1
250892437942;250892438004;62;0,1,2;3;9;1;1;1
250892438004;250892438411;407;0,1,2;3;9;1;1;1
250892438411;250892438854;443;0,1,2;3;9;1;1;1
250892438854;250892438866;12;0,1,2;3;9;1;1;1
250892438866;250892440467;1601;0,1,2;3;9;1;1;1
250892440467;250892440725;258;0,1,2;3;9;1;1;1
250892440725;250892441566;841;0,1,2;3;9;1;1;1
250892441566;250892441568;2;0,1,2;3;9;1;1;1
250892441568;250892441594;26;0,1,2;3;9;1;1;1
250892441594;250892441645;51;0,1,2;3;9;1;1;1
250892441645;250892441695;50;0,1,2;3;9;1;1;1
250892441695;250892441715;20;0,1,2;3;9;1;1;1
250892441715;250892441921;206;0,1,2;3;9;1;1;1
250892441921;250892441932;11;0,1,2;3;9;1;1;1
250892441932;250892442148;216;0,1,2;3;9;1;1;1
250892442148;250892442915;767;0,1,2;3;9;1;1;1
250892442915;250892443379;464;0,1,2;3;9;1;1;1
250892443379;250892443521;142;0,1,2;3;9;1;1;1
250892443521;250892443793;272;0,1,2;3;9;1;1;1
250892443793;250892444328;535;0,1,2;3;9;1;1;1
250892444328;250892445253;925;0,1,2;3;9;1;1;1
250892445253;250892445530;277;0,1,2;3;9;1;1;1
250892445530;250892446687;1157;0,1,2;3;9;1;1;1
250892446687;250892447275;588;0,1,2;3;9;1;1;1
250892447275;250892447311;36;0,1,2;3;9;1;1;1
250892447311;250892447596;285;0,1,2;3;9;1;1;1
250892447596;250892447675;79;0,1,2;3;9;1;1;1
250892447675;250892448932;1257;0,1,2;3;9;1;1;1
250892448932;250892449144;212;0,1,2;3;9;1;1;1
250892449144;250892449257;113;0,1,2;3;9;1;1;1
250892449257;250892449962;705;0,1,2;3;9;1;1;1
250892449962;250892450564;602;0,1,2;3;9;1;1;1
250892450564;250892450634;70;0,1,2;3;9;1;1;1
250892450634;250892451068;434;0,1,2;3;9;1;1;1
250892451068;250892451627;559;0,1,2;3;9;1;1;1
250892451627;250892452176;549;0,1,2;3;9;1;1;1
250892452176;250892452469;293;0,1,2;3;9;1;1;1
250892452469;250892452528;59;0,1,2;3;9;1;1;1
250892452528;250892452645;117;0,1,2;3;9;1;1;1
250892452645;250892452845;200;0,1,2;3;9;1;1;1
250892452845;250892453113;268;0,1,2;3;9;1;1;1
250892453113;250892453345;232;0,1,2;3;9;1;1;1
250892453345;250892454101;756;0,1,2;3;9;1;1;1
250892454101;250892454985;884;0,1,2;3;9;1;1;1
250892454985;250892455092;107;0,1,2;3;9;1;1;1
250892455092;250892455985;893;0,1,2;3;9;1;1;1
250892455985;250892456143;158;0,1,2;3;9;1;1;1
250892456143;250892456801;658;0,1,2;3;9;1;1;1
250892456801;250892456919;118;0,1,2;3;9;1;1;1
250892456919;250892457074;155;0,1,2;3;9;1;1;1
250892457074;250892457393;319;0,1,2;3;9;1;1;1
250892457393;250892457869;476;0,1,2;3;9;1;1;1
250892457869;250892458113;244;0,1,2;3;9;1;1;1
250892458113;250892458304;191;0,1,2;3;9;1;1;1
250892458304;250892459141;837;0,1,2;3;9;1;1;1
250892459141;250892461490;2349;0,1,2;3;9;1;1;1
250892461490;250892462518;1028;0,1,2;3;9;1;1;1
250892462518;250892462719;201;0,1,2;3;9;1;1;1
250892462719;250892463576;857;0,1,2;3;9;1;1;1
250892463576;250892464047;471;0,1,2;3;9;1;1;1
250892464047;250892464372;325;0,1,2;3;9;1;1;1
250892464372;250892464492;120;0,1,2;3;9;1;1;1
250892464492;250892465051;559;0,1,2;3;9;1;1;1
250892465051;250892465079;28;0,1,2;3;9;1;1;1
250892465079;250892465443;364;0,1,2;3;9;1;1;1
250892465443;250892465664;221;0,1,2;3;9;1;1;1
250892465664;250892466088;424;0,1,2;3;9;1;1;1
250892466088;250892466115;27;0,1,2;3;9;1;1;1
250892466115;250892467359;1244;0,1,2;3;9;1;1;1
250892467359;250892467634;275;0,1,2;3;9;1;1;1
250892467634;250892467952;318;0,1,2;3;9;1;1;1
250892467952;250892468707;755;0,1,2;3;9;1;1;1
250892468707;250892469035;328;0,1,2;3;9;1;1;1
250892469035;250892469272;237;0,1,2;3;9;1;1;1
250892469272;250892469634;362;0,1,2;3;9;1;1;1
250892469634;250892469733;99;0,1,2;3;9;1;1;1
250892469733;250892469993;260;0,1,2;3;9;1;1;1
250892469993;250892470392;399;0,1,2;3;9;1;1;1
250892470392;250892470493;101;0,1,2;3;9;1;1;1
250892470493;250892470692;199;0,1,2;3;9;1;1;1
250892470692;250892471216;524;0,1,2;3;9;1;1;1
250892471216;250892471672;456;0,1,2;3;9;1;1;1
250892471672;250892472196;524;0,1,2;3;9;1;1;1
250892472196;250892472459;263;0,1,2;3;9;1;1;1
250892472459;250892472755;296;0,1,2;3;9;1;1;1
250892472755;250892472805;50;0,1,2;3;9;1;1;1
250892472805;250892473248;443;0,1,2;3;9;1;1;1
250892473248;250892473309;61;0,1,2;3;9;1;1;1
250892473309;250892473809;500;0,1,2;3;9;1;1;1
250892473809;250892474157;348;0,1,2;3;9;1;1;1
250892474157;250892474359;202;0,1,2;3;9;1;1;1
250892474359;250892474955;596;0,1,2;3;9;1;1;1
250892474955;250892475214;259;0,1,2;3;9;1;1;1
250892475214;250892476022;808;0,1,2;3;9;1;1;1
250892476022;250892476072;50;0,1,2;3;9;1;1;1
250892476072;250892476198;126;0,1,2;3;9;1;1;1
250892476198;250892476331;133;0,1,2;3;9;1;1;1
250892476331;250892478035;1704;0,1,2;3;9;1;1;1
250892478035;250892478115;80;0,1,2;3;9;1;1;1
250892478115;250892478183;68;0,1,2;3;9;1;1;1
250892478183;250892478296;113;0,1,2;3;9;1;1;1
250892478296;250892479437;1141;0,1,2;3;9;1;1;1
250892479437;250892479479;42;0,1,2;3;9;1;1;1
250892479479;250892479539;60;0,1,2;3;9;1;1;1
250892479539;250892480014;475;0,1,2;3;9;1;1;1
250892480014;250892480096;82;0,1,2;3;9;1;1;1
250892480096;250892481176;1080;0,1,2;3;9;1;1;1
250892481176;250892481655;479;0,1,2;3;9;1;1;1
250892481655;250892481765;110;0,1,2;3;9;1;1;1
250892481765;250892481826;61;0,1,2;3;9;1;1;1
250892481826;250892481927;101;0,1,2;3;9;1;1;1
250892481927;250892482424;497;0,1,2;3;9;1;1;1
250892482424;250892482904;480;0,1,2;3;9;1;1;1
250892482904;250892483826;922;0,1,2;3;9;1;1;1
250892483826;250892483866;40;0,1,2;3;9;1;1;1
250892483866;250892484370;504;0,1,2;3;9;1;1;1
250892484370;250892484454;84;0,1,2;3;9;1;1;1
250892484454;250892484630;176;0,1,2;3;9;1;1;1
250892484630;250892485416;786;0,1,2;3;9;1;1;1
250892485416;250892486267;851;0,1,2;3;9;1;1;1
250892486267;250892486872;605;0,1,2;3;9;1;1;1
250892486872;250892487357;485;0,1,2;3;9;1;1;1
250892487357;250892487442;85;0,1,2;3;9;1;1;1
250892487442;250892487475;33;0,1,2;3;9;1;1;1
250892487475;250892487495;20;0,1,2;3;9;1;1;1
250892487495;250892488095;600;0,1,2;3;9;1;1;1
250892488095;250892488150;55;0,1,2;3;9;1;1;1
250892488150;250892488162;12;0,1,2;3;9;1;1;1
250892488162;250892488438;276;0,1,2;3;9;1;1;1
250892488438;250892488601;163;0,1,2;3;9;1;1;1
250892488601;250892489272;671;0,1,2;3;9;1;1;1
250892489272;250892489670;398;0,1,2;3;9;1;1;1
250892489670;250892491549;1879;0,1,2;3;9;1;1;1
250892491549;250892492092;543;0,1,2;3;9;1;1;1
250892492092;250892492253;161;0,1,2;3;9;1;1;1
250892492253;250892492269;16;0,1,2;3;9;1;1;1
250892492269;250892493098;829;0,1,2;3;9;1;1;1
250892493098;250892493099;1;0,1,2;3;9;1;1;1
250892493099;250892495216;2117;0,1,2;3;9;1;1;1
250892495216;250892495700;484;0,1,2;3;9;1;1;1
250892495700;250892495962;262;0,1,2;3;9;1;1;1
250892495962;250892496008;46;0,1,2;3;9;1;1;1
250892496008;250892496523;515;0,1,2;3;9;1;1;1
250892496523;250892497806;1283;0,1,2;3;9;1;1;1
250892497806;250892498017;211;0,1,2;3;9;1;1;1
250892498017;250892498352;335;0,1,2;3;9;1;1;1
250892498352;250892499923;1571;0,1,2;3;9;1;1;1
250892499923;250892500188;265;0,1,2;3;9;1;1;1
250892500188;250892500429;241;0,1,2;3;9;1;1;1
250892500429;250892500509;80;0,1,2;3;9;1;1;1
250892500509;250892500555;46;0,1,2;3;9;1;1;1
250892500555;250892500560;5;0,1,2;3;9;1;1;1
250892500560;250892500581;21;0,1,2;3;9;1;1;1
250892500581;250892500608;27;0,1,2;3;9;1;1;1
250892500608;250892500620;12;0,1,2;3;9;1;1;1
250892500620;250892500998;378;0,1,2;3;9;1;1;1
250892500998;250892501063;65;0,1,2;3;9;1;1;1
250892501063;250892501144;81;0,1,2;3;9;1;1;1
250892501144;250892501204;60;0,1,2;3;9;1;1;1
250892501204;250892501633;429;0,1,2;3;9;1;1;1
250892501633;250892502201;568;0,1,2;3;9;1;1;1
250892502201;250892502254;53;0,1,2;3;9;1;1;1
250892502254;250892502658;404;0,1,2;3;9;1;1;1
250892502658;250892502678;20;0,1,2;3;9;1;1;1
250892502678;250892504365;1687;0,1,2;3;9;1;1;1
250892504365;250892504728;363;0,1,2;3;9;1;1;1
250892504728;250892504763;35;0,1,2;3;9;1;1;1
250892504763;250892504934;171;0,1,2;3;9;1;1;1
250892504934;250892505294;360;0,1,2;3;9;1;1;1
250892505294;250892505942;648;0,1,2;3;9;1;1;1
250892505942;250892506320;378;0,1,2;3;9;1;1;1
250892506320;250892507777;1457;0,1,2;3;9;1;1;1
250892507777;250892507962;185;0,1,2;3;9;1;1;1
250892507962;250892508047;85;0,1,2;3;9;1;1;1
250892508047;250892508193;146;0,1,2;3;9;1;1;1
250892508193;250892508421;228;0,1,2;3;9;1;1;1
250892508421;250892508500;79;0,1,2;3;9;1;1;1
250892508500;250892508779;279;0,1,2;3;9;1;1;1
250892508779;250892508786;7;0,1,2;3;9;1;1;1
250892508786;250892512559;3773;0,1,2;3;9;1;1;1
250892512559;250892512663;104;0,1,2;3;9;1;1;1
250892512663;250892512938;275;0,1,2;3;9;1;1;1
250892512938;250892513827;889;0,1,2;3;9;1;1;1
250892513827;250892514006;179;0,1,2;3;9;1;1;1
250892514006;250892514729;723;0,1,2;3;9;1;1;1
250892514729;250892514811;82;0,1,2;3;9;1;1;1
250892514811;250892514877;66;0,1,2;3;9;1;1;1
250892514877;250892515548;671;0,1,2;3;9;1;1;1
250892515548;250892517886;2338;0,1,2;3;9;1;1;1
250892517886;250892518015;129;0,1,2;3;9;1;1;1
250892518015;250892518075;60;0,1,2;3;9;1;1;1
250892518075;250892518095;20;0,1,2;3;9;1;1;1
250892518095;250892518274;179;0,1,2;3;9;1;1;1
250892518274;250892518658;384;0,1,2;3;9;1;1;1
250892518658;250892518711;53;0,1,2;3;9;1;1;1
250892518711;250892518814;103;0,1,2;3;9;1;1;1
250892518814;250892518844;30;0,1,2;3;9;1;1;1
250892518844;250892519386;542;0,1,2;3;9;1;1;1
250892519386;250892520711;1325;0,1,2;3;9;1;1;1
250892520711;250892520773;62;0,1,2;3;9;1;1;1
250892520773;250892520787;14;0,1,2;3;9;1;1;1
250892520787;250892520816;29;0,1,2;3;9;1;1;1
250892520816;250892520924;108;0,1,2;3;9;1;1;1
250892520924;250892520978;54;0,1,2;3;9;1;1;1
250892520978;250892520989;11;0,1,2;3;9;1;1;1
250892520989;250892521072;83;0,1,2;3;9;1;1;1
250892521072;250892521094;22;0,1,2;3;9;1;1;1
250892521094;250892521131;37;0,1,2;3;9;1;1;1
250892521131;250892521179;48;0,1,2;3;9;1;1;1
250892521179;250892522364;1185;0,1,2;3;9;1;1;1
250892522364;250892522500;136;0,1,2;3;9;1;1;1
250892522500;250892522679;179;0,1,2;3;9;1;1;1
250892522679;250892524174;1495;0,1,2;3;9;1;1;1
250892524174;250892524295;121;0,1,2;3;9;1;1;1
250892524295;250892526174;1879;0,1,2;3;9;1;1;1
250892526174;250892526648;474;0,1,2;3;9;1;1;1
250892526648;250892527464;816;0,1,2;3;9;1;1;1
250892527464;250892527595;131;0,1,2;3;9;1;1;1
250892527595;250892528243;648;0,1,2;3;9;1;1;1
250892528243;250892529132;889;0,1,2;3;9;1;1;1
250892529132;250892529201;69;0,1,2;3;9;1;1;1
250892529201;250892529406;205;0,1,2;3;9;1;1;1
250892529406;250892529569;163;0,1,2;3;9;1;1;1
250892529569;250892529726;157;0,1,2;3;9;1;1;1
250892529726;250892529915;189;0,1,2;3;9;1;1;1
250892529915;250892529961;46;0,1,2;3;9;1;1;1
250892529961;250892530029;68;0,1,2;3;9;1;1;1
250892530029;250892530952;923;0,1,2;3;9;1;1;1
250892530952;250892531004;52;0,1,2;3;9;1;1;1
250892531004;250892531069;65;0,1,2;3;9;1;1;1
250892531069;250892531082;13;0,1,2;3;9;1;1;1
250892531082;250892531288;206;0,1,2;3;9;1;1;1
250892531288;250892531300;12;0,1,2;3;9;1;1;1
250892531300;250892533121;1821;0,1,2;3;9;1;1;1
250892533121;250892534624;1503;0,1,2;3;9;1;1;1
250892534624;250892535643;1019;0,1,2;3;9;1;1;1
250892535643;250892536530;887;0,1,2;3;9;1;1;1
250892536530;250892536876;346;0,1,2;3;9;1;1;1
250892536876;250892536890;14;0,1,2;3;9;1;1;1
250892536890;250892538475;1585;0,1,2;3;9;1;1;1
250892538475;250892538512;37;0,1,2;3;9;1;1;1
250892538512;250892539179;667;0,1,2;3;9;1;1;1
250892539179;250892539413;234;0,1,2;3;9;1;1;1
250892539413;250892540477;1064;0,1,2;3;9;1;1;1
250892540477;250892540508;31;0,1,2;3;9;1;1;1
250892540508;250892540517;9;0,1,2;3;9;1;1;1
250892540517;250892540608;91;0,1,2;3;9;1;1;1
250892540608;250892540773;165;0,1,2;3;9;1;1;1
250892540773;250892540837;64;0,1,2;3;9;1;1;1
250892540837;250892540995;158;0,1,2;3;9;1;1;1
250892540995;250892541137;142;0,1,2;3;9;1;1;1
250892541137;250892541285;148;0,1,2;3;9;1;1;1
250892541285;250892541307;22;0,1,2;3;9;1;1;1
250892541307;250892541964;657;0,1,2;3;9;1;1;1
250892541964;250892541973;9;0,1,2;3;9;1;1;1
250892541973;250892541993;20;0,1,2;3;9;1;1;1
250892541993;250892542173;180;0,1,2;3;9;1;1;1
250892542173;250892542270;97;0,1,2;3;9;1;1;1
250892542270;250892542313;43;0,1,2;3;9;1;1;1
250892542313;250892542381;68;0,1,2;3;9;1;1;1
250892542381;250892542385;4;0,1,2;3;9;1;1;1
250892542385;250892542796;411;0,1,2;3;9;1;1;1
250892542796;250892543007;211;0,1,2;3;9;1;1;1
250892543007;250892543046;39;0,1,2;3;9;1;1;1
250892543046;250892543116;70;0,1,2;3;9;1;1;1
250892543116;250892543442;326;0,1,2;3;9;1;1;1
250892543442;250892544238;796;0,1,2;3;9;1;1;1
250892544238;250892544656;418;0,1,2;3;9;1;1;1
250892544656;250892544669;13;0,1,2;3;9;1;1;1
250892544669;250892545067;398;0,1,2;3;9;1;1;1
250892545067;250892545755;688;0,1,2;3;9;1;1;1
250892545755;250892546404;649;0,1,2;3;9;1;1;1
250892546404;250892547247;843;0,1,2;3;9;1;1;1
250892547247;250892547364;117;0,1,2;3;9;1;1;1
250892547364;250892547377;13;0,1,2;3;9;1;1;1
250892547377;250892547387;10;0,1,2;3;9;1;1;1
250892547387;250892547406;19;0,1,2;3;9;1;1;1
250892547406;250892547436;30;0,1,2;3;9;1;1;1
250892547436;250892547449;13;0,1,2;3;9;1;1;1
250892547449;250892548037;588;0,1,2;3;9;1;1;1
250892548037;250892548310;273;0,1,2;3;9;1;1;1
250892548310;250892548832;522;0,1,2;3;9;1;1;1
250892548832;250892549199;367;0,1,2;3;9;1;1;1
250892549199;250892549347;148;0,1,2;3;9;1;1;1
250892549347;250892549379;32;0,1,2;3;9;1;1;1
250892549379;250892549567;188;0,1,2;3;9;1;1;1
250892549567;250892549644;77;0,1,2;3;9;1;1;1
250892549644;250892549663;19;0,1,2;3;9;1;1;1
250892549663;250892549803;140;0,1,2;3;9;1;1;1
250892549803;250892549967;164;0,1,2;3;9;1;1;1
250892549967;250892550051;84;0,1,2;3;9;1;1;1
250892550051;250892550249;198;0,1,2;3;9;1;1;1
250892550249;250892550554;305;0,1,2;3;9;1;1;1
250892550554;250892551140;586;0,1,2;3;9;1;1;1
250892551140;250892551364;224;0,1,2;3;9;1;1;1
250892551364;250892551424;60;0,1,2;3;9;1;1;1
250892551424;250892551932;508;0,1,2;3;9;1;1;1
250892551932;250892551961;29;0,1,2;3;9;1;1;1
250892551961;250892551997;36;0,1,2;3;9;1;1;1
250892551997;250892552323;326;0,1,2;3;9;1;1;1
250892552323;250892553225;902;0,1,2;3;9;1;1;1
250892553225;250892553651;426;0,1,2;3;9;1;1;1
250892553651;250892553710;59;0,1,2;3;9;1;1;1
250892553710;250892553963;253;0,1,2;3;9;1;1;1
250892553963;250892554877;914;0,1,2;3;9;1;1;1
250892554877;250892555251;374;0,1,2;3;9;1;1;1
250892555251;250892555433;182;0,1,2;3;9;1;1;1
250892555433;250892555663;230;0,1,2;3;9;1;1;1
250892555663;250892555763;100;0,1,2;3;9;1;1;1
250892555763;250892557073;1310;0,1,2;3;9;1;1;1
250892557073;250892557767;694;0,1,2;3;9;1;1;1
250892557767;250892558898;1131;0,1,2;3;9;1;1;1
250892558898;250892558927;29;0,1,2;3;9;1;1;1
250892558927;250892558947;20;0,1,2;3;9;1;1;1
250892558947;250892559001;54;0,1,2;3;9;1;1;1
250892559001;250892559034;33;0,1,2;3;9;1;1;1
250892559034;250892559543;509;0,1,2;3;9;1;1;1
250892559543;250892559727;184;0,1,2;3;9;1;1;1
250892559727;250892559893;166;0,1,2;3;9;1;1;1
250892559893;250892560098;205;0,1,2;3;9;1;1;1
250892560098;250892560450;352;0,1,2;3;9;1;1;1
250892560450;250892561473;1023;0,1,2;3;9;1;1;1
250892561473;250892561562;89;0,1,2;3;9;1;1;1
250892561562;250892562214;652;0,1,2;3;9;1;1;1
250892562214;250892562386;172;0,1,2;3;9;1;1;1
250892562386;250892562604;218;0,1,2;3;9;1;1;1
250892562604;250892562919;315;0,1,2;3;9;1;1;1
250892562919;250892562932;13;0,1,2;3;9;1;1;1
250892562932;250892563068;136;0,1,2;3;9;1;1;1
250892563068;250892563153;85;0,1,2;3;9;1;1;1
250892563153;250892563914;761;0,1,2;3;9;1;1;1
250892563914;250892563952;38;0,1,2;3;9;1;1;1
250892563952;250892564135;183;0,1,2;3;9;1;1;1
250892564135;250892565493;1358;0,1,2;3;9;1;1;1
250892565493;250892565531;38;0,1,2;3;9;1;1;1
250892565531;250892565624;93;0,1,2;3;9;1;1;1
250892565624;250892566376;752;0,1,2;3;9;1;1;1
250892566376;250892566767;391;0,1,2;3;9;1;1;1
250892566767;250892567359;592;0,1,2;3;9;1;1;1
250892567359;250892567477;118;0,1,2;3;9;1;1;1
250892567477;250892568306;829;0,1,2;3;9;1;1;1
250892568306;250892568391;85;0,1,2;3;9;1;1;1
250892568391;250892568853;462;0,1,2;3;9;1;1;1
250892568853;250892569227;374;0,1,2;3;9;1;1;1
250892569227;250892569249;22;0,1,2;3;9;1;1;1
250892569249;250892569463;214;0,1,2;3;9;1;1;1
250892569463;250892569713;250;0,1,2;3;9;1;1;1
250892569713;250892570378;665;0,1,2;3;9;1;1;1
250892570378;250892570386;8;0,1,2;3;9;1;1;1
250892570386;250892570427;41;0,1,2;3;9;1;1;1
250892570427;250892570723;296;0,1,2;3;9;1;1;1
250892570723;250892571073;350;0,1,2;3;9;1;1;1
250892571073;250892571563;490;0,1,2;3;9;1;1;1
250892571563;250892571616;53;0,1,2;3;9;1;1;1
250892571616;250892572965;1349;0,1,2;3;9;1;1;1
250892572965;250892573012;47;0,1,2;3;9;1;1;1
250892573012;250892573404;392;0,1,2;3;9;1;1;1
250892573404;250892574594;1190;0,1,2;3;9;1;1;1
250892574594;250892574608;14;0,1,2;3;9;1;1;1
250892574608;250892575344;736;0,1,2;3;9;1;1;1
250892575344;250892575457;113;0,1,2;3;9;1;1;1
250892575457;250892576380;923;0,1,2;3;9;1;1;1
250892576380;250892577990;1610;0,1,2;3;9;1;1;1
250892577990;250892578444;454;0,1,2;3;9;1;1;1
250892578444;250892578484;40;0,1,2;3;9;1;1;1
250892578484;250892578885;401;0,1,2;3;9;1;1;1
250892578885;250892579102;217;0,1,2;3;9;1;1;1
250892579102;250892579626;524;0,1,2;3;9;1;1;1
250892579626;250892579817;191;0,1,2;3;9;1;1;1
250892579817;250892579927;110;0,1,2;3;9;1;1;1
250892579927;250892581117;1190;0,1,2;3;9;1;1;1
250892581117;250892581451;334;0,1,2;3;9;1;1;1
250892581451;250892582550;1099;0,1,2;3;9;1;1;1
250892582550;250892582924;374;0,1,2;3;9;1;1;1
250892582924;250892583680;756;0,1,2;3;9;1;1;1
250892583680;250892583730;50;0,1,2;3;9;1;1;1
250892583730;250892583775;45;0,1,2;3;9;1;1;1
250892583775;250892584204;429;0,1,2;3;9;1;1;1
250892584204;250892584905;701;0,1,2;3;9;1;1;1
250892584905;250892585416;511;0,1,2;3;9;1;1;1
250892585416;250892585535;119;0,1,2;3;9;1;1;1
250892585535;250892585625;90;0,1,2;3;9;1;1;1
250892585625;250892585999;374;0,1,2;3;9;1;1;1
250892585999;250892586254;255;0,1,2;3;9;1;1;1
250892586254;250892586796;542;0,1,2;3;9;1;1;1
250892586796;250892586869;73;0,1,2;3;9;1;1;1
250892586869;250892586925;56;0,1,2;3;9;1;1;1
250892586925;250892587165;240;0,1,2;3;9;1;1;1
250892587165;250892587238;73;0,1,2;3;9;1;1;1
250892587238;250892587600;362;0,1,2;3;9;1;1;1
250892587600;250892587992;392;0,1,2;3;9;1;1;1
250892587992;250892588897;905;0,1,2;3;9;1;1;1
250892588897;250892589213;316;0,1,2;3;9;1;1;1
250892589213;250892589495;282;0,1,2;3;9;1;1;1
250892589495;250892589718;223;0,1,2;3;9;1;1;1
250892589718;250892590443;725;0,1,2;3;9;1;1;1
250892590443;250892590476;33;0,1,2;3;9;1;1;1
250892590476;250892590549;73;0,1,2;3;9;1;1;1
250892590549;250892590655;106;0,1,2;3;9;1;1;1
250892590655;250892591934;1279;0,1,2;3;9;1;1;1
250892591934;250892592692;758;0,1,2;3;9;1;1;1
250892592692;250892592711;19;0,1,2;3;9;1;1;1
250892592711;250892592988;277;0,1,2;3;9;1;1;1
250892592988;250892593543;555;0,1,2;3;9;1;1;1
250892593543;250892593658;115;0,1,2;3;9;1;1;1
250892593658;250892593842;184;0,1,2;3;9;1;1;1
250892593842;250892593847;5;0,1,2;3;9;1;1;1
250892593847;250892594082;235;0,1,2;3;9;1;1;1
250892594082;250892594144;62;0,1,2;3;9;1;1;1
250892594144;250892594230;86;0,1,2;3;9;1;1;1
250892594230;250892594273;43;0,1,2;3;9;1;1;1
250892594273;250892594480;207;0,1,2;3;9;1;1;1
250892594480;250892595288;808;0,1,2;3;9;1;1;1
250892595288;250892595439;151;0,1,2;3;9;1;1;1
250892595439;250892595690;251;0,1,2;3;9;1;1;1
250892595690;250892596171;481;0,1,2;3;9;1;1;1
250892596171;250892596420;249;0,1,2;3;9;1;1;1
250892596420;250892598200;1780;0,1,2;3;9;1;1;1
250892598200;250892598486;286;0,1,2;3;9;1;1;1
250892598486;250892598907;421;0,1,2;3;9;1;1;1
250892598907;250892599087;180;0,1,2;3;9;1;1;1
250892599087;250892600839;1752;0,1,2;3;9;1;1;1
250892600839;250892602523;1684;0,1,2;3;9;1;1;1
250892602523;250892603234;711;0,1,2;3;9;1;1;1
250892603234;250892604381;1147;0,1,2;3;9;1;1;1
250892604381;250892605281;900;0,1,2;3;9;1;1;1
250892605281;250892605498;217;0,1,2;3;9;1;1;1
250892605498;250892606847;1349;0,1,2;3;9;1;1;1
250892606847;250892606873;26;0,1,2;3;9;1;1;1
250892606873;250892606927;54;0,1,2;3;9;1;1;1
250892606927;250892607816;889;0,1,2;3;9;1;1;1
250892607816;250892608604;788;0,1,2;3;9;1;1;1
250892608604;250892609225;621;0,1,2;3;9;1;1;1
250892609225;250892609566;341;0,1,2;3;9;1;1;1
250892609566;250892611307;1741;0,1,2;3;9;1;1;1
250892611307;250892611477;170;0,1,2;3;9;1;1;1
250892611477;250892611527;50;0,1,2;3;9;1;1;1
250892611527;250892612402;875;0,1,2;3;9;1;1;1
250892612402;250892612445;43;0,1,2;3;9;1;1;1
250892612445;250892613302;857;0,1,2;3;9;1;1;1
250892613302;250892613562;260;0,1,2;3;9;1;1;1
250892613562;250892613580;18;0,1,2;3;9;1;1;1
250892613580;250892614802;1222;0,1,2;3;9;1;1;1
250892614802;250892614810;8;0,1,2;3;9;1;1;1
250892614810;250892614958;148;0,1,2;3;9;1;1;1
250892614958;250892615556;598;0,1,2;3;9;1;1;1
250892615556;250892615604;48;0,1,2;3;9;1;1;1
250892615604;250892615772;168;0,1,2;3;9;1;1;1
250892615772;250892615868;96;0,1,2;3;9;1;1;1
250892615868;250892617173;1305;0,1,2;3;9;1;1;1
250892617173;250892617801;628;0,1,2;3;9;1;1;1
250892617801;250892618254;453;0,1,2;3;9;1;1;1
250892618254;250892618644;390;0,1,2;3;9;1;1;1
250892618644;250892619103;459;0,1,2;3;9;1;1;1
250892619103;250892619374;271;0,1,2;3;9;1;1;1
250892619374;250892620175;801;0,1,2;3;9;1;1;1
250892620175;250892620279;104;0,1,2;3;9;1;1;1
250892620279;250892620685;406;0,1,2;3;9;1;1;1
250892620685;250892621346;661;0,1,2;3;9;1;1;1
250892621346;250892622836;1490;0,1,2;3;9;1;1;1
250892622836;250892623083;247;0,1,2;3;9;1;1;1
250892623083;250892624537;1454;0,1,2;3;9;1;1;1
250892624537;250892624839;302;0,1,2;3;9;1;1;1
250892624839;250892624911;72;0,1,2;3;9;1;1;1
250892624911;250892625676;765;0,1,2;3;9;1;1;1
250892625676;250892625985;309;0,1,2;3;9;1;1;1
250892625985;250892627557;1572;0,1,2;3;9;1;1;1
250892627557;250892628318;761;0,1,2;3;9;1;1;1
250892628318;250892628382;64;0,1,2;3;9;1;1;1
250892628382;250892628490;108;0,1,2;3;9;1;1;1
250892628490;250892628577;87;0,1,2;3;9;1;1;1
250892628577;250892628752;175;0,1,2;3;9;1;1;1
250892628752;250892629148;396;0,1,2;3;9;1;1;1
250892629148;250892630005;857;0,1,2;3;9;1;1;1
250892630005;250892630971;966;0,1,2;3;9;1;1;1
250892630971;250892633622;2651;0,1,2;3;9;1;1;1
250892633622;250892633637;15;0,1,2;3;9;1;1;1
250892633637;250892634498;861;0,1,2;3;9;1;1;1
250892634498;250892634930;432;0,1,2;3;9;1;1;1
250892634930;250892636380;1450;0,1,2;3;9;1;1;1
250892636380;250892637083;703;0,1,2;3;9;1;1;1
250892637083;250892637213;130;0,1,2;3;9;1;1;1
250892637213;250892639163;1950;0,1,2;3;9;1;1;1
250892639163;250892639303;140;0,1,2;3;9;1;1;1
250892639303;250892639322;19;0,1,2;3;9;1;1;1
250892639322;250892639354;32;0,1,2;3;9;1;1;1
250892639354;250892639548;194;0,1,2;3;9;1;1;1
250892639548;250892639938;390;0,1,2;3;9;1;1;1
250892639938;250892640527;589;0,1,2;3;9;1;1;1
250892640527;250892640696;169;0,1,2;3;9;1;1;1
250892640696;250892640861;165;0,1,2;3;9;1;1;1
250892640861;250892641034;173;0,1,2;3;9;1;1;1
250892641034;250892641602;568;0,1,2;3;9;1;1;1
250892641602;250892642041;439;0,1,2;3;9;1;1;1
250892642041;250892642396;355;0,1,2;3;9;1;1;1
250892642396;250892643072;676;0,1,2;3;9;1;1;1
250892643072;250892644616;1544;0,1,2;3;9;1;1;1
250892644616;250892645535;919;0,1,2;3;9;1;1;1
250892645535;250892646812;1277;0,1,2;3;9;1;1;1
250892646812;250892647248;436;0,1,2;3;9;1;1;1
250892647248;250892647300;52;0,1,2;3;9;1;1;1
250892647300;250892647398;98;0,1,2;3;9;1;1;1
250892647398;250892648065;667;0,1,2;3;9;1;1;1
250892648065;250892648283;218;0,1,2;3;9;1;1;1
250892648283;250892648915;632;0,1,2;3;9;1;1;1
250892648915;250892649087;172;0,1,2;3;9;1;1;1
250892649087;250892649173;86;0,1,2;3;9;1;1;1
250892649173;250892649262;89;0,1,2;3;9;1;1;1
250892649262;250892649580;318;0,1,2;3;9;1;1;1
250892649580;250892649719;139;0,1,2;3;9;1;1;1
250892649719;250892649839;120;0,1,2;3;9;1;1;1
250892649839;250892650060;221;0,1,2;3;9;1;1;1
250892650060;250892650782;722;0,1,2;3;9;1;1;1
250892650782;250892652912;2130;0,1,2;3;9;1;1;1
250892652912;250892653403;491;0,1,2;3;9;1;1;1
250892653403;250892653548;145;0,1,2;3;9;1;1;1
250892653548;250892654051;503;0,1,2;3;9;1;1;1
250892654051;250892654410;359;0,1,2;3;9;1;1;1
250892654410;250892654869;459;0,1,2;3;9;1;1;1
250892654869;250892654981;112;0,1,2;3;9;1;1;1
250892654981;250892656356;1375;0,1,2;3;9;1;1;1
250892656356;250892656553;197;0,1,2;3;9;1;1;1
250892656553;250892656570;17;0,1,2;3;9;1;1;1
250892656570;250892656672;102;0,1,2;3;9;1;1;1
250892656672;250892656888;216;0,1,2;3;9;1;1;1
250892656888;250892657071;183;0,1,2;3;9;1;1;1
250892657071;250892657109;38;0,1,2;3;9;1;1;1
250892657109;250892657358;249;0,1,2;3;9;1;1;1
250892657358;250892657382;24;0,1,2;3;9;1;1;1
250892657382;250892657595;213;0,1,2;3;9;1;1;1
250892657595;250892659174;1579;0,1,2;3;9;1;1;1
250892659174;250892660025;851;0,1,2;3;9;1;1;1
250892660025;250892660581;556;0,1,2;3;9;1;1;1
250892660581;250892661128;547;0,1,2;3;9;1;1;1
250892661128;250892661373;245;0,1,2;3;9;1;1;1
250892661373;250892661620;247;0,1,2;3;9;1;1;1
250892661620;250892661803;183;0,1,2;3;9;1;1;1
250892661803;250892661902;99;0,1,2;3;9;1;1;1
250892661902;250892662113;211;0,1,2;3;9;1;1;1
250892662113;250892662862;749;0,1,2;3;9;1;1;1
250892662862;250892662912;50;0,1,2;3;9;1;1;1
250892662912;250892663107;195;0,1,2;3;9;1;1;1
250892663107;250892663442;335;0,1,2;3;9;1;1;1
250892663442;250892663451;9;0,1,2;3;9;1;1;1
250892663451;250892663652;201;0,1,2;3;9;1;1;1
250892663652;250892664424;772;0,1,2;3;9;1;1;1
250892664424;250892664748;324;0,1,2;3;9;1;1;1
250892664748;250892669424;4676;0,1,2;3;9;1;1;1
250892669424;250892670013;589;0,1,2;3;9;1;1;1
250892670013;250892670762;749;0,1,2;3;9;1;1;1
250892670762;250892672033;1271;0,1,2;3;9;1;1;1
250892672033;250892672095;62;0,1,2;3;9;1;1;1
250892672095;250892672170;75;0,1,2;3;9;1;1;1
250892672170;250892672185;15;0,1,2;3;9;1;1;1
250892672185;250892672292;107;0,1,2;3;9;1;1;1
250892672292;250892672740;448;0,1,2;3;9;1;1;1
250892672740;250892672872;132;0,1,2;3;9;1;1;1
250892672872;250892673202;330;0,1,2;3;9;1;1;1
250892673202;250892673818;616;0,1,2;3;9;1;1;1
250892673818;250892674097;279;0,1,2;3;9;1;1;1
250892674097;250892675118;1021;0,1,2;3;9;1;1;1
250892675118;250892675855;737;0,1,2;3;9;1;1;1
250892675855;250892676027;172;0,1,2;3;9;1;1;1
250892676027;250892676316;289;0,1,2;3;9;1;1;1
250892676316;250892676385;69;0,1,2;3;9;1;1;1
250892676385;250892678309;1924;0,1,2;3;9;1;1;1
250892678309;250892678388;79;0,1,2;3;9;1;1;1
250892678388;250892678843;455;0,1,2;3;9;1;1;1
250892678843;250892679338;495;0,1,2;3;9;1;1;1
250892679338;250892679932;594;0,1,2;3;9;1;1;1
250892679932;250892684830;4898;0,1,2;3;9;1;1;1
250892684830;250892686965;2135;0,1,2;3;9;1;1;1
250892686965;250892687454;489;0,1,2;3;9;1;1;1
250892687454;250892688882;1428;0,1,2;3;9;1;1;1
250892688882;250892690349;1467;0,1,2;3;9;1;1;1
250892690349;250892690385;36;0,1,2;3;9;1;1;1
250892690385;250892690475;90;0,1,2;3;9;1;1;1
250892690475;250892691074;599;0,1,2;3;9;1;1;1
250892691074;250892691310;236;0,1,2;3;9;1;1;1
250892691310;250892691333;23;0,1,2;3;9;1;1;1
250892691333;250892691624;291;0,1,2;3;9;1;1;1
250892691624;250892692136;512;0,1,2;3;9;1;1;1
250892692136;250892692229;93;0,1,2;3;9;1;1;1
250892692229;250892692682;453;0,1,2;3;9;1;1;1
250892692682;250892692772;90;0,1,2;3;9;1;1;1
250892692772;250892693048;276;0,1,2;3;9;1;1;1
250892693048;250892693322;274;0,1,2;3;9;1;1;1
250892693322;250892694122;800;0,1,2;3;9;1;1;1
250892694122;250892694222;100;0,1,2;3;9;1;1;1
250892694222;250892694519;297;0,1,2;3;9;1;1;1
250892694519;250892694524;5;0,1,2;3;9;1;1;1
250892694524;250892694554;30;0,1,2;3;9;1;1;1
250892694554;250892695361;807;0,1,2;3;9;1;1;1
250892695361;250892698009;2648;0,1,2;3;9;1;1;1
250892698009;250892698301;292;0,1,2;3;9;1;1;1
250892698301;250892698308;7;0,1,2;3;9;1;1;1
250892698308;250892698623;315;0,1,2;3;9;1;1;1
250892698623;250892699092;469;0,1,2;3;9;1;1;1
250892699092;250892699173;81;0,1,2;3;9;1;1;1
250892699173;250892699411;238;0,1,2;3;9;1;1;1
250892699411;250892699588;177;0,1,2;3;9;1;1;1
250892699588;250892700225;637;0,1,2;3;9;1;1;1
250892700225;250892700559;334;0,1,2;3;9;1;1;1
250892700559;250892700760;201;0,1,2;3;9;1;1;1
250892700760;250892701202;442;0,1,2;3;9;1;1;1
250892701202;250892701668;466;0,1,2;3;9;1;1;1
250892701668;250892702336;668;0,1,2;3;9;1;1;1
250892702336;250892702366;30;0,1,2;3;9;1;1;1
250892702366;250892702483;117;0,1,2;3;9;1;1;1
250892702483;250892703410;927;0,1,2;3;9;1;1;1
250892703410;250892703534;124;0,1,2;3;9;1;1;1
250892703534;250892703721;187;0,1,2;3;9;1;1;1
250892703721;250892704285;564;0,1,2;3;9;1;1;1
250892704285;250892704793;508;0,1,2;3;9;1;1;1
250892704793;250892705010;217;0,1,2;3;9;1;1;1
250892705010;250892705819;809;0,1,2;3;9;1;1;1
250892705819;250892706156;337;0,1,2;3;9;1;1;1
250892706156;250892706728;572;0,1,2;3;9;1;1;1
250892706728;250892707167;439;0,1,2;3;9;1;1;1
250892707167;250892707174;7;0,1,2;3;9;1;1;1
250892707174;250892707331;157;0,1,2;3;9;1;1;1
250892707331;250892707520;189;0,1,2;3;9;1;1;1
250892707520;250892707531;11;0,1,2;3;9;1;1;1
250892707531;250892707541;10;0,1,2;3;9;1;1;1
250892707541;250892707640;99;0,1,2;3;9;1;1;1
250892707640;250892707756;116;0,1,2;3;9;1;1;1
250892707756;250892707779;23;0,1,2;3;9;1;1;1
250892707779;250892707871;92;0,1,2;3;9;1;1;1
250892707871;250892707981;110;0,1,2;3;9;1;1;1
250892707981;250892709829;1848;0,1,2;3;9;1;1;1
250892709829;250892710010;181;0,1,2;3;9;1;1;1
250892710010;250892710603;593;0,1,2;3;9;1;1;1
250892710603;250892710748;145;0,1,2;3;9;1;1;1
250892710748;250892710922;174;0,1,2;3;9;1;1;1
250892710922;250892711109;187;0,1,2;3;9;1;1;1
250892711109;250892711168;59;0,1,2;3;9;1;1;1
250892711168;250892711290;122;0,1,2;3;9;1;1;1
250892711290;250892711363;73;0,1,2;3;9;1;1;1
250892711363;250892711395;32;0,1,2;3;9;1;1;1
250892711395;250892711440;45;0,1,2;3;9;1;1;1
250892711440;250892711536;96;0,1,2;3;9;1;1;1
250892711536;250892712772;1236;0,1,2;3;9;1;1;1
250892712772;250892713239;467;0,1,2;3;9;1;1;1
250892713239;250892713851;612;0,1,2;3;9;1;1;1
250892713851;250892714212;361;0,1,2;3;9;1;1;1
250892714212;250892714493;281;0,1,2;3;9;1;1;1
250892714493;250892714548;55;0,1,2;3;9;1;1;1
250892714548;250892714668;120;0,1,2;3;9;1;1;1
250892714668;250892714676;8;0,1,2;3;9;1;1;1
250892714676;250892714693;17;0,1,2;3;9;1;1;1
250892714693;250892715087;394;0,1,2;3;9;1;1;1
250892715087;250892715094;7;0,1,2;3;9;1;1;1
250892715094;250892715275;181;0,1,2;3;9;1;1;1
250892715275;250892715866;591;0,1,2;3;9;1;1;1
250892715866;250892716613;747;0,1,2;3;9;1;1;1
250892716613;250892716798;185;0,1,2;3;9;1;1;1
250892716798;250892717013;215;0,1,2;3;9;1;1;1
250892717013;250892717070;57;0,1,2;3;9;1;1;1
250892717070;250892717597;527;0,1,2;3;9;1;1;1
250892717597;250892717702;105;0,1,2;3;9;1;1;1
250892717702;250892718513;811;0,1,2;3;9;1;1;1
250892718513;250892720060;1547;0,1,2;3;9;1;1;1
250892720060;250892720704;644;0,1,2;3;9;1;1;1
250892720704;250892720951;247;0,1,2;3;9;1;1;1
250892720951;250892721198;247;0,1,2;3;9;1;1;1
250892721198;250892721812;614;0,1,2;3;9;1;1;1
250892721812;250892721824;12;0,1,2;3;9;1;1;1
250892721824;250892722007;183;0,1,2;3;9;1;1;1
250892722007;250892722165;158;0,1,2;3;9;1;1;1
250892722165;250892722253;88;0,1,2;3;9;1;1;1
250892722253;250892722354;101;0,1,2;3;9;1;1;1
250892722354;250892722587;233;0,1,2;3;9;1;1;1
250892722587;250892722593;6;0,1,2;3;9;1;1;1
250892722593;250892722819;226;0,1,2;3;9;1;1;1
250892722819;250892722847;28;0,1,2;3;9;1;1;1
250892722847;250892723515;668;0,1,2;3;9;1;1;1
250892723515;250892723680;165;0,1,2;3;9;1;1;1
250892723680;250892723831;151;0,1,2;3;9;1;1;1
250892723831;250892724490;659;0,1,2;3;9;1;1;1
250892724490;250892724491;1;0,1,2;3;9;1;1;1
250892724491;250892724840;349;0,1,2;3;9;1;1;1
250892724840;250892725644;804;0,1,2;3;9;1;1;1
250892725644;250892725799;155;0,1,2;3;9;1;1;1
250892725799;250892726017;218;0,1,2;3;9;1;1;1
250892726017;250892726785;768;0,1,2;3;9;1;1;1
250892726785;250892727793;1008;0,1,2;3;9;1;1;1
250892727793;250892728241;448;0,1,2;3;9;1;1;1
250892728241;250892728406;165;0,1,2;3;9;1;1;1
250892728406;250892728487;81;0,1,2;3;9;1;1;1
250892728487;250892729046;559;0,1,2;3;9;1;1;1
250892729046;250892729415;369;0,1,2;3;9;1;1;1
250892729415;250892731921;2506;0,1,2;3;9;1;1;1
250892731921;250892732241;320;0,1,2;3;9;1;1;1
250892732241;250892733026;785;0,1,2;3;9;1;1;1
250892733026;250892733676;650;0,1,2;3;9;1;1;1
250892733676;250892734839;1163;0,1,2;3;9;1;1;1
250892734839;250892735079;240;0,1,2;3;9;1;1;1
250892735079;250892735472;393;0,1,2;3;9;1;1;1
250892735472;250892735564;92;0,1,2;3;9;1;1;1
250892735564;250892735749;185;0,1,2;3;9;1;1;1
250892735749;250892736031;282;0,1,2;3;9;1;1;1
250892736031;250892736126;95;0,1,2;3;9;1;1;1
250892736126;250892736619;493;0,1,2;3;9;1;1;1
250892736619;250892736642;23;0,1,2;3;9;1;1;1
250892736642;250892736868;226;0,1,2;3;9;1;1;1
250892736868;250892737081;213;0,1,2;3;9;1;1;1
250892737081;250892737129;48;0,1,2;3;9;1;1;1
250892737129;250892737138;9;0,1,2;3;9;1;1;1
250892737138;250892737617;479;0,1,2;3;9;1;1;1
250892737617;250892737835;218;0,1,2;3;9;1;1;1
250892737835;250892738875;1040;0,1,2;3;9;1;1;1
250892738875;250892738966;91;0,1,2;3;9;1;1;1
250892738966;250892739030;64;0,1,2;3;9;1;1;1
250892739030;250892739616;586;0,1,2;3;9;1;1;1
250892739616;250892739965;349;0,1,2;3;9;1;1;1
250892739965;250892740461;496;0,1,2;3;9;1;1;1
250892740461;250892740495;34;0,1,2;3;9;1;1;1
250892740495;250892740830;335;0,1,2;3;9;1;1;1
250892740830;250892740982;152;0,1,2;3;9;1;1;1
250892740982;250892741527;545;0,1,2;3;9;1;1;1
250892741527;250892742091;564;0,1,2;3;9;1;1;1
250892742091;250892742100;9;0,1,2;3;9;1;1;1
250892742100;250892743030;930;0,1,2;3;9;1;1;1
250892743030;250892744032;1002;0,1,2;3;9;1;1;1
250892744032;250892744322;290;0,1,2;3;9;1;1;1
250892744322;250892744490;168;0,1,2;3;9;1;1;1
250892744490;250892744928;438;0,1,2;3;9;1;1;1
250892744928;250892745914;986;0,1,2;3;9;1;1;1
250892745914;250892746191;277;0,1,2;3;9;1;1;1
250892746191;250892746237;46;0,1,2;3;9;1;1;1
250892746237;250892746423;186;0,1,2;3;9;1;1;1
250892746423;250892746632;209;0,1,2;3;9;1;1;1
250892746632;250892746871;239;0,1,2;3;9;1;1;1
250892746871;250892747013;142;0,1,2;3;9;1;1;1
250892747013;250892747029;16;0,1,2;3;9;1;1;1
250892747029;250892747412;383;0,1,2;3;9;1;1;1
250892747412;250892747465;53;0,1,2;3;9;1;1;1
250892747465;250892747775;310;0,1,2;3;9;1;1;1
250892747775;250892747954;179;0,1,2;3;9;1;1;1
250892747954;250892748325;371;0,1,2;3;9;1;1;1
250892748325;250892748385;60;0,1,2;3;9;1;1;1
250892748385;250892748705;320;0,1,2;3;9;1;1;1
250892748705;250892748774;69;0,1,2;3;9;1;1;1
250892748774;250892749208;434;0,1,2;3;9;1;1;1
250892749208;250892749477;269;0,1,2;3;9;1;1;1
250892749477;250892749513;36;0,1,2;3;9;1;1;1
250892749513;250892749567;54;0,1,2;3;9;1;1;1
250892749567;250892749994;427;0,1,2;3;9;1;1;1
250892749994;250892750229;235;0,1,2;3;9;1;1;1
250892750229;250892750947;718;0,1,2;3;9;1;1;1
250892750947;250892751731;784;0,1,2;3;9;1;1;1
250892751731;250892751921;190;0,1,2;3;9;1;1;1
250892751921;250892752313;392;0,1,2;3;9;1;1;1
250892752313;250892752350;37;0,1,2;3;9;1;1;1
250892752350;250892752685;335;0,1,2;3;9;1;1;1
250892752685;250892752756;71;0,1,2;3;9;1;1;1
250892752756;250892752838;82;0,1,2;3;9;1;1;1
250892752838;250892753087;249;0,1,2;3;9;1;1;1
250892753087;250892754362;1275;0,1,2;3;9;1;1;1
250892754362;250892754414;52;0,1,2;3;9;1;1;1
250892754414;250892754491;77;0,1,2;3;9;1;1;1
250892754491;250892755052;561;0,1,2;3;9;1;1;1
250892755052;250892755166;114;0,1,2;3;9;1;1;1
250892755166;250892756254;1088;0,1,2;3;9;1;1;1
250892756254;250892756525;271;0,1,2;3;9;1;1;1
250892756525;250892756582;57;0,1,2;3;9;1;1;1
250892756582;250892757201;619;0,1,2;3;9;1;1;1
250892757201;250892757522;321;0,1,2;3;9;1;1;1
250892757522;250892757568;46;0,1,2;3;9;1;1;1
250892757568;250892757771;203;0,1,2;3;9;1;1;1
250892757771;250892758371;600;0,1,2;3;9;1;1;1
250892758371;250892758374;3;0,1,2;3;9;1;1;1
250892758374;250892759036;662;0,1,2;3;9;1;1;1
250892759036;250892759963;927;0,1,2;3;9;1;1;1
250892759963;250892760269;306;0,1,2;3;9;1;1;1
250892760269;250892761136;867;0,1,2;3;9;1;1;1
250892761136;250892761222;86;0,1,2;3;9;1;1;1
250892761222;250892761569;347;0,1,2;3;9;1;1;1
250892761569;250892762188;619;0,1,2;3;9;1;1;1
250892762188;250892762253;65;0,1,2;3;9;1;1;1
250892762253;250892762486;233;0,1,2;3;9;1;1;1
250892762486;250892762705;219;0,1,2;3;9;1;1;1
250892762705;250892763023;318;0,1,2;3;9;1;1;1
250892763023;250892763578;555;0,1,2;3;9;1;1;1
250892763578;250892763964;386;0,1,2;3;9;1;1;1
250892763964;250892765398;1434;0,1,2;3;9;1;1;1
250892765398;250892765680;282;0,1,2;3;9;1;1;1
250892765680;250892766017;337;0,1,2;3;9;1;1;1
250892766017;250892766141;124;0,1,2;3;9;1;1;1
250892766141;250892766675;534;0,1,2;3;9;1;1;1
250892766675;250892766824;149;0,1,2;3;9;1;1;1
250892766824;250892766883;59;0,1,2;3;9;1;1;1
250892766883;250892767520;637;0,1,2;3;9;1;1;1
250892767520;250892767757;237;0,1,2;3;9;1;1;1
250892767757;250892768720;963;0,1,2;3;9;1;1;1
250892768720;250892768885;165;0,1,2;3;9;1;1;1
250892768885;250892769718;833;0,1,2;3;9;1;1;1
250892769718;250892770932;1214;0,1,2;3;9;1;1;1
250892770932;250892771086;154;0,1,2;3;9;1;1;1
250892771086;250892771124;38;0,1,2;3;9;1;1;1
250892771124;250892771906;782;0,1,2;3;9;1;1;1
250892771906;250892772087;181;0,1,2;3;9;1;1;1
250892772087;250892772407;320;0,1,2;3;9;1;1;1
250892772407;250892772435;28;0,1,2;3;9;1;1;1
250892772435;250892772498;63;0,1,2;3;9;1;1;1
250892772498;250892772997;499;0,1,2;3;9;1;1;1
250892772997;250892773932;935;0,1,2;3;9;1;1;1
250892773932;250892773976;44;0,1,2;3;9;1;1;1
250892773976;250892774027;51;0,1,2;3;9;1;1;1
250892774027;250892774248;221;0,1,2;3;9;1;1;1
250892774248;250892774289;41;0,1,2;3;9;1;1;1
250892774289;250892774456;167;0,1,2;3;9;1;1;1
250892774456;250892774659;203;0,1,2;3;9;1;1;1
250892774659;250892774723;64;0,1,2;3;9;1;1;1
250892774723;250892775476;753;0,1,2;3;9;1;1;1
250892775476;250892775660;184;0,1,2;3;9;1;1;1
250892775660;250892775850;190;0,1,2;3;9;1;1;1
250892775850;250892776103;253;0,1,2;3;9;1;1;1
250892776103;250892776899;796;0,1,2;3;9;1;1;1
250892776899;250892778573;1674;0,1,2;3;9;1;1;1
250892778573;250892778845;272;0,1,2;3;9;1;1;1
250892778845;250892779772;927;0,1,2;3;9;1;1;1
250892779772;250892779825;53;0,1,2;3;9;1;1;1
250892779825;250892780021;196;0,1,2;3;9;1;1;1
250892780021;250892780305;284;0,1,2;3;9;1;1;1
250892780305;250892780342;37;0,1,2;3;9;1;1;1
250892780342;250892781003;661;0,1,2;3;9;1;1;1
250892781003;250892781210;207;0,1,2;3;9;1;1;1
250892781210;250892781259;49;0,1,2;3;9;1;1;1
250892781259;250892781952;693;0,1,2;3;9;1;1;1
250892781952;250892782080;128;0,1,2;3;9;1;1;1
250892782080;250892782108;28;0,1,2;3;9;1;1;1
250892782108;250892782236;128;0,1,2;3;9;1;1;1
250892782236;250892782450;214;0,1,2;3;9;1;1;1
250892782450;250892782557;107;0,1,2;3;9;1;1;1
250892782557;250892782666;109;0,1,2;3;9;1;1;1
250892782666;250892782967;301;0,1,2;3;9;1;1;1
250892782967;250892783293;326;0,1,2;3;9;1;1;1
250892783293;250892783569;276;0,1,2;3;9;1;1;1
250892783569;250892783741;172;0,1,2;3;9;1;1;1
250892783741;250892783854;113;0,1,2;3;9;1;1;1
250892783854;250892783867;13;0,1,2;3;9;1;1;1
250892783867;250892784226;359;0,1,2;3;9;1;1;1
250892784226;250892784442;216;0,1,2;3;9;1;1;1
250892784442;250892784560;118;0,1,2;3;9;1;1;1
250892784560;250892785094;534;0,1,2;3;9;1;1;1
250892785094;250892785396;302;0,1,2;3;9;1;1;1
250892785396;250892785699;303;0,1,2;3;9;1;1;1
250892785699;250892786443;744;0,1,2;3;9;1;1;1
250892786443;250892787693;1250;0,1,2;3;9;1;1;1
250892787693;250892787753;60;0,1,2;3;9;1;1;1
250892787753;250892789936;2183;0,1,2;3;9;1;1;1
250892789936;250892790131;195;0,1,2;3;9;1;1;1
250892790131;250892790301;170;0,1,2;3;9;1;1;1
250892790301;250892790844;543;0,1,2;3;9;1;1;1
250892790844;250892791298;454;0,1,2;3;9;1;1;1
250892791298;250892791773;475;0,1,2;3;9;1;1;1
250892791773;250892791809;36;0,1,2;3;9;1;1;1
250892791809;250892792898;1089;0,1,2;3;9;1;1;1
250892792898;250892793331;433;0,1,2;3;9;1;1;1
250892793331;250892793430;99;0,1,2;3;9;1;1;1
250892793430;250892794260;830;0,1,2;3;9;1;1;1
250892794260;250892794988;728;0,1,2;3;9;1;1;1
250892794988;250892795178;190;0,1,2;3;9;1;1;1
250892795178;250892795236;58;0,1,2;3;9;1;1;1
250892795236;250892795312;76;0,1,2;3;9;1;1;1
250892795312;250892795349;37;0,1,2;3;9;1;1;1
250892795349;250892795575;226;0,1,2;3;9;1;1;1
250892795575;250892796967;1392;0,1,2;3;9;1;1;1
250892796967;250892797658;691;0,1,2;3;9;1;1;1
250892797658;250892798213;555;0,1,2;3;9;1;1;1
250892798213;250892798278;65;0,1,2;3;9;1;1;1
250892798278;250892798401;123;0,1,2;3;9;1;1;1
250892798401;250892798508;107;0,1,2;3;9;1;1;1
250892798508;250892798570;62;0,1,2;3;9;1;1;1
250892798570;250892799509;939;0,1,2;3;9;1;1;1
250892799509;250892800115;606;0,1,2;3;9;1;1;1
250892800115;250892800678;563;0,1,2;3;9;1;1;1
250892800678;250892801573;895;0,1,2;3;9;1;1;1
250892801573;250892801587;14;0,1,2;3;9;1;1;1
250892801587;250892802035;448;0,1,2;3;9;1;1;1
250892802035;250892802142;107;0,1,2;3;9;1;1;1
250892802142;250892802474;332;0,1,2;3;9;1;1;1
250892802474;250892803136;662;0,1,2;3;9;1;1;1
250892803136;250892803246;110;0,1,2;3;9;1;1;1
250892803246;250892803600;354;0,1,2;3;9;1;1;1
250892803600;250892803884;284;0,1,2;3;9;1;1;1
250892803884;250892804377;493;0,1,2;3;9;1;1;1
250892804377;250892804711;334;0,1,2;3;9;1;1;1
250892804711;250892804774;63;0,1,2;3;9;1;1;1
250892804774;250892804948;174;0,1,2;3;9;1;1;1
250892804948;250892805759;811;0,1,2;3;9;1;1;1
250892805759;250892805782;23;0,1,2;3;9;1;1;1
250892805782;250892806069;287;0,1,2;3;9;1;1;1
250892806069;250892807104;1035;0,1,2;3;9;1;1;1
250892807104;250892807192;88;0,1,2;3;9;1;1;1
250892807192;250892807670;478;0,1,2;3;9;1;1;1
250892807670;250892808425;755;0,1,2;3;9;1;1;1
250892808425;250892808498;73;0,1,2;3;9;1;1;1
250892808498;250892808583;85;0,1,2;3;9;1;1;1
250892808583;250892808666;83;0,1,2;3;9;1;1;1
250892808666;250892808973;307;0,1,2;3;9;1;1;1
250892808973;250892809314;341;0,1,2;3;9;1;1;1
250892809314;250892809779;465;0,1,2;3;9;1;1;1
250892809779;250892809808;29;0,1,2;3;9;1;1;1
250892809808;250892809993;185;0,1,2;3;9;1;1;1
250892809993;250892810204;211;0,1,2;3;9;1;1;1
250892810204;250892810446;242;0,1,2;3;9;1;1;1
250892810446;250892811099;653;0,1,2;3;9;1;1;1
250892811099;250892811239;140;0,1,2;3;9;1;1;1
250892811239;250892811419;180;0,1,2;3;9;1;1;1
250892811419;250892811613;194;0,1,2;3;9;1;1;1
250892811613;250892811790;177;0,1,2;3;9;1;1;1
250892811790;250892811917;127;0,1,2;3;9;1;1;1
250892811917;250892811953;36;0,1,2;3;9;1;1;1
250892811953;250892812467;514;0,1,2;3;9;1;1;1
250892812467;250892812488;21;0,1,2;3;9;1;1;1
250892812488;250892812535;47;0,1,2;3;9;1;1;1
250892812535;250892812621;86;0,1,2;3;9;1;1;1
250892812621;250892812693;72;0,1,2;3;9;1;1;1
250892812693;250892812765;72;0,1,2;3;9;1;1;1
250892812765;250892814537;1772;0,1,2;3;9;1;1;1
250892814537;250892815014;477;0,1,2;3;9;1;1;1
250892815014;250892815067;53;0,1,2;3;9;1;1;1
250892815067;250892815128;61;0,1,2;3;9;1;1;1
250892815128;250892815225;97;0,1,2;3;9;1;1;1
250892815225;250892815820;595;0,1,2;3;9;1;1;1
250892815820;250892815944;124;0,1,2;3;9;1;1;1
250892815944;250892816037;93;0,1,2;3;9;1;1;1
250892816037;250892816106;69;0,1,2;3;9;1;1;1
250892816106;250892816256;150;0,1,2;3;9;1;1;1
250892816256;250892816365;109;0,1,2;3;9;1;1;1
250892816365;250892816384;19;0,1,2;3;9;1;1;1
250892816384;250892816392;8;0,1,2;3;9;1;1;1
250892816392;250892816481;89;0,1,2;3;9;1;1;1
250892816481;250892816502;21;0,1,2;3;9;1;1;1
250892816502;250892816568;66;0,1,2;3;9;1;1;1
250892816568;250892816591;23;0,1,2;3;9;1;1;1
250892816591;250892817376;785;0,1,2;3;9;1;1;1
250892817376;250892817573;197;0,1,2;3;9;1;1;1
250892817573;250892818178;605;0,1,2;3;9;1;1;1
250892818178;250892820277;2099;0,1,2;3;9;1;1;1
250892820277;250892820312;35;0,1,2;3;9;1;1;1
250892820312;250892820581;269;0,1,2;3;9;1;1;1
250892820581;250892821608;1027;0,1,2;3;9;1;1;1
250892821608;250892821682;74;0,1,2;3;9;1;1;1
250892821682;250892821822;140;0,1,2;3;9;1;1;1
250892821822;250892821989;167;0,1,2;3;9;1;1;1
250892821989;250892822247;258;0,1,2;3;9;1;1;1
250892822247;250892822401;154;0,1,2;3;9;1;1;1
250892822401;250892822629;228;0,1,2;3;9;1;1;1
250892822629;250892822680;51;0,1,2;3;9;1;1;1
250892822680;250892822800;120;0,1,2;3;9;1;1;1
250892822800;250892823166;366;0,1,2;3;9;1;1;1
250892823166;250892823513;347;0,1,2;3;9;1;1;1
250892823513;250892823610;97;0,1,2;3;9;1;1;1
250892823610;250892823856;246;0,1,2;3;9;1;1;1
250892823856;250892824065;209;0,1,2;3;9;1;1;1
250892824065;250892824651;586;0,1,2;3;9;1;1;1
250892824651;250892825937;1286;0,1,2;3;9;1;1;1
250892825937;250892826035;98;0,1,2;3;9;1;1;1
250892826035;250892826362;327;0,1,2;3;9;1;1;1
250892826362;250892828165;1803;0,1,2;3;9;1;1;1
250892828165;250892828210;45;0,1,2;3;9;1;1;1
250892828210;250892828237;27;0,1,2;3;9;1;1;1
250892828237;250892828418;181;0,1,2;3;9;1;1;1
250892828418;250892828829;411;0,1,2;3;9;1;1;1
250892828829;250892828920;91;0,1,2;3;9;1;1;1
250892828920;250892829509;589;0,1,2;3;9;1;1;1
250892829509;250892829770;261;0,1,2;3;9;1;1;1
250892829770;250892830302;532;0,1,2;3;9;1;1;1
250892830302;250892830325;23;0,1,2;3;9;1;1;1
250892830325;250892830546;221;0,1,2;3;9;1;1;1
250892830546;250892830571;25;0,1,2;3;9;1;1;1
250892830571;250892831837;1266;0,1,2;3;9;1;1;1
250892831837;250892831878;41;0,1,2;3;9;1;1;1
250892831878;250892831983;105;0,1,2;3;9;1;1;1
250892831983;250892833147;1164;0,1,2;3;9;1;1;1
250892833147;250892833153;6;0,1,2;3;9;1;1;1
250892833153;250892833233;80;0,1,2;3;9;1;1;1
250892833233;250892835853;2620;0,1,2;3;9;1;1;1
250892835853;250892836387;534;0,1,2;3;9;1;1;1
250892836387;250892836511;124;0,1,2;3;9;1;1;1
250892836511;250892837744;1233;0,1,2;3;9;1;1;1
250892837744;250892838652;908;0,1,2;3;9;1;1;1
250892838652;250892839196;544;0,1,2;3;9;1;1;1
250892839196;250892841372;2176;0,1,2;3;9;1;1;1
250892841372;250892841503;131;0,1,2;3;9;1;1;1
250892841503;250892846149;4646;0,1,2;3;9;1;1;1
250892846149;250892846205;56;0,1,2;3;9;1;1;1
250892846205;250892846421;216;0,1,2;3;9;1;1;1
250892846421;250892847723;1302;0,1,2;3;9;1;1;1
250892847723;250892848115;392;0,1,2;3;9;1;1;1
250892848115;250892848159;44;0,1,2;3;9;1;1;1
250892848159;250892848474;315;0,1,2;3;9;1;1;1
250892848474;250892848524;50;0,1,2;3;9;1;1;1
250892848524;250892848669;145;0,1,2;3;9;1;1;1
250892848669;250892849522;853;0,1,2;3;9;1;1;1
250892849522;250892849630;108;0,1,2;3;9;1;1;1
250892849630;250892849910;280;0,1,2;3;9;1;1;1
250892849910;250892850249;339;0,1,2;3;9;1;1;1
250892850249;250892850376;127;0,1,2;3;9;1;1;1
250892850376;250892850753;377;0,1,2;3;9;1;1;1
250892850753;250892851380;627;0,1,2;3;9;1;1;1
250892851380;250892851793;413;0,1,2;3;9;1;1;1
250892851793;250892851934;141;0,1,2;3;9;1;1;1
250892851934;250892852092;158;0,1,2;3;9;1;1;1
250892852092;250892852534;442;0,1,2;3;9;1;1;1
250892852534;250892852664;130;0,1,2;3;9;1;1;1
250892852664;250892852823;159;0,1,2;3;9;1;1;1
250892852823;250892853048;225;0,1,2;3;9;1;1;1
250892853048;250892853139;91;0,1,2;3;9;1;1;1
250892853139;250892853824;685;0,1,2;3;9;1;1;1
250892853824;250892854561;737;0,1,2;3;9;1;1;1
250892854561;250892854702;141;0,1,2;3;9;1;1;1
250892854702;250892854980;278;0,1,2;3;9;1;1;1
250892854980;250892855158;178;0,1,2;3;9;1;1;1
250892855158;250892855271;113;0,1,2;3;9;1;1;1
250892855271;250892855573;302;0,1,2;3;9;1;1;1
250892855573;250892855715;142;0,1,2;3;9;1;1;1
250892855715;250892856228;513;0,1,2;3;9;1;1;1
250892856228;250892856286;58;0,1,2;3;9;1;1;1
250892856286;250892856336;50;0,1,2;3;9;1;1;1
250892856336;250892858344;2008;0,1,2;3;9;1;1;1
250892858344;250892858692;348;0,1,2;3;9;1;1;1
250892858692;250892860913;2221;0,1,2;3;9;1;1;1
250892860913;250892861737;824;0,1,2;3;9;1;1;1
250892861737;250892862221;484;0,1,2;3;9;1;1;1
250892862221;250892863560;1339;0,1,2;3;9;1;1;1
250892863560;250892865202;1642;0,1,2;3;9;1;1;1
250892865202;250892867849;2647;0,1,2;3;9;1;1;1
250892867849;250892869191;1342;0,1,2;3;9;1;1;1
250892869191;250892870844;1653;0,1,2;3;9;1;1;1
250892870844;250892872271;1427;0,1,2;3;9;1;1;1
250892872271;250892873281;1010;0,1,2;3;9;1;1;1
250892873281;250892873497;216;0,1,2;3;9;1;1;1
250892873497;250892873549;52;0,1,2;3;9;1;1;1
250892873549;250892873632;83;0,1,2;3;9;1;1;1
250892873632;250892874431;799;0,1,2;3;9;1;1;1
250892874431;250892874507;76;0,1,2;3;9;1;1;1
250892874507;250892874557;50;0,1,2;3;9;1;1;1
250892874557;250892875460;903;0,1,2;3;9;1;1;1
250892875460;250892875813;353;0,1,2;3;9;1;1;1
250892875813;250892877603;1790;0,1,2;3;9;1;1;1
250892877603;250892878629;1026;0,1,2;3;9;1;1;1
250892878629;250892879180;551;0,1,2;3;9;1;1;1
250892879180;250892882168;2988;0,1,2;3;9;1;1;1
250892882168;250892882454;286;0,1,2;3;9;1;1;1
250892882454;250892883046;592;0,1,2;3;9;1;1;1
250892883046;250892884684;1638;0,1,2;3;9;1;1;1
250892884684;250892886338;1654;0,1,2;3;9;1;1;1
250892886338;250892887170;832;0,1,2;3;9;1;1;1
250892887170;250892887191;21;0,1,2;3;9;1;1;1
250892887191;250892887456;265;0,1,2;3;9;1;1;1
250892887456;250892887658;202;0,1,2;3;9;1;1;1
250892887658;250892888217;559;0,1,2;3;9;1;1;1
250892888217;250892888285;68;0,1,2;3;9;1;1;1
250892888285;250892889142;857;0,1,2;3;9;1;1;1
250892889142;250892889284;142;0,1,2;3;9;1;1;1
250892889284;250892889520;236;0,1,2;3;9;1;1;1
250892889520;250892889558;38;0,1,2;3;9;1;1;1
250892889558;250892890052;494;0,1,2;3;9;1;1;1
250892890052;250892891644;1592;0,1,2;3;9;1;1;1
250892891644;250892892216;572;0,1,2;3;9;1;1;1
250892892216;250892892313;97;0,1,2;3;9;1;1;1
250892892313;250892892388;75;0,1,2;3;9;1;1;1
250892892388;250892892505;117;0,1,2;3;9;1;1;1
250892892505;250892892536;31;0,1,2;3;9;1;1;1
250892892536;250892893508;972;0,1,2;3;9;1;1;1
250892893508;250892894336;828;0,1,2;3;9;1;1;1
250892894336;250892894946;610;0,1,2;3;9;1;1;1
250892894946;250892895206;260;0,1,2;3;9;1;1;1
250892895206;250892896584;1378;0,1,2;3;9;1;1;1
250892896584;250892897291;707;0,1,2;3;9;1;1;1
250892897291;250892897975;684;0,1,2;3;9;1;1;1
250892897975;250892898122;147;0,1,2;3;9;1;1;1
250892898122;250892898527;405;0,1,2;3;9;1;1;1
250892898527;250892898956;429;0,1,2;3;9;1;1;1
250892898956;250892899277;321;0,1,2;3;9;1;1;1
250892899277;250892899318;41;0,1,2;3;9;1;1;1
250892899318;250892899354;36;0,1,2;3;9;1;1;1
250892899354;250892899440;86;0,1,2;3;9;1;1;1
250892899440;250892899595;155;0,1,2;3;9;1;1;1
250892899595;250892902200;2605;0,1,2;3;9;1;1;1
250892902200;250892902226;26;0,1,2;3;9;1;1;1
250892902226;250892902230;4;0,1,2;3;9;1;1;1
250892902230;250892902688;458;0,1,2;3;9;1;1;1
250892902688;250892902977;289;0,1,2;3;9;1;1;1
250892902977;250892903023;46;0,1,2;3;9;1;1;1
250892903023;250892903342;319;0,1,2;3;9;1;1;1
250892903342;250892904153;811;0,1,2;3;9;1;1;1
250892904153;250892905659;1506;0,1,2;3;9;1;1;1
250892905659;250892906040;381;0,1,2;3;9;1;1;1
250892906040;250892906083;43;0,1,2;3;9;1;1;1
250892906083;250892906254;171;0,1,2;3;9;1;1;1
250892906254;250892906415;161;0,1,2;3;9;1;1;1
250892906415;250892906706;291;0,1,2;3;9;1;1;1
250892906706;250892906841;135;0,1,2;3;9;1;1;1
250892906841;250892906847;6;0,1,2;3;9;1;1;1
250892906847;250892906932;85;0,1,2;3;9;1;1;1
250892906932;250892907476;544;0,1,2;3;9;1;1;1
250892907476;250892907530;54;0,1,2;3;9;1;1;1
250892907530;250892907965;435;0,1,2;3;9;1;1;1
250892907965;250892909329;1364;0,1,2;3;9;1;1;1
250892909329;250892909398;69;0,1,2;3;9;1;1;1
250892909398;250892909525;127;0,1,2;3;9;1;1;1
250892909525;250892909576;51;0,1,2;3;9;1;1;1
250892909576;250892909738;162;0,1,2;3;9;1;1;1
250892909738;250892909939;201;0,1,2;3;9;1;1;1
250892909939;250892910213;274;0,1,2;3;9;1;1;1
250892910213;250892910729;516;0,1,2;3;9;1;1;1
250892910729;250892910952;223;0,1,2;3;9;1;1;1
250892910952;250892910975;23;0,1,2;3;9;1;1;1
250892910975;250892911647;672;0,1,2;3;9;1;1;1
250892911647;250892912441;794;0,1,2;3;9;1;1;1
250892912441;250892912544;103;0,1,2;3;9;1;1;1
250892912544;250892913466;922;0,1,2;3;9;1;1;1
250892913466;250892913526;60;0,1,2;3;9;1;1;1
250892913526;250892914240;714;0,1,2;3;9;1;1;1
250892914240;250892914688;448;0,1,2;3;9;1;1;1
250892914688;250892914740;52;0,1,2;3;9;1;1;1
250892914740;250892914744;4;0,1,2;3;9;1;1;1
250892914744;250892915169;425;0,1,2;3;9;1;1;1
250892915169;250892915540;371;0,1,2;3;9;1;1;1
250892915540;250892916205;665;0,1,2;3;9;1;1;1
250892916205;250892916385;180;0,1,2;3;9;1;1;1
250892916385;250892917095;710;0,1,2;3;9;1;1;1
250892917095;250892917800;705;0,1,2;3;9;1;1;1
250892917800;250892917984;184;0,1,2;3;9;1;1;1
250892917984;250892918022;38;0,1,2;3;9;1;1;1
250892918022;250892918111;89;0,1,2;3;9;1;1;1
250892918111;250892918168;57;0,1,2;3;9;1;1;1
250892918168;250892918240;72;0,1,2;3;9;1;1;1
250892918240;250892919076;836;0,1,2;3;9;1;1;1
250892919076;250892919642;566;0,1,2;3;9;1;1;1
250892919642;250892920428;786;0,1,2;3;9;1;1;1
250892920428;250892920941;513;0,1,2;3;9;1;1;1
250892920941;250892921080;139;0,1,2;3;9;1;1;1
250892921080;250892921167;87;0,1,2;3;9;1;1;1
250892921167;250892921213;46;0,1,2;3;9;1;1;1
250892921213;250892921247;34;0,1,2;3;9;1;1;1
250892921247;250892921712;465;0,1,2;3;9;1;1;1
250892921712;250892921908;196;0,1,2;3;9;1;1;1
250892921908;250892922084;176;0,1,2;3;9;1;1;1
250892922084;250892922159;75;0,1,2;3;9;1;1;1
250892922159;250892922247;88;0,1,2;3;9;1;1;1
250892922247;250892922397;150;0,1,2;3;9;1;1;1
250892922397;250892922655;258;0,1,2;3;9;1;1;1
250892922655;250892924016;1361;0,1,2;3;9;1;1;1
250892924016;250892924233;217;0,1,2;3;9;1;1;1
250892924233;250892924449;216;0,1,2;3;9;1;1;1
250892924449;250892924695;246;0,1,2;3;9;1;1;1
250892924695;250892924729;34;0,1,2;3;9;1;1;1
250892924729;250892924771;42;0,1,2;3;9;1;1;1
250892924771;250892925067;296;0,1,2;3;9;1;1;1
250892925067;250892925280;213;0,1,2;3;9;1;1;1
250892925280;250892925545;265;0,1,2;3;9;1;1;1
250892925545;250892926058;513;0,1,2;3;9;1;1;1
250892926058;250892926841;783;0,1,2;3;9;1;1;1
250892926841;250892928987;2146;0,1,2;3;9;1;1;1
250892928987;250892929369;382;0,1,2;3;9;1;1;1
250892929369;250892929515;146;0,1,2;3;9;1;1;1
250892929515;250892929637;122;0,1,2;3;9;1;1;1
250892929637;250892929863;226;0,1,2;3;9;1;1;1
250892929863;250892929990;127;0,1,2;3;9;1;1;1
250892929990;250892930452;462;0,1,2;3;9;1;1;1
250892930452;250892930767;315;0,1,2;3;9;1;1;1
250892930767;250892931409;642;0,1,2;3;9;1;1;1
250892931409;250892934482;3073;0,1,2;3;9;1;1;1
250892934482;250892934721;239;0,1,2;3;9;1;1;1
250892934721;250892934829;108;0,1,2;3;9;1;1;1
250892934829;250892934990;161;0,1,2;3;9;1;1;1
250892934990;250892935129;139;0,1,2;3;9;1;1;1
250892935129;250892935221;92;0,1,2;3;9;1;1;1
250892935221;250892935548;327;0,1,2;3;9;1;1;1
250892935548;250892936727;1179;0,1,2;3;9;1;1;1
250892936727;250892936978;251;0,1,2;3;9;1;1;1
250892936978;250892937385;407;0,1,2;3;9;1;1;1
250892937385;250892937902;517;0,1,2;3;9;1;1;1
250892937902;250892938069;167;0,1,2;3;9;1;1;1
250892938069;250892938322;253;0,1,2;3;9;1;1;1
250892938322;250892939384;1062;0,1,2;3;9;1;1;1
250892939384;250892939389;5;0,1,2;3;9;1;1;1
250892939389;250892940721;1332;0,1,2;3;9;1;1;1
250892940721;250892941098;377;0,1,2;3;9;1;1;1
250892941098;250892941239;141;0,1,2;3;9;1;1;1
250892941239;250892941333;94;0,1,2;3;9;1;1;1
250892941333;250892941492;159;0,1,2;3;9;1;1;1
250892941492;250892942208;716;0,1,2;3;9;1;1;1
250892942208;250892942214;6;0,1,2;3;9;1;1;1
250892942214;250892942257;43;0,1,2;3;9;1;1;1
250892942257;250892942325;68;0,1,2;3;9;1;1;1
250892942325;250892942361;36;0,1,2;3;9;1;1;1
250892942361;250892942604;243;0,1,2;3;9;1;1;1
250892942604;250892942704;100;0,1,2;3;9;1;1;1
250892942704;250892942727;23;0,1,2;3;9;1;1;1
250892942727;250892942889;162;0,1,2;3;9;1;1;1
250892942889;250892942907;18;0,1,2;3;9;1;1;1
250892942907;250892943201;294;0,1,2;3;9;1;1;1
250892943201;250892943921;720;0,1,2;3;9;1;1;1
250892943921;250892944506;585;0,1,2;3;9;1;1;1
250892944506;250892945266;760;0,1,2;3;9;1;1;1
250892945266;250892945402;136;0,1,2;3;9;1;1;1
250892945402;250892945439;37;0,1,2;3;9;1;1;1
250892945439;250892945461;22;0,1,2;3;9;1;1;1
250892945461;250892945580;119;0,1,2;3;9;1;1;1
250892945580;250892945601;21;0,1,2;3;9;1;1;1
250892945601;250892945721;120;0,1,2;3;9;1;1;1
250892945721;250892946290;569;0,1,2;3;9;1;1;1
250892946290;250892946700;410;0,1,2;3;9;1;1;1
250892946700;250892947274;574;0,1,2;3;9;1;1;1
250892947274;250892948249;975;0,1,2;3;9;1;1;1
250892948249;250892948618;369;0,1,2;3;9;1;1;1
250892948618;250892949016;398;0,1,2;3;9;1;1;1
250892949016;250892949141;125;0,1,2;3;9;1;1;1
250892949141;250892949349;208;0,1,2;3;9;1;1;1
250892949349;250892949483;134;0,1,2;3;9;1;1;1
250892949483;250892949647;164;0,1,2;3;9;1;1;1
250892949647;250892949667;20;0,1,2;3;9;1;1;1
250892949667;250892950565;898;0,1,2;3;9;1;1;1
250892950565;250892950919;354;0,1,2;3;9;1;1;1
250892950919;250892951186;267;0,1,2;3;9;1;1;1
250892951186;250892951542;356;0,1,2;3;9;1;1;1
250892951542;250892951667;125;0,1,2;3;9;1;1;1
250892951667;250892952038;371;0,1,2;3;9;1;1;1
250892952038;250892952748;710;0,1,2;3;9;1;1;1
250892952748;250892953385;637;0,1,2;3;9;1;1;1
250892953385;250892953485;100;0,1,2;3;9;1;1;1
250892953485;250892955724;2239;0,1,2;3;9;1;1;1
250892955724;250892956657;933;0,1,2;3;9;1;1;1
250892956657;250892956683;26;0,1,2;3;9;1;1;1
250892956683;250892956993;310;0,1,2;3;9;1;1;1
250892956993;250892957381;388;0,1,2;3;9;1;1;1
250892957381;250892957390;9;0,1,2;3;9;1;1;1
250892957390;250892957870;480;0,1,2;3;9;1;1;1
250892957870;250892957995;125;0,1,2;3;9;1;1;1
250892957995;250892958766;771;0,1,2;3;9;1;1;1
250892958766;250892958930;164;0,1,2;3;9;1;1;1
250892958930;250892959253;323;0,1,2;3;9;1;1;1
250892959253;250892959622;369;0,1,2;3;9;1;1;1
250892959622;250892959766;144;0,1,2;3;9;1;1;1
250892959766;250892960014;248;0,1,2;3;9;1;1;1
250892960014;250892960213;199;0,1,2;3;9;1;1;1
250892960213;250892960610;397;0,1,2;3;9;1;1;1
250892960610;250892960973;363;0,1,2;3;9;1;1;1
250892960973;250892961480;507;0,1,2;3;9;1;1;1
250892961480;250892962239;759;0,1,2;3;9;1;1;1
250892962239;250892962856;617;0,1,2;3;9;1;1;1
250892962856;250892963999;1143;0,1,2;3;9;1;1;1
250892963999;250892964293;294;0,1,2;3;9;1;1;1
250892964293;250892964495;202;0,1,2;3;9;1;1;1
250892964495;250892965226;731;0,1,2;3;9;1;1;1
250892965226;250892965407;181;0,1,2;3;9;1;1;1
250892965407;250892965548;141;0,1,2;3;9;1;1;1
250892965548;250892965872;324;0,1,2;3;9;1;1;1
250892965872;250892966157;285;0,1,2;3;9;1;1;1
250892966157;250892966178;21;0,1,2;3;9;1;1;1
250892966178;250892966746;568;0,1,2;3;9;1;1;1
250892966746;250892967280;534;0,1,2;3;9;1;1;1
250892967280;250892967345;65;0,1,2;3;9;1;1;1
250892967345;250892968311;966;0,1,2;3;9;1;1;1
250892968311;250892968407;96;0,1,2;3;9;1;1;1
250892968407;250892968761;354;0,1,2;3;9;1;1;1
250892968761;250892969114;353;0,1,2;3;9;1;1;1
250892969114;250892969462;348;0,1,2;3;9;1;1;1
250892969462;250892969549;87;0,1,2;3;9;1;1;1
250892969549;250892969627;78;0,1,2;3;9;1;1;1
250892969627;250892969749;122;0,1,2;3;9;1;1;1
250892969749;250892970207;458;0,1,2;3;9;1;1;1
250892970207;250892971198;991;0,1,2;3;9;1;1;1
250892971198;250892971394;196;0,1,2;3;9;1;1;1
250892971394;250892972525;1131;0,1,2;3;9;1;1;1
250892972525;250892972535;10;0,1,2;3;9;1;1;1
250892972535;250892973097;562;0,1,2;3;9;1;1;1
250892973097;250892973292;195;0,1,2;3;9;1;1;1
250892973292;250892973627;335;0,1,2;3;9;1;1;1
250892973627;250892973916;289;0,1,2;3;9;1;1;1
250892973916;250892974090;174;0,1,2;3;9;1;1;1
250892974090;250892974285;195;0,1,2;3;9;1;1;1
250892974285;250892974818;533;0,1,2;3;9;1;1;1
250892974818;250892974937;119;0,1,2;3;9;1;1;1
250892974937;250892975154;217;0,1,2;3;9;1;1;1
250892975154;250892975668;514;0,1,2;3;9;1;1;1
250892975668;250892976529;861;0,1,2;3;9;1;1;1
250892976529;250892976777;248;0,1,2;3;9;1;1;1
250892976777;250892979061;2284;0,1,2;3;9;1;1;1
250892979061;250892979276;215;0,1,2;3;9;1;1;1
250892979276;250892979317;41;0,1,2;3;9;1;1;1
250892979317;250892979480;163;0,1,2;3;9;1;1;1
250892979480;250892979917;437;0,1,2;3;9;1;1;1
250892979917;250892980567;650;0,1,2;3;9;1;1;1
250892980567;250892981547;980;0,1,2;3;9;1;1;1
250892981547;250892981868;321;0,1,2;3;9;1;1;1
250892981868;250892982548;680;0,1,2;3;9;1;1;1
250892982548;250892982567;19;0,1,2;3;9;1;1;1
250892982567;250892982788;221;0,1,2;3;9;1;1;1
250892982788;250892982981;193;0,1,2;3;9;1;1;1
250892982981;250892983772;791;0,1,2;3;9;1;1;1
250892983772;250892985733;1961;0,1,2;3;9;1;1;1
250892985733;250892986046;313;0,1,2;3;9;1;1;1
250892986046;250892986082;36;0,1,2;3;9;1;1;1
250892986082;250892986802;720;0,1,2;3;9;1;1;1
250892986802;250892987197;395;0,1,2;3;9;1;1;1
250892987197;250892988695;1498;0,1,2;3;9;1;1;1
250892988695;250892988957;262;0,1,2;3;9;1;1;1
250892988957;250892990016;1059;0,1,2;3;9;1;1;1
250892990016;250892990372;356;0,1,2;3;9;1;1;1
250892990372;250892990680;308;0,1,2;3;9;1;1;1
250892990680;250892990689;9;0,1,2;3;9;1;1;1
250892990689;250892990717;28;0,1,2;3;9;1;1;1
250892990717;250892991032;315;0,1,2;3;9;1;1;1
250892991032;250892991315;283;0,1,2;3;9;1;1;1
250892991315;250892991803;488;0,1,2;3;9;1;1;1
250892991803;250892992117;314;0,1,2;3;9;1;1;1
250892992117;250892992242;125;0,1,2;3;9;1;1;1
250892992242;250892992555;313;0,1,2;3;9;1;1;1
250892992555;250892992751;196;0,1,2;3;9;1;1;1
250892992751;250892993126;375;0,1,2;3;9;1;1;1
250892993126;250892994062;936;0,1,2;3;9;1;1;1
250892994062;250892994261;199;0,1,2;3;9;1;1;1
250892994261;250892994503;242;0,1,2;3;9;1;1;1
250892994503;250892994828;325;0,1,2;3;9;1;1;1
250892994828;250892995003;175;0,1,2;3;9;1;1;1
250892995003;250892995146;143;0,1,2;3;9;1;1;1
250892995146;250892995446;300;0,1,2;3;9;1;1;1
250892995446;250892995476;30;0,1,2;3;9;1;1;1
250892995476;250892995802;326;0,1,2;3;9;1;1;1
250892995802;250892996428;626;0,1,2;3;9;1;1;1
250892996428;250892997031;603;0,1,2;3;9;1;1;1
250892997031;250892999333;2302;0,1,2;3;9;1;1;1
250892999333;250892999696;363;0,1,2;3;9;1;1;1
250892999696;250893001485;1789;0,1,2;3;9;1;1;1
250893001485;250893001598;113;0,1,2;3;9;1;1;1
250893001598;250893002574;976;0,1,2;3;9;1;1;1
250893002574;250893002819;245;0,1,2;3;9;1;1;1
250893002819;250893003341;522;0,1,2;3;9;1;1;1
250893003341;250893003768;427;0,1,2;3;9;1;1;1
250893003768;250893005053;1285;0,1,2;3;9;1;1;1
250893005053;250893005067;14;0,1,2;3;9;1;1;1
250893005067;250893005366;299;0,1,2;3;9;1;1;1
250893005366;250893005443;77;0,1,2;3;9;1;1;1
250893005443;250893005535;92;0,1,2;3;9;1;1;1
250893005535;250893005675;140;0,1,2;3;9;1;1;1
250893005675;250893006694;1019;0,1,2;3;9;1;1;1
250893006694;250893006887;193;0,1,2;3;9;1;1;1
250893006887;250893006925;38;0,1,2;3;9;1;1;1
250893006925;250893007426;501;0,1,2;3;9;1;1;1
250893007426;250893007574;148;0,1,2;3;9;1;1;1
250893007574;250893007792;218;0,1,2;3;9;1;1;1
250893007792;250893008428;636;0,1,2;3;9;1;1;1
250893008428;250893008733;305;0,1,2;3;9;1;1;1
250893008733;250893011270;2537;0,1,2;3;9;1;1;1
250893011270;250893012560;1290;0,1,2;3;9;1;1;1
250893012560;250893013756;1196;0,1,2;3;9;1;1;1
250893013756;250893014075;319;0,1,2;3;9;1;1;1
250893014075;250893014374;299;0,1,2;3;9;1;1;1
250893014374;250893014760;386;0,1,2;3;9;1;1;1
250893014760;250893014781;21;0,1,2;3;9;1;1;1
250893014781;250893014902;121;0,1,2;3;9;1;1;1
250893014902;250893014912;10;0,1,2;3;9;1;1;1
250893014912;250893015428;516;0,1,2;3;9;1;1;1
250893015428;250893015547;119;0,1,2;3;9;1;1;1
250893015547;250893015923;376;0,1,2;3;9;1;1;1
250893015923;250893016099;176;0,1,2;3;9;1;1;1
250893016099;250893016164;65;0,1,2;3;9;1;1;1
250893016164;250893016275;111;0,1,2;3;9;1;1;1
250893016275;250893016292;17;0,1,2;3;9;1;1;1
250893016292;250893016673;381;0,1,2;3;9;1;1;1
250893016673;250893016733;60;0,1,2;3;9;1;1;1
250893016733;250893017029;296;0,1,2;3;9;1;1;1
250893017029;250893017330;301;0,1,2;3;9;1;1;1
250893017330;250893017455;125;0,1,2;3;9;1;1;1
250893017455;250893017617;162;0,1,2;3;9;1;1;1
250893017617;250893017777;160;0,1,2;3;9;1;1;1
250893017777;250893017867;90;0,1,2;3;9;1;1;1
250893017867;250893018877;1010;0,1,2;3;9;1;1;1
250893018877;250893019241;364;0,1,2;3;9;1;1;1
250893019241;250893019279;38;0,1,2;3;9;1;1;1
250893019279;250893019375;96;0,1,2;3;9;1;1;1
250893019375;250893019425;50;0,1,2;3;9;1;1;1
250893019425;250893019466;41;0,1,2;3;9;1;1;1
250893019466;250893020132;666;0,1,2;3;9;1;1;1
250893020132;250893020831;699;0,1,2;3;9;1;1;1
250893020831;250893020890;59;0,1,2;3;9;1;1;1
250893020890;250893021052;162;0,1,2;3;9;1;1;1
250893021052;250893021508;456;0,1,2;3;9;1;1;1
250893021508;250893022131;623;0,1,2;3;9;1;1;1
250893022131;250893023356;1225;0,1,2;3;9;1;1;1
250893023356;250893023730;374;0,1,2;3;9;1;1;1
250893023730;250893023905;175;0,1,2;3;9;1;1;1
250893023905;250893023919;14;0,1,2;3;9;1;1;1
250893023919;250893024146;227;0,1,2;3;9;1;1;1
250893024146;250893024349;203;0,1,2;3;9;1;1;1
250893024349;250893024906;557;0,1,2;3;9;1;1;1
250893024906;250893024922;16;0,1,2;3;9;1;1;1
250893024922;250893025014;92;0,1,2;3;9;1;1;1
250893025014;250893025217;203;0,1,2;3;9;1;1;1
250893025217;250893025902;685;0,1,2;3;9;1;1;1
250893025902;250893025922;20;0,1,2;3;9;1;1;1
250893025922;250893026138;216;0,1,2;3;9;1;1;1
250893026138;250893026430;292;0,1,2;3;9;1;1;1
250893026430;250893026901;471;0,1,2;3;9;1;1;1
250893026901;250893027149;248;0,1,2;3;9;1;1;1
250893027149;250893027192;43;0,1,2;3;9;1;1;1
250893027192;250893027451;259;0,1,2;3;9;1;1;1
250893027451;250893027574;123;0,1,2;3;9;1;1;1
250893027574;250893029104;1530;0,1,2;3;9;1;1;1
250893029104;250893029313;209;0,1,2;3;9;1;1;1
250893029313;250893030205;892;0,1,2;3;9;1;1;1
250893030205;250893030627;422;0,1,2;3;9;1;1;1
250893030627;250893030992;365;0,1,2;3;9;1;1;1
250893030992;250893032468;1476;0,1,2;3;9;1;1;1
250893032468;250893033272;804;0,1,2;3;9;1;1;1
250893033272;250893033325;53;0,1,2;3;9;1;1;1
250893033325;250893033601;276;0,1,2;3;9;1;1;1
250893033601;250893034224;623;0,1,2;3;9;1;1;1
250893034224;250893034426;202;0,1,2;3;9;1;1;1
250893034426;250893034581;155;0,1,2;3;9;1;1;1
250893034581;250893035558;977;0,1,2;3;9;1;1;1
250893035558;250893035848;290;0,1,2;3;9;1;1;1
250893035848;250893035852;4;0,1,2;3;9;1;1;1
250893035852;250893036161;309;0,1,2;3;9;1;1;1
250893036161;250893036476;315;0,1,2;3;9;1;1;1
250893036476;250893037047;571;0,1,2;3;9;1;1;1
250893037047;250893037214;167;0,1,2;3;9;1;1;1
250893037214;250893037335;121;0,1,2;3;9;1;1;1
250893037335;250893037427;92;0,1,2;3;9;1;1;1
250893037427;250893037731;304;0,1,2;3;9;1;1;1
250893037731;250893038184;453;0,1,2;3;9;1;1;1
250893038184;250893038282;98;0,1,2;3;9;1;1;1
250893038282;250893038436;154;0,1,2;3;9;1;1;1
250893038436;250893039211;775;0,1,2;3;9;1;1;1
250893039211;250893039602;391;0,1,2;3;9;1;1;1
250893039602;250893042952;3350;0,1,2;3;9;1;1;1
250893042952;250893043082;130;0,1,2;3;9;1;1;1
250893043082;250893045934;2852;0,1,2;3;9;1;1;1
250893045934;250893046296;362;0,1,2;3;9;1;1;1
250893046296;250893047873;1577;0,1,2;3;9;1;1;1
250893047873;250893047985;112;0,1,2;3;9;1;1;1
250893047985;250893048105;120;0,1,2;3;9;1;1;1
250893048105;250893048301;196;0,1,2;3;9;1;1;1
250893048301;250893048309;8;0,1,2;3;9;1;1;1
250893048309;250893048328;19;0,1,2;3;9;1;1;1
250893048328;250893048333;5;0,1,2;3;9;1;1;1
250893048333;250893048521;188;0,1,2;3;9;1;1;1
250893048521;250893048647;126;0,1,2;3;9;1;1;1
250893048647;250893048839;192;0,1,2;3;9;1;1;1
250893048839;250893048856;17;0,1,2;3;9;1;1;1
250893048856;250893049108;252;0,1,2;3;9;1;1;1
250893049108;250893049334;226;0,1,2;3;9;1;1;1
250893049334;250893049439;105;0,1,2;3;9;1;1;1
250893049439;250893050112;673;0,1,2;3;9;1;1;1
250893050112;250893050244;132;0,1,2;3;9;1;1;1
250893050244;250893052038;1794;0,1,2;3;9;1;1;1
250893052038;250893052601;563;0,1,2;3;9;1;1;1
250893052601;250893053051;450;0,1,2;3;9;1;1;1
250893053051;250893053136;85;0,1,2;3;9;1;1;1
250893053136;250893054477;1341;0,1,2;3;9;1;1;1
250893054477;250893055569;1092;0,1,2;3;9;1;1;1
250893055569;250893055782;213;0,1,2;3;9;1;1;1
250893055782;250893056362;580;0,1,2;3;9;1;1;1
250893056362;250893056531;169;0,1,2;3;9;1;1;1
250893056531;250893057134;603;0,1,2;3;9;1;1;1
250893057134;250893058078;944;0,1,2;3;9;1;1;1
250893058078;250893058273;195;0,1,2;3;9;1;1;1
250893058273;250893058585;312;0,1,2;3;9;1;1;1
250893058585;250893059234;649;0,1,2;3;9;1;1;1
250893059234;250893059853;619;0,1,2;3;9;1;1;1
250893059853;250893060535;682;0,1,2;3;9;1;1;1
250893060535;250893061019;484;0,1,2;3;9;1;1;1
250893061019;250893061206;187;0,1,2;3;9;1;1;1
250893061206;250893061500;294;0,1,2;3;9;1;1;1
250893061500;250893061617;117;0,1,2;3;9;1;1;1
250893061617;250893061872;255;0,1,2;3;9;1;1;1
250893061872;250893061888;16;0,1,2;3;9;1;1;1
250893061888;250893062003;115;0,1,2;3;9;1;1;1
250893062003;250893062051;48;0,1,2;3;9;1;1;1
250893062051;250893062149;98;0,1,2;3;9;1;1;1
250893062149;250893062338;189;0,1,2;3;9;1;1;1
250893062338;250893062500;162;0,1,2;3;9;1;1;1
250893062500;250893062693;193;0,1,2;3;9;1;1;1
250893062693;250893062802;109;0,1,2;3;9;1;1;1
250893062802;250893063601;799;0,1,2;3;9;1;1;1
250893063601;250893064409;808;0,1,2;3;9;1;1;1
250893064409;250893065776;1367;0,1,2;3;9;1;1;1
250893065776;250893066076;300;0,1,2;3;9;1;1;1
250893066076;250893066397;321;0,1,2;3;9;1;1;1
250893066397;250893066929;532;0,1,2;3;9;1;1;1
250893066929;250893067346;417;0,1,2;3;9;1;1;1
250893067346;250893067537;191;0,1,2;3;9;1;1;1
250893067537;250893067916;379;0,1,2;3;9;1;1;1
250893067916;250893068221;305;0,1,2;3;9;1;1;1
250893068221;250893068751;530;0,1,2;3;9;1;1;1
250893068751;250893068787;36;0,1,2;3;9;1;1;1
250893068787;250893069012;225;0,1,2;3;9;1;1;1
250893069012;250893069174;162;0,1,2;3;9;1;1;1
250893069174;250893070187;1013;0,1,2;3;9;1;1;1
250893070187;250893070241;54;0,1,2;3;9;1;1;1
250893070241;250893070534;293;0,1,2;3;9;1;1;1
250893070534;250893070867;333;0,1,2;3;9;1;1;1
250893070867;250893070875;8;0,1,2;3;9;1;1;1
250893070875;250893070967;92;0,1,2;3;9;1;1;1
250893070967;250893071261;294;0,1,2;3;9;1;1;1
250893071261;250893071559;298;0,1,2;3;9;1;1;1
250893071559;250893072537;978;0,1,2;3;9;1;1;1
250893072537;250893072854;317;0,1,2;3;9;1;1;1
250893072854;250893072884;30;0,1,2;3;9;1;1;1
250893072884;250893072992;108;0,1,2;3;9;1;1;1
250893072992;250893074635;1643;0,1,2;3;9;1;1;1
250893074635;250893074881;246;0,1,2;3;9;1;1;1
250893074881;250893075724;843;0,1,2;3;9;1;1;1
250893075724;250893075830;106;0,1,2;3;9;1;1;1
250893075830;250893076517;687;0,1,2;3;9;1;1;1
250893076517;250893076874;357;0,1,2;3;9;1;1;1
250893076874;250893076900;26;0,1,2;3;9;1;1;1
250893076900;250893076971;71;0,1,2;3;9;1;1;1
250893076971;250893077242;271;0,1,2;3;9;1;1;1
250893077242;250893077538;296;0,1,2;3;9;1;1;1
250893077538;250893077887;349;0,1,2;3;9;1;1;1
250893077887;250893078420;533;0,1,2;3;9;1;1;1
250893078420;250893078524;104;0,1,2;3;9;1;1;1
250893078524;250893078551;27;0,1,2;3;9;1;1;1
250893078551;250893078673;122;0,1,2;3;9;1;1;1
250893078673;250893078817;144;0,1,2;3;9;1;1;1
250893078817;250893079059;242;0,1,2;3;9;1;1;1
250893079059;250893079559;500;0,1,2;3;9;1;1;1
250893079559;250893079813;254;0,1,2;3;9;1;1;1
250893079813;250893080321;508;0,1,2;3;9;1;1;1
250893080321;250893080552;231;0,1,2;3;9;1;1;1
250893080552;250893081133;581;0,1,2;3;9;1;1;1
250893081133;250893081608;475;0,1,2;3;9;1;1;1
250893081608;250893082503;895;0,1,2;3;9;1;1;1
250893082503;250893082514;11;0,1,2;3;9;1;1;1
250893082514;250893082558;44;0,1,2;3;9;1;1;1
250893082558;250893082735;177;0,1,2;3;9;1;1;1
250893082735;250893082891;156;0,1,2;3;9;1;1;1
250893082891;250893083023;132;0,1,2;3;9;1;1;1
250893083023;250893083704;681;0,1,2;3;9;1;1;1
250893083704;250893083797;93;0,1,2;3;9;1;1;1
250893083797;250893083917;120;0,1,2;3;9;1;1;1
250893083917;250893084001;84;0,1,2;3;9;1;1;1
250893084001;250893084987;986;0,1,2;3;9;1;1;1
250893084987;250893085245;258;0,1,2;3;9;1;1;1
250893085245;250893085298;53;0,1,2;3;9;1;1;1
250893085298;250893085864;566;0,1,2;3;9;1;1;1
250893085864;250893085980;116;0,1,2;3;9;1;1;1
250893085980;250893086027;47;0,1,2;3;9;1;1;1
250893086027;250893086110;83;0,1,2;3;9;1;1;1
250893086110;250893086198;88;0,1,2;3;9;1;1;1
250893086198;250893086628;430;0,1,2;3;9;1;1;1
250893086628;250893086736;108;0,1,2;3;9;1;1;1
250893086736;250893086800;64;0,1,2;3;9;1;1;1
250893086800;250893086805;5;0,1,2;3;9;1;1;1
250893086805;250893086879;74;0,1,2;3;9;1;1;1
250893086879;250893087064;185;0,1,2;3;9;1;1;1
250893087064;250893087241;177;0,1,2;3;9;1;1;1
250893087241;250893087826;585;0,1,2;3;9;1;1;1
250893087826;250893088191;365;0,1,2;3;9;1;1;1
250893088191;250893088383;192;0,1,2;3;9;1;1;1
250893088383;250893088430;47;0,1,2;3;9;1;1;1
250893088430;250893089486;1056;0,1,2;3;9;1;1;1
250893089486;250893091539;2053;0,1,2;3;9;1;1;1
250893091539;250893092319;780;0,1,2;3;9;1;1;1
250893092319;250893092539;220;0,1,2;3;9;1;1;1
250893092539;250893092990;451;0,1,2;3;9;1;1;1
250893092990;250893093274;284;0,1,2;3;9;1;1;1
250893093274;250893093550;276;0,1,2;3;9;1;1;1
250893093550;250893093558;8;0,1,2;3;9;1;1;1
250893093558;250893093779;221;0,1,2;3;9;1;1;1
250893093779;250893093908;129;0,1,2;3;9;1;1;1
250893093908;250893093943;35;0,1,2;3;9;1;1;1
250893093943;250893094111;168;0,1,2;3;9;1;1;1
250893094111;250893094474;363;0,1,2;3;9;1;1;1
250893094474;250893094831;357;0,1,2;3;9;1;1;1
250893094831;250893095154;323;0,1,2;3;9;1;1;1
250893095154;250893095738;584;0,1,2;3;9;1;1;1
250893095738;250893095787;49;0,1,2;3;9;1;1;1
250893095787;250893096277;490;0,1,2;3;9;1;1;1
250893096277;250893096916;639;0,1,2;3;9;1;1;1
250893096916;250893097759;843;0,1,2;3;9;1;1;1
250893097759;250893098124;365;0,1,2;3;9;1;1;1
250893098124;250893098771;647;0,1,2;3;9;1;1;1
250893098771;250893099102;331;0,1,2;3;9;1;1;1
250893099102;250893099386;284;0,1,2;3;9;1;1;1
250893099386;250893099560;174;0,1,2;3;9;1;1;1
250893099560;250893101609;2049;0,1,2;3;9;1;1;1
250893101609;250893101628;19;0,1,2;3;9;1;1;1
250893101628;250893103011;1383;0,1,2;3;9;1;1;1
250893103011;250893103225;214;0,1,2;3;9;1;1;1
250893103225;250893104980;1755;0,1,2;3;9;1;1;1
250893104980;250893105068;88;0,1,2;3;9;1;1;1
250893105068;250893105426;358;0,1,2;3;9;1;1;1
250893105426;250893105459;33;0,1,2;3;9;1;1;1
250893105459;250893106757;1298;0,1,2;3;9;1;1;1
250893106757;250893107961;1204;0,1,2;3;9;1;1;1
250893107961;250893108336;375;0,1,2;3;9;1;1;1
250893108336;250893110431;2095;0,1,2;3;9;1;1;1
250893110431;250893110554;123;0,1,2;3;9;1;1;1
250893110554;250893111449;895;0,1,2;3;9;1;1;1
250893111449;250893112217;768;0,1,2;3;9;1;1;1
250893112217;250893112332;115;0,1,2;3;9;1;1;1
250893112332;250893112543;211;0,1,2;3;9;1;1;1
250893112543;250893113033;490;0,1,2;3;9;1;1;1
250893113033;250893113227;194;0,1,2;3;9;1;1;1
250893113227;250893113445;218;0,1,2;3;9;1;1;1
250893113445;250893114543;1098;0,1,2;3;9;1;1;1
250893114543;250893114733;190;0,1,2;3;9;1;1;1
250893114733;250893114898;165;0,1,2;3;9;1;1;1
250893114898;250893114901;3;0,1,2;3;9;1;1;1
250893114901;250893115286;385;0,1,2;3;9;1;1;1
250893115286;250893115385;99;0,1,2;3;9;1;1;1
250893115385;250893115392;7;0,1,2;3;9;1;1;1
250893115392;250893115403;11;0,1,2;3;9;1;1;1
250893115403;250893116012;609;0,1,2;3;9;1;1;1
250893116012;250893116419;407;0,1,2;3;9;1;1;1
250893116419;250893120940;4521;0,1,2;3;9;1;1;1
250893120940;250893121422;482;0,1,2;3;9;1;1;1
250893121422;250893121663;241;0,1,2;3;9;1;1;1
250893121663;250893121985;322;0,1,2;3;9;1;1;1
250893121985;250893122111;126;0,1,2;3;9;1;1;1
250893122111;250893122404;293;0,1,2;3;9;1;1;1
250893122404;250893122443;39;0,1,2;3;9;1;1;1
250893122443;250893122663;220;0,1,2;3;9;1;1;1
250893122663;250893122792;129;0,1,2;3;9;1;1;1
250893122792;250893123114;322;0,1,2;3;9;1;1;1
250893123114;250893123522;408;0,1,2;3;9;1;1;1
250893123522;250893123842;320;0,1,2;3;9;1;1;1
250893123842;250893124364;522;0,1,2;3;9;1;1;1
250893124364;250893124417;53;0,1,2;3;9;1;1;1
250893124417;250893126118;1701;0,1,2;3;9;1;1;1
250893126118;250893126259;141;0,1,2;3;9;1;1;1
250893126259;250893126759;500;0,1,2;3;9;1;1;1
250893126759;250893127904;1145;0,1,2;3;9;1;1;1
250893127904;250893127969;65;0,1,2;3;9;1;1;1
250893127969;250893128114;145;0,1,2;3;9;1;1;1
250893128114;250893128354;240;0,1,2;3;9;1;1;1
250893128354;250893128809;455;0,1,2;3;9;1;1;1
250893128809;250893129193;384;0,1,2;3;9;1;1;1
250893129193;250893129294;101;0,1,2;3;9;1;1;1
250893129294;250893129419;125;0,1,2;3;9;1;1;1
250893129419;250893129677;258;0,1,2;3;9;1;1;1
250893129677;250893130885;1208;0,1,2;3;9;1;1;1
250893130885;250893131068;183;0,1,2;3;9;1;1;1
250893131068;250893131731;663;0,1,2;3;9;1;1;1
250893131731;250893131813;82;0,1,2;3;9;1;1;1
250893131813;250893132094;281;0,1,2;3;9;1;1;1
250893132094;250893132098;4;0,1,2;3;9;1;1;1
250893132098;250893132320;222;0,1,2;3;9;1;1;1
250893132320;250893132493;173;0,1,2;3;9;1;1;1
250893132493;250893132676;183;0,1,2;3;9;1;1;1
250893132676;250893132688;12;0,1,2;3;9;1;1;1
250893132688;250893132695;7;0,1,2;3;9;1;1;1
250893132695;250893133119;424;0,1,2;3;9;1;1;1
250893133119;250893133230;111;0,1,2;3;9;1;1;1
250893133230;250893133447;217;0,1,2;3;9;1;1;1
250893133447;250893134872;1425;0,1,2;3;9;1;1;1
250893134872;250893135130;258;0,1,2;3;9;1;1;1
250893135130;250893135258;128;0,1,2;3;9;1;1;1
250893135258;250893135518;260;0,1,2;3;9;1;1;1
250893135518;250893135647;129;0,1,2;3;9;1;1;1
250893135647;250893136779;1132;0,1,2;3;9;1;1;1
250893136779;250893137467;688;0,1,2;3;9;1;1;1
250893137467;250893138005;538;0,1,2;3;9;1;1;1
250893138005;250893138230;225;0,1,2;3;9;1;1;1
250893138230;250893139025;795;0,1,2;3;9;1;1;1
250893139025;250893139537;512;0,1,2;3;9;1;1;1
250893139537;250893140122;585;0,1,2;3;9;1;1;1
250893140122;250893140258;136;0,1,2;3;9;1;1;1
250893140258;250893140701;443;0,1,2;3;9;1;1;1
250893140701;250893141199;498;0,1,2;3;9;1;1;1
250893141199;250893142007;808;0,1,2;3;9;1;1;1
250893142007;250893143308;1301;0,1,2;3;9;1;1;1
250893143308;250893143634;326;0,1,2;3;9;1;1;1
250893143634;250893143993;359;0,1,2;3;9;1;1;1
250893143993;250893144017;24;0,1,2;3;9;1;1;1
250893144017;250893144103;86;0,1,2;3;9;1;1;1
250893144103;250893144243;140;0,1,2;3;9;1;1;1
250893144243;250893144726;483;0,1,2;3;9;1;1;1
250893144726;250893145926;1200;0,1,2;3;9;1;1;1
250893145926;250893146247;321;0,1,2;3;9;1;1;1
250893146247;250893146260;13;0,1,2;3;9;1;1;1
250893146260;250893146993;733;0,1,2;3;9;1;1;1
250893146993;250893147770;777;0,1,2;3;9;1;1;1
250893147770;250893147959;189;0,1,2;3;9;1;1;1
250893147959;250893149061;1102;0,1,2;3;9;1;1;1
250893149061;250893149895;834;0,1,2;3;9;1;1;1
250893149895;250893150245;350;0,1,2;3;9;1;1;1
250893150245;250893152901;2656;0,1,2;3;9;1;1;1
250893152901;250893153152;251;0,1,2;3;9;1;1;1
250893153152;250893153314;162;0,1,2;3;9;1;1;1
250893153314;250893153322;8;0,1,2;3;9;1;1;1
250893153322;250893153417;95;0,1,2;3;9;1;1;1
250893153417;250893153625;208;0,1,2;3;9;1;1;1
250893153625;250893154752;1127;0,1,2;3;9;1;1;1
250893154752;250893155321;569;0,1,2;3;9;1;1;1
250893155321;250893155797;476;0,1,2;3;9;1;1;1
250893155797;250893156683;886;0,1,2;3;9;1;1;1
250893156683;250893156830;147;0,1,2;3;9;1;1;1
250893156830;250893156865;35;0,1,2;3;9;1;1;1
250893156865;250893157051;186;0,1,2;3;9;1;1;1
250893157051;250893157170;119;0,1,2;3;9;1;1;1
250893157170;250893157442;272;0,1,2;3;9;1;1;1
250893157442;250893157444;2;0,1,2;3;9;1;1;1
250893157444;250893157909;465;0,1,2;3;9;1;1;1
250893157909;250893158057;148;0,1,2;3;9;1;1;1
250893158057;250893158834;777;0,1,2;3;9;1;1;1
250893158834;250893159097;263;0,1,2;3;9;1;1;1
250893159097;250893159423;326;0,1,2;3;9;1;1;1
250893159423;250893160835;1412;0,1,2;3;9;1;1;1
250893160835;250893160972;137;0,1,2;3;9;1;1;1
250893160972;250893162744;1772;0,1,2;3;9;1;1;1
250893162744;250893164179;1435;0,1,2;3;9;1;1;1
250893164179;250893164849;670;0,1,2;3;9;1;1;1
250893164849;250893165443;594;0,1,2;3;9;1;1;1
250893165443;250893167086;1643;0,1,2;3;9;1;1;1
250893167086;250893169478;2392;0,1,2;3;9;1;1;1
250893169478;250893169981;503;0,1,2;3;9;1;1;1
250893169981;250893170210;229;0,1,2;3;9;1;1;1
250893170210;250893170242;32;0,1,2;3;9;1;1;1
250893170242;250893170394;152;0,1,2;3;9;1;1;1
250893170394;250893170439;45;0,1,2;3;9;1;1;1
250893170439;250893170527;88;0,1,2;3;9;1;1;1
250893170527;250893170938;411;0,1,2;3;9;1;1;1
250893170938;250893171076;138;0,1,2;3;9;1;1;1
250893171076;250893171791;715;0,1,2;3;9;1;1;1
250893171791;250893172902;1111;0,1,2;3;9;1;1;1
250893172902;250893172964;62;0,1,2;3;9;1;1;1
250893172964;250893172996;32;0,1,2;3;9;1;1;1
250893172996;250893175061;2065;0,1,2;3;9;1;1;1
250893175061;250893175100;39;0,1,2;3;9;1;1;1
250893175100;250893176186;1086;0,1,2;3;9;1;1;1
250893176186;250893176573;387;0,1,2;3;9;1;1;1
250893176573;250893176631;58;0,1,2;3;9;1;1;1
250893176631;250893176807;176;0,1,2;3;9;1;1;1
250893176807;250893178010;1203;0,1,2;3;9;1;1;1
250893178010;250893178113;103;0,1,2;3;9;1;1;1
250893178113;250893178431;318;0,1,2;3;9;1;1;1
250893178431;250893179616;1185;0,1,2;3;9;1;1;1
250893179616;250893180350;734;0,1,2;3;9;1;1;1
250893180350;250893181257;907;0,1,2;3;9;1;1;1
250893181257;250893182240;983;0,1,2;3;9;1;1;1
250893182240;250893182684;444;0,1,2;3;9;1;1;1
250893182684;250893182995;311;0,1,2;3;9;1;1;1
250893182995;250893183094;99;0,1,2;3;9;1;1;1
250893183094;250893183217;123;0,1,2;3;9;1;1;1
250893183217;250893183239;22;0,1,2;3;9;1;1;1
250893183239;250893183339;100;0,1,2;3;9;1;1;1
250893183339;250893183500;161;0,1,2;3;9;1;1;1
250893183500;250893185897;2397;0,1,2;3;9;1;1;1
250893185897;250893186361;464;0,1,2;3;9;1;1;1
250893186361;250893186555;194;0,1,2;3;9;1;1;1
250893186555;250893188821;2266;0,1,2;3;9;1;1;1
250893188821;250893188854;33;0,1,2;3;9;1;1;1
250893188854;250893188887;33;0,1,2;3;9;1;1;1
250893188887;250893189036;149;0,1,2;3;9;1;1;1
250893189036;250893189729;693;0,1,2;3;9;1;1;1
250893189729;250893194104;4375;0,1,2;3;9;1;1;1
250893194104;250893194363;259;0,1,2;3;9;1;1;1
250893194363;250893194513;150;0,1,2;3;9;1;1;1
250893194513;250893195497;984;0,1,2;3;9;1;1;1
250893195497;250893195511;14;0,1,2;3;9;1;1;1
250893195511;250893195668;157;0,1,2;3;9;1;1;1
250893195668;250893197209;1541;0,1,2;3;9;1;1;1
250893197209;250893199553;2344;0,1,2;3;9;1;1;1
250893199553;250893199746;193;0,1,2;3;9;1;1;1
250893199746;250893206784;7038;0,1,2;3;9;1;1;1
250893206784;250893207113;329;0,1,2;3;9;1;1;1
250893207113;250893207159;46;0,1,2;3;9;1;1;1
250893207159;250893210436;3277;0,1,2;3;9;1;1;1
250893210436;250893211267;831;0,1,2;3;9;1;1;1
250893211267;250893212700;1433;0,1,2;3;9;1;1;1
250893212700;250893212929;229;0,1,2;3;9;1;1;1
250893212929;250893213211;282;0,1,2;3;9;1;1;1
250893213211;250893213717;506;0,1,2;3;9;1;1;1
250893213717;250893214043;326;0,1,2;3;9;1;1;1
250893214043;250893214237;194;0,1,2;3;9;1;1;1
250893214237;250893215667;1430;0,1,2;3;9;1;1;1
250893215667;250893216808;1141;0,1,2;3;9;1;1;1
250893216808;250893217078;270;0,1,2;3;9;1;1;1
250893217078;250893217235;157;0,1,2;3;9;1;1;1
250893217235;250893217360;125;0,1,2;3;9;1;1;1
250893217360;250893218200;840;0,1,2;3;9;1;1;1
250893218200;250893218633;433;0,1,2;3;9;1;1;1
250893218633;250893218815;182;0,1,2;3;9;1;1;1
250893218815;250893219035;220;0,1,2;3;9;1;1;1
250893219035;250893220422;1387;0,1,2;3;9;1;1;1
250893220422;250893220750;328;0,1,2;3;9;1;1;1
250893220750;250893220818;68;0,1,2;3;9;1;1;1
250893220818;250893221051;233;0,1,2;3;9;1;1;1
250893221051;250893223794;2743;0,1,2;3;9;1;1;1
250893223794;250893223966;172;0,1,2;3;9;1;1;1
250893223966;250893224068;102;0,1,2;3;9;1;1;1
250893224068;250893224221;153;0,1,2;3;9;1;1;1
250893224221;250893224524;303;0,1,2;3;9;1;1;1
250893224524;250893224711;187;0,1,2;3;9;1;1;1
250893224711;250893225131;420;0,1,2;3;9;1;1;1
250893225131;250893225512;381;0,1,2;3;9;1;1;1
250893225512;250893226136;624;0,1,2;3;9;1;1;1
250893226136;250893226272;136;0,1,2;3;9;1;1;1
250893226272;250893226732;460;0,1,2;3;9;1;1;1
250893226732;250893227823;1091;0,1,2;3;9;1;1;1
250893227823;250893227976;153;0,1,2;3;9;1;1;1
250893227976;250893228572;596;0,1,2;3;9;1;1;1
250893228572;250893228599;27;0,1,2;3;9;1;1;1
250893228599;250893229176;577;0,1,2;3;9;1;1;1
250893229176;250893229748;572;0,1,2;3;9;1;1;1
250893229748;250893229952;204;0,1,2;3;9;1;1;1
250893229952;250893230313;361;0,1,2;3;9;1;1;1
250893230313;250893230917;604;0,1,2;3;9;1;1;1
250893230917;250893231003;86;0,1,2;3;9;1;1;1
250893231003;250893231766;763;0,1,2;3;9;1;1;1
250893231766;250893232401;635;0,1,2;3;9;1;1;1
250893232401;250893232738;337;0,1,2;3;9;1;1;1
250893232738;250893232931;193;0,1,2;3;9;1;1;1
250893232931;250893233237;306;0,1,2;3;9;1;1;1
250893233237;250893233965;728;0,1,2;3;9;1;1;1
250893233965;250893234348;383;0,1,2;3;9;1;1;1
250893234348;250893234448;100;0,1,2;3;9;1;1;1
250893234448;250893234848;400;0,1,2;3;9;1;1;1
250893234848;250893237594;2746;0,1,2;3;9;1;1;1
250893237594;250893237893;299;0,1,2;3;9;1;1;1
250893237893;250893238981;1088;0,1,2;3;9;1;1;1
250893238981;250893239376;395;0,1,2;3;9;1;1;1
250893239376;250893239436;60;0,1,2;3;9;1;1;1
250893239436;250893239815;379;0,1,2;3;9;1;1;1
250893239815;250893241048;1233;0,1,2;3;9;1;1;1
250893241048;250893242509;1461;0,1,2;3;9;1;1;1
250893242509;250893242870;361;0,1,2;3;9;1;1;1
250893242870;250893243987;1117;0,1,2;3;9;1;1;1
250893243987;250893244499;512;0,1,2;3;9;1;1;1
250893244499;250893245132;633;0,1,2;3;9;1;1;1
250893245132;250893245156;24;0,1,2;3;9;1;1;1
250893245156;250893245364;208;0,1,2;3;9;1;1;1
250893245364;250893246670;1306;0,1,2;3;9;1;1;1
250893246670;250893246831;161;0,1,2;3;9;1;1;1
250893246831;250893248086;1255;0,1,2;3;9;1;1;1
250893248086;250893248396;310;0,1,2;3;9;1;1;1
250893248396;250893250417;2021;0,1,2;3;9;1;1;1
250893250417;250893250447;30;0,1,2;3;9;1;1;1
250893250447;250893250548;101;0,1,2;3;9;1;1;1
250893250548;250893251032;484;0,1,2;3;9;1;1;1
250893251032;250893256607;5575;0,1,2;3;9;1;1;1
250893256607;250893259376;2769;0,1,2;3;9;1;1;1
250893259376;250893259386;10;0,1,2;3;9;1;1;1
250893259386;250893259481;95;0,1,2;3;9;1;1;1
250893259481;250893259578;97;0,1,2;3;9;1;1;1
250893259578;250893259690;112;0,1,2;3;9;1;1;1
250893259690;250893259804;114;0,1,2;3;9;1;1;1
250893259804;250893260424;620;0,1,2;3;9;1;1;1
250893260424;250893261073;649;0,1,2;3;9;1;1;1
250893261073;250893262620;1547;0,1,2;3;9;1;1;1
250893262620;250893263861;1241;0,1,2;3;9;1;1;1
250893263861;250893265313;1452;0,1,2;3;9;1;1;1
250893265313;250893272502;7189;0,1,2;3;9;1;1;1
250893272502;250893276710;4208;0,1,2;3;9;1;1;1
250893276710;250893276764;54;0,1,2;3;9;1;1;1
250893276764;250893276773;9;0,1,2;3;9;1;1;1
250893276773;250893276813;40;0,1,2;3;9;1;1;1
250893276813;250893278118;1305;0,1,2;3;9;1;1;1
250893278118;250893278443;325;0,1,2;3;9;1;1;1
250893278443;250893278460;17;0,1,2;3;9;1;1;1
250893278460;250893278797;337;0,1,2;3;9;1;1;1
250893278797;250893279581;784;0,1,2;3;9;1;1;1
250893279581;250893283084;3503;0,1,2;3;9;1;1;1
250893283084;250893283172;88;0,1,2;3;9;1;1;1
250893283172;250893284571;1399;0,1,2;3;9;1;1;1
250893284571;250893284616;45;0,1,2;3;9;1;1;1
250893284616;250893284648;32;0,1,2;3;9;1;1;1
250893284648;250893289014;4366;0,1,2;3;9;1;1;1
250893289014;250893289168;154;0,1,2;3;9;1;1;1
250893289168;250893290623;1455;0,1,2;3;9;1;1;1
250893290623;250893290647;24;0,1,2;3;9;1;1;1
250893290647;250893291037;390;0,1,2;3;9;1;1;1
250893291037;250893291577;540;0,1,2;3;9;1;1;1
250893291577;250893291695;118;0,1,2;3;9;1;1;1
250893291695;250893291771;76;0,1,2;3;9;1;1;1
250893291771;250893292049;278;0,1,2;3;9;1;1;1
250893292049;250893292103;54;0,1,2;3;9;1;1;1
250893292103;250893292460;357;0,1,2;3;9;1;1;1
250893292460;250893293329;869;0,1,2;3;9;1;1;1
250893293329;250893295201;1872;0,1,2;3;9;1;1;1
250893295201;250893295698;497;0,1,2;3;9;1;1;1
250893295698;250893295728;30;0,1,2;3;9;1;1;1
250893295728;250893296937;1209;0,1,2;3;9;1;1;1
250893296937;250893297113;176;0,1,2;3;9;1;1;1
250893297113;250893297758;645;0,1,2;3;9;1;1;1
250893297758;250893297844;86;0,1,2;3;9;1;1;1
250893297844;250893299174;1330;0,1,2;3;9;1;1;1
250893299174;250893299193;19;0,1,2;3;9;1;1;1
250893299193;250893300749;1556;0,1,2;3;9;1;1;1
250893300749;250893301695;946;0,1,2;3;9;1;1;1
250893301695;250893301730;35;0,1,2;3;9;1;1;1
250893301730;250893302289;559;0,1,2;3;9;1;1;1
250893302289;250893302646;357;0,1,2;3;9;1;1;1
250893302646;250893302881;235;0,1,2;3;9;1;1;1
250893302881;250893303015;134;0,1,2;3;9;1;1;1
250893303015;250893303352;337;0,1,2;3;9;1;1;1
250893303352;250893304021;669;0,1,2;3;9;1;1;1
250893304021;250893304599;578;0,1,2;3;9;1;1;1
250893304599;250893304711;112;0,1,2;3;9;1;1;1
250893304711;250893304884;173;0,1,2;3;9;1;1;1
250893304884;250893305133;249;0,1,2;3;9;1;1;1
250893305133;250893305362;229;0,1,2;3;9;1;1;1
250893305362;250893305627;265;0,1,2;3;9;1;1;1
250893305627;250893305691;64;0,1,2;3;9;1;1;1
250893305691;250893306051;360;0,1,2;3;9;1;1;1
250893306051;250893306292;241;0,1,2;3;9;1;1;1
250893306292;250893306401;109;0,1,2;3;9;1;1;1
250893306401;250893306464;63;0,1,2;3;9;1;1;1
250893306464;250893308029;1565;0,1,2;3;9;1;1;1
250893308029;250893308349;320;0,1,2;3;9;1;1;1
250893308349;250893309464;1115;0,1,2;3;9;1;1;1
250893309464;250893309900;436;0,1,2;3;9;1;1;1
250893309900;250893310691;791;0,1,2;3;9;1;1;1
250893310691;250893311113;422;0,1,2;3;9;1;1;1
250893311113;250893311218;105;0,1,2;3;9;1;1;1
250893311218;250893311259;41;0,1,2;3;9;1;1;1
250893311259;250893311337;78;0,1,2;3;9;1;1;1
250893311337;250893311677;340;0,1,2;3;9;1;1;1
250893311677;250893311846;169;0,1,2;3;9;1;1;1
250893311846;250893311962;116;0,1,2;3;9;1;1;1
250893311962;250893312234;272;0,1,2;3;9;1;1;1
250893312234;250893312304;70;0,1,2;3;9;1;1;1
250893312304;250893312415;111;0,1,2;3;9;1;1;1
250893312415;250893314635;2220;0,1,2;3;9;1;1;1
250893314635;250893315200;565;0,1,2;3;9;1;1;1
250893315200;250893315944;744;0,1,2;3;9;1;1;1
250893315944;250893316370;426;0,1,2;3;9;1;1;1
250893316370;250893316801;431;0,1,2;3;9;1;1;1
250893316801;250893320021;3220;0,1,2;3;9;1;1;1
250893320021;250893323498;3477;0,1,2;3;9;1;1;1
250893323498;250893326814;3316;0,1,2;3;9;1;1;1
250893326814;250893326900;86;0,1,2;3;9;1;1;1
250893326900;250893327088;188;0,1,2;3;9;1;1;1
250893327088;250893327573;485;0,1,2;3;9;1;1;1
250893327573;250893327594;21;0,1,2;3;9;1;1;1
250893327594;250893328315;721;0,1,2;3;9;1;1;1
250893328315;250893329384;1069;0,1,2;3;9;1;1;1
250893329384;250893331320;1936;0,1,2;3;9;1;1;1
250893331320;250893333898;2578;0,1,2;3;9;1;1;1
250893333898;250893334068;170;0,1,2;3;9;1;1;1
250893334068;250893334205;137;0,1,2;3;9;1;1;1
250893334205;250893334550;345;0,1,2;3;9;1;1;1
250893334550;250893334840;290;0,1,2;3;9;1;1;1
250893334840;250893335154;314;0,1,2;3;9;1;1;1
250893335154;250893335929;775;0,1,2;3;9;1;1;1
250893335929;250893336540;611;0,1,2;3;9;1;1;1
250893336540;250893339523;2983;0,1,2;3;9;1;1;1
250893339523;250893339729;206;0,1,2;3;9;1;1;1
250893339729;250893339930;201;0,1,2;3;9;1;1;1
250893339930;250893340457;527;0,1,2;3;9;1;1;1
250893340457;250893341591;1134;0,1,2;3;9;1;1;1
250893341591;250893341719;128;0,1,2;3;9;1;1;1
250893341719;250893341895;176;0,1,2;3;9;1;1;1
250893341895;250893342257;362;0,1,2;3;9;1;1;1
250893342257;250893342649;392;0,1,2;3;9;1;1;1
250893342649;250893342678;29;0,1,2;3;9;1;1;1
250893342678;250893343074;396;0,1,2;3;9;1;1;1
250893343074;250893343587;513;0,1,2;3;9;1;1;1
250893343587;250893343974;387;0,1,2;3;9;1;1;1
250893343974;250893344008;34;0,1,2;3;9;1;1;1
250893344008;250893344357;349;0,1,2;3;9;1;1;1
250893344357;250893347744;3387;0,1,2;3;9;1;1;1
250893347744;250893349064;1320;0,1,2;3;9;1;1;1
250893349064;250893349135;71;0,1,2;3;9;1;1;1
250893349135;250893349458;323;0,1,2;3;9;1;1;1
250893349458;250893349645;187;0,1,2;3;9;1;1;1
250893349645;250893350057;412;0,1,2;3;9;1;1;1
250893350057;250893350911;854;0,1,2;3;9;1;1;1
250893350911;250893352187;1276;0,1,2;3;9;1;1;1
250893352187;250893352592;405;0,1,2;3;9;1;1;1
250893352592;250893353097;505;0,1,2;3;9;1;1;1
250893353097;250893353146;49;0,1,2;3;9;1;1;1
250893353146;250893353539;393;0,1,2;3;9;1;1;1
250893353539;250893354594;1055;0,1,2;3;9;1;1;1
250893354594;250893355651;1057;0,1,2;3;9;1;1;1
250893355651;250893356504;853;0,1,2;3;9;1;1;1
250893356504;250893357114;610;0,1,2;3;9;1;1;1
250893357114;250893358224;1110;0,1,2;3;9;1;1;1
250893358224;250893358468;244;0,1,2;3;9;1;1;1
250893358468;250893358554;86;0,1,2;3;9;1;1;1
250893358554;250893358596;42;0,1,2;3;9;1;1;1
250893358596;250893358900;304;0,1,2;3;9;1;1;1
250893358900;250893360159;1259;0,1,2;3;9;1;1;1
250893360159;250893362296;2137;0,1,2;3;9;1;1;1
250893362296;250893362626;330;0,1,2;3;9;1;1;1
250893362626;250893363690;1064;0,1,2;3;9;1;1;1
250893363690;250893364655;965;0,1,2;3;9;1;1;1
250893364655;250893364695;40;0,1,2;3;9;1;1;1
250893364695;250893365260;565;0,1,2;3;9;1;1;1
250893365260;250893365399;139;0,1,2;3;9;1;1;1
250893365399;250893365633;234;0,1,2;3;9;1;1;1
250893365633;250893366074;441;0,1,2;3;9;1;1;1
250893366074;250893366131;57;0,1,2;3;9;1;1;1
250893366131;250893367931;1800;0,1,2;3;9;1;1;1
250893367931;250893368026;95;0,1,2;3;9;1;1;1
250893368026;250893368187;161;0,1,2;3;9;1;1;1
250893368187;250893368296;109;0,1,2;3;9;1;1;1
250893368296;250893368393;97;0,1,2;3;9;1;1;1
250893368393;250893368789;396;0,1,2;3;9;1;1;1
250893368789;250893368924;135;0,1,2;3;9;1;1;1
250893368924;250893369411;487;0,1,2;3;9;1;1;1
250893369411;250893369513;102;0,1,2;3;9;1;1;1
250893369513;250893369695;182;0,1,2;3;9;1;1;1
250893369695;250893369871;176;0,1,2;3;9;1;1;1
250893369871;250893369958;87;0,1,2;3;9;1;1;1
250893369958;250893370171;213;0,1,2;3;9;1;1;1
250893370171;250893370915;744;0,1,2;3;9;1;1;1
250893370915;250893371138;223;0,1,2;3;9;1;1;1
250893371138;250893371442;304;0,1,2;3;9;1;1;1
250893371442;250893371551;109;0,1,2;3;9;1;1;1
250893371551;250893371682;131;0,1,2;3;9;1;1;1
250893371682;250893371712;30;0,1,2;3;9;1;1;1
250893371712;250893371979;267;0,1,2;3;9;1;1;1
250893371979;250893372155;176;0,1,2;3;9;1;1;1
250893372155;250893372343;188;0,1,2;3;9;1;1;1
250893372343;250893374789;2446;0,1,2;3;9;1;1;1
250893374789;250893375397;608;0,1,2;3;9;1;1;1
250893375397;250893375441;44;0,1,2;3;9;1;1;1
250893375441;250893375938;497;0,1,2;3;9;1;1;1
250893375938;250893376197;259;0,1,2;3;9;1;1;1
250893376197;250893376242;45;0,1,2;3;9;1;1;1
250893376242;250893376696;454;0,1,2;3;9;1;1;1
250893376696;250893376894;198;0,1,2;3;9;1;1;1
250893376894;250893377355;461;0,1,2;3;9;1;1;1
250893377355;250893377415;60;0,1,2;3;9;1;1;1
250893377415;250893377581;166;0,1,2;3;9;1;1;1
250893377581;250893377634;53;0,1,2;3;9;1;1;1
250893377634;250893378172;538;0,1,2;3;9;1;1;1
250893378172;250893378265;93;0,1,2;3;9;1;1;1
250893378265;250893380036;1771;0,1,2;3;9;1;1;1
250893380036;250893380926;890;0,1,2;3;9;1;1;1
250893380926;250893380954;28;0,1,2;3;9;1;1;1
250893380954;250893381659;705;0,1,2;3;9;1;1;1
250893381659;250893382292;633;0,1,2;3;9;1;1;1
250893382292;250893382761;469;0,1,2;3;9;1;1;1
250893382761;250893382799;38;0,1,2;3;9;1;1;1
250893382799;250893382845;46;0,1,2;3;9;1;1;1
250893382845;250893382865;20;0,1,2;3;9;1;1;1
250893382865;250893382872;7;0,1,2;3;9;1;1;1
250893382872;250893382893;21;0,1,2;3;9;1;1;1
250893382893;250893383061;168;0,1,2;3;9;1;1;1
250893383061;250893383246;185;0,1,2;3;9;1;1;1
250893383246;250893384295;1049;0,1,2;3;9;1;1;1
250893384295;250893384437;142;0,1,2;3;9;1;1;1
250893384437;250893384471;34;0,1,2;3;9;1;1;1
250893384471;250893384893;422;0,1,2;3;9;1;1;1
250893384893;250893385582;689;0,1,2;3;9;1;1;1
250893385582;250893385754;172;0,1,2;3;9;1;1;1
250893385754;250893386045;291;0,1,2;3;9;1;1;1
250893386045;250893387257;1212;0,1,2;3;9;1;1;1
250893387257;250893387533;276;0,1,2;3;9;1;1;1
250893387533;250893389488;1955;0,1,2;3;9;1;1;1
250893389488;250893389658;170;0,1,2;3;9;1;1;1
250893389658;250893389926;268;0,1,2;3;9;1;1;1
250893389926;250893390282;356;0,1,2;3;9;1;1;1
250893390282;250893392681;2399;0,1,2;3;9;1;1;1
250893392681;250893392935;254;0,1,2;3;9;1;1;1
250893392935;250893393247;312;0,1,2;3;9;1;1;1
250893393247;250893393331;84;0,1,2;3;9;1;1;1
250893393331;250893393371;40;0,1,2;3;9;1;1;1
250893393371;250893393375;4;0,1,2;3;9;1;1;1
250893393375;250893395354;1979;0,1,2;3;9;1;1;1
250893395354;250893400881;5527;0,1,2;3;9;1;1;1
250893400881;250893402763;1882;0,1,2;3;9;1;1;1
250893402763;250893403147;384;0,1,2;3;9;1;1;1
250893403147;250893405076;1929;0,1,2;3;9;1;1;1
250893405076;250893407359;2283;0,1,2;3;9;1;1;1
250893407359;250893407642;283;0,1,2;3;9;1;1;1
250893407642;250893414897;7255;0,1,2;3;9;1;1;1
250893414897;250893414919;22;0,1,2;3;9;1;1;1
250893414919;250893415788;869;0,1,2;3;9;1;1;1
250893415788;250893418623;2835;0,1,2;3;9;1;1;1
250893418623;250893422184;3561;0,1,2;3;9;1;1;1
250893422184;250893424280;2096;0,1,2;3;9;1;1;1
250893424280;250893427112;2832;0,1,2;3;9;1;1;1
250893427112;250893427458;346;0,1,2;3;9;1;1;1
250893427458;250893427490;32;0,1,2;3;9;1;1;1
250893427490;250893429752;2262;0,1,2;3;9;1;1;1
250893429752;250893429920;168;0,1,2;3;9;1;1;1
250893429920;250893430051;131;0,1,2;3;9;1;1;1
250893430051;250893430099;48;0,1,2;3;9;1;1;1
250893430099;250893430126;27;0,1,2;3;9;1;1;1
250893430126;250893430364;238;0,1,2;3;9;1;1;1
250893430364;250893430441;77;0,1,2;3;9;1;1;1
250893430441;250893430592;151;0,1,2;3;9;1;1;1
250893430592;250893431553;961;0,1,2;3;9;1;1;1
250893431553;250893433948;2395;0,1,2;3;9;1;1;1
250893433948;250893434195;247;0,1,2;3;9;1;1;1
250893434195;250893439727;5532;0,1,2;3;9;1;1;1
250893439727;250893440219;492;0,1,2;3;9;1;1;1
250893440219;250893444695;4476;0,1,2;3;9;1;1;1
250893444695;250893445172;477;0,1,2;3;9;1;1;1
250893445172;250893446688;1516;0,1,2;3;9;1;1;1
250893446688;250893447639;951;0,1,2;3;9;1;1;1
250893447639;250893447722;83;0,1,2;3;9;1;1;1
250893447722;250893447974;252;0,1,2;3;9;1;1;1
250893447974;250893449135;1161;0,1,2;3;9;1;1;1
250893449135;250893450102;967;0,1,2;3;9;1;1;1
250893450102;250893450157;55;0,1,2;3;9;1;1;1
250893450157;250893452099;1942;0,1,2;3;9;1;1;1
250893452099;250893456117;4018;0,1,2;3;9;1;1;1
250893456117;250893456365;248;0,1,2;3;9;1;1;1
250893456365;250893456938;573;0,1,2;3;9;1;1;1
250893456938;250893457243;305;0,1,2;3;9;1;1;1
250893457243;250893457370;127;0,1,2;3;9;1;1;1
250893457370;250893457502;132;0,1,2;3;9;1;1;1
250893457502;250893457902;400;0,1,2;3;9;1;1;1
250893457902;250893457998;96;0,1,2;3;9;1;1;1
250893457998;250893458229;231;0,1,2;3;9;1;1;1
250893458229;250893458725;496;0,1,2;3;9;1;1;1
250893458725;250893461654;2929;0,1,2;3;9;1;1;1
250893461654;250893464696;3042;0,1,2;3;9;1;1;1
250893464696;250893464788;92;0,1,2;3;9;1;1;1
250893464788;250893464809;21;0,1,2;3;9;1;1;1
250893464809;250893464947;138;0,1,2;3;9;1;1;1
250893464947;250893465790;843;0,1,2;3;9;1;1;1
250893465790;250893468080;2290;0,1,2;3;9;1;1;1
250893468080;250893468104;24;0,1,2;3;9;1;1;1
250893468104;250893470301;2197;0,1,2;3;9;1;1;1
250893470301;250893470575;274;0,1,2;3;9;1;1;1
250893470575;250893470659;84;0,1,2;3;9;1;1;1
250893470659;250893471627;968;0,1,2;3;9;1;1;1
250893471627;250893471777;150;0,1,2;3;9;1;1;1
250893471777;250893475158;3381;0,1,2;3;9;1;1;1
250893475158;250893475757;599;0,1,2;3;9;1;1;1
250893475757;250893480021;4264;0,1,2;3;9;1;1;1
250893480021;250893480916;895;0,1,2;3;9;1;1;1
250893480916;250893483076;2160;0,1,2;3;9;1;1;1
250893483076;250893483573;497;0,1,2;3;9;1;1;1
250893483573;250893485085;1512;0,1,2;3;9;1;1;1
250893485085;250893485367;282;0,1,2;3;9;1;1;1
250893485367;250893485833;466;0,1,2;3;9;1;1;1
250893485833;250893486101;268;0,1,2;3;9;1;1;1
250893486101;250893488482;2381;0,1,2;3;9;1;1;1
250893488482;250893488968;486;0,1,2;3;9;1;1;1
250893488968;250893493307;4339;0,1,2;3;9;1;1;1
250893493307;250893494744;1437;0,1,2;3;9;1;1;1
250893494744;250893494985;241;0,1,2;3;9;1;1;1
250893494985;250893495036;51;0,1,2;3;9;1;1;1
250893495036;250893495422;386;0,1,2;3;9;1;1;1
250893495422;250893495649;227;0,1,2;3;9;1;1;1
250893495649;250893495928;279;0,1,2;3;9;1;1;1
250893495928;250893496977;1049;0,1,2;3;9;1;1;1
250893496977;250893497848;871;0,1,2;3;9;1;1;1
250893497848;250893497880;32;0,1,2;3;9;1;1;1
250893497880;250893497975;95;0,1,2;3;9;1;1;1
250893497975;250893499547;1572;0,1,2;3;9;1;1;1
250893499547;250893499690;143;0,1,2;3;9;1;1;1
250893499690;250893500057;367;0,1,2;3;9;1;1;1
250893500057;250893501442;1385;0,1,2;3;9;1;1;1
250893501442;250893501841;399;0,1,2;3;9;1;1;1
250893501841;250893502002;161;0,1,2;3;9;1;1;1
250893502002;250893502068;66;0,1,2;3;9;1;1;1
250893502068;250893502397;329;0,1,2;3;9;1;1;1
250893502397;250893502625;228;0,1,2;3;9;1;1;1
250893502625;250893502667;42;0,1,2;3;9;1;1;1
250893502667;250893503294;627;0,1,2;3;9;1;1;1
250893503294;250893503325;31;0,1,2;3;9;1;1;1
250893503325;250893503640;315;0,1,2;3;9;1;1;1
250893503640;250893504852;1212;0,1,2;3;9;1;1;1
250893504852;250893505711;859;0,1,2;3;9;1;1;1
250893505711;250893506845;1134;0,1,2;3;9;1;1;1
250893506845;250893507311;466;0,1,2;3;9;1;1;1
250893507311;250893507717;406;0,1,2;3;9;1;1;1
250893507717;250893508361;644;0,1,2;3;9;1;1;1
250893508361;250893509199;838;0,1,2;3;9;1;1;1
250893509199;250893509425;226;0,1,2;3;9;1;1;1
250893509425;250893510522;1097;0,1,2;3;9;1;1;1
250893510522;250893510616;94;0,1,2;3;9;1;1;1
250893510616;250893511407;791;0,1,2;3;9;1;1;1
250893511407;250893512034;627;0,1,2;3;9;1;1;1
250893512034;250893514158;2124;0,1,2;3;9;1;1;1
250893514158;250893514339;181;0,1,2;3;9;1;1;1
250893514339;250893515595;1256;0,1,2;3;9;1;1;1
250893515595;250893515857;262;0,1,2;3;9;1;1;1
250893515857;250893517799;1942;0,1,2;3;9;1;1;1
250893517799;250893517934;135;0,1,2;3;9;1;1;1
250893517934;250893518206;272;0,1,2;3;9;1;1;1
250893518206;250893518716;510;0,1,2;3;9;1;1;1
250893518716;250893520993;2277;0,1,2;3;9;1;1;1
250893520993;250893521840;847;0,1,2;3;9;1;1;1
250893521840;250893522609;769;0,1,2;3;9;1;1;1
250893522609;250893522754;145;0,1,2;3;9;1;1;1
250893522754;250893522906;152;0,1,2;3;9;1;1;1
250893522906;250893526632;3726;0,1,2;3;9;1;1;1
250893526632;250893526693;61;0,1,2;3;9;1;1;1
250893526693;250893527650;957;0,1,2;3;9;1;1;1
250893527650;250893527820;170;0,1,2;3;9;1;1;1
250893527820;250893527880;60;0,1,2;3;9;1;1;1
250893527880;250893528231;351;0,1,2;3;9;1;1;1
250893528231;250893528264;33;0,1,2;3;9;1;1;1
250893528264;250893528770;506;0,1,2;3;9;1;1;1
250893528770;250893528841;71;0,1,2;3;9;1;1;1
250893528841;250893529321;480;0,1,2;3;9;1;1;1
250893529321;250893529668;347;0,1,2;3;9;1;1;1
250893529668;250893530360;692;0,1,2;3;9;1;1;1
250893530360;250893532730;2370;0,1,2;3;9;1;1;1
250893532730;250893533152;422;0,1,2;3;9;1;1;1
250893533152;250893533975;823;0,1,2;3;9;1;1;1
250893533975;250893535514;1539;0,1,2;3;9;1;1;1
250893535514;250893537986;2472;0,1,2;3;9;1;1;1
250893537986;250893538480;494;0,1,2;3;9;1;1;1
250893538480;250893538717;237;0,1,2;3;9;1;1;1
250893538717;250893539164;447;0,1,2;3;9;1;1;1
250893539164;250893539569;405;0,1,2;3;9;1;1;1
250893539569;250893541304;1735;0,1,2;3;9;1;1;1
250893541304;250893544901;3597;0,1,2;3;9;1;1;1
250893544901;250893545683;782;0,1,2;3;9;1;1;1
250893545683;250893546333;650;0,1,2;3;9;1;1;1
250893546333;250893546835;502;0,1,2;3;9;1;1;1
250893546835;250893559201;12366;0,1,2;3;9;1;1;1
250893559201;250893559905;704;0,1,2;3;9;1;1;1
250893559905;250893560440;535;0,1,2;3;9;1;1;1
250893560440;250893560533;93;0,1,2;3;9;1;1;1
250893560533;250893563061;2528;0,1,2;3;9;1;1;1
250893563061;250893563556;495;0,1,2;3;9;1;1;1
250893563556;250893563811;255;0,1,2;3;9;1;1;1
250893563811;250893563973;162;0,1,2;3;9;1;1;1
250893563973;250893563983;10;0,1,2;3;9;1;1;1
250893563983;250893564177;194;0,1,2;3;9;1;1;1
250893564177;250893564673;496;0,1,2;3;9;1;1;1
250893564673;250893565462;789;0,1,2;3;9;1;1;1
250893565462;250893566207;745;0,1,2;3;9;1;1;1
250893566207;250893566256;49;0,1,2;3;9;1;1;1
250893566256;250893566658;402;0,1,2;3;9;1;1;1
250893566658;250893566939;281;0,1,2;3;9;1;1;1
250893566939;250893567457;518;0,1,2;3;9;1;1;1
250893567457;250893568228;771;0,1,2;3;9;1;1;1
250893568228;250893568369;141;0,1,2;3;9;1;1;1
250893568369;250893568480;111;0,1,2;3;9;1;1;1
250893568480;250893568689;209;0,1,2;3;9;1;1;1
250893568689;250893570277;1588;0,1,2;3;9;1;1;1
250893570277;250893570525;248;0,1,2;3;9;1;1;1
250893570525;250893571330;805;0,1,2;3;9;1;1;1
250893571330;250893571614;284;0,1,2;3;9;1;1;1
250893571614;250893572303;689;0,1,2;3;9;1;1;1
250893572303;250893572336;33;0,1,2;3;9;1;1;1
250893572336;250893572365;29;0,1,2;3;9;1;1;1
250893572365;250893572939;574;0,1,2;3;9;1;1;1
250893572939;250893573068;129;0,1,2;3;9;1;1;1
250893573068;250893573301;233;0,1,2;3;9;1;1;1
250893573301;250893573428;127;0,1,2;3;9;1;1;1
250893573428;250893573616;188;0,1,2;3;9;1;1;1
250893573616;250893573976;360;0,1,2;3;9;1;1;1
250893573976;250893574005;29;0,1,2;3;9;1;1;1
250893574005;250893574511;506;0,1,2;3;9;1;1;1
250893574511;250893574626;115;0,1,2;3;9;1;1;1
250893574626;250893574973;347;0,1,2;3;9;1;1;1
250893574973;250893575083;110;0,1,2;3;9;1;1;1
250893575083;250893575465;382;0,1,2;3;9;1;1;1
250893575465;250893576420;955;0,1,2;3;9;1;1;1
250893576420;250893576774;354;0,1,2;3;9;1;1;1
250893576774;250893577184;410;0,1,2;3;9;1;1;1
250893577184;250893577222;38;0,1,2;3;9;1;1;1
250893577222;250893579210;1988;0,1,2;3;9;1;1;1
250893579210;250893579211;1;0,1,2;3;9;1;1;1
250893579211;250893579317;106;0,1,2;3;9;1;1;1
250893579317;250893579628;311;0,1,2;3;9;1;1;1
250893579628;250893579702;74;0,1,2;3;9;1;1;1
250893579702;250893579712;10;0,1,2;3;9;1;1;1
250893579712;250893579948;236;0,1,2;3;9;1;1;1
250893579948;250893580403;455;0,1,2;3;9;1;1;1
250893580403;250893581111;708;0,1,2;3;9;1;1;1
250893581111;250893581186;75;0,1,2;3;9;1;1;1
250893581186;250893581269;83;0,1,2;3;9;1;1;1
250893581269;250893581786;517;0,1,2;3;9;1;1;1
250893581786;250893582155;369;0,1,2;3;9;1;1;1
250893582155;250893582255;100;0,1,2;3;9;1;1;1
250893582255;250893582276;21;0,1,2;3;9;1;1;1
250893582276;250893582838;562;0,1,2;3;9;1;1;1
250893582838;250893583475;637;0,1,2;3;9;1;1;1
250893583475;250893583556;81;0,1,2;3;9;1;1;1
250893583556;250893583566;10;0,1,2;3;9;1;1;1
250893583566;250893585144;1578;0,1,2;3;9;1;1;1
250893585144;250893585966;822;0,1,2;3;9;1;1;1
250893585966;250893586702;736;0,1,2;3;9;1;1;1
250893586702;250893586779;77;0,1,2;3;9;1;1;1
250893586779;250893587870;1091;0,1,2;3;9;1;1;1
250893587870;250893588572;702;0,1,2;3;9;1;1;1
250893588572;250893590134;1562;0,1,2;3;9;1;1;1
250893590134;250893591193;1059;0,1,2;3;9;1;1;1
250893591193;250893591872;679;0,1,2;3;9;1;1;1
250893591872;250893593865;1993;0,1,2;3;9;1;1;1
250893593865;250893594325;460;0,1,2;3;9;1;1;1
250893594325;250893595229;904;0,1,2;3;9;1;1;1
250893595229;250893597814;2585;0,1,2;3;9;1;1;1
250893597814;250893598455;641;0,1,2;3;9;1;1;1
250893598455;250893600490;2035;0,1,2;3;9;1;1;1
250893600490;250893601812;1322;0,1,2;3;9;1;1;1
250893601812;250893602789;977;0,1,2;3;9;1;1;1
250893602789;250893603404;615;0,1,2;3;9;1;1;1
250893603404;250893606782;3378;0,1,2;3;9;1;1;1
250893606782;250893607369;587;0,1,2;3;9;1;1;1
250893607369;250893607647;278;0,1,2;3;9;1;1;1
250893607647;250893607727;80;0,1,2;3;9;1;1;1
250893607727;250893608449;722;0,1,2;3;9;1;1;1
250893608449;250893609074;625;0,1,2;3;9;1;1;1
250893609074;250893609190;116;0,1,2;3;9;1;1;1
250893609190;250893612142;2952;0,1,2;3;9;1;1;1
250893612142;250893612332;190;0,1,2;3;9;1;1;1
250893612332;250893614193;1861;0,1,2;3;9;1;1;1
250893614193;250893614347;154;0,1,2;3;9;1;1;1
250893614347;250893617131;2784;0,1,2;3;9;1;1;1
250893617131;250893617312;181;0,1,2;3;9;1;1;1
250893617312;250893619197;1885;0,1,2;3;9;1;1;1
250893619197;250893619252;55;0,1,2;3;9;1;1;1
250893619252;250893619381;129;0,1,2;3;9;1;1;1
250893619381;250893619632;251;0,1,2;3;9;1;1;1
250893619632;250893619947;315;0,1,2;3;9;1;1;1
250893619947;250893619956;9;0,1,2;3;9;1;1;1
250893619956;250893620418;462;0,1,2;3;9;1;1;1
250893620418;250893620557;139;0,1,2;3;9;1;1;1
250893620557;250893621673;1116;0,1,2;3;9;1;1;1
250893621673;250893621714;41;0,1,2;3;9;1;1;1
250893621714;250893623157;1443;0,1,2;3;9;1;1;1
250893623157;250893623306;149;0,1,2;3;9;1;1;1
250893623306;250893623824;518;0,1,2;3;9;1;1;1
250893623824;250893624366;542;0,1,2;3;9;1;1;1
250893624366;250893624398;32;0,1,2;3;9;1;1;1
250893624398;250893624455;57;0,1,2;3;9;1;1;1
250893624455;250893624855;400;0,1,2;3;9;1;1;1
250893624855;250893625011;156;0,1,2;3;9;1;1;1
250893625011;250893626636;1625;0,1,2;3;9;1;1;1
250893626636;250893627263;627;0,1,2;3;9;1;1;1
250893627263;250893627304;41;0,1,2;3;9;1;1;1
250893627304;250893627985;681;0,1,2;3;9;1;1;1
250893627985;250893628490;505;0,1,2;3;9;1;1;1
250893628490;250893628565;75;0,1,2;3;9;1;1;1
250893628565;250893629351;786;0,1,2;3;9;1;1;1
250893629351;250893630639;1288;0,1,2;3;9;1;1;1
250893630639;250893632200;1561;0,1,2;3;9;1;1;1
250893632200;250893632293;93;0,1,2;3;9;1;1;1
250893632293;250893633882;1589;0,1,2;3;9;1;1;1
250893633882;250893635069;1187;0,1,2;3;9;1;1;1
250893635069;250893635300;231;0,1,2;3;9;1;1;1
250893635300;250893635719;419;0,1,2;3;9;1;1;1
250893635719;250893636028;309;0,1,2;3;9;1;1;1
250893636028;250893636320;292;0,1,2;3;9;1;1;1
250893636320;250893636382;62;0,1,2;3;9;1;1;1
250893636382;250893639273;2891;0,1,2;3;9;1;1;1
250893639273;250893639769;496;0,1,2;3;9;1;1;1
250893639769;250893642242;2473;0,1,2;3;9;1;1;1
250893642242;250893643303;1061;0,1,2;3;9;1;1;1
250893643303;250893643487;184;0,1,2;3;9;1;1;1
250893643487;250893643762;275;0,1,2;3;9;1;1;1
250893643762;250893644184;422;0,1,2;3;9;1;1;1
250893644184;250893645349;1165;0,1,2;3;9;1;1;1
250893645349;250893646709;1360;0,1,2;3;9;1;1;1
250893646709;250893646925;216;0,1,2;3;9;1;1;1
250893646925;250893649647;2722;0,1,2;3;9;1;1;1
250893649647;250893649994;347;0,1,2;3;9;1;1;1
250893649994;250893651296;1302;0,1,2;3;9;1;1;1
250893651296;250893657702;6406;0,1,2;3;9;1;1;1
250893657702;250893658066;364;0,1,2;3;9;1;1;1
250893658066;250893658226;160;0,1,2;3;9;1;1;1
250893658226;250893658448;222;0,1,2;3;9;1;1;1
250893658448;250893658548;100;0,1,2;3;9;1;1;1
250893658548;250893665751;7203;0,1,2;3;9;1;1;1
250893665751;250893666386;635;0,1,2;3;9;1;1;1
250893666386;250893667806;1420;0,1,2;3;9;1;1;1
250893667806;250893667816;10;0,1,2;3;9;1;1;1
250893667816;250893667933;117;0,1,2;3;9;1;1;1
250893667933;250893668450;517;0,1,2;3;9;1;1;1
250893668450;250893670030;1580;0,1,2;3;9;1;1;1
250893670030;250893671297;1267;0,1,2;3;9;1;1;1
250893671297;250893675287;3990;0,1,2;3;9;1;1;1
250893675287;250893675391;104;0,1,2;3;9;1;1;1
250893675391;250893675530;139;0,1,2;3;9;1;1;1
250893675530;250893675635;105;0,1,2;3;9;1;1;1
250893675635;250893675760;125;0,1,2;3;9;1;1;1
250893675760;250893675886;126;0,1,2;3;9;1;1;1
250893675886;250893676323;437;0,1,2;3;9;1;1;1
250893676323;250893677849;1526;0,1,2;3;9;1;1;1
250893677849;250893678777;928;0,1,2;3;9;1;1;1
250893678777;250893682235;3458;0,1,2;3;9;1;1;1
250893682235;250893685962;3727;0,1,2;3;9;1;1;1
250893685962;250893688306;2344;0,1,2;3;9;1;1;1
250893688306;250893688323;17;0,1,2;3;9;1;1;1
250893688323;250893688409;86;0,1,2;3;9;1;1;1
250893688409;250893689290;881;0,1,2;3;9;1;1;1
250893689290;250893690103;813;0,1,2;3;9;1;1;1
250893690103;250893690826;723;0,1,2;3;9;1;1;1
250893690826;250893690958;132;0,1,2;3;9;1;1;1
250893690958;250893691949;991;0,1,2;3;9;1;1;1
250893691949;250893694248;2299;0,1,2;3;9;1;1;1
250893694248;250893695006;758;0,1,2;3;9;1;1;1
250893695006;250893695527;521;0,1,2;3;9;1;1;1
250893695527;250893695775;248;0,1,2;3;9;1;1;1
250893695775;250893695823;48;0,1,2;3;9;1;1;1
250893695823;250893696130;307;0,1,2;3;9;1;1;1
250893696130;250893696133;3;0,1,2;3;9;1;1;1
250893696133;250893696239;106;0,1,2;3;9;1;1;1
250893696239;250893697879;1640;0,1,2;3;9;1;1;1
250893697879;250893698047;168;0,1,2;3;9;1;1;1
250893698047;250893698136;89;0,1,2;3;9;1;1;1
250893698136;250893698240;104;0,1,2;3;9;1;1;1
250893698240;250893698266;26;0,1,2;3;9;1;1;1
250893698266;250893698515;249;0,1,2;3;9;1;1;1
250893698515;250893698538;23;0,1,2;3;9;1;1;1
250893698538;250893698670;132;0,1,2;3;9;1;1;1
250893698670;250893698930;260;0,1,2;3;9;1;1;1
250893698930;250893699091;161;0,1,2;3;9;1;1;1
250893699091;250893699210;119;0,1,2;3;9;1;1;1
250893699210;250893699489;279;0,1,2;3;9;1;1;1
250893699489;250893699971;482;0,1,2;3;9;1;1;1
250893699971;250893700055;84;0,1,2;3;9;1;1;1
250893700055;250893700363;308;0,1,2;3;9;1;1;1
250893700363;250893700544;181;0,1,2;3;9;1;1;1
250893700544;250893700824;280;0,1,2;3;9;1;1;1
250893700824;250893701764;940;0,1,2;3;9;1;1;1
250893701764;250893703480;1716;0,1,2;3;9;1;1;1
250893703480;250893705065;1585;0,1,2;3;9;1;1;1
250893705065;250893705152;87;0,1,2;3;9;1;1;1
250893705152;250893705475;323;0,1,2;3;9;1;1;1
250893705475;250893705749;274;0,1,2;3;9;1;1;1
250893705749;250893706327;578;0,1,2;3;9;1;1;1
250893706327;250893706445;118;0,1,2;3;9;1;1;1
250893706445;250893706887;442;0,1,2;3;9;1;1;1
250893706887;250893706947;60;0,1,2;3;9;1;1;1
250893706947;250893707030;83;0,1,2;3;9;1;1;1
250893707030;250893707488;458;0,1,2;3;9;1;1;1
250893707488;250893707606;118;0,1,2;3;9;1;1;1
250893707606;250893708085;479;0,1,2;3;9;1;1;1
250893708085;250893708139;54;0,1,2;3;9;1;1;1
250893708139;250893708147;8;0,1,2;3;9;1;1;1
250893708147;250893708342;195;0,1,2;3;9;1;1;1
250893708342;250893709054;712;0,1,2;3;9;1;1;1
250893709054;250893709419;365;0,1,2;3;9;1;1;1
250893709419;250893709525;106;0,1,2;3;9;1;1;1
250893709525;250893709557;32;0,1,2;3;9;1;1;1
250893709557;250893709836;279;0,1,2;3;9;1;1;1
250893709836;250893710162;326;0,1,2;3;9;1;1;1
250893710162;250893710182;20;0,1,2;3;9;1;1;1
250893710182;250893710570;388;0,1,2;3;9;1;1;1
250893710570;250893712007;1437;0,1,2;3;9;1;1;1
250893712007;250893714466;2459;0,1,2;3;9;1;1;1
250893714466;250893715964;1498;0,1,2;3;9;1;1;1
250893715964;250893716050;86;0,1,2;3;9;1;1;1
250893716050;250893716240;190;0,1,2;3;9;1;1;1
250893716240;250893716243;3;0,1,2;3;9;1;1;1
250893716243;250893716412;169;0,1,2;3;9;1;1;1
250893716412;250893717075;663;0,1,2;3;9;1;1;1
250893717075;250893717269;194;0,1,2;3;9;1;1;1
250893717269;250893717351;82;0,1,2;3;9;1;1;1
250893717351;250893717529;178;0,1,2;3;9;1;1;1
250893717529;250893717964;435;0,1,2;3;9;1;1;1
250893717964;250894004300;286336;1,2;2;9;1;1;1
250894004300;250894042763;38463;1,2;2;9;1;1;1
250894042763;250894074083;31320;1,2;2;9;1;1;1
250894074083;250894140441;66358;1,2;2;9;1;1;1
250894140441;250894217145;76704;1,2;2;9;1;1;1
250894217145;250894563616;346471;1,2;2;9;1;1;1
250894563616;250895089919;526303;1,2;2;9;1;1;1
250895089919;250895090322;403;0,1,2;3;9;1;1;1
250895090322;250895090346;24;0,1,2;3;9;1;1;1
250895090346;250895090347;1;0,1,2;3;9;1;1;1
250895090347;250895090535;188;0,1,2;3;9;1;1;1
250895090535;250895090620;85;0,1,2;3;9;1;1;1
250895090620;250895091142;522;0,1,2;3;9;1;1;1
250895091142;250895091939;797;0,1,2;3;9;1;1;1
250895091939;250895092899;960;0,1,2;3;9;1;1;1
250895092899;250895093309;410;0,1,2;3;9;1;1;1
250895093309;250895093907;598;0,1,2;3;9;1;1;1
250895093907;250895094126;219;0,1,2;3;9;1;1;1
250895094126;250895094188;62;0,1,2;3;9;1;1;1
250895094188;250895094201;13;0,1,2;3;9;1;1;1
250895094201;250895094287;86;0,1,2;3;9;1;1;1
250895094287;250895095846;1559;0,1,2;3;9;1;1;1
250895095846;250895095951;105;0,1,2;3;9;1;1;1
250895095951;250895097136;1185;0,1,2;3;9;1;1;1
250895097136;250895097307;171;0,1,2;3;9;1;1;1
250895097307;250895097332;25;0,1,2;3;9;1;1;1
250895097332;250895097401;69;0,1,2;3;9;1;1;1
250895097401;250895097522;121;0,1,2;3;9;1;1;1
250895097522;250895097955;433;0,1,2;3;9;1;1;1
250895097955;250895097990;35;0,1,2;3;9;1;1;1
250895097990;250895100180;2190;0,1,2;3;9;1;1;1
250895100180;250895100608;428;0,1,2;3;9;1;1;1
250895100608;250895101282;674;0,1,2;3;9;1;1;1
250895101282;250895101378;96;0,1,2;3;9;1;1;1
250895101378;250895101631;253;0,1,2;3;9;1;1;1
250895101631;250895102288;657;0,1,2;3;9;1;1;1
250895102288;250895104022;1734;0,1,2;3;9;1;1;1
250895104022;250895104454;432;0,1,2;3;9;1;1;1
250895104454;250895105137;683;0,1,2;3;9;1;1;1
250895105137;250895105253;116;0,1,2;3;9;1;1;1
250895105253;250895105443;190;0,1,2;3;9;1;1;1
250895105443;250895105476;33;0,1,2;3;9;1;1;1
250895105476;250895107527;2051;0,1,2;3;9;1;1;1
250895107527;250895107694;167;0,1,2;3;9;1;1;1
250895107694;250895108121;427;0,1,2;3;9;1;1;1
250895108121;250895108534;413;0,1,2;3;9;1;1;1
250895108534;250895109046;512;0,1,2;3;9;1;1;1
250895109046;250895109190;144;0,1,2;3;9;1;1;1
250895109190;250895109335;145;0,1,2;3;9;1;1;1
250895109335;250895110326;991;0,1,2;3;9;1;1;1
250895110326;250895110629;303;0,1,2;3;9;1;1;1
250895110629;250895111086;457;0,1,2;3;9;1;1;1
250895111086;250895111111;25;0,1,2;3;9;1;1;1
250895111111;250895111331;220;0,1,2;3;9;1;1;1
250895111331;250895112356;1025;0,1,2;3;9;1;1;1
250895112356;250895112461;105;0,1,2;3;9;1;1;1
250895112461;250895112464;3;0,1,2;3;9;1;1;1
250895112464;250895112709;245;0,1,2;3;9;1;1;1
250895112709;250895112759;50;0,1,2;3;9;1;1;1
250895112759;250895113144;385;0,1,2;3;9;1;1;1
250895113144;250895113568;424;0,1,2;3;9;1;1;1
250895113568;250895113700;132;0,1,2;3;9;1;1;1
250895113700;250895114055;355;0,1,2;3;9;1;1;1
250895114055;250895114260;205;0,1,2;3;9;1;1;1
250895114260;250895115166;906;0,1,2;3;9;1;1;1
250895115166;250895115211;45;0,1,2;3;9;1;1;1
250895115211;250895115621;410;0,1,2;3;9;1;1;1
250895115621;250895115645;24;0,1,2;3;9;1;1;1
250895115645;250895116055;410;0,1,2;3;9;1;1;1
250895116055;250895116799;744;0,1,2;3;9;1;1;1
250895116799;250895116945;146;0,1,2;3;9;1;1;1
250895116945;250895117012;67;0,1,2;3;9;1;1;1
250895117012;250895117380;368;0,1,2;3;9;1;1;1
250895117380;250895117764;384;0,1,2;3;9;1;1;1
250895117764;250895118349;585;0,1,2;3;9;1;1;1
250895118349;250895118483;134;0,1,2;3;9;1;1;1
250895118483;250895118509;26;0,1,2;3;9;1;1;1
250895118509;250895118703;194;0,1,2;3;9;1;1;1
250895118703;250895118817;114;0,1,2;3;9;1;1;1
250895118817;250895119562;745;0,1,2;3;9;1;1;1
250895119562;250895119817;255;0,1,2;3;9;1;1;1
250895119817;250895119922;105;0,1,2;3;9;1;1;1
250895119922;250895120157;235;0,1,2;3;9;1;1;1
250895120157;250895120522;365;0,1,2;3;9;1;1;1
250895120522;250895120552;30;0,1,2;3;9;1;1;1
250895120552;250895120612;60;0,1,2;3;9;1;1;1
250895120612;250895121285;673;0,1,2;3;9;1;1;1
250895121285;250895121506;221;0,1,2;3;9;1;1;1
250895121506;250895121611;105;0,1,2;3;9;1;1;1
250895121611;250895121674;63;0,1,2;3;9;1;1;1
250895121674;250895121791;117;0,1,2;3;9;1;1;1
250895121791;250895122087;296;0,1,2;3;9;1;1;1
250895122087;250895122401;314;0,1,2;3;9;1;1;1
250895122401;250895122426;25;0,1,2;3;9;1;1;1
250895122426;250895122513;87;0,1,2;3;9;1;1;1
250895122513;250895122532;19;0,1,2;3;9;1;1;1
250895122532;250895122845;313;0,1,2;3;9;1;1;1
250895122845;250895122852;7;0,1,2;3;9;1;1;1
250895122852;250895122897;45;0,1,2;3;9;1;1;1
250895122897;250895123532;635;0,1,2;3;9;1;1;1
250895123532;250895123939;407;0,1,2;3;9;1;1;1
250895123939;250895124355;416;0,1,2;3;9;1;1;1
250895124355;250895124621;266;0,1,2;3;9;1;1;1
250895124621;250895124646;25;0,1,2;3;9;1;1;1
250895124646;250895124925;279;0,1,2;3;9;1;1;1
250895124925;250895125145;220;0,1,2;3;9;1;1;1
250895125145;250895125239;94;0,1,2;3;9;1;1;1
250895125239;250895125535;296;0,1,2;3;9;1;1;1
250895125535;250895126252;717;0,1,2;3;9;1;1;1
250895126252;250895126277;25;0,1,2;3;9;1;1;1
250895126277;250895126451;174;0,1,2;3;9;1;1;1
250895126451;250895127162;711;0,1,2;3;9;1;1;1
250895127162;250895127273;111;0,1,2;3;9;1;1;1
250895127273;250895127761;488;0,1,2;3;9;1;1;1
250895127761;250895127837;76;0,1,2;3;9;1;1;1
250895127837;250895127875;38;0,1,2;3;9;1;1;1
250895127875;250895128019;144;0,1,2;3;9;1;1;1
250895128019;250895128091;72;0,1,2;3;9;1;1;1
250895128091;250895128487;396;0,1,2;3;9;1;1;1
250895128487;250895128696;209;0,1,2;3;9;1;1;1
250895128696;250895129625;929;0,1,2;3;9;1;1;1
250895129625;250895129674;49;0,1,2;3;9;1;1;1
250895129674;250895130615;941;0,1,2;3;9;1;1;1
250895130615;250895130810;195;0,1,2;3;9;1;1;1
250895130810;250895131119;309;0,1,2;3;9;1;1;1
250895131119;250895131543;424;0,1,2;3;9;1;1;1
250895131543;250895131665;122;0,1,2;3;9;1;1;1
250895131665;250895131679;14;0,1,2;3;9;1;1;1
250895131679;250895131699;20;0,1,2;3;9;1;1;1
250895131699;250895132075;376;0,1,2;3;9;1;1;1
250895132075;250895132086;11;0,1,2;3;9;1;1;1
250895132086;250895132461;375;0,1,2;3;9;1;1;1
250895132461;250895132957;496;0,1,2;3;9;1;1;1
250895132957;250895133000;43;0,1,2;3;9;1;1;1
250895133000;250895133439;439;0,1,2;3;9;1;1;1
250895133439;250895133477;38;0,1,2;3;9;1;1;1
250895133477;250895133495;18;0,1,2;3;9;1;1;1
250895133495;250895133717;222;0,1,2;3;9;1;1;1
250895133717;250895133724;7;0,1,2;3;9;1;1;1
250895133724;250895133734;10;0,1,2;3;9;1;1;1
250895133734;250895133825;91;0,1,2;3;9;1;1;1
250895133825;250895134087;262;0,1,2;3;9;1;1;1
250895134087;250895134134;47;0,1,2;3;9;1;1;1
250895134134;250895134441;307;0,1,2;3;9;1;1;1
250895134441;250895134642;201;0,1,2;3;9;1;1;1
250895134642;250895135217;575;0,1,2;3;9;1;1;1
250895135217;250895135413;196;0,1,2;3;9;1;1;1
250895135413;250895135733;320;0,1,2;3;9;1;1;1
250895135733;250895136712;979;0,1,2;3;9;1;1;1
250895136712;250895136744;32;0,1,2;3;9;1;1;1
250895136744;250895136909;165;0,1,2;3;9;1;1;1
250895136909;250895137165;256;0,1,2;3;9;1;1;1
250895137165;250895137310;145;0,1,2;3;9;1;1;1
250895137310;250895137399;89;0,1,2;3;9;1;1;1
250895137399;250895137512;113;0,1,2;3;9;1;1;1
250895137512;250895137867;355;0,1,2;3;9;1;1;1
250895137867;250895138604;737;0,1,2;3;9;1;1;1
250895138604;250895139764;1160;0,1,2;3;9;1;1;1
250895139764;250895139788;24;0,1,2;3;9;1;1;1
250895139788;250895139911;123;0,1,2;3;9;1;1;1
250895139911;250895140479;568;0,1,2;3;9;1;1;1
250895140479;250895140511;32;0,1,2;3;9;1;1;1
250895140511;250895140797;286;0,1,2;3;9;1;1;1
250895140797;250895140912;115;0,1,2;3;9;1;1;1
250895140912;250895141181;269;0,1,2;3;9;1;1;1
250895141181;250895141938;757;0,1,2;3;9;1;1;1
250895141938;250895141945;7;0,1,2;3;9;1;1;1
250895141945;250895142031;86;0,1,2;3;9;1;1;1
250895142031;250895142114;83;0,1,2;3;9;1;1;1
250895142114;250895142124;10;0,1,2;3;9;1;1;1
250895142124;250895142149;25;0,1,2;3;9;1;1;1
250895142149;250895143541;1392;0,1,2;3;9;1;1;1
250895143541;250895144007;466;0,1,2;3;9;1;1;1
250895144007;250895144021;14;0,1,2;3;9;1;1;1
250895144021;250895144489;468;0,1,2;3;9;1;1;1
250895144489;250895144663;174;0,1,2;3;9;1;1;1
250895144663;250895144897;234;0,1,2;3;9;1;1;1
250895144897;250895144944;47;0,1,2;3;9;1;1;1
250895144944;250895145051;107;0,1,2;3;9;1;1;1
250895145051;250895145362;311;0,1,2;3;9;1;1;1
250895145362;250895146119;757;0,1,2;3;9;1;1;1
250895146119;250895146627;508;0,1,2;3;9;1;1;1
250895146627;250895147231;604;0,1,2;3;9;1;1;1
250895147231;250895147385;154;0,1,2;3;9;1;1;1
250895147385;250895148195;810;0,1,2;3;9;1;1;1
250895148195;250895148411;216;0,1,2;3;9;1;1;1
250895148411;250895148642;231;0,1,2;3;9;1;1;1
250895148642;250895148835;193;0,1,2;3;9;1;1;1
250895148835;250895148995;160;0,1,2;3;9;1;1;1
250895148995;250895149053;58;0,1,2;3;9;1;1;1
250895149053;250895149339;286;0,1,2;3;9;1;1;1
250895149339;250895149582;243;0,1,2;3;9;1;1;1
250895149582;250895149778;196;0,1,2;3;9;1;1;1
250895149778;250895150809;1031;0,1,2;3;9;1;1;1
250895150809;250895150838;29;0,1,2;3;9;1;1;1
250895150838;250895150933;95;0,1,2;3;9;1;1;1
250895150933;250895151174;241;0,1,2;3;9;1;1;1
250895151174;250895151402;228;0,1,2;3;9;1;1;1
250895151402;250895151617;215;0,1,2;3;9;1;1;1
250895151617;250895151872;255;0,1,2;3;9;1;1;1
250895151872;250895151995;123;0,1,2;3;9;1;1;1
250895151995;250895152711;716;0,1,2;3;9;1;1;1
250895152711;250895152794;83;0,1,2;3;9;1;1;1
250895152794;250895152804;10;0,1,2;3;9;1;1;1
250895152804;250895152838;34;0,1,2;3;9;1;1;1
250895152838;250895153213;375;0,1,2;3;9;1;1;1
250895153213;250895154122;909;0,1,2;3;9;1;1;1
250895154122;250895154391;269;0,1,2;3;9;1;1;1
250895154391;250895154430;39;0,1,2;3;9;1;1;1
250895154430;250895154450;20;0,1,2;3;9;1;1;1
250895154450;250895154606;156;0,1,2;3;9;1;1;1
250895154606;250895154646;40;0,1,2;3;9;1;1;1
250895154646;250895154920;274;0,1,2;3;9;1;1;1
250895154920;250895155030;110;0,1,2;3;9;1;1;1
250895155030;250895155037;7;0,1,2;3;9;1;1;1
250895155037;250895155255;218;0,1,2;3;9;1;1;1
250895155255;250895155795;540;0,1,2;3;9;1;1;1
250895155795;250895155802;7;0,1,2;3;9;1;1;1
250895155802;250895155827;25;0,1,2;3;9;1;1;1
250895155827;250895156091;264;0,1,2;3;9;1;1;1
250895156091;250895156172;81;0,1,2;3;9;1;1;1
250895156172;250895156312;140;0,1,2;3;9;1;1;1
250895156312;250895156660;348;0,1,2;3;9;1;1;1
250895156660;250895157049;389;0,1,2;3;9;1;1;1
250895157049;250895157205;156;0,1,2;3;9;1;1;1
250895157205;250895157264;59;0,1,2;3;9;1;1;1
250895157264;250895157501;237;0,1,2;3;9;1;1;1
250895157501;250895158146;645;0,1,2;3;9;1;1;1
250895158146;250895158210;64;0,1,2;3;9;1;1;1
250895158210;250895158592;382;0,1,2;3;9;1;1;1
250895158592;250895158876;284;0,1,2;3;9;1;1;1
250895158876;250895159075;199;0,1,2;3;9;1;1;1
250895159075;250895159137;62;0,1,2;3;9;1;1;1
250895159137;250895159268;131;0,1,2;3;9;1;1;1
250895159268;250895159343;75;0,1,2;3;9;1;1;1
250895159343;250895159388;45;0,1,2;3;9;1;1;1
250895159388;250895159413;25;0,1,2;3;9;1;1;1
250895159413;250895159555;142;0,1,2;3;9;1;1;1
250895159555;250895160037;482;0,1,2;3;9;1;1;1
250895160037;250895160397;360;0,1,2;3;9;1;1;1
250895160397;250895160528;131;0,1,2;3;9;1;1;1
250895160528;250895160618;90;0,1,2;3;9;1;1;1
250895160618;250895160669;51;0,1,2;3;9;1;1;1
250895160669;250895160724;55;0,1,2;3;9;1;1;1
250895160724;250895160911;187;0,1,2;3;9;1;1;1
250895160911;250895161121;210;0,1,2;3;9;1;1;1
250895161121;250895161784;663;0,1,2;3;9;1;1;1
250895161784;250895161810;26;0,1,2;3;9;1;1;1
250895161810;250895161872;62;0,1,2;3;9;1;1;1
250895161872;250895161907;35;0,1,2;3;9;1;1;1
250895161907;250895162811;904;0,1,2;3;9;1;1;1
250895162811;250895162857;46;0,1,2;3;9;1;1;1
250895162857;250895163337;480;0,1,2;3;9;1;1;1
250895163337;250895163751;414;0,1,2;3;9;1;1;1
250895163751;250895164083;332;0,1,2;3;9;1;1;1
250895164083;250895164185;102;0,1,2;3;9;1;1;1
250895164185;250895164418;233;0,1,2;3;9;1;1;1
250895164418;250895164548;130;0,1,2;3;9;1;1;1
250895164548;250895164760;212;0,1,2;3;9;1;1;1
250895164760;250895165015;255;0,1,2;3;9;1;1;1
250895165015;250895165196;181;0,1,2;3;9;1;1;1
250895165196;250895165257;61;0,1,2;3;9;1;1;1
250895165257;250895165305;48;0,1,2;3;9;1;1;1
250895165305;250895165562;257;0,1,2;3;9;1;1;1
250895165562;250895165693;131;0,1,2;3;9;1;1;1
250895165693;250895165780;87;0,1,2;3;9;1;1;1
250895165780;250895166569;789;0,1,2;3;9;1;1;1
250895166569;250895166860;291;0,1,2;3;9;1;1;1
250895166860;250895167025;165;0,1,2;3;9;1;1;1
250895167025;250895167868;843;0,1,2;3;9;1;1;1
250895167868;250895168003;135;0,1,2;3;9;1;1;1
250895168003;250895168050;47;0,1,2;3;9;1;1;1
250895168050;250895168320;270;0,1,2;3;9;1;1;1
250895168320;250895168430;110;0,1,2;3;9;1;1;1
250895168430;250895168738;308;0,1,2;3;9;1;1;1
250895168738;250895169087;349;0,1,2;3;9;1;1;1
250895169087;250895169181;94;0,1,2;3;9;1;1;1
250895169181;250895169464;283;0,1,2;3;9;1;1;1
250895169464;250895169837;373;0,1,2;3;9;1;1;1
250895169837;250895169947;110;0,1,2;3;9;1;1;1
250895169947;250895169966;19;0,1,2;3;9;1;1;1
250895169966;250895170033;67;0,1,2;3;9;1;1;1
250895170033;250895170251;218;0,1,2;3;9;1;1;1
250895170251;250895170386;135;0,1,2;3;9;1;1;1
250895170386;250895171032;646;0,1,2;3;9;1;1;1
250895171032;250895171037;5;0,1,2;3;9;1;1;1
250895171037;250895171545;508;0,1,2;3;9;1;1;1
250895171545;250895172026;481;0,1,2;3;9;1;1;1
250895172026;250895172263;237;0,1,2;3;9;1;1;1
250895172263;250895172265;2;0,1,2;3;9;1;1;1
250895172265;250895172628;363;0,1,2;3;9;1;1;1
250895172628;250895172832;204;0,1,2;3;9;1;1;1
250895172832;250895173257;425;0,1,2;3;9;1;1;1
250895173257;250895173299;42;0,1,2;3;9;1;1;1
250895173299;250895173303;4;0,1,2;3;9;1;1;1
250895173303;250895173663;360;0,1,2;3;9;1;1;1
250895173663;250895174512;849;0,1,2;3;9;1;1;1
250895174512;250895174807;295;0,1,2;3;9;1;1;1
250895174807;250895175130;323;0,1,2;3;9;1;1;1
250895175130;250895175663;533;0,1,2;3;9;1;1;1
250895175663;250895175855;192;0,1,2;3;9;1;1;1
250895175855;250895177125;1270;0,1,2;3;9;1;1;1
250895177125;250895177397;272;0,1,2;3;9;1;1;1
250895177397;250895177786;389;0,1,2;3;9;1;1;1
250895177786;250895178184;398;0,1,2;3;9;1;1;1
250895178184;250895178502;318;0,1,2;3;9;1;1;1
250895178502;250895178601;99;0,1,2;3;9;1;1;1
250895178601;250895178734;133;0,1,2;3;9;1;1;1
250895178734;250895178994;260;0,1,2;3;9;1;1;1
250895178994;250895179202;208;0,1,2;3;9;1;1;1
250895179202;250895179650;448;0,1,2;3;9;1;1;1
250895179650;250895179902;252;0,1,2;3;9;1;1;1
250895179902;250895180199;297;0,1,2;3;9;1;1;1
250895180199;250895180240;41;0,1,2;3;9;1;1;1
250895180240;250895180314;74;0,1,2;3;9;1;1;1
250895180314;250895180846;532;0,1,2;3;9;1;1;1
250895180846;250895181288;442;0,1,2;3;9;1;1;1
250895181288;250895181310;22;0,1,2;3;9;1;1;1
250895181310;250895181999;689;0,1,2;3;9;1;1;1
250895181999;250895182665;666;0,1,2;3;9;1;1;1
250895182665;250895183424;759;0,1,2;3;9;1;1;1
250895183424;250895183432;8;0,1,2;3;9;1;1;1
250895183432;250895183508;76;0,1,2;3;9;1;1;1
250895183508;250895183639;131;0,1,2;3;9;1;1;1
250895183639;250895184541;902;0,1,2;3;9;1;1;1
250895184541;250895184620;79;0,1,2;3;9;1;1;1
250895184620;250895184782;162;0,1,2;3;9;1;1;1
250895184782;250895185076;294;0,1,2;3;9;1;1;1
250895185076;250895185364;288;0,1,2;3;9;1;1;1
250895185364;250895185432;68;0,1,2;3;9;1;1;1
250895185432;250895185579;147;0,1,2;3;9;1;1;1
250895185579;250895185813;234;0,1,2;3;9;1;1;1
250895185813;250895186213;400;0,1,2;3;9;1;1;1
250895186213;250895186240;27;0,1,2;3;9;1;1;1
250895186240;250895186547;307;0,1,2;3;9;1;1;1
250895186547;250895186662;115;0,1,2;3;9;1;1;1
250895186662;250895186872;210;0,1,2;3;9;1;1;1
250895186872;250895186918;46;0,1,2;3;9;1;1;1
250895186918;250895187131;213;0,1,2;3;9;1;1;1
250895187131;250895187448;317;0,1,2;3;9;1;1;1
250895187448;250895188045;597;0,1,2;3;9;1;1;1
250895188045;250895188236;191;0,1,2;3;9;1;1;1
250895188236;250895188643;407;0,1,2;3;9;1;1;1
250895188643;250895189646;1003;0,1,2;3;9;1;1;1
250895189646;250895190076;430;0,1,2;3;9;1;1;1
250895190076;250895190344;268;0,1,2;3;9;1;1;1
250895190344;250895190605;261;0,1,2;3;9;1;1;1
250895190605;250895191058;453;0,1,2;3;9;1;1;1
250895191058;250895191492;434;0,1,2;3;9;1;1;1
250895191492;250895191937;445;0,1,2;3;9;1;1;1
250895191937;250895192347;410;0,1,2;3;9;1;1;1
250895192347;250895192353;6;0,1,2;3;9;1;1;1
250895192353;250895192695;342;0,1,2;3;9;1;1;1
250895192695;250895194269;1574;0,1,2;3;9;1;1;1
250895194269;250895194467;198;0,1,2;3;9;1;1;1
250895194467;250895195144;677;0,1,2;3;9;1;1;1
250895195144;250895195429;285;0,1,2;3;9;1;1;1
250895195429;250895195437;8;0,1,2;3;9;1;1;1
250895195437;250895197268;1831;0,1,2;3;9;1;1;1
250895197268;250895197688;420;0,1,2;3;9;1;1;1
250895197688;250895197786;98;0,1,2;3;9;1;1;1
250895197786;250895198056;270;0,1,2;3;9;1;1;1
250895198056;250895198773;717;0,1,2;3;9;1;1;1
250895198773;250895198904;131;0,1,2;3;9;1;1;1
250895198904;250895199140;236;0,1,2;3;9;1;1;1
250895199140;250895199161;21;0,1,2;3;9;1;1;1
250895199161;250895199351;190;0,1,2;3;9;1;1;1
250895199351;250895199384;33;0,1,2;3;9;1;1;1
250895199384;250895199434;50;0,1,2;3;9;1;1;1
250895199434;250895200495;1061;0,1,2;3;9;1;1;1
250895200495;250895200927;432;0,1,2;3;9;1;1;1
250895200927;250895201190;263;0,1,2;3;9;1;1;1
250895201190;250895201355;165;0,1,2;3;9;1;1;1
250895201355;250895201419;64;0,1,2;3;9;1;1;1
250895201419;250895202571;1152;0,1,2;3;9;1;1;1
250895202571;250895202711;140;0,1,2;3;9;1;1;1
250895202711;250895202878;167;0,1,2;3;9;1;1;1
250895202878;250895202955;77;0,1,2;3;9;1;1;1
250895202955;250895203277;322;0,1,2;3;9;1;1;1
250895203277;250895203440;163;0,1,2;3;9;1;1;1
250895203440;250895204435;995;0,1,2;3;9;1;1;1
250895204435;250895204499;64;0,1,2;3;9;1;1;1
250895204499;250895204564;65;0,1,2;3;9;1;1;1
250895204564;250895205426;862;0,1,2;3;9;1;1;1
250895205426;250895205966;540;0,1,2;3;9;1;1;1
250895205966;250895206703;737;0,1,2;3;9;1;1;1
250895206703;250895207281;578;0,1,2;3;9;1;1;1
250895207281;250895207638;357;0,1,2;3;9;1;1;1
250895207638;250895208384;746;0,1,2;3;9;1;1;1
250895208384;250895208687;303;0,1,2;3;9;1;1;1
250895208687;250895209651;964;0,1,2;3;9;1;1;1
250895209651;250895210568;917;0,1,2;3;9;1;1;1
250895210568;250895210604;36;0,1,2;3;9;1;1;1
250895210604;250895211425;821;0,1,2;3;9;1;1;1
250895211425;250895211893;468;0,1,2;3;9;1;1;1
250895211893;250895212315;422;0,1,2;3;9;1;1;1
250895212315;250895213689;1374;0,1,2;3;9;1;1;1
250895213689;250895213972;283;0,1,2;3;9;1;1;1
250895213972;250895214867;895;0,1,2;3;9;1;1;1
250895214867;250895215023;156;0,1,2;3;9;1;1;1
250895215023;250895216236;1213;0,1,2;3;9;1;1;1
250895216236;250895217452;1216;0,1,2;3;9;1;1;1
250895217452;250895218304;852;0,1,2;3;9;1;1;1
250895218304;250895218815;511;0,1,2;3;9;1;1;1
250895218815;250895221210;2395;0,1,2;3;9;1;1;1
250895221210;250895221786;576;0,1,2;3;9;1;1;1
250895221786;250895222619;833;0,1,2;3;9;1;1;1
250895222619;250895223050;431;0,1,2;3;9;1;1;1
250895223050;250895223758;708;0,1,2;3;9;1;1;1
250895223758;250895224688;930;0,1,2;3;9;1;1;1
250895224688;250895225860;1172;0,1,2;3;9;1;1;1
250895225860;250895225928;68;0,1,2;3;9;1;1;1
250895225928;250895226060;132;0,1,2;3;9;1;1;1
250895226060;250895226805;745;0,1,2;3;9;1;1;1
250895226805;250895226905;100;0,1,2;3;9;1;1;1
250895226905;250895227065;160;0,1,2;3;9;1;1;1
250895227065;250895227371;306;0,1,2;3;9;1;1;1
250895227371;250895227441;70;0,1,2;3;9;1;1;1
250895227441;250895227695;254;0,1,2;3;9;1;1;1
250895227695;250895228172;477;0,1,2;3;9;1;1;1
250895228172;250895228189;17;0,1,2;3;9;1;1;1
250895228189;250895229605;1416;0,1,2;3;9;1;1;1
250895229605;250895230007;402;0,1,2;3;9;1;1;1
250895230007;250895230150;143;0,1,2;3;9;1;1;1
250895230150;250895231954;1804;0,1,2;3;9;1;1;1
250895231954;250895232170;216;0,1,2;3;9;1;1;1
250895232170;250895233032;862;0,1,2;3;9;1;1;1
250895233032;250895233448;416;0,1,2;3;9;1;1;1
250895233448;250895234188;740;0,1,2;3;9;1;1;1
250895234188;250895234205;17;0,1,2;3;9;1;1;1
250895234205;250895234281;76;0,1,2;3;9;1;1;1
250895234281;250895234461;180;0,1,2;3;9;1;1;1
250895234461;250895235182;721;0,1,2;3;9;1;1;1
250895235182;250895236364;1182;0,1,2;3;9;1;1;1
250895236364;250895236385;21;0,1,2;3;9;1;1;1
250895236385;250895236868;483;0,1,2;3;9;1;1;1
250895236868;250895236874;6;0,1,2;3;9;1;1;1
250895236874;250895236908;34;0,1,2;3;9;1;1;1
250895236908;250895237053;145;0,1,2;3;9;1;1;1
250895237053;250895238081;1028;0,1,2;3;9;1;1;1
250895238081;250895238579;498;0,1,2;3;9;1;1;1
250895238579;250895238800;221;0,1,2;3;9;1;1;1
250895238800;250895239080;280;0,1,2;3;9;1;1;1
250895239080;250895239338;258;0,1,2;3;9;1;1;1
250895239338;250895239938;600;0,1,2;3;9;1;1;1
250895239938;250895240244;306;0,1,2;3;9;1;1;1
250895240244;250895241091;847;0,1,2;3;9;1;1;1
250895241091;250895241101;10;0,1,2;3;9;1;1;1
250895241101;250895241551;450;0,1,2;3;9;1;1;1
250895241551;250895241760;209;0,1,2;3;9;1;1;1
250895241760;250895241938;178;0,1,2;3;9;1;1;1
250895241938;250895242397;459;0,1,2;3;9;1;1;1
250895242397;250895242628;231;0,1,2;3;9;1;1;1
250895242628;250895242960;332;0,1,2;3;9;1;1;1
250895242960;250895243448;488;0,1,2;3;9;1;1;1
250895243448;250895243573;125;0,1,2;3;9;1;1;1
250895243573;250895243634;61;0,1,2;3;9;1;1;1
250895243634;250895243731;97;0,1,2;3;9;1;1;1
250895243731;250895244981;1250;0,1,2;3;9;1;1;1
250895244981;250895245508;527;0,1,2;3;9;1;1;1
250895245508;250895245998;490;0,1,2;3;9;1;1;1
250895245998;250895246376;378;0,1,2;3;9;1;1;1
250895246376;250895246999;623;0,1,2;3;9;1;1;1
250895246999;250895247488;489;0,1,2;3;9;1;1;1
250895247488;250895247842;354;0,1,2;3;9;1;1;1
250895247842;250895248293;451;0,1,2;3;9;1;1;1
250895248293;250895248403;110;0,1,2;3;9;1;1;1
250895248403;250895248427;24;0,1,2;3;9;1;1;1
250895248427;250895248443;16;0,1,2;3;9;1;1;1
250895248443;250895248594;151;0,1,2;3;9;1;1;1
250895248594;250895249277;683;0,1,2;3;9;1;1;1
250895249277;250895249443;166;0,1,2;3;9;1;1;1
250895249443;250895250646;1203;0,1,2;3;9;1;1;1
250895250646;250895251335;689;0,1,2;3;9;1;1;1
250895251335;250895251587;252;0,1,2;3;9;1;1;1
250895251587;250895251614;27;0,1,2;3;9;1;1;1
250895251614;250895251687;73;0,1,2;3;9;1;1;1
250895251687;250895251902;215;0,1,2;3;9;1;1;1
250895251902;250895252136;234;0,1,2;3;9;1;1;1
250895252136;250895252485;349;0,1,2;3;9;1;1;1
250895252485;250895252500;15;0,1,2;3;9;1;1;1
250895252500;250895252576;76;0,1,2;3;9;1;1;1
250895252576;250895252634;58;0,1,2;3;9;1;1;1
250895252634;250895253015;381;0,1,2;3;9;1;1;1
250895253015;250895253315;300;0,1,2;3;9;1;1;1
250895253315;250895253796;481;0,1,2;3;9;1;1;1
250895253796;250895254142;346;0,1,2;3;9;1;1;1
250895254142;250895254270;128;0,1,2;3;9;1;1;1
250895254270;250895254559;289;0,1,2;3;9;1;1;1
250895254559;250895255098;539;0,1,2;3;9;1;1;1
250895255098;250895255402;304;0,1,2;3;9;1;1;1
250895255402;250895255421;19;0,1,2;3;9;1;1;1
250895255421;250895255957;536;0,1,2;3;9;1;1;1
250895255957;250895256032;75;0,1,2;3;9;1;1;1
250895256032;250895256056;24;0,1,2;3;9;1;1;1
250895256056;250895256273;217;0,1,2;3;9;1;1;1
250895256273;250895256472;199;0,1,2;3;9;1;1;1
250895256472;250895257098;626;0,1,2;3;9;1;1;1
250895257098;250895257233;135;0,1,2;3;9;1;1;1
250895257233;250895257443;210;0,1,2;3;9;1;1;1
250895257443;250895257471;28;0,1,2;3;9;1;1;1
250895257471;250895258587;1116;0,1,2;3;9;1;1;1
250895258587;250895258674;87;0,1,2;3;9;1;1;1
250895258674;250895258906;232;0,1,2;3;9;1;1;1
250895258906;250895258918;12;0,1,2;3;9;1;1;1
250895258918;250895259051;133;0,1,2;3;9;1;1;1
250895259051;250895259546;495;0,1,2;3;9;1;1;1
250895259546;250895260001;455;0,1,2;3;9;1;1;1
250895260001;250895260151;150;0,1,2;3;9;1;1;1
250895260151;250895260156;5;0,1,2;3;9;1;1;1
250895260156;250895260393;237;0,1,2;3;9;1;1;1
250895260393;250895260578;185;0,1,2;3;9;1;1;1
250895260578;250895261000;422;0,1,2;3;9;1;1;1
250895261000;250895261933;933;0,1,2;3;9;1;1;1
250895261933;250895262377;444;0,1,2;3;9;1;1;1
250895262377;250895262924;547;0,1,2;3;9;1;1;1
250895262924;250895262937;13;0,1,2;3;9;1;1;1
250895262937;250895263295;358;0,1,2;3;9;1;1;1
250895263295;250895263305;10;0,1,2;3;9;1;1;1
250895263305;250895263346;41;0,1,2;3;9;1;1;1
250895263346;250895263475;129;0,1,2;3;9;1;1;1
250895263475;250895263799;324;0,1,2;3;9;1;1;1
250895263799;250895264582;783;0,1,2;3;9;1;1;1
250895264582;250895264810;228;0,1,2;3;9;1;1;1
250895264810;250895264859;49;0,1,2;3;9;1;1;1
250895264859;250895264872;13;0,1,2;3;9;1;1;1
250895264872;250895265248;376;0,1,2;3;9;1;1;1
250895265248;250895265538;290;0,1,2;3;9;1;1;1
250895265538;250895266751;1213;0,1,2;3;9;1;1;1
250895266751;250895266765;14;0,1,2;3;9;1;1;1
250895266765;250895266950;185;0,1,2;3;9;1;1;1
250895266950;250895266969;19;0,1,2;3;9;1;1;1
250895266969;250895267203;234;0,1,2;3;9;1;1;1
250895267203;250895267554;351;0,1,2;3;9;1;1;1
250895267554;250895267847;293;0,1,2;3;9;1;1;1
250895267847;250895268114;267;0,1,2;3;9;1;1;1
250895268114;250895268141;27;0,1,2;3;9;1;1;1
250895268141;250895268605;464;0,1,2;3;9;1;1;1
250895268605;250895268731;126;0,1,2;3;9;1;1;1
250895268731;250895268900;169;0,1,2;3;9;1;1;1
250895268900;250895269296;396;0,1,2;3;9;1;1;1
250895269296;250895270058;762;0,1,2;3;9;1;1;1
250895270058;250895270073;15;0,1,2;3;9;1;1;1
250895270073;250895270373;300;0,1,2;3;9;1;1;1
250895270373;250895270917;544;0,1,2;3;9;1;1;1
250895270917;250895271260;343;0,1,2;3;9;1;1;1
250895271260;250895271428;168;0,1,2;3;9;1;1;1
250895271428;250895271691;263;0,1,2;3;9;1;1;1
250895271691;250895271836;145;0,1,2;3;9;1;1;1
250895271836;250895271845;9;0,1,2;3;9;1;1;1
250895271845;250895272198;353;0,1,2;3;9;1;1;1
250895272198;250895272402;204;0,1,2;3;9;1;1;1
250895272402;250895272472;70;0,1,2;3;9;1;1;1
250895272472;250895272565;93;0,1,2;3;9;1;1;1
250895272565;250895272635;70;0,1,2;3;9;1;1;1
250895272635;250895272827;192;0,1,2;3;9;1;1;1
250895272827;250895273128;301;0,1,2;3;9;1;1;1
250895273128;250895273392;264;0,1,2;3;9;1;1;1
250895273392;250895274308;916;0,1,2;3;9;1;1;1
250895274308;250895274430;122;0,1,2;3;9;1;1;1
250895274430;250895274871;441;0,1,2;3;9;1;1;1
250895274871;250895274878;7;0,1,2;3;9;1;1;1
250895274878;250895274985;107;0,1,2;3;9;1;1;1
250895274985;250895275093;108;0,1,2;3;9;1;1;1
250895275093;250895275237;144;0,1,2;3;9;1;1;1
250895275237;250895275662;425;0,1,2;3;9;1;1;1
250895275662;250895275862;200;0,1,2;3;9;1;1;1
250895275862;250895275926;64;0,1,2;3;9;1;1;1
250895275926;250895276726;800;0,1,2;3;9;1;1;1
250895276726;250895276966;240;0,1,2;3;9;1;1;1
250895276966;250895277332;366;0,1,2;3;9;1;1;1
250895277332;250895277851;519;0,1,2;3;9;1;1;1
250895277851;250895278080;229;0,1,2;3;9;1;1;1
250895278080;250895278484;404;0,1,2;3;9;1;1;1
250895278484;250895278673;189;0,1,2;3;9;1;1;1
250895278673;250895278734;61;0,1,2;3;9;1;1;1
250895278734;250895279039;305;0,1,2;3;9;1;1;1
250895279039;250895279196;157;0,1,2;3;9;1;1;1
250895279196;250895279300;104;0,1,2;3;9;1;1;1
250895279300;250895279793;493;0,1,2;3;9;1;1;1
250895279793;250895280272;479;0,1,2;3;9;1;1;1
250895280272;250895280290;18;0,1,2;3;9;1;1;1
250895280290;250895280345;55;0,1,2;3;9;1;1;1
250895280345;250895280422;77;0,1,2;3;9;1;1;1
250895280422;250895280575;153;0,1,2;3;9;1;1;1
250895280575;250895280863;288;0,1,2;3;9;1;1;1
250895280863;250895280894;31;0,1,2;3;9;1;1;1
250895280894;250895280937;43;0,1,2;3;9;1;1;1
250895280937;250895281412;475;0,1,2;3;9;1;1;1
250895281412;250895282082;670;0,1,2;3;9;1;1;1
250895282082;250895282172;90;0,1,2;3;9;1;1;1
250895282172;250895282437;265;0,1,2;3;9;1;1;1
250895282437;250895282594;157;0,1,2;3;9;1;1;1
250895282594;250895282860;266;0,1,2;3;9;1;1;1
250895282860;250895283014;154;0,1,2;3;9;1;1;1
250895283014;250895283764;750;0,1,2;3;9;1;1;1
250895283764;250895284340;576;0,1,2;3;9;1;1;1
250895284340;250895284474;134;0,1,2;3;9;1;1;1
250895284474;250895284778;304;0,1,2;3;9;1;1;1
250895284778;250895284851;73;0,1,2;3;9;1;1;1
250895284851;250895284908;57;0,1,2;3;9;1;1;1
250895284908;250895285307;399;0,1,2;3;9;1;1;1
250895285307;250895285520;213;0,1,2;3;9;1;1;1
250895285520;250895286101;581;0,1,2;3;9;1;1;1
250895286101;250895286642;541;0,1,2;3;9;1;1;1
250895286642;250895286846;204;0,1,2;3;9;1;1;1
250895286846;250895287533;687;0,1,2;3;9;1;1;1
250895287533;250895287546;13;0,1,2;3;9;1;1;1
250895287546;250895287767;221;0,1,2;3;9;1;1;1
250895287767;250895287808;41;0,1,2;3;9;1;1;1
250895287808;250895288279;471;0,1,2;3;9;1;1;1
250895288279;250895288452;173;0,1,2;3;9;1;1;1
250895288452;250895288779;327;0,1,2;3;9;1;1;1
250895288779;250895289571;792;0,1,2;3;9;1;1;1
250895289571;250895289575;4;0,1,2;3;9;1;1;1
250895289575;250895289821;246;0,1,2;3;9;1;1;1
250895289821;250895290152;331;0,1,2;3;9;1;1;1
250895290152;250895290246;94;0,1,2;3;9;1;1;1
250895290246;250895290618;372;0,1,2;3;9;1;1;1
250895290618;250895290735;117;0,1,2;3;9;1;1;1
250895290735;250895290891;156;0,1,2;3;9;1;1;1
250895290891;250895290929;38;0,1,2;3;9;1;1;1
250895290929;250895290989;60;0,1,2;3;9;1;1;1
250895290989;250895291004;15;0,1,2;3;9;1;1;1
250895291004;250895291612;608;0,1,2;3;9;1;1;1
250895291612;250895291651;39;0,1,2;3;9;1;1;1
250895291651;250895292972;1321;0,1,2;3;9;1;1;1
250895292972;250895293224;252;0,1,2;3;9;1;1;1
250895293224;250895293986;762;0,1,2;3;9;1;1;1
250895293986;250895294061;75;0,1,2;3;9;1;1;1
250895294061;250895294231;170;0,1,2;3;9;1;1;1
250895294231;250895294387;156;0,1,2;3;9;1;1;1
250895294387;250895294462;75;0,1,2;3;9;1;1;1
250895294462;250895294576;114;0,1,2;3;9;1;1;1
250895294576;250895294608;32;0,1,2;3;9;1;1;1
250895294608;250895294704;96;0,1,2;3;9;1;1;1
250895294704;250895295045;341;0,1,2;3;9;1;1;1
250895295045;250895295084;39;0,1,2;3;9;1;1;1
250895295084;250895295184;100;0,1,2;3;9;1;1;1
250895295184;250895295367;183;0,1,2;3;9;1;1;1
250895295367;250895295571;204;0,1,2;3;9;1;1;1
250895295571;250895295601;30;0,1,2;3;9;1;1;1
250895295601;250895295636;35;0,1,2;3;9;1;1;1
250895295636;250895296107;471;0,1,2;3;9;1;1;1
250895296107;250895296228;121;0,1,2;3;9;1;1;1
250895296228;250895296704;476;0,1,2;3;9;1;1;1
250895296704;250895297659;955;0,1,2;3;9;1;1;1
250895297659;250895297904;245;0,1,2;3;9;1;1;1
250895297904;250895298104;200;0,1,2;3;9;1;1;1
250895298104;250895298211;107;0,1,2;3;9;1;1;1
250895298211;250895298570;359;0,1,2;3;9;1;1;1
250895298570;250895298632;62;0,1,2;3;9;1;1;1
250895298632;250895299294;662;0,1,2;3;9;1;1;1
250895299294;250895299379;85;0,1,2;3;9;1;1;1
250895299379;250895299788;409;0,1,2;3;9;1;1;1
250895299788;250895299950;162;0,1,2;3;9;1;1;1
250895299950;250895300804;854;0,1,2;3;9;1;1;1
250895300804;250895301028;224;0,1,2;3;9;1;1;1
250895301028;250895301197;169;0,1,2;3;9;1;1;1
250895301197;250895301284;87;0,1,2;3;9;1;1;1
250895301284;250895301336;52;0,1,2;3;9;1;1;1
250895301336;250895301462;126;0,1,2;3;9;1;1;1
250895301462;250895301859;397;0,1,2;3;9;1;1;1
250895301859;250895302510;651;0,1,2;3;9;1;1;1
250895302510;250895302568;58;0,1,2;3;9;1;1;1
250895302568;250895302617;49;0,1,2;3;9;1;1;1
250895302617;250895302888;271;0,1,2;3;9;1;1;1
250895302888;250895303098;210;0,1,2;3;9;1;1;1
250895303098;250895303263;165;0,1,2;3;9;1;1;1
250895303263;250895303274;11;0,1,2;3;9;1;1;1
250895303274;250895303605;331;0,1,2;3;9;1;1;1
250895303605;250895304217;612;0,1,2;3;9;1;1;1
250895304217;250895304247;30;0,1,2;3;9;1;1;1
250895304247;250895304649;402;0,1,2;3;9;1;1;1
250895304649;250895305842;1193;0,1,2;3;9;1;1;1
250895305842;250895306810;968;0,1,2;3;9;1;1;1
250895306810;250895306821;11;0,1,2;3;9;1;1;1
250895306821;250895306881;60;0,1,2;3;9;1;1;1
250895306881;250895307306;425;0,1,2;3;9;1;1;1
250895307306;250895307534;228;0,1,2;3;9;1;1;1
250895307534;250895307595;61;0,1,2;3;9;1;1;1
250895307595;250895307621;26;0,1,2;3;9;1;1;1
250895307621;250895307867;246;0,1,2;3;9;1;1;1
250895307867;250895307892;25;0,1,2;3;9;1;1;1
250895307892;250895308092;200;0,1,2;3;9;1;1;1
250895308092;250895308163;71;0,1,2;3;9;1;1;1
250895308163;250895309055;892;0,1,2;3;9;1;1;1
250895309055;250895309351;296;0,1,2;3;9;1;1;1
250895309351;250895309951;600;0,1,2;3;9;1;1;1
250895309951;250895310544;593;0,1,2;3;9;1;1;1
250895310544;250895310551;7;0,1,2;3;9;1;1;1
250895310551;250895310553;2;0,1,2;3;9;1;1;1
250895310553;250895311102;549;0,1,2;3;9;1;1;1
250895311102;250895311176;74;0,1,2;3;9;1;1;1
250895311176;250895311438;262;0,1,2;3;9;1;1;1
250895311438;250895311666;228;0,1,2;3;9;1;1;1
250895311666;250895311904;238;0,1,2;3;9;1;1;1
250895311904;250895312471;567;0,1,2;3;9;1;1;1
250895312471;250895312692;221;0,1,2;3;9;1;1;1
250895312692;250895312995;303;0,1,2;3;9;1;1;1
250895312995;250895313608;613;0,1,2;3;9;1;1;1
250895313608;250895314660;1052;0,1,2;3;9;1;1;1
250895314660;250895315165;505;0,1,2;3;9;1;1;1
250895315165;250895315627;462;0,1,2;3;9;1;1;1
250895315627;250895315813;186;0,1,2;3;9;1;1;1
250895315813;250895315837;24;0,1,2;3;9;1;1;1
250895315837;250895316227;390;0,1,2;3;9;1;1;1
250895316227;250895316464;237;0,1,2;3;9;1;1;1
250895316464;250895317051;587;0,1,2;3;9;1;1;1
250895317051;250895317490;439;0,1,2;3;9;1;1;1
250895317490;250895317542;52;0,1,2;3;9;1;1;1
250895317542;250895317744;202;0,1,2;3;9;1;1;1
250895317744;250895318819;1075;0,1,2;3;9;1;1;1
250895318819;250895319372;553;0,1,2;3;9;1;1;1
250895319372;250895319487;115;0,1,2;3;9;1;1;1
250895319487;250895319694;207;0,1,2;3;9;1;1;1
250895319694;250895319769;75;0,1,2;3;9;1;1;1
250895319769;250895320955;1186;0,1,2;3;9;1;1;1
250895320955;250895321264;309;0,1,2;3;9;1;1;1
250895321264;250895321486;222;0,1,2;3;9;1;1;1
250895321486;250895322333;847;0,1,2;3;9;1;1;1
250895322333;250895322455;122;0,1,2;3;9;1;1;1
250895322455;250895322853;398;0,1,2;3;9;1;1;1
250895322853;250895323029;176;0,1,2;3;9;1;1;1
250895323029;250895324149;1120;0,1,2;3;9;1;1;1
250895324149;250895324470;321;0,1,2;3;9;1;1;1
250895324470;250895325157;687;0,1,2;3;9;1;1;1
250895325157;250895325791;634;0,1,2;3;9;1;1;1
250895325791;250895325815;24;0,1,2;3;9;1;1;1
250895325815;250895326218;403;0,1,2;3;9;1;1;1
250895326218;250895327105;887;0,1,2;3;9;1;1;1
250895327105;250895327279;174;0,1,2;3;9;1;1;1
250895327279;250895327618;339;0,1,2;3;9;1;1;1
250895327618;250895328879;1261;0,1,2;3;9;1;1;1
250895328879;250895329121;242;0,1,2;3;9;1;1;1
250895329121;250895329832;711;0,1,2;3;9;1;1;1
250895329832;250895330078;246;0,1,2;3;9;1;1;1
250895330078;250895332138;2060;0,1,2;3;9;1;1;1
250895332138;250895333138;1000;0,1,2;3;9;1;1;1
250895333138;250895333534;396;0,1,2;3;9;1;1;1
250895333534;250895334108;574;0,1,2;3;9;1;1;1
250895334108;250895334532;424;0,1,2;3;9;1;1;1
250895334532;250895336095;1563;0,1,2;3;9;1;1;1
250895336095;250895337194;1099;0,1,2;3;9;1;1;1
250895337194;250895338842;1648;0,1,2;3;9;1;1;1
250895338842;250895339501;659;0,1,2;3;9;1;1;1
250895339501;250895339638;137;0,1,2;3;9;1;1;1
250895339638;250895340221;583;0,1,2;3;9;1;1;1
250895340221;250895341180;959;0,1,2;3;9;1;1;1
250895341180;250895341412;232;0,1,2;3;9;1;1;1
250895341412;250895341849;437;0,1,2;3;9;1;1;1
250895341849;250895342231;382;0,1,2;3;9;1;1;1
250895342231;250895342479;248;0,1,2;3;9;1;1;1
250895342479;250895343396;917;0,1,2;3;9;1;1;1
250895343396;250895343495;99;0,1,2;3;9;1;1;1
250895343495;250895343560;65;0,1,2;3;9;1;1;1
250895343560;250895343611;51;0,1,2;3;9;1;1;1
250895343611;250895343958;347;0,1,2;3;9;1;1;1
250895343958;250895344900;942;0,1,2;3;9;1;1;1
250895344900;250895345062;162;0,1,2;3;9;1;1;1
250895345062;250895345351;289;0,1,2;3;9;1;1;1
250895345351;250895345467;116;0,1,2;3;9;1;1;1
250895345467;250895345662;195;0,1,2;3;9;1;1;1
250895345662;250895345865;203;0,1,2;3;9;1;1;1
250895345865;250895346029;164;0,1,2;3;9;1;1;1
250895346029;250895346608;579;0,1,2;3;9;1;1;1
250895346608;250895347004;396;0,1,2;3;9;1;1;1
250895347004;250895347260;256;0,1,2;3;9;1;1;1
250895347260;250895347356;96;0,1,2;3;9;1;1;1
250895347356;250895347736;380;0,1,2;3;9;1;1;1
250895347736;250895347805;69;0,1,2;3;9;1;1;1
250895347805;250895348296;491;0,1,2;3;9;1;1;1
250895348296;250895348732;436;0,1,2;3;9;1;1;1
250895348732;250895349168;436;0,1,2;3;9;1;1;1
250895349168;250895349176;8;0,1,2;3;9;1;1;1
250895349176;250895349827;651;0,1,2;3;9;1;1;1
250895349827;250895349881;54;0,1,2;3;9;1;1;1
250895349881;250895350149;268;0,1,2;3;9;1;1;1
250895350149;250895350962;813;0,1,2;3;9;1;1;1
250895350962;250895351246;284;0,1,2;3;9;1;1;1
250895351246;250895351530;284;0,1,2;3;9;1;1;1
250895351530;250895351711;181;0,1,2;3;9;1;1;1
250895351711;250895351839;128;0,1,2;3;9;1;1;1
250895351839;250895351995;156;0,1,2;3;9;1;1;1
250895351995;250895352486;491;0,1,2;3;9;1;1;1
250895352486;250895352943;457;0,1,2;3;9;1;1;1
250895352943;250895352969;26;0,1,2;3;9;1;1;1
250895352969;250895353140;171;0,1,2;3;9;1;1;1
250895353140;250895353803;663;0,1,2;3;9;1;1;1
250895353803;250895354084;281;0,1,2;3;9;1;1;1
250895354084;250895354175;91;0,1,2;3;9;1;1;1
250895354175;250895354410;235;0,1,2;3;9;1;1;1
250895354410;250895354643;233;0,1,2;3;9;1;1;1
250895354643;250895355352;709;0,1,2;3;9;1;1;1
250895355352;250895355706;354;0,1,2;3;9;1;1;1
250895355706;250895355923;217;0,1,2;3;9;1;1;1
250895355923;250895356249;326;0,1,2;3;9;1;1;1
250895356249;250895356301;52;0,1,2;3;9;1;1;1
250895356301;250895356600;299;0,1,2;3;9;1;1;1
250895356600;250895357856;1256;0,1,2;3;9;1;1;1
250895357856;250895358158;302;0,1,2;3;9;1;1;1
250895358158;250895358480;322;0,1,2;3;9;1;1;1
250895358480;250895358918;438;0,1,2;3;9;1;1;1
250895358918;250895359020;102;0,1,2;3;9;1;1;1
250895359020;250895359164;144;0,1,2;3;9;1;1;1
250895359164;250895359195;31;0,1,2;3;9;1;1;1
250895359195;250895359332;137;0,1,2;3;9;1;1;1
250895359332;250895359427;95;0,1,2;3;9;1;1;1
250895359427;250895359658;231;0,1,2;3;9;1;1;1
250895359658;250895360045;387;0,1,2;3;9;1;1;1
250895360045;250895361104;1059;0,1,2;3;9;1;1;1
250895361104;250895361178;74;0,1,2;3;9;1;1;1
250895361178;250895361863;685;0,1,2;3;9;1;1;1
250895361863;250895362258;395;0,1,2;3;9;1;1;1
250895362258;250895362325;67;0,1,2;3;9;1;1;1
250895362325;250895362751;426;0,1,2;3;9;1;1;1
250895362751;250895362947;196;0,1,2;3;9;1;1;1
250895362947;250895363360;413;0,1,2;3;9;1;1;1
250895363360;250895363376;16;0,1,2;3;9;1;1;1
250895363376;250895363663;287;0,1,2;3;9;1;1;1
250895363663;250895364152;489;0,1,2;3;9;1;1;1
250895364152;250895364413;261;0,1,2;3;9;1;1;1
250895364413;250895364584;171;0,1,2;3;9;1;1;1
250895364584;250895364762;178;0,1,2;3;9;1;1;1
250895364762;250895365957;1195;0,1,2;3;9;1;1;1
250895365957;250895366056;99;0,1,2;3;9;1;1;1
250895366056;250895366323;267;0,1,2;3;9;1;1;1
250895366323;250895366490;167;0,1,2;3;9;1;1;1
250895366490;250895366902;412;0,1,2;3;9;1;1;1
250895366902;250895366904;2;0,1,2;3;9;1;1;1
250895366904;250895366989;85;0,1,2;3;9;1;1;1
250895366989;250895367465;476;0,1,2;3;9;1;1;1
250895367465;250895367546;81;0,1,2;3;9;1;1;1
250895367546;250895367554;8;0,1,2;3;9;1;1;1
250895367554;250895367626;72;0,1,2;3;9;1;1;1
250895367626;250895368859;1233;0,1,2;3;9;1;1;1
250895368859;250895369283;424;0,1,2;3;9;1;1;1
250895369283;250895369311;28;0,1,2;3;9;1;1;1
250895369311;250895369993;682;0,1,2;3;9;1;1;1
250895369993;250895370216;223;0,1,2;3;9;1;1;1
250895370216;250895370558;342;0,1,2;3;9;1;1;1
250895370558;250895370747;189;0,1,2;3;9;1;1;1
250895370747;250895371164;417;0,1,2;3;9;1;1;1
250895371164;250895371210;46;0,1,2;3;9;1;1;1
250895371210;250895371242;32;0,1,2;3;9;1;1;1
250895371242;250895371461;219;0,1,2;3;9;1;1;1
250895371461;250895371540;79;0,1,2;3;9;1;1;1
250895371540;250895371786;246;0,1,2;3;9;1;1;1
250895371786;250895371787;1;0,1,2;3;9;1;1;1
250895371787;250895371930;143;0,1,2;3;9;1;1;1
250895371930;250895372063;133;0,1,2;3;9;1;1;1
250895372063;250895372220;157;0,1,2;3;9;1;1;1
250895372220;250895372768;548;0,1,2;3;9;1;1;1
250895372768;250895372906;138;0,1,2;3;9;1;1;1
250895372906;250895373261;355;0,1,2;3;9;1;1;1
250895373261;250895373829;568;0,1,2;3;9;1;1;1
250895373829;250895374053;224;0,1,2;3;9;1;1;1
250895374053;250895374177;124;0,1,2;3;9;1;1;1
250895374177;250895374318;141;0,1,2;3;9;1;1;1
250895374318;250895374759;441;0,1,2;3;9;1;1;1
250895374759;250895375244;485;0,1,2;3;9;1;1;1
250895375244;250895375517;273;0,1,2;3;9;1;1;1
250895375517;250895375562;45;0,1,2;3;9;1;1;1
250895375562;250895376848;1286;0,1,2;3;9;1;1;1
250895376848;250895376884;36;0,1,2;3;9;1;1;1
250895376884;250895377393;509;0,1,2;3;9;1;1;1
250895377393;250895378368;975;0,1,2;3;9;1;1;1
250895378368;250895378488;120;0,1,2;3;9;1;1;1
250895378488;250895378600;112;0,1,2;3;9;1;1;1
250895378600;250895379319;719;0,1,2;3;9;1;1;1
250895379319;250895379965;646;0,1,2;3;9;1;1;1
250895379965;250895379967;2;0,1,2;3;9;1;1;1
250895379967;250895379977;10;0,1,2;3;9;1;1;1
250895379977;250895380579;602;0,1,2;3;9;1;1;1
250895380579;250895381593;1014;0,1,2;3;9;1;1;1
250895381593;250895381879;286;0,1,2;3;9;1;1;1
250895381879;250895382191;312;0,1,2;3;9;1;1;1
250895382191;250895382737;546;0,1,2;3;9;1;1;1
250895382737;250895383012;275;0,1,2;3;9;1;1;1
250895383012;250895383656;644;0,1,2;3;9;1;1;1
250895383656;250895383911;255;0,1,2;3;9;1;1;1
250895383911;250895384094;183;0,1,2;3;9;1;1;1
250895384094;250895384354;260;0,1,2;3;9;1;1;1
250895384354;250895385084;730;0,1,2;3;9;1;1;1
250895385084;250895386034;950;0,1,2;3;9;1;1;1
250895386034;250895386036;2;0,1,2;3;9;1;1;1
250895386036;250895386102;66;0,1,2;3;9;1;1;1
250895386102;250895386451;349;0,1,2;3;9;1;1;1
250895386451;250895386455;4;0,1,2;3;9;1;1;1
250895386455;250895386631;176;0,1,2;3;9;1;1;1
250895386631;250895387915;1284;0,1,2;3;9;1;1;1
250895387915;250895388255;340;0,1,2;3;9;1;1;1
250895388255;250895388514;259;0,1,2;3;9;1;1;1
250895388514;250895389340;826;0,1,2;3;9;1;1;1
250895389340;250895389907;567;0,1,2;3;9;1;1;1
250895389907;250895390229;322;0,1,2;3;9;1;1;1
250895390229;250895390365;136;0,1,2;3;9;1;1;1
250895390365;250895390927;562;0,1,2;3;9;1;1;1
250895390927;250895391100;173;0,1,2;3;9;1;1;1
250895391100;250895391191;91;0,1,2;3;9;1;1;1
250895391191;250895391263;72;0,1,2;3;9;1;1;1
250895391263;250895392586;1323;0,1,2;3;9;1;1;1
250895392586;250895393326;740;0,1,2;3;9;1;1;1
250895393326;250895393469;143;0,1,2;3;9;1;1;1
250895393469;250895393732;263;0,1,2;3;9;1;1;1
250895393732;250895394120;388;0,1,2;3;9;1;1;1
250895394120;250895394535;415;0,1,2;3;9;1;1;1
250895394535;250895394613;78;0,1,2;3;9;1;1;1
250895394613;250895394693;80;0,1,2;3;9;1;1;1
250895394693;250895394889;196;0,1,2;3;9;1;1;1
250895394889;250895396049;1160;0,1,2;3;9;1;1;1
250895396049;250895396087;38;0,1,2;3;9;1;1;1
250895396087;250895397376;1289;0,1,2;3;9;1;1;1
250895397376;250895398037;661;0,1,2;3;9;1;1;1
250895398037;250895398133;96;0,1,2;3;9;1;1;1
250895398133;250895398234;101;0,1,2;3;9;1;1;1
250895398234;250895399576;1342;0,1,2;3;9;1;1;1
250895399576;250895399713;137;0,1,2;3;9;1;1;1
250895399713;250895401101;1388;0,1,2;3;9;1;1;1
250895401101;250895401206;105;0,1,2;3;9;1;1;1
250895401206;250895403069;1863;0,1,2;3;9;1;1;1
250895403069;250895403085;16;0,1,2;3;9;1;1;1
250895403085;250895403939;854;0,1,2;3;9;1;1;1
250895403939;250895407789;3850;0,1,2;3;9;1;1;1
250895407789;250895407910;121;0,1,2;3;9;1;1;1
250895407910;250895411043;3133;0,1,2;3;9;1;1;1
250895411043;250895412741;1698;0,1,2;3;9;1;1;1
250895412741;250895414106;1365;0,1,2;3;9;1;1;1
250895414106;250895416140;2034;0,1,2;3;9;1;1;1
250895416140;250895416912;772;0,1,2;3;9;1;1;1
250895416912;250895416950;38;0,1,2;3;9;1;1;1
250895416950;250895423527;6577;0,1,2;3;9;1;1;1
250895423527;250895426324;2797;0,1,2;3;9;1;1;1
250895426324;250895428911;2587;0,1,2;3;9;1;1;1
250895428911;250895436757;7846;0,1,2;3;9;1;1;1
250895436757;250895437514;757;0,1,2;3;9;1;1;1
250895437514;250895440854;3340;0,1,2;3;9;1;1;1
250895440854;250895440920;66;0,1,2;3;9;1;1;1
250895440920;250895441149;229;0,1,2;3;9;1;1;1
250895441149;250895441271;122;0,1,2;3;9;1;1;1
250895441271;250895444650;3379;0,1,2;3;9;1;1;1
250895444650;250895445065;415;0,1,2;3;9;1;1;1
250895445065;250895445286;221;0,1,2;3;9;1;1;1
250895445286;250895446035;749;0,1,2;3;9;1;1;1
250895446035;250895448598;2563;0,1,2;3;9;1;1;1
250895448598;250895448621;23;0,1,2;3;9;1;1;1
250895448621;250895449595;974;0,1,2;3;9;1;1;1
250895449595;250895449668;73;0,1,2;3;9;1;1;1
250895449668;250895451405;1737;0,1,2;3;9;1;1;1
250895451405;250895451665;260;0,1,2;3;9;1;1;1
250895451665;250895452815;1150;0,1,2;3;9;1;1;1
250895452815;250895454076;1261;0,1,2;3;9;1;1;1
250895454076;250895454567;491;0,1,2;3;9;1;1;1
250895454567;250895454700;133;0,1,2;3;9;1;1;1
250895454700;250895457507;2807;0,1,2;3;9;1;1;1
250895457507;250895458078;571;0,1,2;3;9;1;1;1
250895458078;250895458881;803;0,1,2;3;9;1;1;1
250895458881;250895459147;266;0,1,2;3;9;1;1;1
250895459147;250895459753;606;0,1,2;3;9;1;1;1
250895459753;250895461895;2142;0,1,2;3;9;1;1;1
250895461895;250895462395;500;0,1,2;3;9;1;1;1
250895462395;250895463681;1286;0,1,2;3;9;1;1;1
250895463681;250895465167;1486;0,1,2;3;9;1;1;1
250895465167;250895465787;620;0,1,2;3;9;1;1;1
250895465787;250895466778;991;0,1,2;3;9;1;1;1
250895466778;250895466960;182;0,1,2;3;9;1;1;1
250895466960;250895467555;595;0,1,2;3;9;1;1;1
250895467555;250895470156;2601;0,1,2;3;9;1;1;1
250895470156;250895471037;881;0,1,2;3;9;1;1;1
250895471037;250895471240;203;1,2;2;9;1;1;1
250895471240;250895471625;385;0,1,2;3;9;1;1;1
250895471625;250895475273;3648;0,1,2;3;9;1;1;1
250895475273;250895475287;14;0,1,2;3;9;1;1;1
250895475287;250895483009;7722;1,2;2;9;1;1;1
250895483009;250895490672;7663;0,1,2;3;9;1;1;1
250895490672;250895492708;2036;0,1,2;3;9;1;1;1
250895492708;250895798183;305475;1,2;2;9;1;1;1
250895798183;250896323208;525025;1,2;2;9;1;1;1
250896323208;250896335343;12135;1,2;2;9;1;1;1
250896335343;250909960316;13624973;1,2;2;9;1;1;1
250909960316;250911101293;1140977;1,2;2;9;1;1;1
250911101293;250911484122;382829;1,2;2;9;1;1;1
250911484122;250911679260;195138;1,2;2;9;1;1;1
250911679260;250912025681;346421;1,2;2;9;1;1;1
250912025681;250912255335;229654;1,2;2;9;1;1;1
250912255335;250912633722;378387;1,2;2;9;1;1;1
250912633722;250913063129;429407;1,2;2;9;1;1;1
250913063129;250913259672;196543;1,2;2;9;1;1;1
250913259672;250913414407;154735;1,2;2;9;1;1;1
250913414407;250913485142;70735;1,2;2;9;1;1;1
250913485142;250913657585;172443;1,2;2;9;1;1;1
250913657585;250913696584;38999;1,2;2;9;1;1;1
250913696584;250913753306;56722;1,2;2;9;1;1;1
250913753306;250913820132;66826;1,2;2;9;1;1;1
250913820132;250914137248;317116;1,2;2;9;1;1;1
250914137248;250914211070;73822;1,2;2;9;1;1;1
250914211070;250914443849;232779;1,2;2;9;1;1;1
250914443849;250915821484;1377635;1,2;2;9;1;1;1
250915821484;250915822304;820;1,2;2;9;1;1;1
250915822304;250915822825;521;1,2;2;9;1;1;1
250915822825;250915824946;2121;1,2;2;9;1;1;1
250915824946;250915827062;2116;1,2;2;9;1;1;1
250915827062;250915827776;714;1,2;2;9;1;1;1
250915827776;250916199853;372077;1,2;2;9;1;1;1
250916199853;250916375472;175619;1,2;2;9;1;1;1
250916375472;250916562784;187312;1,2;2;9;1;1;1
250916562784;250916789069;226285;1,2;2;9;1;1;1
250916789069;250916987244;198175;1,2;2;9;1;1;1
250916987244;250917212312;225068;1,2;2;9;1;1;1
250917212312;250945674495;28462183;1,2;2;9;1;1;1
250945674495;250946666537;992042;1,2;2;9;1;1;1
250946666537;250954711561;8045024;1,2;2;9;1;1;1
250954711561;250955140870;429309;1,2;2;9;1;1;1
250955140870;250963081937;7941067;1,2;2;9;1;1;1
250963081937;250963457480;375543;1,2;2;9;1;1;1
250963457480;250969166725;5709245;1,2;2;9;1;1;1
250969166725;250969496599;329874;1,2;2;9;1;1;1
250969496599;250975061408;5564809;1,2;2;9;1;1;1
250975061408;250975472164;410756;1,2;2;9;1;1;1
250975472164;250983026124;7553960;1,2;2;9;1;1;1
250983026124;250983544526;518402;1,2;2;9;1;1;1
250983544526;250988834968;5290442;1,2;2;9;1;1;1
250988834968;250989358844;523876;1,2;2;9;1;1;1
250989358844;250994763546;5404702;1,2;2;9;1;1;1
250994763546;250995261149;497603;1,2;2;9;1;1;1
250995261149;251000641622;5380473;1,2;2;9;1;1;1
251000641622;251000784276;142654;1,2;2;9;1;1;1
251000784276;251013148408;12364132;1,2;2;9;1;1;1
251013148408;251016256982;3108574;1,2;2;9;1;1;1
251016256982;251016319687;62705;1,2;2;9;1;1;1
251016319687;251016320486;799;1,2;2;9;1;1;1
251016320486;251016324077;3591;1,2;2;9;1;1;1
251016324077;251016332493;8416;1,2;2;9;1;1;1
251016332493;251016385099;52606;1,2;2;9;1;1;1
251016385099;251016435312;50213;1,2;2;9;1;1;1
251016435312;251016497362;62050;1,2;2;9;1;1;1
251016497362;251016499035;1673;1,2;2;9;1;1;1
251016499035;251016602449;103414;1,2;2;9;1;1;1
251016602449;251016611641;9192;1,2;2;9;1;1;1
251016611641;251016612544;903;1,2;2;9;1;1;1
251016612544;251016612923;379;1,2;2;9;1;1;1
251016612923;251016620382;7459;1,2;2;9;1;1;1
251016620382;251016622964;2582;1,2;2;9;1;1;1
251016622964;251016646001;23037;1,2;2;9;1;1;1
251016646001;251016646898;897;1,2;2;9;1;1;1
251016646898;251016703325;56427;1,2;2;9;1;1;1
251016703325;251016753484;50159;1,2;2;9;1;1;1
251016753484;251016786185;32701;1,2;2;9;1;1;1
251016786185;251016791681;5496;1,2;2;9;1;1;1
251016791681;251016899366;107685;1,2;2;9;1;1;1
251016899366;251016953809;54443;1,2;2;9;1;1;1
251016953809;251017000932;47123;1,2;2;9;1;1;1
251017000932;251017002546;1614;1,2;2;9;1;1;1
251017002546;251017006506;3960;1,2;2;9;1;1;1
251017006506;251017045670;39164;1,2;2;9;1;1;1
251017045670;251017048890;3220;1,2;2;9;1;1;1
251017048890;251017059880;10990;1,2;2;9;1;1;1
251017059880;251017084970;25090;1,2;2;9;1;1;1
251017084970;251017118516;33546;1,2;2;9;1;1;1
251017118516;251017118708;192;1,2;2;9;1;1;1
251017118708;251017132851;14143;1,2;2;9;1;1;1
251017132851;251017172802;39951;1,2;2;9;1;1;1
251017172802;251017235954;63152;1,2;2;9;1;1;1
251017235954;251017289348;53394;1,2;2;9;1;1;1
251017289348;251017321091;31743;1,2;2;9;1;1;1
251017321091;251017352487;31396;1,2;2;9;1;1;1
251017352487;251017384020;31533;1,2;2;9;1;1;1
251017384020;251017389664;5644;1,2;2;9;1;1;1
251017389664;251017394010;4346;1,2;2;9;1;1;1
251017394010;251017436342;42332;1,2;2;9;1;1;1
251017436342;251017473394;37052;1,2;2;9;1;1;1
251017473394;251017597228;123834;1,2;2;9;1;1;1
251017597228;251017633073;35845;1,2;2;9;1;1;1
251017633073;251017634881;1808;1,2;2;9;1;1;1
251017634881;251017641009;6128;1,2;2;9;1;1;1
251017641009;251017669762;28753;1,2;2;9;1;1;1
251017669762;251017739830;70068;1,2;2;9;1;1;1
251017739830;251017747724;7894;1,2;2;9;1;1;1
251017747724;251017750997;3273;1,2;2;9;1;1;1
251017750997;251017796581;45584;1,2;2;9;1;1;1
251017796581;251017857227;60646;1,2;2;9;1;1;1
251017857227;251017869472;12245;1,2;2;9;1;1;1
251017869472;251017949672;80200;1,2;2;9;1;1;1
251017949672;251018119468;169796;1,2;2;9;1;1;1
251018119468;251018164071;44603;1,2;2;9;1;1;1
251018164071;251018203624;39553;1,2;2;9;1;1;1
251018203624;251018205651;2027;1,2;2;9;1;1;1
251018205651;251018205736;85;1,2;2;9;1;1;1
251018205736;251018242694;36958;1,2;2;9;1;1;1
251018242694;251018283497;40803;1,2;2;9;1;1;1
251018283497;251018326552;43055;1,2;2;9;1;1;1
251018326552;251018369231;42679;1,2;2;9;1;1;1
251018369231;251018370746;1515;1,2;2;9;1;1;1
251018370746;251018381475;10729;1,2;2;9;1;1;1
251018381475;251018382798;1323;1,2;2;9;1;1;1
251018382798;251018388808;6010;1,2;2;9;1;1;1
251018388808;251018424494;35686;1,2;2;9;1;1;1
251018424494;251018454691;30197;1,2;2;9;1;1;1
251018454691;251018491224;36533;1,2;2;9;1;1;1
251018491224;251018520977;29753;1,2;2;9;1;1;1
251018520977;251018562341;41364;1,2;2;9;1;1;1
251018562341;251018562421;80;1,2;2;9;1;1;1
251018562421;251018583154;20733;1,2;2;9;1;1;1
251018583154;251018601393;18239;1,2;2;9;1;1;1
251018601393;251018602194;801;1,2;2;9;1;1;1
251018602194;251018678159;75965;1,2;2;9;1;1;1
251018678159;251018726761;48602;1,2;2;9;1;1;1
251018726761;251018734444;7683;1,2;2;9;1;1;1
251018734444;251018766000;31556;1,2;2;9;1;1;1
251018766000;251018811572;45572;1,2;2;9;1;1;1
251018811572;251018854899;43327;1,2;2;9;1;1;1
251018854899;251018926749;71850;1,2;2;9;1;1;1
251018926749;251018962148;35399;1,2;2;9;1;1;1
251018962148;251018962365;217;1,2;2;9;1;1;1
251018962365;251019002957;40592;1,2;2;9;1;1;1
251019002957;251019012155;9198;1,2;2;9;1;1;1
251019012155;251019046960;34805;1,2;2;9;1;1;1
251019046960;251019085778;38818;1,2;2;9;1;1;1
251019085778;251019121308;35530;1,2;2;9;1;1;1
251019121308;251019160788;39480;1,2;2;9;1;1;1
251019160788;251019163760;2972;1,2;2;9;1;1;1
251019163760;251019165706;1946;1,2;2;9;1;1;1
251019165706;251019226399;60693;1,2;2;9;1;1;1
251019226399;251019270950;44551;1,2;2;9;1;1;1
251019270950;251019279883;8933;1,2;2;9;1;1;1
251019279883;251019310944;31061;1,2;2;9;1;1;1
251019310944;251019389089;78145;1,2;2;9;1;1;1
251019389089;251019431980;42891;1,2;2;9;1;1;1
251019431980;251019465626;33646;1,2;2;9;1;1;1
251019465626;251019465916;290;1,2;2;9;1;1;1
251019465916;251019466447;531;1,2;2;9;1;1;1
251019466447;251019472478;6031;1,2;2;9;1;1;1
251019472478;251019521268;48790;1,2;2;9;1;1;1
251019521268;251019560668;39400;1,2;2;9;1;1;1
251019560668;251019594629;33961;1,2;2;9;1;1;1
251019594629;251019630860;36231;1,2;2;9;1;1;1
251019630860;251023808905;4178045;1,2;2;9;1;1;1
251023808905;251023832650;23745;1,2;2;9;1;1;1
251023832650;251023967958;135308;1,2;2;9;1;1;1
251023967958;251024022312;54354;1,2;2;9;1;1;1
251024022312;251024069658;47346;1,2;2;9;1;1;1
251024069658;251024070615;957;1,2;2;9;1;1;1
251024070615;251024071819;1204;1,2;2;9;1;1;1
251024071819;251024072363;544;1,2;2;9;1;1;1
251024072363;251024078484;6121;1,2;2;9;1;1;1
251024078484;251024117511;39027;1,2;2;9;1;1;1
251024117511;251024118597;1086;1,2;2;9;1;1;1
251024118597;251024150706;32109;1,2;2;9;1;1;1
251024150706;251024190373;39667;1,2;2;9;1;1;1
251024190373;251024265259;74886;1,2;2;9;1;1;1
251024265259;251024311433;46174;1,2;2;9;1;1;1
251024311433;251024342654;31221;1,2;2;9;1;1;1
251024342654;251024383355;40701;1,2;2;9;1;1;1
251024383355;251024385907;2552;1,2;2;9;1;1;1
251024385907;251024428573;42666;1,2;2;9;1;1;1
251024428573;251024458634;30061;1,2;2;9;1;1;1
251024458634;251024495071;36437;1,2;2;9;1;1;1
251024495071;251024526947;31876;1,2;2;9;1;1;1
251024526947;251024577237;50290;1,2;2;9;1;1;1
251024577237;251024711207;133970;1,2;2;9;1;1;1
251024711207;251024755949;44742;1,2;2;9;1;1;1
251024755949;251024756032;83;1,2;2;9;1;1;1
251024756032;251024757952;1920;1,2;2;9;1;1;1
251024757952;251024771394;13442;1,2;2;9;1;1;1
251024771394;251024773449;2055;1,2;2;9;1;1;1
251024773449;251024829362;55913;1,2;2;9;1;1;1
251024829362;251024914201;84839;1,2;2;9;1;1;1
251024914201;251024926128;11927;1,2;2;9;1;1;1
251024926128;251025001144;75016;1,2;2;9;1;1;1
251025001144;251025066049;64905;1,2;2;9;1;1;1
251025066049;251025114235;48186;1,2;2;9;1;1;1
251025114235;251025156446;42211;1,2;2;9;1;1;1
251025156446;251025156709;263;1,2;2;9;1;1;1
251025156709;251025166597;9888;1,2;2;9;1;1;1
251025166597;251025243026;76429;1,2;2;9;1;1;1
251025243026;251025282032;39006;1,2;2;9;1;1;1
251025282032;251025293910;11878;1,2;2;9;1;1;1
251025293910;251025327953;34043;1,2;2;9;1;1;1
251025327953;251025355817;27864;1,2;2;9;1;1;1
251025355817;251025419534;63717;1,2;2;9;1;1;1
251025419534;251025421341;1807;1,2;2;9;1;1;1
251025421341;251025422813;1472;1,2;2;9;1;1;1
251025422813;251025452918;30105;1,2;2;9;1;1;1
251025452918;251025494688;41770;1,2;2;9;1;1;1
251025494688;251025495018;330;1,2;2;9;1;1;1
251025495018;251025523899;28881;1,2;2;9;1;1;1
251025523899;251025564780;40881;1,2;2;9;1;1;1
251025564780;251025596862;32082;1,2;2;9;1;1;1
251025596862;251025668219;71357;1,2;2;9;1;1;1
251025668219;251025677356;9137;1,2;2;9;1;1;1
251025677356;251034747910;9070554;1,2;2;9;1;1;1
251034747910;251065741438;30993528;1,2;2;9;1;1;1
251065741438;251065761198;19760;1,2;2;9;1;1;1
251065761198;251065775463;14265;1,2,5;3;9;1;1;1
251065775463;251065878589;103126;1,2,5;3;9;1;1;1
251065878589;251065878765;176;1,2,5;3;9;1;1;1
251065878765;251065888623;9858;1,2,5;3;9;1;1;1
251065888623;251065891686;3063;1,2,5;3;9;1;1;1
251065891686;251065902877;11191;1,2,5;3;9;1;1;1
251065902877;251065905546;2669;1,2,5;3;9;1;1;1
251065905546;251065938687;33141;1,2,5;3;9;1;1;1
251065938687;251065940801;2114;1,2,5;3;9;1;1;1
251065940801;251065950135;9334;1,2,5;3;9;1;1;1
251065950135;251065959931;9796;1,2,5;3;9;1;1;1
251065959931;251065962103;2172;1,2,5;3;9;1;1;1
251065962103;251065971176;9073;1,2,5;3;9;1;1;1
251065971176;251066001701;30525;1,2,5;3;9;1;1;1
251066001701;251066016968;15267;1,2,5;3;9;1;1;1
251066016968;251066025772;8804;1,2,5;3;9;1;1;1
251066025772;251066045475;19703;1,2,5;3;9;1;1;1
251066045475;251066055486;10011;1,2,5;3;9;1;1;1
251066055486;251066064614;9128;1,2,5;3;9;1;1;1
251066064614;251066077318;12704;1,2,5;3;9;1;1;1
251066077318;251066092651;15333;1,2,5;3;9;1;1;1
251066092651;251066137924;45273;1,2,5;3;9;1;1;1
251066137924;251066152599;14675;1,2,5;3;9;1;1;1
251066152599;251066152732;133;1,2,5;3;9;1;1;1
251066152732;251066161827;9095;1,2,5;3;9;1;1;1
251066161827;251066169168;7341;1,2,5;3;9;1;1;1
251066169168;251066177948;8780;1,2,5;3;9;1;1;1
251066177948;251066187942;9994;1,2,5;3;9;1;1;1
251066187942;251066200003;12061;1,2,5;3;9;1;1;1
251066200003;251066201243;1240;1,2,5;3;9;1;1;1
251066201243;251066202020;777;1,2,5;3;9;1;1;1
251066202020;251066202320;300;1,2,5;3;9;1;1;1
251066202320;251066209149;6829;1,2,5;3;9;1;1;1
251066209149;251066211724;2575;1,2,5;3;9;1;1;1
251066211724;251066217910;6186;1,2,5;3;9;1;1;1
251066217910;251066221613;3703;1,2,5;3;9;1;1;1
251066221613;251066222616;1003;1,2,5;3;9;1;1;1
251066222616;251066224456;1840;1,2,5;3;9;1;1;1
251066224456;251066229664;5208;1,2,5;3;9;1;1;1
251066229664;251066249153;19489;1,2,5;3;9;1;1;1
251066249153;251066253892;4739;1,2,5;3;9;1;1;1
251066253892;251066269861;15969;1,2,5;3;9;1;1;1
251066269861;251066278624;8763;1,2,5;3;9;1;1;1
251066278624;251066295489;16865;1,2,5;3;9;1;1;1
251066295489;251066305159;9670;1,2,5;3;9;1;1;1
251066305159;251066314656;9497;1,2,5;3;9;1;1;1
251066314656;251066336851;22195;1,2,5;3;9;1;1;1
251066336851;251066346190;9339;1,2,5;3;9;1;1;1
251066346190;251066354944;8754;1,2,5;3;9;1;1;1
251066354944;251066395408;40464;1,2,5;3;9;1;1;1
251066395408;251066406720;11312;1,2,5;3;9;1;1;1
251066406720;251066410562;3842;1,2,5;3;9;1;1;1
251066410562;251066420066;9504;1,2,5;3;9;1;1;1
251066420066;251066422831;2765;1,2,5;3;9;1;1;1
251066422831;251066473065;50234;1,2,5;3;9;1;1;1
251066473065;251066488374;15309;1,2,5;3;9;1;1;1
251066488374;251066492061;3687;1,2,5;3;9;1;1;1
251066492061;251066523032;30971;1,2,5;3;9;1;1;1
251066523032;251066529933;6901;1,2,5;3;9;1;1;1
251066529933;251066535458;5525;1,2,5;3;9;1;1;1
251066535458;251066539785;4327;1,2,5;3;9;1;1;1
251066539785;251066581615;41830;1,2,5;3;9;1;1;1
251066581615;251066581646;31;1,2,5;3;9;1;1;1
251066581646;251066589610;7964;1,2,5;3;9;1;1;1
251066589610;251066592676;3066;1,2,5;3;9;1;1;1
251066592676;251066611302;18626;1,2,5;3;9;1;1;1
251066611302;251066619964;8662;1,2,5;3;9;1;1;1
251066619964;251066633792;13828;1,2,5;3;9;1;1;1
251066633792;251066643218;9426;1,2,5;3;9;1;1;1
251066643218;251066652306;9088;1,2,5;3;9;1;1;1
251066652306;251066667582;15276;1,2,5;3;9;1;1;1
251066667582;251066682596;15014;1,2,5;3;9;1;1;1
251066682596;251066692229;9633;1,2,5;3;9;1;1;1
251066692229;251066701786;9557;1,2,5;3;9;1;1;1
251066701786;251066727435;25649;1,2,5;3;9;1;1;1
251066727435;251066734785;7350;1,2,5;3;9;1;1;1
251066734785;251066745296;10511;1,2,5;3;9;1;1;1
251066745296;251066770207;24911;1,2,5;3;9;1;1;1
251066770207;251066775056;4849;1,2,5;3;9;1;1;1
251066775056;251066783557;8501;1,2,5;3;9;1;1;1
251066783557;251066784263;706;1,2,5;3;9;1;1;1
251066784263;251066785778;1515;1,2,5;3;9;1;1;1
251066785778;251066785886;108;1,2,5;3;9;1;1;1
251066785886;251066788329;2443;1,2,5;3;9;1;1;1
251066788329;251066789217;888;1,2,5;3;9;1;1;1
251066789217;251066799342;10125;1,2,5;3;9;1;1;1
251066799342;251066801468;2126;1,2,5;3;9;1;1;1
251066801468;251066801890;422;1,2,5;3;9;1;1;1
251066801890;251066807887;5997;1,2,5;3;9;1;1;1
251066807887;251066809377;1490;1,2,5;3;9;1;1;1
251066809377;251066810897;1520;1,2,5;3;9;1;1;1
251066810897;251066820674;9777;1,2,5;3;9;1;1;1
251066820674;251066856486;35812;1,2,5;3;9;1;1;1
251066856486;251066872304;15818;1,2,5;3;9;1;1;1
251066872304;251066882359;10055;1,2,5;3;9;1;1;1
251066882359;251066898781;16422;1,2,5;3;9;1;1;1
251066898781;251066909271;10490;1,2,5;3;9;1;1;1
251066909271;251066925830;16559;1,2,5;3;9;1;1;1
251066925830;251066935426;9596;1,2,5;3;9;1;1;1
251066935426;251066938177;2751;1,2,5;3;9;1;1;1
251066938177;251066947549;9372;1,2,5;3;9;1;1;1
251066947549;251066956123;8574;1,2,5;3;9;1;1;1
251066956123;251066975199;19076;1,2,5;3;9;1;1;1
251066975199;251066979259;4060;1,2,5;3;9;1;1;1
251066979259;251066984327;5068;1,2,5;3;9;1;1;1
251066984327;251066990704;6377;1,2,5;3;9;1;1;1
251066990704;251066991405;701;1,2,5;3;9;1;1;1
251066991405;251066999047;7642;1,2,5;3;9;1;1;1
251066999047;251067003755;4708;1,2,5;3;9;1;1;1
251067003755;251067007180;3425;1,2,5;3;9;1;1;1
251067007180;251067012361;5181;1,2,5;3;9;1;1;1
251067012361;251067018017;5656;1,2,5;3;9;1;1;1
251067018017;251067028377;10360;1,2,5;3;9;1;1;1
251067028377;251067075642;47265;1,2,5;3;9;1;1;1
251067075642;251067091210;15568;1,2,5;3;9;1;1;1
251067091210;251067102524;11314;1,2,5;3;9;1;1;1
251067102524;251067170839;68315;1,2,5;3;9;1;1;1
251067170839;251067178343;7504;1,2,5;3;9;1;1;1
251067178343;251067198294;19951;1,2,5;3;9;1;1;1
251067198294;251067209638;11344;1,2,5;3;9;1;1;1
251067209638;251067213255;3617;1,2,5;3;9;1;1;1
251067213255;251067225276;12021;1,2,5;3;9;1;1;1
251067225276;251067237355;12079;1,2,5;3;9;1;1;1
251067237355;251067255691;18336;1,2,5;3;9;1;1;1
251067255691;251067263972;8281;1,2,5;3;9;1;1;1
251067263972;251067265393;1421;1,2,5;3;9;1;1;1
251067265393;251067274215;8822;1,2,5;3;9;1;1;1
251067274215;251067282871;8656;1,2,5;3;9;1;1;1
251067282871;251067303849;20978;1,2,5;3;9;1;1;1
251067303849;251067324122;20273;1,2,5;3;9;1;1;1
251067324122;251067335498;11376;1,2,5;3;9;1;1;1
251067335498;251067375495;39997;1,2,5;3;9;1;1;1
251067375495;251067386733;11238;1,2,5;3;9;1;1;1
251067386733;251067391573;4840;1,2,5;3;9;1;1;1
251067391573;251067402918;11345;1,2,5;3;9;1;1;1
251067402918;251067403359;441;1,2,5;3;9;1;1;1
251067403359;251067412667;9308;1,2,5;3;9;1;1;1
251067412667;251067420554;7887;1,2,5;3;9;1;1;1
251067420554;251067437230;16676;1,2,5;3;9;1;1;1
251067437230;251067447276;10046;1,2,5;3;9;1;1;1
251067447276;251067469967;22691;1,2,5;3;9;1;1;1
251067469967;251067482444;12477;1,2,5;3;9;1;1;1
251067482444;251067491041;8597;1,2,5;3;9;1;1;1
251067491041;251067556827;65786;1,2,5;3;9;1;1;1
251067556827;251067572885;16058;1,2,5;3;9;1;1;1
251067572885;251067583244;10359;1,2,5;3;9;1;1;1
251067583244;251067628927;45683;1,2,5;3;9;1;1;1
251067628927;251067630745;1818;1,2,5;3;9;1;1;1
251067630745;251067638937;8192;1,2,5;3;9;1;1;1
251067638937;251067658099;19162;1,2,5;3;9;1;1;1
251067658099;251067666083;7984;1,2,5;3;9;1;1;1
251067666083;251067668450;2367;1,2,5;3;9;1;1;1
251067668450;251067677451;9001;1,2,5;3;9;1;1;1
251067677451;251067680879;3428;1,2,5;3;9;1;1;1
251067680879;251067709484;28605;1,2,5;3;9;1;1;1
251067709484;251067715827;6343;1,2,5;3;9;1;1;1
251067715827;251067719332;3505;1,2,5;3;9;1;1;1
251067719332;251067721435;2103;1,2,5;3;9;1;1;1
251067721435;251067732224;10789;1,2,5;3;9;1;1;1
251067732224;251067732639;415;1,2,5;3;9;1;1;1
251067732639;251082094532;14361893;1,2,5;3;9;1;1;1
251082094532;251082096896;2364;1,2,5;3;9;1;1;1
251082096896;251082097038;142;1,2,5;3;9;1;1;1
251082097038;251082097081;43;1,2,5;3;9;1;1;1
251082097081;251082097116;35;1,2,5;3;9;1;1;1
251082097116;251082097578;462;1,2,5;3;9;1;1;1
251082097578;251082097747;169;1,2,5;3;9;1;1;1
251082097747;251082097754;7;1,2,5;3;9;1;1;1
251082097754;251082097999;245;1,2,5;3;9;1;1;1
251082097999;251082098067;68;1,2,5;3;9;1;1;1
251082098067;251082098299;232;1,2,5;3;9;1;1;1
251082098299;251082098547;248;1,2,5;3;9;1;1;1
251082098547;251082098784;237;1,2,5;3;9;1;1;1
251082098784;251082098839;55;1,2,5;3;9;1;1;1
251082098839;251082098885;46;1,2,5;3;9;1;1;1
251082098885;251082099422;537;1,2,5;3;9;1;1;1
251082099422;251082099762;340;1,2,5;3;9;1;1;1
251082099762;251082099821;59;1,2,5;3;9;1;1;1
251082099821;251082100210;389;1,2,5;3;9;1;1;1
251082100210;251082100560;350;1,2,5;3;9;1;1;1
251082100560;251082100666;106;1,2,5;3;9;1;1;1
251082100666;251082100848;182;1,2,5;3;9;1;1;1
251082100848;251082100994;146;1,2,5;3;9;1;1;1
251082100994;251082101085;91;1,2,5;3;9;1;1;1
251082101085;251082101183;98;1,2,5;3;9;1;1;1
251082101183;251082101449;266;1,2,5;3;9;1;1;1
251082101449;251082101754;305;1,2,5;3;9;1;1;1
251082101754;251082101784;30;1,2,5;3;9;1;1;1
251082101784;251082101944;160;1,2,5;3;9;1;1;1
251082101944;251082102000;56;1,2,5;3;9;1;1;1
251082102000;251082102271;271;1,2,5;3;9;1;1;1
251082102271;251082102440;169;1,2,5;3;9;1;1;1
251082102440;251082102766;326;1,2,5;3;9;1;1;1
251082102766;251082102806;40;1,2,5;3;9;1;1;1
251082102806;251082103060;254;1,2,5;3;9;1;1;1
251082103060;251082103074;14;1,2,5;3;9;1;1;1
251082103074;251082104529;1455;1,2,5;3;9;1;1;1
251082104529;251082104687;158;1,2,5;3;9;1;1;1
251082104687;251082104983;296;1,2,5;3;9;1;1;1
251082104983;251082105049;66;1,2,5;3;9;1;1;1
251082105049;251082105121;72;1,2,5;3;9;1;1;1
251082105121;251082105524;403;1,2,5;3;9;1;1;1
251082105524;251082105999;475;1,2,5;3;9;1;1;1
251082105999;251082106109;110;1,2,5;3;9;1;1;1
251082106109;251082106328;219;1,2,5;3;9;1;1;1
251082106328;251082106449;121;1,2,5;3;9;1;1;1
251082106449;251082107928;1479;1,2,5;3;9;1;1;1
251082107928;251082108011;83;1,2,5;3;9;1;1;1
251082108011;251082109281;1270;1,2,5;3;9;1;1;1
251082109281;251082112628;3347;1,2,5;3;9;1;1;1
251082112628;251082123434;10806;1,2,5;3;9;1;1;1
251082123434;251082127004;3570;1,2,5;3;9;1;1;1
251082127004;251082155932;28928;1,2,5;3;9;1;1;1
251082155932;251082164305;8373;1,2,5;3;9;1;1;1
251082164305;251082224248;59943;1,2,5;3;9;1;1;1
251082224248;251082225021;773;1,2,5;3;9;1;1;1
251082225021;251082225515;494;1,2,5;3;9;1;1;1
251082225515;251082225537;22;1,2,5;3;9;1;1;1
251082225537;251082225562;25;1,2,5;3;9;1;1;1
251082225562;251082225869;307;1,2,5;3;9;1;1;1
251082225869;251082225871;2;1,2,5;3;9;1;1;1
251082225871;251082225873;2;1,2,5;3;9;1;1;1
251082225873;251082225911;38;1,2,5;3;9;1;1;1
251082225911;251082225934;23;1,2,5;3;9;1;1;1
251082225934;251082226002;68;1,2,5;3;9;1;1;1
251082226002;251082226066;64;1,2,5;3;9;1;1;1
251082226066;251082226077;11;1,2,5;3;9;1;1;1
251082226077;251082226093;16;1,2,5;3;9;1;1;1
251082226093;251082226105;12;1,2,5;3;9;1;1;1
251082226105;251082226156;51;1,2,5;3;9;1;1;1
251082226156;251082226162;6;1,2,5;3;9;1;1;1
251082226162;251082226299;137;1,2,5;3;9;1;1;1
251082226299;251082226327;28;1,2,5;3;9;1;1;1
251082226327;251082226554;227;1,2,5;3;9;1;1;1
251082226554;251082226581;27;1,2,5;3;9;1;1;1
251082226581;251082226594;13;1,2,5;3;9;1;1;1
251082226594;251082226648;54;1,2,5;3;9;1;1;1
251082226648;251082226696;48;1,2,5;3;9;1;1;1
251082226696;251082226957;261;1,2,5;3;9;1;1;1
251082226957;251082227026;69;1,2,5;3;9;1;1;1
251082227026;251082227375;349;1,2,5;3;9;1;1;1
251082227375;251082227454;79;1,2,5;3;9;1;1;1
251082227454;251082227652;198;1,2,5;3;9;1;1;1
251082227652;251082228226;574;1,2,5;3;9;1;1;1
251082228226;251082228267;41;1,2,5;3;9;1;1;1
251082228267;251082228401;134;1,2,5;3;9;1;1;1
251082228401;251082228946;545;1,2,5;3;9;1;1;1
251082228946;251082229074;128;1,2,5;3;9;1;1;1
251082229074;251082229083;9;1,2,5;3;9;1;1;1
251082229083;251082229434;351;1,2,5;3;9;1;1;1
251082229434;251082229507;73;1,2,5;3;9;1;1;1
251082229507;251082229561;54;1,2,5;3;9;1;1;1
251082229561;251082229609;48;1,2,5;3;9;1;1;1
251082229609;251082229629;20;1,2,5;3;9;1;1;1
251082229629;251082229967;338;1,2,5;3;9;1;1;1
251082229967;251082230294;327;1,2,5;3;9;1;1;1
251082230294;251082230316;22;1,2,5;3;9;1;1;1
251082230316;251082234108;3792;1,2,5;3;9;1;1;1
251082234108;251082236199;2091;1,2,5;3;9;1;1;1
251082236199;251082236242;43;1,2,5;3;9;1;1;1
251082236242;251082236271;29;1,2,5;3;9;1;1;1
251082236271;251082236284;13;1,2,5;3;9;1;1;1
251082236284;251082236366;82;1,2,5;3;9;1;1;1
251082236366;251082236476;110;1,2,5;3;9;1;1;1
251082236476;251082295452;58976;1,2,5;3;9;1;1;1
251082295452;251082295582;130;1,2,5;3;9;1;1;1
251082295582;251082295593;11;1,2,5;3;9;1;1;1
251082295593;252169267789;1086972196;1,2,5;3;9;1;1;1
252169267789;252169294162;26373;1,2,5;3;9;1;1;1
252169294162;252169313952;19790;1,2,5;3;9;1;1;1
252169313952;252169314817;865;1,2,5;3;9;1;1;1
252169314817;252169341038;26221;1,2,5;3;9;1;1;1
252169341038;252169354193;13155;1,2,5;3;9;1;1;1
252169354193;252169381314;27121;1,2,5;3;9;1;1;1
252169381314;252169404966;23652;1,2,5;3;9;1;1;1
252169404966;252169407307;2341;1,2,5;3;9;1;1;1
252169407307;252169455777;48470;1,2,5;3;9;1;1;1
252169455777;252169458165;2388;1,2,5;3;9;1;1;1
252169458165;252169514468;56303;1,2,5;3;9;1;1;1
252169514468;252169533399;18931;1,2,5;3;9;1;1;1
252169533399;252169634929;101530;1,2,5;3;9;1;1;1
252169634929;252169644051;9122;1,2,5;3;9;1;1;1
252169644051;252169669078;25027;1,2,5;3;9;1;1;1
252169669078;252169698220;29142;1,2,5;3;9;1;1;1
252169698220;252169719192;20972;1,2,5;3;9;1;1;1
252169719192;252169732150;12958;1,2,5;3;9;1;1;1
252169732150;252169743701;11551;1,2,5;3;9;1;1;1
252169743701;252169745022;1321;1,2,5;3;9;1;1;1
252169745022;252169756702;11680;1,2,5;3;9;1;1;1
252169756702;252169758616;1914;1,2,5;3;9;1;1;1
252169758616;252169769262;10646;1,2,5;3;9;1;1;1
252169769262;252169778339;9077;1,2,5;3;9;1;1;1
252169778339;252169784992;6653;1,2,5;3;9;1;1;1
252169784992;252169822822;37830;1,2,5;3;9;1;1;1
252169822822;252169850242;27420;1,2,5;3;9;1;1;1
252169850242;252169877104;26862;1,2,5;3;9;1;1;1
252169877104;252169904670;27566;1,2,5;3;9;1;1;1
252169904670;252169960287;55617;1,2,5;3;9;1;1;1
252169960287;252169963271;2984;1,2,5;3;9;1;1;1
252169963271;252169970734;7463;1,2,5;3;9;1;1;1
252169970734;252169972124;1390;1,2,5;3;9;1;1;1
252169972124;252169984761;12637;1,2,5;3;9;1;1;1
252169984761;252170022061;37300;1,2,5;3;9;1;1;1
252170022061;252170033361;11300;1,2,5;3;9;1;1;1
252170033361;252170054687;21326;1,2,5;3;9;1;1;1
252170054687;252170095313;40626;1,2,5;3;9;1;1;1
252170095313;252170097684;2371;1,2,5;3;9;1;1;1
252170097684;252170115822;18138;1,2,5;3;9;1;1;1
252170115822;252170119444;3622;1,2,5;3;9;1;1;1
252170119444;252170145666;26222;1,2,5;3;9;1;1;1
252170145666;252170149234;3568;1,2,5;3;9;1;1;1
252170149234;252170175111;25877;1,2,5;3;9;1;1;1
252170175111;252170185895;10784;1,2,5;3;9;1;1;1
252170185895;252170197145;11250;1,2,5;3;9;1;1;1
252170197145;252170197180;35;1,2,5;3;9;1;1;1
252170197180;252170197444;264;1,2,5;3;9;1;1;1
252170197444;252170224101;26657;1,2,5;3;9;1;1;1
252170224101;252170224412;311;1,2,5;3;9;1;1;1
252170224412;252170228487;4075;1,2,5;3;9;1;1;1
252170228487;252170235951;7464;1,2,5;3;9;1;1;1
252170235951;252170265302;29351;1,2,5;3;9;1;1;1
252170265302;252170324000;58698;1,2,5;3;9;1;1;1
252170324000;252170349075;25075;1,2,5;3;9;1;1;1
252170349075;252170356839;7764;1,2,5;3;9;1;1;1
252170356839;252170368115;11276;1,2,5;3;9;1;1;1
252170368115;252170381258;13143;1,2,5;3;9;1;1;1
252170381258;252170389925;8667;1,2,5;3;9;1;1;1
252170389925;252170410820;20895;1,2,5;3;9;1;1;1
252170410820;252170437391;26571;1,2,5;3;9;1;1;1
252170437391;252170465464;28073;1,2,5;3;9;1;1;1
252170465464;252170472620;7156;1,2,5;3;9;1;1;1
252170472620;252170494513;21893;1,2,5;3;9;1;1;1
252170494513;252170537061;42548;1,2,5;3;9;1;1;1
252170537061;252170555645;18584;1,2,5;3;9;1;1;1
252170555645;252170579962;24317;1,2,5;3;9;1;1;1
252170579962;252170592428;12466;1,2,5;3;9;1;1;1
252170592428;252170599231;6803;1,2,5;3;9;1;1;1
252170599231;252170601411;2180;1,2,5;3;9;1;1;1
252170601411;252170602761;1350;1,2,5;3;9;1;1;1
252170602761;252170613920;11159;1,2,5;3;9;1;1;1
252170613920;252170625564;11644;1,2,5;3;9;1;1;1
252170625564;252170626623;1059;1,2,5;3;9;1;1;1
252170626623;252170628382;1759;1,2,5;3;9;1;1;1
252170628382;252170634020;5638;1,2,5;3;9;1;1;1
252170634020;252170641036;7016;1,2,5;3;9;1;1;1
252170641036;252170656871;15835;1,2,5;3;9;1;1;1
252170656871;252170657760;889;1,2,5;3;9;1;1;1
252170657760;252170677298;19538;1,2,5;3;9;1;1;1
252170677298;252170683262;5964;1,2,5;3;9;1;1;1
252170683262;252170685559;2297;1,2,5;3;9;1;1;1
252170685559;252170721139;35580;1,2,5;3;9;1;1;1
252170721139;252170774323;53184;1,2,5;3;9;1;1;1
252170774323;252170808510;34187;1,2,5;3;9;1;1;1
252170808510;252170850869;42359;1,2,5;3;9;1;1;1
252170850869;252170871262;20393;1,2,5;3;9;1;1;1
252170871262;252170894134;22872;1,2,5;3;9;1;1;1
252170894134;252170902776;8642;1,2,5;3;9;1;1;1
252170902776;252170913168;10392;1,2,5;3;9;1;1;1
252170913168;252170920389;7221;1,2,5;3;9;1;1;1
252170920389;252170932980;12591;1,2,5;3;9;1;1;1
252170932980;252170946988;14008;1,2,5;3;9;1;1;1
252170946988;252170947024;36;1,2,5;3;9;1;1;1
252170947024;252170956183;9159;1,2,5;3;9;1;1;1
252170956183;252170956419;236;1,2,5;3;9;1;1;1
252170956419;252171003725;47306;1,2,5;3;9;1;1;1
252171003725;252171007193;3468;1,2,5;3;9;1;1;1
252171007193;252171017660;10467;1,2,5;3;9;1;1;1
252171017660;252171019660;2000;1,2,5;3;9;1;1;1
252171019660;252171024650;4990;1,2,5;3;9;1;1;1
252171024650;252171047110;22460;1,2,5;3;9;1;1;1
252171047110;252171055728;8618;1,2,5;3;9;1;1;1
252171055728;252171056169;441;1,2,5;3;9;1;1;1
252171056169;252171072520;16351;1,2,5;3;9;1;1;1
252171072520;252171091190;18670;1,2,5;3;9;1;1;1
252171091190;252171115968;24778;1,2,5;3;9;1;1;1
252171115968;252236693634;65577666;1,2,5;3;9;1;1;1
252236693634;252255228699;18535065;1,2,3,5;4;9;1;1;1
252255228699;252255231136;2437;1,2,3,5;4;9;1;1;1
252255231136;252255278761;47625;1,2,3,5;4;9;1;1;1
252255278761;252255279736;975;1,2,3,5;4;9;1;1;1
252255279736;252255288220;8484;1,2,3,5;4;9;1;1;1
252255288220;252255315514;27294;1,2,3,5;4;9;1;1;1
252255315514;252255358575;43061;1,2,3,5;4;9;1;1;1
252255358575;252255410776;52201;1,2,3,5;4;9;1;1;1
252255410776;252255414529;3753;1,2,3,5;4;9;1;1;1
252255414529;252255421097;6568;1,2,3,5;4;9;1;1;1
252255421097;252255509995;88898;1,2,3,5;4;9;1;1;1
252255509995;252255560560;50565;1,2,3,5;4;9;1;1;1
252255560560;252255602413;41853;1,2,3,5;4;9;1;1;1
252255602413;252255610856;8443;1,2,3,5;4;9;1;1;1
252255610856;252255612828;1972;1,2,3,5;4;9;1;1;1
252255612828;252255616602;3774;1,2,3,5;4;9;1;1;1
252255616602;252255658620;42018;1,2,3,5;4;9;1;1;1
252255658620;252255720101;61481;1,2,3,5;4;9;1;1;1
252255720101;252255755673;35572;1,2,3,5;4;9;1;1;1
252255755673;252255757936;2263;1,2,3,5;4;9;1;1;1
252255757936;252255771537;13601;1,2,3,5;4;9;1;1;1
252255771537;252255784701;13164;1,2,3,5;4;9;1;1;1
252255784701;252255785155;454;1,2,3,5;4;9;1;1;1
252255785155;252255786234;1079;1,2,3,5;4;9;1;1;1
252255786234;252255873103;86869;1,2,3,5;4;9;1;1;1
252255873103;252255916337;43234;1,2,3,5;4;9;1;1;1
252255916337;252255949665;33328;1,2,3,5;4;9;1;1;1
252255949665;252255988593;38928;1,2,3,5;4;9;1;1;1
252255988593;252255999839;11246;1,2,3,5;4;9;1;1;1
252255999839;252256031915;32076;1,2,3,5;4;9;1;1;1
252256031915;252256063402;31487;1,2,3,5;4;9;1;1;1
252256063402;252256108300;44898;1,2,3,5;4;9;1;1;1
252256108300;252256148254;39954;1,2,3,5;4;9;1;1;1
252256148254;252256191707;43453;1,2,3,5;4;9;1;1;1
252256191707;252256254776;63069;1,2,3,5;4;9;1;1;1
252256254776;252256299220;44444;1,2,3,5;4;9;1;1;1
252256299220;252256339286;40066;1,2,3,5;4;9;1;1;1
252256339286;252256379499;40213;1,2,3,5;4;9;1;1;1
252256379499;252256380582;1083;1,2,3,5;4;9;1;1;1
252256380582;252256383321;2739;1,2,3,5;4;9;1;1;1
252256383321;252256414416;31095;1,2,3,5;4;9;1;1;1
252256414416;252256426422;12006;1,2,3,5;4;9;1;1;1
252256426422;252256442670;16248;1,2,3,5;4;9;1;1;1
252256442670;252256492188;49518;1,2,3,5;4;9;1;1;1
252256492188;252256499184;6996;1,2,3,5;4;9;1;1;1
252256499184;252256499630;446;1,2,3,5;4;9;1;1;1
252256499630;252256549871;50241;1,2,3,5;4;9;1;1;1
252256549871;252256587855;37984;1,2,3,5;4;9;1;1;1
252256587855;252256634169;46314;1,2,3,5;4;9;1;1;1
252256634169;252256656278;22109;1,2,3,5;4;9;1;1;1
252256656278;252256704259;47981;1,2,3,5;4;9;1;1;1
252256704259;252256736862;32603;1,2,3,5;4;9;1;1;1
252256736862;252256767507;30645;1,2,3,5;4;9;1;1;1
252256767507;252256769267;1760;1,2,3,5;4;9;1;1;1
252256769267;252256776123;6856;1,2,3,5;4;9;1;1;1
252256776123;252256796579;20456;1,2,3,5;4;9;1;1;1
252256796579;252256937314;140735;1,2,3,5;4;9;1;1;1
252256937314;252256977013;39699;1,2,3,5;4;9;1;1;1
252256977013;252257030063;53050;1,2,3,5;4;9;1;1;1
252257030063;252257070786;40723;1,2,3,5;4;9;1;1;1
252257070786;252257071082;296;1,2,3,5;4;9;1;1;1
252257071082;252257078351;7269;1,2,3,5;4;9;1;1;1
252257078351;252257081451;3100;1,2,3,5;4;9;1;1;1
252257081451;252257089463;8012;1,2,3,5;4;9;1;1;1
252257089463;252257101352;11889;1,2,3,5;4;9;1;1;1
252257101352;252257139572;38220;1,2,3,5;4;9;1;1;1
252257139572;252257145252;5680;1,2,3,5;4;9;1;1;1
252257145252;252257184485;39233;1,2,3,5;4;9;1;1;1
252257184485;252257186260;1775;1,2,3,5;4;9;1;1;1
252257186260;252257193525;7265;1,2,3,5;4;9;1;1;1
252257193525;252257222977;29452;1,2,3,5;4;9;1;1;1
252257222977;252257263168;40191;1,2,3,5;4;9;1;1;1
252257263168;252257311395;48227;1,2,3,5;4;9;1;1;1
252257311395;252257361884;50489;1,2,3,5;4;9;1;1;1
252257361884;252257396114;34230;1,2,3,5;4;9;1;1;1
252257396114;252257432803;36689;1,2,3,5;4;9;1;1;1
252257432803;252257441863;9060;1,2,3,5;4;9;1;1;1
252257441863;252257442696;833;1,2,3,5;4;9;1;1;1
252257442696;252257485130;42434;1,2,3,5;4;9;1;1;1
252257485130;252257486571;1441;1,2,3,5;4;9;1;1;1
252257486571;252257513796;27225;1,2,3,5;4;9;1;1;1
252257513796;252257557794;43998;1,2,3,5;4;9;1;1;1
252257557794;252257563295;5501;1,2,3,5;4;9;1;1;1
252257563295;252257569484;6189;1,2,3,5;4;9;1;1;1
252257569484;252257574790;5306;1,2,3,5;4;9;1;1;1
252257574790;252257598939;24149;1,2,3,5;4;9;1;1;1
252257598939;252257642863;43924;1,2,3,5;4;9;1;1;1
252257642863;252257706792;63929;1,2,3,5;4;9;1;1;1
252257706792;252257746187;39395;1,2,3,5;4;9;1;1;1
252257746187;252257755158;8971;1,2,3,5;4;9;1;1;1
252257755158;252257798195;43037;1,2,3,5;4;9;1;1;1
252257798195;252257800873;2678;1,2,3,5;4;9;1;1;1
252257800873;252257825259;24386;1,2,3,5;4;9;1;1;1
252257825259;252257833147;7888;1,2,3,5;4;9;1;1;1
252257833147;252257848926;15779;1,2,3,5;4;9;1;1;1
252257848926;252257865618;16692;1,2,3,5;4;9;1;1;1
252257865618;252257896185;30567;1,2,3,5;4;9;1;1;1
252257896185;252257940560;44375;1,2,3,5;4;9;1;1;1
252257940560;252258000074;59514;1,2,3,5;4;9;1;1;1
252258000074;252258007723;7649;1,2,3,5;4;9;1;1;1
252258007723;252258010559;2836;1,2,3,5;4;9;1;1;1
252258010559;252258016796;6237;1,2,3,5;4;9;1;1;1
252258016796;252258053944;37148;1,2,3,5;4;9;1;1;1
252258053944;252258097310;43366;1,2,3,5;4;9;1;1;1
252258097310;252258130813;33503;1,2,3,5;4;9;1;1;1
252258130813;252258170096;39283;1,2,3,5;4;9;1;1;1
252258170096;252258179399;9303;1,2,3,5;4;9;1;1;1
252258179399;252258179414;15;1,2,3,5;4;9;1;1;1
252258179414;252258179614;200;1,2,3,5;4;9;1;1;1
252258179614;252258180033;419;1,2,3,5;4;9;1;1;1
252258180033;252258210616;30583;1,2,3,5;4;9;1;1;1
252258210616;252258213962;3346;1,2,3,5;4;9;1;1;1
252258213962;252258219837;5875;1,2,3,5;4;9;1;1;1
252258219837;252258219936;99;1,2,3,5;4;9;1;1;1
252258219936;252258267870;47934;1,2,3,5;4;9;1;1;1
252258267870;252258273327;5457;1,2,3,5;4;9;1;1;1
252258273327;252258283394;10067;1,2,3,5;4;9;1;1;1
252258283394;252258283426;32;1,2,3,5;4;9;1;1;1
252258283426;252258338167;54741;1,2,3,5;4;9;1;1;1
252258338167;252258349162;10995;1,2,3,5;4;9;1;1;1
252258349162;252258384788;35626;1,2,3,5;4;9;1;1;1
252258384788;252258396964;12176;1,2,3,5;4;9;1;1;1
252258396964;252258397710;746;1,2,3,5;4;9;1;1;1
252258397710;252258414344;16634;1,2,3,5;4;9;1;1;1
252258414344;252258420233;5889;1,2,3,5;4;9;1;1;1
252258420233;252258441772;21539;1,2,3,5;4;9;1;1;1
252258441772;252258453228;11456;1,2,3,5;4;9;1;1;1
252258453228;252258465984;12756;1,2,3,5;4;9;1;1;1
252258465984;252258498836;32852;1,2,3,5;4;9;1;1;1
252258498836;252258540601;41765;1,2,3,5;4;9;1;1;1
252258540601;252258574029;33428;1,2,3,5;4;9;1;1;1
252258574029;252258637436;63407;1,2,3,5;4;9;1;1;1
252258637436;252258649114;11678;1,2,3,5;4;9;1;1;1
252258649114;252258693734;44620;1,2,3,5;4;9;1;1;1
252258693734;252258726623;32889;1,2,3,5;4;9;1;1;1
252258726623;252258766080;39457;1,2,3,5;4;9;1;1;1
252258766080;252258804838;38758;1,2,3,5;4;9;1;1;1
252258804838;252258837444;32606;1,2,3,5;4;9;1;1;1
252258837444;252258876583;39139;1,2,3,5;4;9;1;1;1
252258876583;252258952905;76322;1,2,3,5;4;9;1;1;1
252258952905;252258953967;1062;1,2,3,5;4;9;1;1;1
252258953967;252258963855;9888;1,2,3,5;4;9;1;1;1
252258963855;252259017975;54120;1,2,3,5;4;9;1;1;1
252259017975;252259058129;40154;1,2,3,5;4;9;1;1;1
252259058129;252259100047;41918;1,2,3,5;4;9;1;1;1
252259100047;252259146442;46395;1,2,3,5;4;9;1;1;1
252259146442;252259146875;433;1,2,3,5;4;9;1;1;1
252259146875;252259153214;6339;1,2,3,5;4;9;1;1;1
252259153214;252259183768;30554;1,2,3,5;4;9;1;1;1
252259183768;252259196915;13147;1,2,3,5;4;9;1;1;1
252259196915;252259202488;5573;1,2,3,5;4;9;1;1;1
252259202488;252259227999;25511;1,2,3,5;4;9;1;1;1
252259227999;252259292143;64144;1,2,3,5;4;9;1;1;1
252259292143;252259303143;11000;1,2,3,5;4;9;1;1;1
252259303143;252259303693;550;1,2,3,5;4;9;1;1;1
252259303693;252259338863;35170;1,2,3,5;4;9;1;1;1
252259338863;252259379468;40605;1,2,3,5;4;9;1;1;1
252259379468;252259385095;5627;1,2,3,5;4;9;1;1;1
252259385095;252259417427;32332;1,2,3,5;4;9;1;1;1
252259417427;252259418118;691;1,2,3,5;4;9;1;1;1
252259418118;252259426564;8446;1,2,3,5;4;9;1;1;1
252259426564;252259456850;30286;1,2,3,5;4;9;1;1;1
252259456850;252259497111;40261;1,2,3,5;4;9;1;1;1
252259497111;252259533453;36342;1,2,3,5;4;9;1;1;1
252259533453;252259607815;74362;1,2,3,5;4;9;1;1;1
252259607815;252259644226;36411;1,2,3,5;4;9;1;1;1
252259644226;252259688937;44711;1,2,3,5;4;9;1;1;1
252259688937;252259729601;40664;1,2,3,5;4;9;1;1;1
252259729601;252259814231;84630;1,2,3,5;4;9;1;1;1
252259814231;252259824663;10432;1,2,3,5;4;9;1;1;1
252259824663;252259824975;312;1,2,3,5;4;9;1;1;1
252259824975;252259825162;187;1,2,3,5;4;9;1;1;1
252259825162;252259864484;39322;1,2,3,5;4;9;1;1;1
252259864484;252259934304;69820;1,2,3,5;4;9;1;1;1
252259934304;252259934449;145;1,2,3,5;4;9;1;1;1
252259934449;252260032310;97861;1,2,3,5;4;9;1;1;1
252260032310;252260093958;61648;1,2,3,5;4;9;1;1;1
252260093958;252260138278;44320;1,2,3,5;4;9;1;1;1
252260138278;252260173913;35635;1,2,3,5;4;9;1;1;1
252260173913;252260180182;6269;1,2,3,5;4;9;1;1;1
252260180182;252260195782;15600;1,2,3,5;4;9;1;1;1
252260195782;252260238126;42344;1,2,3,5;4;9;1;1;1
252260238126;252260241171;3045;1,2,3,5;4;9;1;1;1
252260241171;252260248036;6865;1,2,3,5;4;9;1;1;1
252260248036;252260290946;42910;1,2,3,5;4;9;1;1;1
252260290946;252260361306;70360;1,2,3,5;4;9;1;1;1
252260361306;252260392575;31269;1,2,3,5;4;9;1;1;1
252260392575;252260428530;35955;1,2,3,5;4;9;1;1;1
252260428530;252260459351;30821;1,2,3,5;4;9;1;1;1
252260459351;252260500690;41339;1,2,3,5;4;9;1;1;1
252260500690;252260537956;37266;1,2,3,5;4;9;1;1;1
252260537956;252260545238;7282;1,2,3,5;4;9;1;1;1
252260545238;252260581910;36672;1,2,3,5;4;9;1;1;1
252260581910;252260582726;816;1,2,3,5;4;9;1;1;1
252260582726;252260609850;27124;1,2,3,5;4;9;1;1;1
252260609850;252260654400;44550;1,2,3,5;4;9;1;1;1
252260654400;252260661721;7321;1,2,3,5;4;9;1;1;1
252260661721;252260694352;32631;1,2,3,5;4;9;1;1;1
252260694352;252260762685;68333;1,2,3,5;4;9;1;1;1
252260762685;252260803867;41182;1,2,3,5;4;9;1;1;1
252260803867;252260813087;9220;1,2,3,5;4;9;1;1;1
252260813087;252260852241;39154;1,2,3,5;4;9;1;1;1
252260852241;252260895387;43146;1,2,3,5;4;9;1;1;1
252260895387;252260905646;10259;1,2,3,5;4;9;1;1;1
252260905646;252260906703;1057;1,2,3,5;4;9;1;1;1
252260906703;252260941427;34724;1,2,3,5;4;9;1;1;1
252260941427;252261030084;88657;1,2,3,5;4;9;1;1;1
252261030084;252261070295;40211;1,2,3,5;4;9;1;1;1
252261070295;252261130761;60466;1,2,3,5;4;9;1;1;1
252261130761;252261133713;2952;1,2,3,5;4;9;1;1;1
252261133713;252261168647;34934;1,2,3,5;4;9;1;1;1
252261168647;252261252039;83392;1,2,3,5;4;9;1;1;1
252261252039;252261302649;50610;1,2,3,5;4;9;1;1;1
252261302649;252261344160;41511;1,2,3,5;4;9;1;1;1
252261344160;252261385806;41646;1,2,3,5;4;9;1;1;1
252261385806;252261399868;14062;1,2,3,5;4;9;1;1;1
252261399868;252261400021;153;1,2,3,5;4;9;1;1;1
252261400021;252261400130;109;1,2,3,5;4;9;1;1;1
252261400130;252261423311;23181;1,2,3,5;4;9;1;1;1
252261423311;252261496300;72989;1,2,3,5;4;9;1;1;1
252261496300;252261542625;46325;1,2,3,5;4;9;1;1;1
252261542625;252261574528;31903;1,2,3,5;4;9;1;1;1
252261574528;252261577093;2565;1,2,3,5;4;9;1;1;1
252261577093;252261578750;1657;1,2,3,5;4;9;1;1;1
252261578750;252261583414;4664;1,2,3,5;4;9;1;1;1
252261583414;252261584383;969;1,2,3,5;4;9;1;1;1
252261584383;252261584785;402;1,2,3,5;4;9;1;1;1
252261584785;252261592802;8017;1,2,3,5;4;9;1;1;1
252261592802;252261593263;461;1,2,3,5;4;9;1;1;1
252261593263;252261642598;49335;1,2,3,5;4;9;1;1;1
252261642598;252261677419;34821;1,2,3,5;4;9;1;1;1
252261677419;252261682855;5436;1,2,3,5;4;9;1;1;1
252261682855;252261753241;70386;1,2,3,5;4;9;1;1;1
252261753241;252261765528;12287;1,2,3,5;4;9;1;1;1
252261765528;252261768139;2611;1,2,3,5;4;9;1;1;1
252261768139;252261768814;675;1,2,3,5;4;9;1;1;1
252261768814;252261796380;27566;1,2,3,5;4;9;1;1;1
252261796380;252261975961;179581;1,2,3,5;4;9;1;1;1
252261975961;252261987033;11072;1,2,3,5;4;9;1;1;1
252261987033;252262025686;38653;1,2,3,5;4;9;1;1;1
252262025686;252262048288;22602;1,2,3,5;4;9;1;1;1
252262048288;252262225947;177659;1,2,3,5;4;9;1;1;1
252262225947;252262230925;4978;1,2,3,5;4;9;1;1;1
252262230925;252262231401;476;1,2,3,5;4;9;1;1;1
252262231401;252262277271;45870;1,2,3,5;4;9;1;1;1
252262277271;252262307822;30551;1,2,3,5;4;9;1;1;1
252262307822;252262370820;62998;1,2,3,5;4;9;1;1;1
252262370820;252262408187;37367;1,2,3,5;4;9;1;1;1
252262408187;252262451642;43455;1,2,3,5;4;9;1;1;1
252262451642;252262466837;15195;1,2,3,5;4;9;1;1;1
252262466837;252262504874;38037;1,2,3,5;4;9;1;1;1
252262504874;252262550546;45672;1,2,3,5;4;9;1;1;1
252262550546;252262553598;3052;1,2,3,5;4;9;1;1;1
252262553598;252262570975;17377;1,2,3,5;4;9;1;1;1
252262570975;252262588193;17218;1,2,3,5;4;9;1;1;1
252262588193;252262632816;44623;1,2,3,5;4;9;1;1;1
252262632816;252262684902;52086;1,2,3,5;4;9;1;1;1
252262684902;252262756940;72038;1,2,3,5;4;9;1;1;1
252262756940;252262788805;31865;1,2,3,5;4;9;1;1;1
252262788805;252262820393;31588;1,2,3,5;4;9;1;1;1
252262820393;252262872848;52455;1,2,3,5;4;9;1;1;1
252262872848;252262872922;74;1,2,3,5;4;9;1;1;1
252262872922;252262883292;10370;1,2,3,5;4;9;1;1;1
252262883292;252262885933;2641;1,2,3,5;4;9;1;1;1
252262885933;252262895045;9112;1,2,3,5;4;9;1;1;1
252262895045;252262938514;43469;1,2,3,5;4;9;1;1;1
252262938514;252262985382;46868;1,2,3,5;4;9;1;1;1
252262985382;252262999350;13968;1,2,3,5;4;9;1;1;1
252262999350;252263013794;14444;1,2,3,5;4;9;1;1;1
252263013794;252263024470;10676;1,2,3,5;4;9;1;1;1
252263024470;252263098038;73568;1,2,3,5;4;9;1;1;1
252263098038;252263100270;2232;1,2,3,5;4;9;1;1;1
252263100270;252263106190;5920;1,2,3,5;4;9;1;1;1
252263106190;252263108573;2383;1,2,3,5;4;9;1;1;1
252263108573;252263115251;6678;1,2,3,5;4;9;1;1;1
252263115251;252263121917;6666;1,2,3,5;4;9;1;1;1
252263121917;252263142857;20940;1,2,3,5;4;9;1;1;1
252263142857;252263182008;39151;1,2,3,5;4;9;1;1;1
252263182008;252263216575;34567;1,2,3,5;4;9;1;1;1
252263216575;252263260638;44063;1,2,3,5;4;9;1;1;1
252263260638;252263297325;36687;1,2,3,5;4;9;1;1;1
252263297325;252263303150;5825;1,2,3,5;4;9;1;1;1
252263303150;252263337629;34479;1,2,3,5;4;9;1;1;1
252263337629;252263406604;68975;1,2,3,5;4;9;1;1;1
252263406604;252263417434;10830;1,2,3,5;4;9;1;1;1
252263417434;252263420927;3493;1,2,3,5;4;9;1;1;1
252263420927;252263462813;41886;1,2,3,5;4;9;1;1;1
252263462813;252263505399;42586;1,2,3,5;4;9;1;1;1
252263505399;252263512700;7301;1,2,3,5;4;9;1;1;1
252263512700;252263513775;1075;1,2,3,5;4;9;1;1;1
252263513775;252263520100;6325;1,2,3,5;4;9;1;1;1
252263520100;252263544375;24275;1,2,3,5;4;9;1;1;1
252263544375;252263585237;40862;1,2,3,5;4;9;1;1;1
252263585237;252263629209;43972;1,2,3,5;4;9;1;1;1
252263629209;252263670104;40895;1,2,3,5;4;9;1;1;1
252263670104;252263670413;309;1,2,3,5;4;9;1;1;1
252263670413;252263684684;14271;1,2,3,5;4;9;1;1;1
252263684684;252263734859;50175;1,2,3,5;4;9;1;1;1
252263734859;252263755189;20330;1,2,3,5;4;9;1;1;1
252263755189;252263797541;42352;1,2,3,5;4;9;1;1;1
252263797541;252263833373;35832;1,2,3,5;4;9;1;1;1
252263833373;252263837312;3939;1,2,3,5;4;9;1;1;1
252263837312;252263844939;7627;1,2,3,5;4;9;1;1;1
252263844939;252263846474;1535;1,2,3,5;4;9;1;1;1
252263846474;252263846594;120;1,2,3,5;4;9;1;1;1
252263846594;252263872541;25947;1,2,3,5;4;9;1;1;1
252263872541;252263929210;56669;1,2,3,5;4;9;1;1;1
252263929210;252263968499;39289;1,2,3,5;4;9;1;1;1
252263968499;252264028061;59562;1,2,3,5;4;9;1;1;1
252264028061;252264100577;72516;1,2,3,5;4;9;1;1;1
252264100577;252264101173;596;1,2,3,5;4;9;1;1;1
252264101173;252264110431;9258;1,2,3,5;4;9;1;1;1
252264110431;252264154198;43767;1,2,3,5;4;9;1;1;1
252264154198;252264193943;39745;1,2,3,5;4;9;1;1;1
252264193943;252264224853;30910;1,2,3,5;4;9;1;1;1
252264224853;252264256311;31458;1,2,3,5;4;9;1;1;1
252264256311;252264292380;36069;1,2,3,5;4;9;1;1;1
252264292380;252264332015;39635;1,2,3,5;4;9;1;1;1
252264332015;252264388907;56892;1,2,3,5;4;9;1;1;1
252264388907;252264399158;10251;1,2,3,5;4;9;1;1;1
252264399158;252264459272;60114;1,2,3,5;4;9;1;1;1
252264459272;252264462088;2816;1,2,3,5;4;9;1;1;1
252264462088;252264464936;2848;1,2,3,5;4;9;1;1;1
252264464936;252264473331;8395;1,2,3,5;4;9;1;1;1
252264473331;252264497162;23831;1,2,3,5;4;9;1;1;1
252264497162;252264540704;43542;1,2,3,5;4;9;1;1;1
252264540704;252264542319;1615;1,2,3,5;4;9;1;1;1
252264542319;252264550400;8081;1,2,3,5;4;9;1;1;1
252264550400;252264572761;22361;1,2,3,5;4;9;1;1;1
252264572761;252264617643;44882;1,2,3,5;4;9;1;1;1
252264617643;252264659459;41816;1,2,3,5;4;9;1;1;1
252264659459;252264740642;81183;1,2,3,5;4;9;1;1;1
252264740642;252264771716;31074;1,2,3,5;4;9;1;1;1
252264771716;252264772721;1005;1,2,3,5;4;9;1;1;1
252264772721;252264781438;8717;1,2,3,5;4;9;1;1;1
252264781438;252264820977;39539;1,2,3,5;4;9;1;1;1
252264820977;252264861967;40990;1,2,3,5;4;9;1;1;1
252264861967;252264904331;42364;1,2,3,5;4;9;1;1;1
252264904331;252264911871;7540;1,2,3,5;4;9;1;1;1
252264911871;252264933260;21389;1,2,3,5;4;9;1;1;1
252264933260;252264978528;45268;1,2,3,5;4;9;1;1;1
252264978528;252265042388;63860;1,2,3,5;4;9;1;1;1
252265042388;252265053558;11170;1,2,3,5;4;9;1;1;1
252265053558;252265093283;39725;1,2,3,5;4;9;1;1;1
252265093283;252265103314;10031;1,2,3,5;4;9;1;1;1
252265103314;252265103368;54;1,2,3,5;4;9;1;1;1
252265103368;252265133661;30293;1,2,3,5;4;9;1;1;1
252265133661;252265133736;75;1,2,3,5;4;9;1;1;1
252265133736;252265169611;35875;1,2,3,5;4;9;1;1;1
252265169611;252265171984;2373;1,2,3,5;4;9;1;1;1
252265171984;252265172411;427;1,2,3,5;4;9;1;1;1
252265172411;252265218333;45922;1,2,3,5;4;9;1;1;1
252265218333;252265219673;1340;1,2,3,5;4;9;1;1;1
252265219673;252265296383;76710;1,2,3,5;4;9;1;1;1
252265296383;252265464426;168043;1,2,3,5;4;9;1;1;1
252265464426;252265478848;14422;1,2,3,5;4;9;1;1;1
252265478848;252265480401;1553;1,2,3,5;4;9;1;1;1
252265480401;252265496127;15726;1,2,3,5;4;9;1;1;1
252265496127;252265504251;8124;1,2,3,5;4;9;1;1;1
252265504251;252265520029;15778;1,2,3,5;4;9;1;1;1
252265520029;252265545895;25866;1,2,3,5;4;9;1;1;1
252265545895;252265584329;38434;1,2,3,5;4;9;1;1;1
252265584329;252265606345;22016;1,2,3,5;4;9;1;1;1
252265606345;252265633000;26655;1,2,3,5;4;9;1;1;1
252265633000;252265673490;40490;1,2,3,5;4;9;1;1;1
252265673490;252265712723;39233;1,2,3,5;4;9;1;1;1
252265712723;252265774982;62259;1,2,3,5;4;9;1;1;1
252265774982;252265817166;42184;1,2,3,5;4;9;1;1;1
252265817166;252265853438;36272;1,2,3,5;4;9;1;1;1
252265853438;252265893115;39677;1,2,3,5;4;9;1;1;1
252265893115;252265929264;36149;1,2,3,5;4;9;1;1;1
252265929264;252265969207;39943;1,2,3,5;4;9;1;1;1
252265969207;252266000010;30803;1,2,3,5;4;9;1;1;1
252266000010;252266032359;32349;1,2,3,5;4;9;1;1;1
252266032359;252266062062;29703;1,2,3,5;4;9;1;1;1
252266062062;252266132509;70447;1,2,3,5;4;9;1;1;1
252266132509;252266174080;41571;1,2,3,5;4;9;1;1;1
252266174080;252266180570;6490;1,2,3,5;4;9;1;1;1
252266180570;252266219164;38594;1,2,3,5;4;9;1;1;1
252266219164;252266219441;277;1,2,3,5;4;9;1;1;1
252266219441;252266261905;42464;1,2,3,5;4;9;1;1;1
252266261905;252266305571;43666;1,2,3,5;4;9;1;1;1
252266305571;252266349489;43918;1,2,3,5;4;9;1;1;1
252266349489;252266411480;61991;1,2,3,5;4;9;1;1;1
252266411480;252266483490;72010;1,2,3,5;4;9;1;1;1
252266483490;252266508421;24931;1,2,3,5;4;9;1;1;1
252266508421;252266538961;30540;1,2,3,5;4;9;1;1;1
252266538961;252266551614;12653;1,2,3,5;4;9;1;1;1
252266551614;252266562712;11098;1,2,3,5;4;9;1;1;1
252266562712;252266593542;30830;1,2,3,5;4;9;1;1;1
252266593542;252266635264;41722;1,2,3,5;4;9;1;1;1
252266635264;252266676897;41633;1,2,3,5;4;9;1;1;1
252266676897;252266739777;62880;1,2,3,5;4;9;1;1;1
252266739777;252266748871;9094;1,2,3,5;4;9;1;1;1
252266748871;252266836468;87597;1,2,3,5;4;9;1;1;1
252266836468;252266855433;18965;1,2,3,5;4;9;1;1;1
252266855433;252266875994;20561;1,2,3,5;4;9;1;1;1
252266875994;252266876251;257;1,2,3,5;4;9;1;1;1
252266876251;252266925968;49717;1,2,3,5;4;9;1;1;1
252266925968;252267017423;91455;1,2,3,5;4;9;1;1;1
252267017423;252267025468;8045;1,2,3,5;4;9;1;1;1
252267025468;252267076830;51362;1,2,3,5;4;9;1;1;1
252267076830;252267130284;53454;1,2,3,5;4;9;1;1;1
252267130284;252267189915;59631;1,2,3,5;4;9;1;1;1
252267189915;252267197760;7845;1,2,3,5;4;9;1;1;1
252267197760;252267217025;19265;1,2,3,5;4;9;1;1;1
252267217025;252267226003;8978;1,2,3,5;4;9;1;1;1
252267226003;252267226142;139;1,2,3,5;4;9;1;1;1
252267226142;252267269851;43709;1,2,3,5;4;9;1;1;1
252267269851;252267328925;59074;1,2,3,5;4;9;1;1;1
252267328925;252267440702;111777;1,2,3,5;4;9;1;1;1
252267440702;252267486392;45690;1,2,3,5;4;9;1;1;1
252267486392;252267539100;52708;1,2,3,5;4;9;1;1;1
252267539100;252267577688;38588;1,2,3,5;4;9;1;1;1
252267577688;252267653717;76029;1,2,3,5;4;9;1;1;1
252267653717;252267656450;2733;1,2,3,5;4;9;1;1;1
252267656450;252267662164;5714;1,2,3,5;4;9;1;1;1
252267662164;252267662736;572;1,2,3,5;4;9;1;1;1
252267662736;252267698919;36183;1,2,3,5;4;9;1;1;1
252267698919;252267700448;1529;1,2,3,5;4;9;1;1;1
252267700448;252267799322;98874;1,2,3,5;4;9;1;1;1
252267799322;252267808034;8712;1,2,3,5;4;9;1;1;1
252267808034;252267818126;10092;1,2,3,5;4;9;1;1;1
252267818126;252267872973;54847;1,2,3,5;4;9;1;1;1
252267872973;252267952397;79424;1,2,3,5;4;9;1;1;1
252267952397;252267991120;38723;1,2,3,5;4;9;1;1;1
252267991120;252267999436;8316;1,2,3,5;4;9;1;1;1
252267999436;252268000343;907;1,2,3,5;4;9;1;1;1
252268000343;252268044172;43829;1,2,3,5;4;9;1;1;1
252268044172;252268103866;59694;1,2,3,5;4;9;1;1;1
252268103866;252268142328;38462;1,2,3,5;4;9;1;1;1
252268142328;252268148440;6112;1,2,3,5;4;9;1;1;1
252268148440;252268196243;47803;1,2,3,5;4;9;1;1;1
252268196243;252268242261;46018;1,2,3,5;4;9;1;1;1
252268242261;252268286544;44283;1,2,3,5;4;9;1;1;1
252268286544;252268316003;29459;1,2,3,5;4;9;1;1;1
252268316003;252268351957;35954;1,2,3,5;4;9;1;1;1
252268351957;252268387274;35317;1,2,3,5;4;9;1;1;1
252268387274;252268427703;40429;1,2,3,5;4;9;1;1;1
252268427703;252268448823;21120;1,2,3,5;4;9;1;1;1
252268448823;252268504907;56084;1,2,3,5;4;9;1;1;1
252268504907;252268570403;65496;1,2,3,5;4;9;1;1;1
252268570403;252268697132;126729;1,2,3,5;4;9;1;1;1
252268697132;252268704384;7252;1,2,3,5;4;9;1;1;1
252268704384;252268710844;6460;1,2,3,5;4;9;1;1;1
252268710844;252268797699;86855;1,2,3,5;4;9;1;1;1
252268797699;252268800160;2461;1,2,3,5;4;9;1;1;1
252268800160;252268812785;12625;1,2,3,5;4;9;1;1;1
252268812785;252268813526;741;1,2,3,5;4;9;1;1;1
252268813526;252268823753;10227;1,2,3,5;4;9;1;1;1
252268823753;252268855395;31642;1,2,3,5;4;9;1;1;1
252268855395;252268898425;43030;1,2,3,5;4;9;1;1;1
252268898425;252268937967;39542;1,2,3,5;4;9;1;1;1
252268937967;252269017990;80023;1,2,3,5;4;9;1;1;1
252269017990;252269018325;335;1,2,3,5;4;9;1;1;1
252269018325;252269027552;9227;1,2,3,5;4;9;1;1;1
252269027552;252269063215;35663;1,2,3,5;4;9;1;1;1
252269063215;252269064477;1262;1,2,3,5;4;9;1;1;1
252269064477;252269071353;6876;1,2,3,5;4;9;1;1;1
252269071353;252269102988;31635;1,2,3,5;4;9;1;1;1
252269102988;252269145647;42659;1,2,3,5;4;9;1;1;1
252269145647;252269240196;94549;1,2,3,5;4;9;1;1;1
252269240196;252269257068;16872;1,2,3,5;4;9;1;1;1
252269257068;252269266068;9000;1,2,3,5;4;9;1;1;1
252269266068;252269270170;4102;1,2,3,5;4;9;1;1;1
252269270170;252269307304;37134;1,2,3,5;4;9;1;1;1
252269307304;252269317230;9926;1,2,3,5;4;9;1;1;1
252269317230;252269426541;109311;1,2,3,5;4;9;1;1;1
252269426541;252269442088;15547;1,2,3,5;4;9;1;1;1
252269442088;252269474057;31969;1,2,3,5;4;9;1;1;1
252269474057;252269475644;1587;1,2,3,5;4;9;1;1;1
252269475644;252269475945;301;1,2,3,5;4;9;1;1;1
252269475945;252269585043;109098;1,2,3,5;4;9;1;1;1
252269585043;252269595975;10932;1,2,3,5;4;9;1;1;1
252269595975;252269597918;1943;1,2,3,5;4;9;1;1;1
252269597918;252269604373;6455;1,2,3,5;4;9;1;1;1
252269604373;252269612935;8562;1,2,3,5;4;9;1;1;1
252269612935;252269615883;2948;1,2,3,5;4;9;1;1;1
252269615883;252269653850;37967;1,2,3,5;4;9;1;1;1
252269653850;252269681593;27743;1,2,3,5;4;9;1;1;1
252269681593;252269736138;54545;1,2,3,5;4;9;1;1;1
252269736138;252269767003;30865;1,2,3,5;4;9;1;1;1
252269767003;252269777024;10021;1,2,3,5;4;9;1;1;1
252269777024;252269782733;5709;1,2,3,5;4;9;1;1;1
252269782733;252269787270;4537;1,2,3,5;4;9;1;1;1
252269787270;252269793141;5871;1,2,3,5;4;9;1;1;1
252269793141;252854455600;584662459;1,2,3,5;4;9;1;1;1
252854455600;252854635545;179945;0,1,2,3,5;5;2,9;2;1;1
252854635545;252854637114;1569;0,1,2,3,5;5;2,9;2;1;1
252854637114;252854773357;136243;0,1,2,3,5;5;2,9;2;1;1
252854773357;252855648564;875207;0,1,2,3,5;5;2,9;2;1;1
252855648564;252855667473;18909;0,1,2,3,5;5;2,9;2;1;1
252855667473;252855686123;18650;0,1,2,3,5;5;2,9;2;1;1
252855686123;252855691281;5158;0,1,2,3,5;5;2,9;2;1;1
252855691281;252855891191;199910;0,1,2,3,5;5;2,9;2;1;1
252855891191;252856121574;230383;0,1,2,3,5;5;2,9;2;1;1
252856121574;252856785101;663527;0,1,2,3,5;5;2,9;2;1;1
252856785101;252856786767;1666;0,1,2,3,5;5;2,9;2;1;1
252856786767;252856832423;45656;0,1,2,3,5;5;2,9;2;1;1
252856832423;252856916559;84136;0,1,2,3,5;5;2,9;2;1;1
252856916559;252856916570;11;0,1,2,3,5;5;2,9;2;1;1
252856916570;252856916587;17;0,1,2,3,5;5;2,9;2;1;1
252856916587;252856916617;30;0,1,2,3,5;5;2,9;2;1;1
252856916617;252856916633;16;0,1,2,3,5;5;2,9;2;1;1
252856916633;252856916663;30;0,1,2,3,5;5;2,9;2;1;1
252856916663;252856916717;54;0,1,2,3,5;5;2,9;2;1;1
252856916717;252856916742;25;0,1,2,3,5;5;2,9;2;1;1
252856916742;252856916802;60;0,1,2,3,5;5;2,9;2;1;1
252856916802;252856916815;13;0,1,2,3,5;5;2,9;2;1;1
252856916815;252856916830;15;0,1,2,3,5;5;2,9;2;1;1
252856916830;252856916860;30;0,1,2,3,5;5;2,9;2;1;1
252856916860;252856916874;14;0,1,2,3,5;5;2,9;2;1;1
252856916874;252856916908;34;0,1,2,3,5;5;2,9;2;1;1
252856916908;252856916963;55;0,1,2,3,5;5;2,9;2;1;1
252856916963;252856917007;44;0,1,2,3,5;5;2,9;2;1;1
252856917007;252856917041;34;0,1,2,3,5;5;2,9;2;1;1
252856917041;252856917092;51;0,1,2,3,5;5;2,9;2;1;1
252856917092;252856917109;17;0,1,2,3,5;5;2,9;2;1;1
252856917109;252856917125;16;0,1,2,3,5;5;2,9;2;1;1
252856917125;252856917137;12;0,1,2,3,5;5;2,9;2;1;1
252856917137;252856917187;50;0,1,2,3,5;5;2,9;2;1;1
252856917187;252856917218;31;0,1,2,3,5;5;2,9;2;1;1
252856917218;252856917233;15;0,1,2,3,5;5;2,9;2;1;1
252856917233;252856917249;16;0,1,2,3,5;5;2,9;2;1;1
252856917249;252856917292;43;0,1,2,3,5;5;2,9;2;1;1
252856917292;252856917306;14;0,1,2,3,5;5;2,9;2;1;1
252856917306;252856917321;15;0,1,2,3,5;5;2,9;2;1;1
252856917321;252856917350;29;0,1,2,3,5;5;2,9;2;1;1
252856917350;252856917396;46;0,1,2,3,5;5;2,9;2;1;1
252856917396;252856917413;17;0,1,2,3,5;5;2,9;2;1;1
252856917413;252856917433;20;0,1,2,3,5;5;2,9;2;1;1
252856917433;252856917457;24;0,1,2,3,5;5;2,9;2;1;1
252856917457;252856917506;49;0,1,2,3,5;5;2,9;2;1;1
252856917506;252856917559;53;0,1,2,3,5;5;2,9;2;1;1
252856917559;252856917611;52;0,1,2,3,5;5;2,9;2;1;1
252856917611;252856917644;33;0,1,2,3,5;5;2,9;2;1;1
252856917644;252856917665;21;0,1,2,3,5;5;2,9;2;1;1
252856917665;252856917696;31;0,1,2,3,5;5;2,9;2;1;1
252856917696;252856917708;12;0,1,2,3,5;5;2,9;2;1;1
252856917708;252856917727;19;0,1,2,3,5;5;2,9;2;1;1
252856917727;252856917735;8;0,1,2,3,5;5;2,9;2;1;1
252856917735;252856917755;20;0,1,2,3,5;5;2,9;2;1;1
252856917755;252856917772;17;0,1,2,3,5;5;2,9;2;1;1
252856917772;252856917817;45;0,1,2,3,5;5;2,9;2;1;1
252856917817;252856917841;24;0,1,2,3,5;5;2,9;2;1;1
252856917841;252856917859;18;0,1,2,3,5;5;2,9;2;1;1
252856917859;252856917869;10;0,1,2,3,5;5;2,9;2;1;1
252856917869;252856917894;25;0,1,2,3,5;5;2,9;2;1;1
252856917894;252856917897;3;0,1,2,3,5;5;2,9;2;1;1
252856917897;252856917956;59;0,1,2,3,5;5;2,9;2;1;1
252856917956;252856917963;7;0,1,2,3,5;5;2,9;2;1;1
252856917963;252856917997;34;0,1,2,3,5;5;2,9;2;1;1
252856917997;252856918018;21;0,1,2,3,5;5;2,9;2;1;1
252856918018;252856918042;24;0,1,2,3,5;5;2,9;2;1;1
252856918042;252856918101;59;0,1,2,3,5;5;2,9;2;1;1
252856918101;252856918118;17;0,1,2,3,5;5;2,9;2;1;1
252856918118;252856918127;9;0,1,2,3,5;5;2,9;2;1;1
252856918127;252856918152;25;0,1,2,3,5;5;2,9;2;1;1
252856918152;252856918181;29;0,1,2,3,5;5;2,9;2;1;1
252856918181;252856918235;54;0,1,2,3,5;5;2,9;2;1;1
252856918235;252856918239;4;0,1,2,3,5;5;2,9;2;1;1
252856918239;252856918249;10;0,1,2,3,5;5;2,9;2;1;1
252856918249;252856918273;24;0,1,2,3,5;5;2,9;2;1;1
252856918273;252856918290;17;0,1,2,3,5;5;2,9;2;1;1
252856918290;252856918337;47;0,1,2,3,5;5;2,9;2;1;1
252856918337;252856918344;7;0,1,2,3,5;5;2,9;2;1;1
252856918344;252856918350;6;0,1,2,3,5;5;2,9;2;1;1
252856918350;252856918369;19;0,1,2,3,5;5;2,9;2;1;1
252856918369;252856918388;19;0,1,2,3,5;5;2,9;2;1;1
252856918388;252856918398;10;0,1,2,3,5;5;2,9;2;1;1
252856918398;252856918408;10;0,1,2,3,5;5;2,9;2;1;1
252856918408;252856918446;38;0,1,2,3,5;5;2,9;2;1;1
252856918446;252856918472;26;0,1,2,3,5;5;2,9;2;1;1
252856918472;252856918725;253;0,1,2,3,5;5;2,9;2;1;1
252856918725;252856918767;42;0,1,2,3,5;5;2,9;2;1;1
252856918767;252856918803;36;0,1,2,3,5;5;2,9;2;1;1
252856918803;252856918828;25;0,1,2,3,5;5;2,9;2;1;1
252856918828;252856918883;55;0,1,2,3,5;5;2,9;2;1;1
252856918883;252856919022;139;0,1,2,3,5;5;2,9;2;1;1
252856919022;252856919037;15;0,1,2,3,5;5;2,9;2;1;1
252856919037;252856919091;54;0,1,2,3,5;5;2,9;2;1;1
252856919091;252856919179;88;0,1,2,3,5;5;2,9;2;1;1
252856919179;252856919198;19;0,1,2,3,5;5;2,9;2;1;1
252856919198;252856919217;19;0,1,2,3,5;5;2,9;2;1;1
252856919217;252856919247;30;0,1,2,3,5;5;2,9;2;1;1
252856919247;252856919266;19;0,1,2,3,5;5;2,9;2;1;1
252856919266;252856919370;104;0,1,2,3,5;5;2,9;2;1;1
252856919370;252856919480;110;0,1,2,3,5;5;2,9;2;1;1
252856919480;252856919664;184;0,1,2,3,5;5;2,9;2;1;1
252856919664;252856919682;18;0,1,2,3,5;5;2,9;2;1;1
252856919682;252856919777;95;0,1,2,3,5;5;2,9;2;1;1
252856919777;252856919809;32;0,1,2,3,5;5;2,9;2;1;1
252856919809;252856919832;23;0,1,2,3,5;5;2,9;2;1;1
252856919832;252856919937;105;0,1,2,3,5;5;2,9;2;1;1
252856919937;252856921361;1424;0,1,2,3,5;5;2,9;2;1;1
252856921361;252856921396;35;0,1,2,3,5;5;2,9;2;1;1
252856921396;252856921478;82;0,1,2,3,5;5;2,9;2;1;1
252856921478;252856921567;89;0,1,2,3,5;5;2,9;2;1;1
252856921567;252856921585;18;0,1,2,3,5;5;2,9;2;1;1
252856921585;252856921694;109;0,1,2,3,5;5;2,9;2;1;1
252856921694;252856921717;23;0,1,2,3,5;5;2,9;2;1;1
252856921717;252856921753;36;0,1,2,3,5;5;2,9;2;1;1
252856921753;252856921829;76;0,1,2,3,5;5;2,9;2;1;1
252856921829;252856921881;52;0,1,2,3,5;5;2,9;2;1;1
252856921881;252856922006;125;0,1,2,3,5;5;2,9;2;1;1
252856922006;252856922040;34;0,1,2,3,5;5;2,9;2;1;1
252856922040;252856922117;77;0,1,2,3,5;5;2,9;2;1;1
252856922117;252856922166;49;0,1,2,3,5;5;2,9;2;1;1
252856922166;252856922325;159;0,1,2,3,5;5;2,9;2;1;1
252856922325;252856922356;31;0,1,2,3,5;5;2,9;2;1;1
252856922356;252856922458;102;0,1,2,3,5;5;2,9;2;1;1
252856922458;252856922584;126;0,1,2,3,5;5;2,9;2;1;1
252856922584;252856922700;116;0,1,2,3,5;5;2,9;2;1;1
252856922700;252856922738;38;0,1,2,3,5;5;2,9;2;1;1
252856922738;252856922773;35;0,1,2,3,5;5;2,9;2;1;1
252856922773;252856922796;23;0,1,2,3,5;5;2,9;2;1;1
252856922796;252856922824;28;0,1,2,3,5;5;2,9;2;1;1
252856922824;252856922867;43;0,1,2,3,5;5;2,9;2;1;1
252856922867;252856922990;123;0,1,2,3,5;5;2,9;2;1;1
252856922990;252856923024;34;0,1,2,3,5;5;2,9;2;1;1
252856923024;252856924064;1040;0,1,2,3,5;5;2,9;2;1;1
252856924064;252856924116;52;0,1,2,3,5;5;2,9;2;1;1
252856924116;252856924863;747;0,1,2,3,5;5;2,9;2;1;1
252856924863;252856924969;106;0,1,2,3,5;5;2,9;2;1;1
252856924969;252856958937;33968;0,1,2,3,5;5;2,9;2;1;1
252856958937;252856958946;9;0,1,2,3,5;5;2,9;2;1;1
252856958946;252856958962;16;0,1,2,3,5;5;2,9;2;1;1
252856958962;252856958989;27;0,1,2,3,5;5;2,9;2;1;1
252856958989;252856959006;17;0,1,2,3,5;5;2,9;2;1;1
252856959006;252856959053;47;0,1,2,3,5;5;2,9;2;1;1
252856959053;252856959104;51;0,1,2,3,5;5;2,9;2;1;1
252856959104;252856959117;13;0,1,2,3,5;5;2,9;2;1;1
252856959117;252856960264;1147;0,1,2,3,5;5;2,9;2;1;1
252856960264;252856960353;89;0,1,2,3,5;5;2,9;2;1;1
252856960353;252856960408;55;0,1,2,3,5;5;2,9;2;1;1
252856960408;252856960518;110;0,1,2,3,5;5;2,9;2;1;1
252856960518;252856960557;39;0,1,2,3,5;5;2,9;2;1;1
252856960557;252856960688;131;0,1,2,3,5;5;2,9;2;1;1
252856960688;252856960720;32;0,1,2,3,5;5;2,9;2;1;1
252856960720;252856960749;29;0,1,2,3,5;5;2,9;2;1;1
252856960749;252856960778;29;0,1,2,3,5;5;2,9;2;1;1
252856960778;252856960799;21;0,1,2,3,5;5;2,9;2;1;1
252856960799;252856960911;112;0,1,2,3,5;5;2,9;2;1;1
252856960911;252856960940;29;0,1,2,3,5;5;2,9;2;1;1
252856960940;252856961057;117;0,1,2,3,5;5;2,9;2;1;1
252856961057;252856961100;43;0,1,2,3,5;5;2,9;2;1;1
252856961100;252856961113;13;0,1,2,3,5;5;2,9;2;1;1
252856961113;252856961121;8;0,1,2,3,5;5;2,9;2;1;1
252856961121;252856961141;20;0,1,2,3,5;5;2,9;2;1;1
252856961141;252856961178;37;0,1,2,3,5;5;2,9;2;1;1
252856961178;252856961192;14;0,1,2,3,5;5;2,9;2;1;1
252856961192;252856961197;5;0,1,2,3,5;5;2,9;2;1;1
252856961197;252856961216;19;0,1,2,3,5;5;2,9;2;1;1
252856961216;252856961222;6;0,1,2,3,5;5;2,9;2;1;1
252856961222;252856961228;6;0,1,2,3,5;5;2,9;2;1;1
252856961228;252856961238;10;0,1,2,3,5;5;2,9;2;1;1
252856961238;252856961246;8;0,1,2,3,5;5;2,9;2;1;1
252856961246;252856961255;9;0,1,2,3,5;5;2,9;2;1;1
252856961255;252856961257;2;0,1,2,3,5;5;2,9;2;1;1
252856961257;252856961265;8;0,1,2,3,5;5;2,9;2;1;1
252856961265;252856961307;42;0,1,2,3,5;5;2,9;2;1;1
252856961307;252856961331;24;0,1,2,3,5;5;2,9;2;1;1
252856961331;252856961379;48;0,1,2,3,5;5;2,9;2;1;1
252856961379;252856961386;7;0,1,2,3,5;5;2,9;2;1;1
252856961386;252856961387;1;0,1,2,3,5;5;2,9;2;1;1
252856961387;252856961409;22;0,1,2,3,5;5;2,9;2;1;1
252856961409;252856961413;4;0,1,2,3,5;5;2,9;2;1;1
252856961413;252856961416;3;0,1,2,3,5;5;2,9;2;1;1
252856961416;252856961418;2;0,1,2,3,5;5;2,9;2;1;1
252856961418;252856961426;8;0,1,2,3,5;5;2,9;2;1;1
252856961426;252856961449;23;0,1,2,3,5;5;2,9;2;1;1
252856961449;252856961454;5;0,1,2,3,5;5;2,9;2;1;1
252856961454;252856961637;183;0,1,2,3,5;5;2,9;2;1;1
252856961637;252856961674;37;0,1,2,3,5;5;2,9;2;1;1
252856961674;252856961700;26;0,1,2,3,5;5;2,9;2;1;1
252856961700;252856961742;42;0,1,2,3,5;5;2,9;2;1;1
252856961742;252856961805;63;0,1,2,3,5;5;2,9;2;1;1
252856961805;252856961822;17;0,1,2,3,5;5;2,9;2;1;1
252856961822;252856961848;26;0,1,2,3,5;5;2,9;2;1;1
252856961848;252856961850;2;0,1,2,3,5;5;2,9;2;1;1
252856961850;252856961875;25;0,1,2,3,5;5;2,9;2;1;1
252856961875;252856961891;16;0,1,2,3,5;5;2,9;2;1;1
252856961891;252856961908;17;0,1,2,3,5;5;2,9;2;1;1
252856961908;252856961916;8;0,1,2,3,5;5;2,9;2;1;1
252856961916;252856961947;31;0,1,2,3,5;5;2,9;2;1;1
252856961947;252856961969;22;0,1,2,3,5;5;2,9;2;1;1
252856961969;252856962021;52;0,1,2,3,5;5;2,9;2;1;1
252856962021;252856962022;1;0,1,2,3,5;5;2,9;2;1;1
252856962022;252856962046;24;0,1,2,3,5;5;2,9;2;1;1
252856962046;252856962057;11;0,1,2,3,5;5;2,9;2;1;1
252856962057;252856962073;16;0,1,2,3,5;5;2,9;2;1;1
252856962073;252856962082;9;0,1,2,3,5;5;2,9;2;1;1
252856962082;252856962103;21;0,1,2,3,5;5;2,9;2;1;1
252856962103;252856962112;9;0,1,2,3,5;5;2,9;2;1;1
252856962112;252856962119;7;0,1,2,3,5;5;2,9;2;1;1
252856962119;252856962120;1;0,1,2,3,5;5;2,9;2;1;1
252856962120;252856962138;18;0,1,2,3,5;5;2,9;2;1;1
252856962138;252856962139;1;0,1,2,3,5;5;2,9;2;1;1
252856962139;252856962147;8;0,1,2,3,5;5;2,9;2;1;1
252856962147;252856962162;15;0,1,2,3,5;5;2,9;2;1;1
252856962162;252856962167;5;0,1,2,3,5;5;2,9;2;1;1
252856962167;252856962171;4;0,1,2,3,5;5;2,9;2;1;1
252856962171;252856962174;3;0,1,2,3,5;5;2,9;2;1;1
252856962174;252856962179;5;0,1,2,3,5;5;2,9;2;1;1
252856962179;252856962183;4;0,1,2,3,5;5;2,9;2;1;1
252856962183;252856962184;1;0,1,2,3,5;5;2,9;2;1;1
252856962184;252856962186;2;0,1,2,3,5;5;2,9;2;1;1
252856962186;252856962188;2;0,1,2,3,5;5;2,9;2;1;1
252856962188;252856962201;13;0,1,2,3,5;5;2,9;2;1;1
252856962201;252856962209;8;0,1,2,3,5;5;2,9;2;1;1
252856962209;252856962217;8;0,1,2,3,5;5;2,9;2;1;1
252856962217;252856962219;2;0,1,2,3,5;5;2,9;2;1;1
252856962219;252856962225;6;0,1,2,3,5;5;2,9;2;1;1
252856962225;252856962242;17;0,1,2,3,5;5;2,9;2;1;1
252856962242;252856962247;5;0,1,2,3,5;5;2,9;2;1;1
252856962247;252856962250;3;0,1,2,3,5;5;2,9;2;1;1
252856962250;252856962285;35;0,1,2,3,5;5;2,9;2;1;1
252856962285;252856962294;9;0,1,2,3,5;5;2,9;2;1;1
252856962294;252856962311;17;0,1,2,3,5;5;2,9;2;1;1
252856962311;252856962318;7;0,1,2,3,5;5;2,9;2;1;1
252856962318;252856962339;21;0,1,2,3,5;5;2,9;2;1;1
252856962339;252856962342;3;0,1,2,3,5;5;2,9;2;1;1
252856962342;252856962356;14;0,1,2,3,5;5;2,9;2;1;1
252856962356;252856962379;23;0,1,2,3,5;5;2,9;2;1;1
252856962379;252856962405;26;0,1,2,3,5;5;2,9;2;1;1
252856962405;252856962409;4;0,1,2,3,5;5;2,9;2;1;1
252856962409;252856962412;3;0,1,2,3,5;5;2,9;2;1;1
252856962412;252856962425;13;0,1,2,3,5;5;2,9;2;1;1
252856962425;252856962428;3;0,1,2,3,5;5;2,9;2;1;1
252856962428;252856962443;15;0,1,2,3,5;5;2,9;2;1;1
252856962443;252856962453;10;0,1,2,3,5;5;2,9;2;1;1
252856962453;252856962457;4;0,1,2,3,5;5;2,9;2;1;1
252856962457;252856962463;6;0,1,2,3,5;5;2,9;2;1;1
252856962463;252856962492;29;0,1,2,3,5;5;2,9;2;1;1
252856962492;252856962525;33;0,1,2,3,5;5;2,9;2;1;1
252856962525;252856962527;2;0,1,2,3,5;5;2,9;2;1;1
252856962527;252856962558;31;0,1,2,3,5;5;2,9;2;1;1
252856962558;252856962562;4;0,1,2,3,5;5;2,9;2;1;1
252856962562;252856962578;16;0,1,2,3,5;5;2,9;2;1;1
252856962578;252856962583;5;0,1,2,3,5;5;2,9;2;1;1
252856962583;252856962596;13;0,1,2,3,5;5;2,9;2;1;1
252856962596;252856962605;9;0,1,2,3,5;5;2,9;2;1;1
252856962605;252856962610;5;0,1,2,3,5;5;2,9;2;1;1
252856962610;252856962651;41;0,1,2,3,5;5;2,9;2;1;1
252856962651;252856962670;19;0,1,2,3,5;5;2,9;2;1;1
252856962670;252856962694;24;0,1,2,3,5;5;2,9;2;1;1
252856962694;252856962714;20;0,1,2,3,5;5;2,9;2;1;1
252856962714;252856962767;53;0,1,2,3,5;5;2,9;2;1;1
252856962767;252856962789;22;0,1,2,3,5;5;2,9;2;1;1
252856962789;252856962804;15;0,1,2,3,5;5;2,9;2;1;1
252856962804;252856962847;43;0,1,2,3,5;5;2,9;2;1;1
252856962847;252856962863;16;0,1,2,3,5;5;2,9;2;1;1
252856962863;252856962884;21;0,1,2,3,5;5;2,9;2;1;1
252856962884;252856962890;6;0,1,2,3,5;5;2,9;2;1;1
252856962890;252856962895;5;0,1,2,3,5;5;2,9;2;1;1
252856962895;252856962915;20;0,1,2,3,5;5;2,9;2;1;1
252856962915;252856962956;41;0,1,2,3,5;5;2,9;2;1;1
252856962956;252856963135;179;0,1,2,3,5;5;2,9;2;1;1
252856963135;252856963445;310;0,1,2,3,5;5;2,9;2;1;1
252856963445;252856963675;230;0,1,2,3,5;5;2,9;2;1;1
252856963675;252856963708;33;0,1,2,3,5;5;2,9;2;1;1
252856963708;252856963728;20;0,1,2,3,5;5;2,9;2;1;1
252856963728;252856963752;24;0,1,2,3,5;5;2,9;2;1;1
252856963752;252856963767;15;0,1,2,3,5;5;2,9;2;1;1
252856963767;252856963800;33;0,1,2,3,5;5;2,9;2;1;1
252856963800;252856963820;20;0,1,2,3,5;5;2,9;2;1;1
252856963820;252856963828;8;0,1,2,3,5;5;2,9;2;1;1
252856963828;252856964012;184;0,1,2,3,5;5;2,9;2;1;1
252856964012;252856964022;10;0,1,2,3,5;5;2,9;2;1;1
252856964022;252856964054;32;0,1,2,3,5;5;2,9;2;1;1
252856964054;252856964085;31;0,1,2,3,5;5;2,9;2;1;1
252856964085;252856964104;19;0,1,2,3,5;5;2,9;2;1;1
252856964104;252856964112;8;0,1,2,3,5;5;2,9;2;1;1
252856964112;252856964117;5;0,1,2,3,5;5;2,9;2;1;1
252856964117;252856964125;8;0,1,2,3,5;5;2,9;2;1;1
252856964125;252856964152;27;0,1,2,3,5;5;2,9;2;1;1
252856964152;252856964167;15;0,1,2,3,5;5;2,9;2;1;1
252856964167;252856964202;35;0,1,2,3,5;5;2,9;2;1;1
252856964202;252856964225;23;0,1,2,3,5;5;2,9;2;1;1
252856964225;252856964228;3;0,1,2,3,5;5;2,9;2;1;1
252856964228;252856964230;2;0,1,2,3,5;5;2,9;2;1;1
252856964230;252856964254;24;0,1,2,3,5;5;2,9;2;1;1
252856964254;252856964283;29;0,1,2,3,5;5;2,9;2;1;1
252856964283;252856964293;10;0,1,2,3,5;5;2,9;2;1;1
252856964293;252856964306;13;0,1,2,3,5;5;2,9;2;1;1
252856964306;252856964312;6;0,1,2,3,5;5;2,9;2;1;1
252856964312;252856964314;2;0,1,2,3,5;5;2,9;2;1;1
252856964314;252856964348;34;0,1,2,3,5;5;2,9;2;1;1
252856964348;252856964365;17;0,1,2,3,5;5;2,9;2;1;1
252856964365;252856964367;2;0,1,2,3,5;5;2,9;2;1;1
252856964367;252856964375;8;0,1,2,3,5;5;2,9;2;1;1
252856964375;252856964395;20;0,1,2,3,5;5;2,9;2;1;1
252856964395;252856964403;8;0,1,2,3,5;5;2,9;2;1;1
252856964403;252856964415;12;0,1,2,3,5;5;2,9;2;1;1
252856964415;252856964418;3;0,1,2,3,5;5;2,9;2;1;1
252856964418;252856964430;12;0,1,2,3,5;5;2,9;2;1;1
252856964430;252856964437;7;0,1,2,3,5;5;2,9;2;1;1
252856964437;252856964455;18;0,1,2,3,5;5;2,9;2;1;1
252856964455;252856964460;5;0,1,2,3,5;5;2,9;2;1;1
252856964460;252856964461;1;0,1,2,3,5;5;2,9;2;1;1
252856964461;252856964464;3;0,1,2,3,5;5;2,9;2;1;1
252856964464;252856964471;7;0,1,2,3,5;5;2,9;2;1;1
252856964471;252856964485;14;0,1,2,3,5;5;2,9;2;1;1
252856964485;252856964495;10;0,1,2,3,5;5;2,9;2;1;1
252856964495;252856964504;9;0,1,2,3,5;5;2,9;2;1;1
252856964504;252856964505;1;0,1,2,3,5;5;2,9;2;1;1
252856964505;252856964514;9;0,1,2,3,5;5;2,9;2;1;1
252856964514;252856964528;14;0,1,2,3,5;5;2,9;2;1;1
252856964528;252856964530;2;0,1,2,3,5;5;2,9;2;1;1
252856964530;252856964555;25;0,1,2,3,5;5;2,9;2;1;1
252856964555;252856964560;5;0,1,2,3,5;5;2,9;2;1;1
252856964560;252856964567;7;0,1,2,3,5;5;2,9;2;1;1
252856964567;252856964645;78;0,1,2,3,5;5;2,9;2;1;1
252856964645;252856964648;3;0,1,2,3,5;5;2,9;2;1;1
252856964648;252856964662;14;0,1,2,3,5;5;2,9;2;1;1
252856964662;252856964666;4;0,1,2,3,5;5;2,9;2;1;1
252856964666;252856964689;23;0,1,2,3,5;5;2,9;2;1;1
252856964689;252856964710;21;0,1,2,3,5;5;2,9;2;1;1
252856964710;252856964725;15;0,1,2,3,5;5;2,9;2;1;1
252856964725;252856964731;6;0,1,2,3,5;5;2,9;2;1;1
252856964731;252856964763;32;0,1,2,3,5;5;2,9;2;1;1
252856964763;252856964777;14;0,1,2,3,5;5;2,9;2;1;1
252856964777;252856964780;3;0,1,2,3,5;5;2,9;2;1;1
252856964780;252856964794;14;0,1,2,3,5;5;2,9;2;1;1
252856964794;252856964800;6;0,1,2,3,5;5;2,9;2;1;1
252856964800;252856964802;2;0,1,2,3,5;5;2,9;2;1;1
252856964802;252856964813;11;0,1,2,3,5;5;2,9;2;1;1
252856964813;252856964825;12;0,1,2,3,5;5;2,9;2;1;1
252856964825;252856964830;5;0,1,2,3,5;5;2,9;2;1;1
252856964830;252856964839;9;0,1,2,3,5;5;2,9;2;1;1
252856964839;252856964867;28;0,1,2,3,5;5;2,9;2;1;1
252856964867;252856964891;24;0,1,2,3,5;5;2,9;2;1;1
252856964891;252856964906;15;0,1,2,3,5;5;2,9;2;1;1
252856964906;252856964924;18;0,1,2,3,5;5;2,9;2;1;1
252856964924;252856964926;2;0,1,2,3,5;5;2,9;2;1;1
252856964926;252856964966;40;0,1,2,3,5;5;2,9;2;1;1
252856964966;252856964971;5;0,1,2,3,5;5;2,9;2;1;1
252856964971;252856964986;15;0,1,2,3,5;5;2,9;2;1;1
252856964986;252856964988;2;0,1,2,3,5;5;2,9;2;1;1
252856964988;252856964989;1;0,1,2,3,5;5;2,9;2;1;1
252856964989;252856964992;3;0,1,2,3,5;5;2,9;2;1;1
252856964992;252856965008;16;0,1,2,3,5;5;2,9;2;1;1
252856965008;252856965009;1;0,1,2,3,5;5;2,9;2;1;1
252856965009;252856965016;7;0,1,2,3,5;5;2,9;2;1;1
252856965016;252856965020;4;0,1,2,3,5;5;2,9;2;1;1
252856965020;252856965025;5;0,1,2,3,5;5;2,9;2;1;1
252856965025;252856965039;14;0,1,2,3,5;5;2,9;2;1;1
252856965039;252856965042;3;0,1,2,3,5;5;2,9;2;1;1
252856965042;252856965050;8;0,1,2,3,5;5;2,9;2;1;1
252856965050;252856965059;9;0,1,2,3,5;5;2,9;2;1;1
252856965059;252856965061;2;0,1,2,3,5;5;2,9;2;1;1
252856965061;252856965075;14;0,1,2,3,5;5;2,9;2;1;1
252856965075;252856965091;16;0,1,2,3,5;5;2,9;2;1;1
252856965091;252856965101;10;0,1,2,3,5;5;2,9;2;1;1
252856965101;252856965112;11;0,1,2,3,5;5;2,9;2;1;1
252856965112;252856965113;1;0,1,2,3,5;5;2,9;2;1;1
252856965113;252856965133;20;0,1,2,3,5;5;2,9;2;1;1
252856965133;252856965137;4;0,1,2,3,5;5;2,9;2;1;1
252856965137;252856965142;5;0,1,2,3,5;5;2,9;2;1;1
252856965142;252856965156;14;0,1,2,3,5;5;2,9;2;1;1
252856965156;252856965165;9;0,1,2,3,5;5;2,9;2;1;1
252856965165;252856965168;3;0,1,2,3,5;5;2,9;2;1;1
252856965168;252856965174;6;0,1,2,3,5;5;2,9;2;1;1
252856965174;252856965202;28;0,1,2,3,5;5;2,9;2;1;1
252856965202;252856965216;14;0,1,2,3,5;5;2,9;2;1;1
252856965216;252856965223;7;0,1,2,3,5;5;2,9;2;1;1
252856965223;252856965226;3;0,1,2,3,5;5;2,9;2;1;1
252856965226;252856965242;16;0,1,2,3,5;5;2,9;2;1;1
252856965242;252856965260;18;0,1,2,3,5;5;2,9;2;1;1
252856965260;252856965267;7;0,1,2,3,5;5;2,9;2;1;1
252856965267;252856965283;16;0,1,2,3,5;5;2,9;2;1;1
252856965283;252856965327;44;0,1,2,3,5;5;2,9;2;1;1
252856965327;252856965338;11;0,1,2,3,5;5;2,9;2;1;1
252856965338;252856965346;8;0,1,2,3,5;5;2,9;2;1;1
252856965346;252856965380;34;0,1,2,3,5;5;2,9;2;1;1
252856965380;252856965404;24;0,1,2,3,5;5;2,9;2;1;1
252856965404;252856965428;24;0,1,2,3,5;5;2,9;2;1;1
252856965428;252856965433;5;0,1,2,3,5;5;2,9;2;1;1
252856965433;252856965436;3;0,1,2,3,5;5;2,9;2;1;1
252856965436;252856965457;21;0,1,2,3,5;5;2,9;2;1;1
252856965457;252856965462;5;0,1,2,3,5;5;2,9;2;1;1
252856965462;252856965464;2;0,1,2,3,5;5;2,9;2;1;1
252856965464;252856965483;19;0,1,2,3,5;5;2,9;2;1;1
252856965483;252856965492;9;0,1,2,3,5;5;2,9;2;1;1
252856965492;252856965539;47;0,1,2,3,5;5;2,9;2;1;1
252856965539;252856965541;2;0,1,2,3,5;5;2,9;2;1;1
252856965541;252856965547;6;0,1,2,3,5;5;2,9;2;1;1
252856965547;252856965556;9;0,1,2,3,5;5;2,9;2;1;1
252856965556;252856965563;7;0,1,2,3,5;5;2,9;2;1;1
252856965563;252856965576;13;0,1,2,3,5;5;2,9;2;1;1
252856965576;252856965581;5;0,1,2,3,5;5;2,9;2;1;1
252856965581;252856965595;14;0,1,2,3,5;5;2,9;2;1;1
252856965595;252856965602;7;0,1,2,3,5;5;2,9;2;1;1
252856965602;252856965608;6;0,1,2,3,5;5;2,9;2;1;1
252856965608;252856965619;11;0,1,2,3,5;5;2,9;2;1;1
252856965619;252856965628;9;0,1,2,3,5;5;2,9;2;1;1
252856965628;252856965629;1;0,1,2,3,5;5;2,9;2;1;1
252856965629;252856965644;15;0,1,2,3,5;5;2,9;2;1;1
252856965644;252856965645;1;0,1,2,3,5;5;2,9;2;1;1
252856965645;252856965651;6;0,1,2,3,5;5;2,9;2;1;1
252856965651;252856965660;9;0,1,2,3,5;5;2,9;2;1;1
252856965660;252856965663;3;0,1,2,3,5;5;2,9;2;1;1
252856965663;252856965681;18;0,1,2,3,5;5;2,9;2;1;1
252856965681;252856965692;11;0,1,2,3,5;5;2,9;2;1;1
252856965692;252856965696;4;0,1,2,3,5;5;2,9;2;1;1
252856965696;252856965697;1;0,1,2,3,5;5;2,9;2;1;1
252856965697;252856965700;3;0,1,2,3,5;5;2,9;2;1;1
252856965700;252856965705;5;0,1,2,3,5;5;2,9;2;1;1
252856965705;252856965724;19;0,1,2,3,5;5;2,9;2;1;1
252856965724;252856965732;8;0,1,2,3,5;5;2,9;2;1;1
252856965732;252856965733;1;0,1,2,3,5;5;2,9;2;1;1
252856965733;252856965757;24;0,1,2,3,5;5;2,9;2;1;1
252856965757;252856965765;8;0,1,2,3,5;5;2,9;2;1;1
252856965765;252856965788;23;0,1,2,3,5;5;2,9;2;1;1
252856965788;252856965801;13;0,1,2,3,5;5;2,9;2;1;1
252856965801;252856965814;13;0,1,2,3,5;5;2,9;2;1;1
252856965814;252856965827;13;0,1,2,3,5;5;2,9;2;1;1
252856965827;252856965852;25;0,1,2,3,5;5;2,9;2;1;1
252856965852;252856965869;17;0,1,2,3,5;5;2,9;2;1;1
252856965869;252856965870;1;0,1,2,3,5;5;2,9;2;1;1
252856965870;252856965874;4;0,1,2,3,5;5;2,9;2;1;1
252856965874;252856965880;6;0,1,2,3,5;5;2,9;2;1;1
252856965880;252856965882;2;0,1,2,3,5;5;2,9;2;1;1
252856965882;252856965890;8;0,1,2,3,5;5;2,9;2;1;1
252856965890;252856965908;18;0,1,2,3,5;5;2,9;2;1;1
252856965908;252856965910;2;0,1,2,3,5;5;2,9;2;1;1
252856965910;252856965916;6;0,1,2,3,5;5;2,9;2;1;1
252856965916;252856965925;9;0,1,2,3,5;5;2,9;2;1;1
252856965925;252856965933;8;0,1,2,3,5;5;2,9;2;1;1
252856965933;252856965946;13;0,1,2,3,5;5;2,9;2;1;1
252856965946;252856965964;18;0,1,2,3,5;5;2,9;2;1;1
252856965964;252856965985;21;0,1,2,3,5;5;2,9;2;1;1
252856965985;252856965986;1;0,1,2,3,5;5;2,9;2;1;1
252856965986;252856965987;1;0,1,2,3,5;5;2,9;2;1;1
252856965987;252856965995;8;0,1,2,3,5;5;2,9;2;1;1
252856965995;252856965999;4;0,1,2,3,5;5;2,9;2;1;1
252856965999;252856966006;7;0,1,2,3,5;5;2,9;2;1;1
252856966006;252856966009;3;0,1,2,3,5;5;2,9;2;1;1
252856966009;252856966017;8;0,1,2,3,5;5;2,9;2;1;1
252856966017;252856966022;5;0,1,2,3,5;5;2,9;2;1;1
252856966022;252856966028;6;0,1,2,3,5;5;2,9;2;1;1
252856966028;252856966032;4;0,1,2,3,5;5;2,9;2;1;1
252856966032;252856966036;4;0,1,2,3,5;5;2,9;2;1;1
252856966036;252856966051;15;0,1,2,3,5;5;2,9;2;1;1
252856966051;252856966058;7;0,1,2,3,5;5;2,9;2;1;1
252856966058;252856966068;10;0,1,2,3,5;5;2,9;2;1;1
252856966068;252856966096;28;0,1,2,3,5;5;2,9;2;1;1
252856966096;252856966142;46;0,1,2,3,5;5;2,9;2;1;1
252856966142;252856966149;7;0,1,2,3,5;5;2,9;2;1;1
252856966149;252856966152;3;0,1,2,3,5;5;2,9;2;1;1
252856966152;252856966155;3;0,1,2,3,5;5;2,9;2;1;1
252856966155;252856966156;1;0,1,2,3,5;5;2,9;2;1;1
252856966156;252856966164;8;0,1,2,3,5;5;2,9;2;1;1
252856966164;252856966166;2;0,1,2,3,5;5;2,9;2;1;1
252856966166;252856966209;43;0,1,2,3,5;5;2,9;2;1;1
252856966209;252856966214;5;0,1,2,3,5;5;2,9;2;1;1
252856966214;252856966233;19;0,1,2,3,5;5;2,9;2;1;1
252856966233;252856966240;7;0,1,2,3,5;5;2,9;2;1;1
252856966240;252856966249;9;0,1,2,3,5;5;2,9;2;1;1
252856966249;252856966290;41;0,1,2,3,5;5;2,9;2;1;1
252856966290;252856966292;2;0,1,2,3,5;5;2,9;2;1;1
252856966292;252856966306;14;0,1,2,3,5;5;2,9;2;1;1
252856966306;252856966310;4;0,1,2,3,5;5;2,9;2;1;1
252856966310;252856966317;7;0,1,2,3,5;5;2,9;2;1;1
252856966317;252856966332;15;0,1,2,3,5;5;2,9;2;1;1
252856966332;252856966357;25;0,1,2,3,5;5;2,9;2;1;1
252856966357;252856966359;2;0,1,2,3,5;5;2,9;2;1;1
252856966359;252856966386;27;0,1,2,3,5;5;2,9;2;1;1
252856966386;252856966390;4;0,1,2,3,5;5;2,9;2;1;1
252856966390;252856966421;31;0,1,2,3,5;5;2,9;2;1;1
252856966421;252856966426;5;0,1,2,3,5;5;2,9;2;1;1
252856966426;252856966432;6;0,1,2,3,5;5;2,9;2;1;1
252856966432;252856966442;10;0,1,2,3,5;5;2,9;2;1;1
252856966442;252856966455;13;0,1,2,3,5;5;2,9;2;1;1
252856966455;252856966467;12;0,1,2,3,5;5;2,9;2;1;1
252856966467;252856966476;9;0,1,2,3,5;5;2,9;2;1;1
252856966476;252856966495;19;0,1,2,3,5;5;2,9;2;1;1
252856966495;252856966500;5;0,1,2,3,5;5;2,9;2;1;1
252856966500;252856966501;1;0,1,2,3,5;5;2,9;2;1;1
252856966501;252856966506;5;0,1,2,3,5;5;2,9;2;1;1
252856966506;252856966526;20;0,1,2,3,5;5;2,9;2;1;1
252856966526;252856966532;6;0,1,2,3,5;5;2,9;2;1;1
252856966532;252856966539;7;0,1,2,3,5;5;2,9;2;1;1
252856966539;252856966546;7;0,1,2,3,5;5;2,9;2;1;1
252856966546;252856966568;22;0,1,2,3,5;5;2,9;2;1;1
252856966568;252856966604;36;0,1,2,3,5;5;2,9;2;1;1
252856966604;252856966612;8;0,1,2,3,5;5;2,9;2;1;1
252856966612;252856966624;12;0,1,2,3,5;5;2,9;2;1;1
252856966624;252856966635;11;0,1,2,3,5;5;2,9;2;1;1
252856966635;252856966643;8;0,1,2,3,5;5;2,9;2;1;1
252856966643;252856966660;17;0,1,2,3,5;5;2,9;2;1;1
252856966660;252856966663;3;0,1,2,3,5;5;2,9;2;1;1
252856966663;252856966665;2;0,1,2,3,5;5;2,9;2;1;1
252856966665;252856966683;18;0,1,2,3,5;5;2,9;2;1;1
252856966683;252856966689;6;0,1,2,3,5;5;2,9;2;1;1
252856966689;252856966709;20;0,1,2,3,5;5;2,9;2;1;1
252856966709;252856966715;6;0,1,2,3,5;5;2,9;2;1;1
252856966715;252856966722;7;0,1,2,3,5;5;2,9;2;1;1
252856966722;252856966728;6;0,1,2,3,5;5;2,9;2;1;1
252856966728;252856966734;6;0,1,2,3,5;5;2,9;2;1;1
252856966734;252856966755;21;0,1,2,3,5;5;2,9;2;1;1
252856966755;252856966764;9;0,1,2,3,5;5;2,9;2;1;1
252856966764;252856966774;10;0,1,2,3,5;5;2,9;2;1;1
252856966774;252856966779;5;0,1,2,3,5;5;2,9;2;1;1
252856966779;252856966796;17;0,1,2,3,5;5;2,9;2;1;1
252856966796;252856966818;22;0,1,2,3,5;5;2,9;2;1;1
252856966818;252856966825;7;0,1,2,3,5;5;2,9;2;1;1
252856966825;252856966837;12;0,1,2,3,5;5;2,9;2;1;1
252856966837;252856966842;5;0,1,2,3,5;5;2,9;2;1;1
252856966842;252856966861;19;0,1,2,3,5;5;2,9;2;1;1
252856966861;252856966863;2;0,1,2,3,5;5;2,9;2;1;1
252856966863;252856966867;4;0,1,2,3,5;5;2,9;2;1;1
252856966867;252856966872;5;0,1,2,3,5;5;2,9;2;1;1
252856966872;252856966882;10;0,1,2,3,5;5;2,9;2;1;1
252856966882;252856966884;2;0,1,2,3,5;5;2,9;2;1;1
252856966884;252856966893;9;0,1,2,3,5;5;2,9;2;1;1
252856966893;252856966906;13;0,1,2,3,5;5;2,9;2;1;1
252856966906;252856966912;6;0,1,2,3,5;5;2,9;2;1;1
252856966912;252856966916;4;0,1,2,3,5;5;2,9;2;1;1
252856966916;252856966933;17;0,1,2,3,5;5;2,9;2;1;1
252856966933;252856966935;2;0,1,2,3,5;5;2,9;2;1;1
252856966935;252856966944;9;0,1,2,3,5;5;2,9;2;1;1
252856966944;252856966963;19;0,1,2,3,5;5;2,9;2;1;1
252856966963;252856966969;6;0,1,2,3,5;5;2,9;2;1;1
252856966969;252856966974;5;0,1,2,3,5;5;2,9;2;1;1
252856966974;252856967003;29;0,1,2,3,5;5;2,9;2;1;1
252856967003;252856967004;1;0,1,2,3,5;5;2,9;2;1;1
252856967004;252856967005;1;0,1,2,3,5;5;2,9;2;1;1
252856967005;252856967023;18;0,1,2,3,5;5;2,9;2;1;1
252856967023;252856967025;2;0,1,2,3,5;5;2,9;2;1;1
252856967025;252856967049;24;0,1,2,3,5;5;2,9;2;1;1
252856967049;252856967058;9;0,1,2,3,5;5;2,9;2;1;1
252856967058;252856967069;11;0,1,2,3,5;5;2,9;2;1;1
252856967069;252856967080;11;0,1,2,3,5;5;2,9;2;1;1
252856967080;252856967081;1;0,1,2,3,5;5;2,9;2;1;1
252856967081;252856967099;18;0,1,2,3,5;5;2,9;2;1;1
252856967099;252856967141;42;0,1,2,3,5;5;2,9;2;1;1
252856967141;252856967151;10;0,1,2,3,5;5;2,9;2;1;1
252856967151;252856967162;11;0,1,2,3,5;5;2,9;2;1;1
252856967162;252856967165;3;0,1,2,3,5;5;2,9;2;1;1
252856967165;252856967173;8;0,1,2,3,5;5;2,9;2;1;1
252856967173;252856967178;5;0,1,2,3,5;5;2,9;2;1;1
252856967178;252856967184;6;0,1,2,3,5;5;2,9;2;1;1
252856967184;252856967192;8;0,1,2,3,5;5;2,9;2;1;1
252856967192;252856967194;2;0,1,2,3,5;5;2,9;2;1;1
252856967194;252856967214;20;0,1,2,3,5;5;2,9;2;1;1
252856967214;252856967233;19;0,1,2,3,5;5;2,9;2;1;1
252856967233;252856967236;3;0,1,2,3,5;5;2,9;2;1;1
252856967236;252856967237;1;0,1,2,3,5;5;2,9;2;1;1
252856967237;252856967256;19;0,1,2,3,5;5;2,9;2;1;1
252856967256;252856967257;1;0,1,2,3,5;5;2,9;2;1;1
252856967257;252856967261;4;0,1,2,3,5;5;2,9;2;1;1
252856967261;252856967287;26;0,1,2,3,5;5;2,9;2;1;1
252856967287;252856967290;3;0,1,2,3,5;5;2,9;2;1;1
252856967290;252856967297;7;0,1,2,3,5;5;2,9;2;1;1
252856967297;252856967306;9;0,1,2,3,5;5;2,9;2;1;1
252856967306;252856967307;1;0,1,2,3,5;5;2,9;2;1;1
252856967307;252856967316;9;0,1,2,3,5;5;2,9;2;1;1
252856967316;252856967324;8;0,1,2,3,5;5;2,9;2;1;1
252856967324;252856967339;15;0,1,2,3,5;5;2,9;2;1;1
252856967339;252856967362;23;0,1,2,3,5;5;2,9;2;1;1
252856967362;252856967371;9;0,1,2,3,5;5;2,9;2;1;1
252856967371;252856967374;3;0,1,2,3,5;5;2,9;2;1;1
252856967374;252856967388;14;0,1,2,3,5;5;2,9;2;1;1
252856967388;252856967389;1;0,1,2,3,5;5;2,9;2;1;1
252856967389;252856967397;8;0,1,2,3,5;5;2,9;2;1;1
252856967397;252856967405;8;0,1,2,3,5;5;2,9;2;1;1
252856967405;252856967407;2;0,1,2,3,5;5;2,9;2;1;1
252856967407;252856967417;10;0,1,2,3,5;5;2,9;2;1;1
252856967417;252856967430;13;0,1,2,3,5;5;2,9;2;1;1
252856967430;252856967431;1;0,1,2,3,5;5;2,9;2;1;1
252856967431;252856967432;1;0,1,2,3,5;5;2,9;2;1;1
252856967432;252856967438;6;0,1,2,3,5;5;2,9;2;1;1
252856967438;252856967443;5;0,1,2,3,5;5;2,9;2;1;1
252856967443;252856967449;6;0,1,2,3,5;5;2,9;2;1;1
252856967449;252856967478;29;0,1,2,3,5;5;2,9;2;1;1
252856967478;252856967493;15;0,1,2,3,5;5;2,9;2;1;1
252856967493;252856967499;6;0,1,2,3,5;5;2,9;2;1;1
252856967499;252856967500;1;0,1,2,3,5;5;2,9;2;1;1
252856967500;252856967514;14;0,1,2,3,5;5;2,9;2;1;1
252856967514;252856967532;18;0,1,2,3,5;5;2,9;2;1;1
252856967532;252856967545;13;0,1,2,3,5;5;2,9;2;1;1
252856967545;252856967579;34;0,1,2,3,5;5;2,9;2;1;1
252856967579;252856967585;6;0,1,2,3,5;5;2,9;2;1;1
252856967585;252856967600;15;0,1,2,3,5;5;2,9;2;1;1
252856967600;252856967609;9;0,1,2,3,5;5;2,9;2;1;1
252856967609;252856967616;7;0,1,2,3,5;5;2,9;2;1;1
252856967616;252856967633;17;0,1,2,3,5;5;2,9;2;1;1
252856967633;252856967635;2;0,1,2,3,5;5;2,9;2;1;1
252856967635;252856967637;2;0,1,2,3,5;5;2,9;2;1;1
252856967637;252856967644;7;0,1,2,3,5;5;2,9;2;1;1
252856967644;252856967662;18;0,1,2,3,5;5;2,9;2;1;1
252856967662;252856967665;3;0,1,2,3,5;5;2,9;2;1;1
252856967665;252856967670;5;0,1,2,3,5;5;2,9;2;1;1
252856967670;252856967684;14;0,1,2,3,5;5;2,9;2;1;1
252856967684;252856967709;25;0,1,2,3,5;5;2,9;2;1;1
252856967709;252856967724;15;0,1,2,3,5;5;2,9;2;1;1
252856967724;252856967733;9;0,1,2,3,5;5;2,9;2;1;1
252856967733;252856967757;24;0,1,2,3,5;5;2,9;2;1;1
252856967757;252856967763;6;0,1,2,3,5;5;2,9;2;1;1
252856967763;252856967776;13;0,1,2,3,5;5;2,9;2;1;1
252856967776;252856967783;7;0,1,2,3,5;5;2,9;2;1;1
252856967783;252856967807;24;0,1,2,3,5;5;2,9;2;1;1
252856967807;252856967822;15;0,1,2,3,5;5;2,9;2;1;1
252856967822;252856967825;3;0,1,2,3,5;5;2,9;2;1;1
252856967825;252856967826;1;0,1,2,3,5;5;2,9;2;1;1
252856967826;252856967827;1;0,1,2,3,5;5;2,9;2;1;1
252856967827;252856967851;24;0,1,2,3,5;5;2,9;2;1;1
252856967851;252856967852;1;0,1,2,3,5;5;2,9;2;1;1
252856967852;252856967861;9;0,1,2,3,5;5;2,9;2;1;1
252856967861;252856967867;6;0,1,2,3,5;5;2,9;2;1;1
252856967867;252856967873;6;0,1,2,3,5;5;2,9;2;1;1
252856967873;252856967888;15;0,1,2,3,5;5;2,9;2;1;1
252856967888;252856967895;7;0,1,2,3,5;5;2,9;2;1;1
252856967895;252856967905;10;0,1,2,3,5;5;2,9;2;1;1
252856967905;252856967923;18;0,1,2,3,5;5;2,9;2;1;1
252856967923;252856967930;7;0,1,2,3,5;5;2,9;2;1;1
252856967930;252856967932;2;0,1,2,3,5;5;2,9;2;1;1
252856967932;252856967938;6;0,1,2,3,5;5;2,9;2;1;1
252856967938;252856967959;21;0,1,2,3,5;5;2,9;2;1;1
252856967959;252856967985;26;0,1,2,3,5;5;2,9;2;1;1
252856967985;252856967990;5;0,1,2,3,5;5;2,9;2;1;1
252856967990;252856967995;5;0,1,2,3,5;5;2,9;2;1;1
252856967995;252856968003;8;0,1,2,3,5;5;2,9;2;1;1
252856968003;252856968005;2;0,1,2,3,5;5;2,9;2;1;1
252856968005;252856968006;1;0,1,2,3,5;5;2,9;2;1;1
252856968006;252856968029;23;0,1,2,3,5;5;2,9;2;1;1
252856968029;252856968032;3;0,1,2,3,5;5;2,9;2;1;1
252856968032;252856968035;3;0,1,2,3,5;5;2,9;2;1;1
252856968035;252856968037;2;0,1,2,3,5;5;2,9;2;1;1
252856968037;252856968057;20;0,1,2,3,5;5;2,9;2;1;1
252856968057;252856968067;10;0,1,2,3,5;5;2,9;2;1;1
252856968067;252856968068;1;0,1,2,3,5;5;2,9;2;1;1
252856968068;252856968090;22;0,1,2,3,5;5;2,9;2;1;1
252856968090;252856968098;8;0,1,2,3,5;5;2,9;2;1;1
252856968098;252856968128;30;0,1,2,3,5;5;2,9;2;1;1
252856968128;252856968151;23;0,1,2,3,5;5;2,9;2;1;1
252856968151;252856968175;24;0,1,2,3,5;5;2,9;2;1;1
252856968175;252856968186;11;0,1,2,3,5;5;2,9;2;1;1
252856968186;252856968204;18;0,1,2,3,5;5;2,9;2;1;1
252856968204;252856968209;5;0,1,2,3,5;5;2,9;2;1;1
252856968209;252856968234;25;0,1,2,3,5;5;2,9;2;1;1
252856968234;252856968242;8;0,1,2,3,5;5;2,9;2;1;1
252856968242;252856968287;45;0,1,2,3,5;5;2,9;2;1;1
252856968287;252856968289;2;0,1,2,3,5;5;2,9;2;1;1
252856968289;252856968290;1;0,1,2,3,5;5;2,9;2;1;1
252856968290;252856968299;9;0,1,2,3,5;5;2,9;2;1;1
252856968299;252856968307;8;0,1,2,3,5;5;2,9;2;1;1
252856968307;252856968328;21;0,1,2,3,5;5;2,9;2;1;1
252856968328;252856968331;3;0,1,2,3,5;5;2,9;2;1;1
252856968331;252856968334;3;0,1,2,3,5;5;2,9;2;1;1
252856968334;252856968337;3;0,1,2,3,5;5;2,9;2;1;1
252856968337;252856968340;3;0,1,2,3,5;5;2,9;2;1;1
252856968340;252856968359;19;0,1,2,3,5;5;2,9;2;1;1
252856968359;252856968361;2;0,1,2,3,5;5;2,9;2;1;1
252856968361;252856968365;4;0,1,2,3,5;5;2,9;2;1;1
252856968365;252856968366;1;0,1,2,3,5;5;2,9;2;1;1
252856968366;252856968370;4;0,1,2,3,5;5;2,9;2;1;1
252856968370;252856968373;3;0,1,2,3,5;5;2,9;2;1;1
252856968373;252856968374;1;0,1,2,3,5;5;2,9;2;1;1
252856968374;252856968384;10;0,1,2,3,5;5;2,9;2;1;1
252856968384;252856968386;2;0,1,2,3,5;5;2,9;2;1;1
252856968386;252856968392;6;0,1,2,3,5;5;2,9;2;1;1
252856968392;252856968393;1;0,1,2,3,5;5;2,9;2;1;1
252856968393;252856968402;9;0,1,2,3,5;5;2,9;2;1;1
252856968402;252856968410;8;0,1,2,3,5;5;2,9;2;1;1
252856968410;252856968414;4;0,1,2,3,5;5;2,9;2;1;1
252856968414;252856968420;6;0,1,2,3,5;5;2,9;2;1;1
252856968420;252856968421;1;0,1,2,3,5;5;2,9;2;1;1
252856968421;252856968429;8;0,1,2,3,5;5;2,9;2;1;1
252856968429;252856968444;15;0,1,2,3,5;5;2,9;2;1;1
252856968444;252856968454;10;0,1,2,3,5;5;2,9;2;1;1
252856968454;252856968459;5;0,1,2,3,5;5;2,9;2;1;1
252856968459;252856968465;6;0,1,2,3,5;5;2,9;2;1;1
252856968465;252856968467;2;0,1,2,3,5;5;2,9;2;1;1
252856968467;252856968470;3;0,1,2,3,5;5;2,9;2;1;1
252856968470;252856968475;5;0,1,2,3,5;5;2,9;2;1;1
252856968475;252856968478;3;0,1,2,3,5;5;2,9;2;1;1
252856968478;252856968493;15;0,1,2,3,5;5;2,9;2;1;1
252856968493;252856968497;4;0,1,2,3,5;5;2,9;2;1;1
252856968497;252856968506;9;0,1,2,3,5;5;2,9;2;1;1
252856968506;252856968508;2;0,1,2,3,5;5;2,9;2;1;1
252856968508;252856968513;5;0,1,2,3,5;5;2,9;2;1;1
252856968513;252856968518;5;0,1,2,3,5;5;2,9;2;1;1
252856968518;252856968534;16;0,1,2,3,5;5;2,9;2;1;1
252856968534;252856968550;16;0,1,2,3,5;5;2,9;2;1;1
252856968550;252856968553;3;0,1,2,3,5;5;2,9;2;1;1
252856968553;252856968555;2;0,1,2,3,5;5;2,9;2;1;1
252856968555;252856968558;3;0,1,2,3,5;5;2,9;2;1;1
252856968558;252856968569;11;0,1,2,3,5;5;2,9;2;1;1
252856968569;252856968571;2;0,1,2,3,5;5;2,9;2;1;1
252856968571;252856968578;7;0,1,2,3,5;5;2,9;2;1;1
252856968578;252856968591;13;0,1,2,3,5;5;2,9;2;1;1
252856968591;252856968599;8;0,1,2,3,5;5;2,9;2;1;1
252856968599;252856968601;2;0,1,2,3,5;5;2,9;2;1;1
252856968601;252856968602;1;0,1,2,3,5;5;2,9;2;1;1
252856968602;252856968612;10;0,1,2,3,5;5;2,9;2;1;1
252856968612;252856968617;5;0,1,2,3,5;5;2,9;2;1;1
252856968617;252856968618;1;0,1,2,3,5;5;2,9;2;1;1
252856968618;252856968623;5;0,1,2,3,5;5;2,9;2;1;1
252856968623;252856968631;8;0,1,2,3,5;5;2,9;2;1;1
252856968631;252856968634;3;0,1,2,3,5;5;2,9;2;1;1
252856968634;252856968648;14;0,1,2,3,5;5;2,9;2;1;1
252856968648;252856968650;2;0,1,2,3,5;5;2,9;2;1;1
252856968650;252856968654;4;0,1,2,3,5;5;2,9;2;1;1
252856968654;252856968658;4;0,1,2,3,5;5;2,9;2;1;1
252856968658;252856968660;2;0,1,2,3,5;5;2,9;2;1;1
252856968660;252856968664;4;0,1,2,3,5;5;2,9;2;1;1
252856968664;252856968669;5;0,1,2,3,5;5;2,9;2;1;1
252856968669;252856968673;4;0,1,2,3,5;5;2,9;2;1;1
252856968673;252856968678;5;0,1,2,3,5;5;2,9;2;1;1
252856968678;252856968686;8;0,1,2,3,5;5;2,9;2;1;1
252856968686;252856968688;2;0,1,2,3,5;5;2,9;2;1;1
252856968688;252856968691;3;0,1,2,3,5;5;2,9;2;1;1
252856968691;252856968698;7;0,1,2,3,5;5;2,9;2;1;1
252856968698;252856968699;1;0,1,2,3,5;5;2,9;2;1;1
252856968699;252856968705;6;0,1,2,3,5;5;2,9;2;1;1
252856968705;252856968715;10;0,1,2,3,5;5;2,9;2;1;1
252856968715;252856968716;1;0,1,2,3,5;5;2,9;2;1;1
252856968716;252856968718;2;0,1,2,3,5;5;2,9;2;1;1
252856968718;252856968724;6;0,1,2,3,5;5;2,9;2;1;1
252856968724;252856968725;1;0,1,2,3,5;5;2,9;2;1;1
252856968725;252856968745;20;0,1,2,3,5;5;2,9;2;1;1
252856968745;252856968748;3;0,1,2,3,5;5;2,9;2;1;1
252856968748;252856968753;5;0,1,2,3,5;5;2,9;2;1;1
252856968753;252856968755;2;0,1,2,3,5;5;2,9;2;1;1
252856968755;252856968760;5;0,1,2,3,5;5;2,9;2;1;1
252856968760;252856968762;2;0,1,2,3,5;5;2,9;2;1;1
252856968762;252856968770;8;0,1,2,3,5;5;2,9;2;1;1
252856968770;252856968773;3;0,1,2,3,5;5;2,9;2;1;1
252856968773;252856968782;9;0,1,2,3,5;5;2,9;2;1;1
252856968782;252856968783;1;0,1,2,3,5;5;2,9;2;1;1
252856968783;252856968789;6;0,1,2,3,5;5;2,9;2;1;1
252856968789;252856968802;13;0,1,2,3,5;5;2,9;2;1;1
252856968802;252856968803;1;0,1,2,3,5;5;2,9;2;1;1
252856968803;252856968808;5;0,1,2,3,5;5;2,9;2;1;1
252856968808;252856968813;5;0,1,2,3,5;5;2,9;2;1;1
252856968813;252856968816;3;0,1,2,3,5;5;2,9;2;1;1
252856968816;252856968817;1;0,1,2,3,5;5;2,9;2;1;1
252856968817;252856968822;5;0,1,2,3,5;5;2,9;2;1;1
252856968822;252856968829;7;0,1,2,3,5;5;2,9;2;1;1
252856968829;252856968833;4;0,1,2,3,5;5;2,9;2;1;1
252856968833;252856968836;3;0,1,2,3,5;5;2,9;2;1;1
252856968836;252856968837;1;0,1,2,3,5;5;2,9;2;1;1
252856968837;252856968849;12;0,1,2,3,5;5;2,9;2;1;1
252856968849;252856968867;18;0,1,2,3,5;5;2,9;2;1;1
252856968867;252856968873;6;0,1,2,3,5;5;2,9;2;1;1
252856968873;252856968880;7;0,1,2,3,5;5;2,9;2;1;1
252856968880;252856968883;3;0,1,2,3,5;5;2,9;2;1;1
252856968883;252856968902;19;0,1,2,3,5;5;2,9;2;1;1
252856968902;252856968903;1;0,1,2,3,5;5;2,9;2;1;1
252856968903;252856968905;2;0,1,2,3,5;5;2,9;2;1;1
252856968905;252856968916;11;0,1,2,3,5;5;2,9;2;1;1
252856968916;252856968925;9;0,1,2,3,5;5;2,9;2;1;1
252856968925;252856968931;6;0,1,2,3,5;5;2,9;2;1;1
252856968931;252856968935;4;0,1,2,3,5;5;2,9;2;1;1
252856968935;252856968954;19;0,1,2,3,5;5;2,9;2;1;1
252856968954;252856968961;7;0,1,2,3,5;5;2,9;2;1;1
252856968961;252856968962;1;0,1,2,3,5;5;2,9;2;1;1
252856968962;252856968972;10;0,1,2,3,5;5;2,9;2;1;1
252856968972;252856968973;1;0,1,2,3,5;5;2,9;2;1;1
252856968973;252856969000;27;0,1,2,3,5;5;2,9;2;1;1
252856969000;252856969008;8;0,1,2,3,5;5;2,9;2;1;1
252856969008;252856969010;2;0,1,2,3,5;5;2,9;2;1;1
252856969010;252856969023;13;0,1,2,3,5;5;2,9;2;1;1
252856969023;252856969025;2;0,1,2,3,5;5;2,9;2;1;1
252856969025;252856969051;26;0,1,2,3,5;5;2,9;2;1;1
252856969051;252856969070;19;0,1,2,3,5;5;2,9;2;1;1
252856969070;252856969081;11;0,1,2,3,5;5;2,9;2;1;1
252856969081;252856969084;3;0,1,2,3,5;5;2,9;2;1;1
252856969084;252856969100;16;0,1,2,3,5;5;2,9;2;1;1
252856969100;252856969106;6;0,1,2,3,5;5;2,9;2;1;1
252856969106;252856969125;19;0,1,2,3,5;5;2,9;2;1;1
252856969125;252856969130;5;0,1,2,3,5;5;2,9;2;1;1
252856969130;252856969165;35;0,1,2,3,5;5;2,9;2;1;1
252856969165;252856969173;8;0,1,2,3,5;5;2,9;2;1;1
252856969173;252856969174;1;0,1,2,3,5;5;2,9;2;1;1
252856969174;252856969176;2;0,1,2,3,5;5;2,9;2;1;1
252856969176;252856969183;7;0,1,2,3,5;5;2,9;2;1;1
252856969183;252856969197;14;0,1,2,3,5;5;2,9;2;1;1
252856969197;252856969215;18;0,1,2,3,5;5;2,9;2;1;1
252856969215;252856969218;3;0,1,2,3,5;5;2,9;2;1;1
252856969218;252856969221;3;0,1,2,3,5;5;2,9;2;1;1
252856969221;252856969245;24;0,1,2,3,5;5;2,9;2;1;1
252856969245;252856969254;9;0,1,2,3,5;5;2,9;2;1;1
252856969254;252856969257;3;0,1,2,3,5;5;2,9;2;1;1
252856969257;252856969258;1;0,1,2,3,5;5;2,9;2;1;1
252856969258;252856969263;5;0,1,2,3,5;5;2,9;2;1;1
252856969263;252856969266;3;0,1,2,3,5;5;2,9;2;1;1
252856969266;252856969270;4;0,1,2,3,5;5;2,9;2;1;1
252856969270;252856969275;5;0,1,2,3,5;5;2,9;2;1;1
252856969275;252856969279;4;0,1,2,3,5;5;2,9;2;1;1
252856969279;252856969288;9;0,1,2,3,5;5;2,9;2;1;1
252856969288;252856969291;3;0,1,2,3,5;5;2,9;2;1;1
252856969291;252856969302;11;0,1,2,3,5;5;2,9;2;1;1
252856969302;252856969310;8;0,1,2,3,5;5;2,9;2;1;1
252856969310;252856969324;14;0,1,2,3,5;5;2,9;2;1;1
252856969324;252856969334;10;0,1,2,3,5;5;2,9;2;1;1
252856969334;252856969376;42;0,1,2,3,5;5;2,9;2;1;1
252856969376;252856969387;11;0,1,2,3,5;5;2,9;2;1;1
252856969387;252856969391;4;0,1,2,3,5;5;2,9;2;1;1
252856969391;252856969392;1;0,1,2,3,5;5;2,9;2;1;1
252856969392;252856969408;16;0,1,2,3,5;5;2,9;2;1;1
252856969408;252856969410;2;0,1,2,3,5;5;2,9;2;1;1
252856969410;252856969427;17;0,1,2,3,5;5;2,9;2;1;1
252856969427;252856969451;24;0,1,2,3,5;5;2,9;2;1;1
252856969451;252856969463;12;0,1,2,3,5;5;2,9;2;1;1
252856969463;252856969480;17;0,1,2,3,5;5;2,9;2;1;1
252856969480;252856969525;45;0,1,2,3,5;5;2,9;2;1;1
252856969525;252856969536;11;0,1,2,3,5;5;2,9;2;1;1
252856969536;252856969539;3;0,1,2,3,5;5;2,9;2;1;1
252856969539;252856969551;12;0,1,2,3,5;5;2,9;2;1;1
252856969551;252856969554;3;0,1,2,3,5;5;2,9;2;1;1
252856969554;252856969572;18;0,1,2,3,5;5;2,9;2;1;1
252856969572;252856969588;16;0,1,2,3,5;5;2,9;2;1;1
252856969588;252856969592;4;0,1,2,3,5;5;2,9;2;1;1
252856969592;252856969596;4;0,1,2,3,5;5;2,9;2;1;1
252856969596;252856969629;33;0,1,2,3,5;5;2,9;2;1;1
252856969629;252856969654;25;0,1,2,3,5;5;2,9;2;1;1
252856969654;252856969658;4;0,1,2,3,5;5;2,9;2;1;1
252856969658;252856969676;18;0,1,2,3,5;5;2,9;2;1;1
252856969676;252856969687;11;0,1,2,3,5;5;2,9;2;1;1
252856969687;252856969694;7;0,1,2,3,5;5;2,9;2;1;1
252856969694;252856969724;30;0,1,2,3,5;5;2,9;2;1;1
252856969724;252856969740;16;0,1,2,3,5;5;2,9;2;1;1
252856969740;252856969757;17;0,1,2,3,5;5;2,9;2;1;1
252856969757;252856969758;1;0,1,2,3,5;5;2,9;2;1;1
252856969758;252856969791;33;0,1,2,3,5;5;2,9;2;1;1
252856969791;252856969798;7;0,1,2,3,5;5;2,9;2;1;1
252856969798;252856969829;31;0,1,2,3,5;5;2,9;2;1;1
252856969829;252856969830;1;0,1,2,3,5;5;2,9;2;1;1
252856969830;252856969846;16;0,1,2,3,5;5;2,9;2;1;1
252856969846;252856969854;8;0,1,2,3,5;5;2,9;2;1;1
252856969854;252856969869;15;0,1,2,3,5;5;2,9;2;1;1
252856969869;252856969909;40;0,1,2,3,5;5;2,9;2;1;1
252856969909;252856969917;8;0,1,2,3,5;5;2,9;2;1;1
252856969917;252856969919;2;0,1,2,3,5;5;2,9;2;1;1
252856969919;252856969940;21;0,1,2,3,5;5;2,9;2;1;1
252856969940;252856969942;2;0,1,2,3,5;5;2,9;2;1;1
252856969942;252856969950;8;0,1,2,3,5;5;2,9;2;1;1
252856969950;252856969951;1;0,1,2,3,5;5;2,9;2;1;1
252856969951;252856969990;39;0,1,2,3,5;5;2,9;2;1;1
252856969990;252856969998;8;0,1,2,3,5;5;2,9;2;1;1
252856969998;252856970000;2;0,1,2,3,5;5;2,9;2;1;1
252856970000;252856970005;5;0,1,2,3,5;5;2,9;2;1;1
252856970005;252856970008;3;0,1,2,3,5;5;2,9;2;1;1
252856970008;252856970009;1;0,1,2,3,5;5;2,9;2;1;1
252856970009;252856970039;30;0,1,2,3,5;5;2,9;2;1;1
252856970039;252856970044;5;0,1,2,3,5;5;2,9;2;1;1
252856970044;252856970048;4;0,1,2,3,5;5;2,9;2;1;1
252856970048;252856970076;28;0,1,2,3,5;5;2,9;2;1;1
252856970076;252856970088;12;0,1,2,3,5;5;2,9;2;1;1
252856970088;252856970100;12;0,1,2,3,5;5;2,9;2;1;1
252856970100;252856970149;49;0,1,2,3,5;5;2,9;2;1;1
252856970149;252856970158;9;0,1,2,3,5;5;2,9;2;1;1
252856970158;252856970178;20;0,1,2,3,5;5;2,9;2;1;1
252856970178;252856970199;21;0,1,2,3,5;5;2,9;2;1;1
252856970199;252856970202;3;0,1,2,3,5;5;2,9;2;1;1
252856970202;252856970204;2;0,1,2,3,5;5;2,9;2;1;1
252856970204;252856970205;1;0,1,2,3,5;5;2,9;2;1;1
252856970205;252856970229;24;0,1,2,3,5;5;2,9;2;1;1
252856970229;252856970251;22;0,1,2,3,5;5;2,9;2;1;1
252856970251;252856970270;19;0,1,2,3,5;5;2,9;2;1;1
252856970270;252856970279;9;0,1,2,3,5;5;2,9;2;1;1
252856970279;252856970295;16;0,1,2,3,5;5;2,9;2;1;1
252856970295;252856970299;4;0,1,2,3,5;5;2,9;2;1;1
252856970299;252856970304;5;0,1,2,3,5;5;2,9;2;1;1
252856970304;252856970306;2;0,1,2,3,5;5;2,9;2;1;1
252856970306;252856970317;11;0,1,2,3,5;5;2,9;2;1;1
252856970317;252856970332;15;0,1,2,3,5;5;2,9;2;1;1
252856970332;252856970342;10;0,1,2,3,5;5;2,9;2;1;1
252856970342;252856970366;24;0,1,2,3,5;5;2,9;2;1;1
252856970366;252856970368;2;0,1,2,3,5;5;2,9;2;1;1
252856970368;252856970376;8;0,1,2,3,5;5;2,9;2;1;1
252856970376;252856970380;4;0,1,2,3,5;5;2,9;2;1;1
252856970380;252856970392;12;0,1,2,3,5;5;2,9;2;1;1
252856970392;252856970394;2;0,1,2,3,5;5;2,9;2;1;1
252856970394;252856970418;24;0,1,2,3,5;5;2,9;2;1;1
252856970418;252856970419;1;0,1,2,3,5;5;2,9;2;1;1
252856970419;252856970423;4;0,1,2,3,5;5;2,9;2;1;1
252856970423;252856970428;5;0,1,2,3,5;5;2,9;2;1;1
252856970428;252856970446;18;0,1,2,3,5;5;2,9;2;1;1
252856970446;252856970447;1;0,1,2,3,5;5;2,9;2;1;1
252856970447;252856970453;6;0,1,2,3,5;5;2,9;2;1;1
252856970453;252856970464;11;0,1,2,3,5;5;2,9;2;1;1
252856970464;252856970475;11;0,1,2,3,5;5;2,9;2;1;1
252856970475;252856970477;2;0,1,2,3,5;5;2,9;2;1;1
252856970477;252856970489;12;0,1,2,3,5;5;2,9;2;1;1
252856970489;252856970495;6;0,1,2,3,5;5;2,9;2;1;1
252856970495;252856970496;1;0,1,2,3,5;5;2,9;2;1;1
252856970496;252856970514;18;0,1,2,3,5;5;2,9;2;1;1
252856970514;252856970533;19;0,1,2,3,5;5;2,9;2;1;1
252856970533;252856970541;8;0,1,2,3,5;5;2,9;2;1;1
252856970541;252856970559;18;0,1,2,3,5;5;2,9;2;1;1
252856970559;252856970572;13;0,1,2,3,5;5;2,9;2;1;1
252856970572;252856970585;13;0,1,2,3,5;5;2,9;2;1;1
252856970585;252856970593;8;0,1,2,3,5;5;2,9;2;1;1
252856970593;252856970594;1;0,1,2,3,5;5;2,9;2;1;1
252856970594;252856970600;6;0,1,2,3,5;5;2,9;2;1;1
252856970600;252856970601;1;0,1,2,3,5;5;2,9;2;1;1
252856970601;252856970603;2;0,1,2,3,5;5;2,9;2;1;1
252856970603;252856970616;13;0,1,2,3,5;5;2,9;2;1;1
252856970616;252856970617;1;0,1,2,3,5;5;2,9;2;1;1
252856970617;252856970631;14;0,1,2,3,5;5;2,9;2;1;1
252856970631;252856970633;2;0,1,2,3,5;5;2,9;2;1;1
252856970633;252856970643;10;0,1,2,3,5;5;2,9;2;1;1
252856970643;252856970652;9;0,1,2,3,5;5;2,9;2;1;1
252856970652;252856970654;2;0,1,2,3,5;5;2,9;2;1;1
252856970654;252856970656;2;0,1,2,3,5;5;2,9;2;1;1
252856970656;252856970679;23;0,1,2,3,5;5;2,9;2;1;1
252856970679;252856970686;7;0,1,2,3,5;5;2,9;2;1;1
252856970686;252856970701;15;0,1,2,3,5;5;2,9;2;1;1
252856970701;252856970708;7;0,1,2,3,5;5;2,9;2;1;1
252856970708;252856970709;1;0,1,2,3,5;5;2,9;2;1;1
252856970709;252856970710;1;0,1,2,3,5;5;2,9;2;1;1
252856970710;252856970711;1;0,1,2,3,5;5;2,9;2;1;1
252856970711;252856970725;14;0,1,2,3,5;5;2,9;2;1;1
252856970725;252856970735;10;0,1,2,3,5;5;2,9;2;1;1
252856970735;252856970738;3;0,1,2,3,5;5;2,9;2;1;1
252856970738;252856970740;2;0,1,2,3,5;5;2,9;2;1;1
252856970740;252856970746;6;0,1,2,3,5;5;2,9;2;1;1
252856970746;252856970749;3;0,1,2,3,5;5;2,9;2;1;1
252856970749;252856970765;16;0,1,2,3,5;5;2,9;2;1;1
252856970765;252856970767;2;0,1,2,3,5;5;2,9;2;1;1
252856970767;252856970770;3;0,1,2,3,5;5;2,9;2;1;1
252856970770;252856970804;34;0,1,2,3,5;5;2,9;2;1;1
252856970804;252856970814;10;0,1,2,3,5;5;2,9;2;1;1
252856970814;252856970815;1;0,1,2,3,5;5;2,9;2;1;1
252856970815;252856970816;1;0,1,2,3,5;5;2,9;2;1;1
252856970816;252856970843;27;0,1,2,3,5;5;2,9;2;1;1
252856970843;252856970856;13;0,1,2,3,5;5;2,9;2;1;1
252856970856;252856970869;13;0,1,2,3,5;5;2,9;2;1;1
252856970869;252856970898;29;0,1,2,3,5;5;2,9;2;1;1
252856970898;252856970900;2;0,1,2,3,5;5;2,9;2;1;1
252856970900;252856970911;11;0,1,2,3,5;5;2,9;2;1;1
252856970911;252856970912;1;0,1,2,3,5;5;2,9;2;1;1
252856970912;252856970916;4;0,1,2,3,5;5;2,9;2;1;1
252856970916;252856970932;16;0,1,2,3,5;5;2,9;2;1;1
252856970932;252856970940;8;0,1,2,3,5;5;2,9;2;1;1
252856970940;252856970965;25;0,1,2,3,5;5;2,9;2;1;1
252856970965;252856970974;9;0,1,2,3,5;5;2,9;2;1;1
252856970974;252856970985;11;0,1,2,3,5;5;2,9;2;1;1
252856970985;252856970992;7;0,1,2,3,5;5;2,9;2;1;1
252856970992;252856970998;6;0,1,2,3,5;5;2,9;2;1;1
252856970998;252856970999;1;0,1,2,3,5;5;2,9;2;1;1
252856970999;252856971013;14;0,1,2,3,5;5;2,9;2;1;1
252856971013;252856971017;4;0,1,2,3,5;5;2,9;2;1;1
252856971017;252856971019;2;0,1,2,3,5;5;2,9;2;1;1
252856971019;252856971035;16;0,1,2,3,5;5;2,9;2;1;1
252856971035;252856971042;7;0,1,2,3,5;5;2,9;2;1;1
252856971042;252856971057;15;0,1,2,3,5;5;2,9;2;1;1
252856971057;252856971083;26;0,1,2,3,5;5;2,9;2;1;1
252856971083;252856971103;20;0,1,2,3,5;5;2,9;2;1;1
252856971103;252856971106;3;0,1,2,3,5;5;2,9;2;1;1
252856971106;252856971110;4;0,1,2,3,5;5;2,9;2;1;1
252856971110;252856971133;23;0,1,2,3,5;5;2,9;2;1;1
252856971133;252856971135;2;0,1,2,3,5;5;2,9;2;1;1
252856971135;252856971138;3;0,1,2,3,5;5;2,9;2;1;1
252856971138;252856971153;15;0,1,2,3,5;5;2,9;2;1;1
252856971153;252856971168;15;0,1,2,3,5;5;2,9;2;1;1
252856971168;252856971171;3;0,1,2,3,5;5;2,9;2;1;1
252856971171;252856971173;2;0,1,2,3,5;5;2,9;2;1;1
252856971173;252856971174;1;0,1,2,3,5;5;2,9;2;1;1
252856971174;252856971189;15;0,1,2,3,5;5;2,9;2;1;1
252856971189;252856971192;3;0,1,2,3,5;5;2,9;2;1;1
252856971192;252856971200;8;0,1,2,3,5;5;2,9;2;1;1
252856971200;252856971202;2;0,1,2,3,5;5;2,9;2;1;1
252856971202;252856971222;20;0,1,2,3,5;5;2,9;2;1;1
252856971222;252856971231;9;0,1,2,3,5;5;2,9;2;1;1
252856971231;252856971237;6;0,1,2,3,5;5;2,9;2;1;1
252856971237;252856971256;19;0,1,2,3,5;5;2,9;2;1;1
252856971256;252856971286;30;0,1,2,3,5;5;2,9;2;1;1
252856971286;252856971299;13;0,1,2,3,5;5;2,9;2;1;1
252856971299;252856971308;9;0,1,2,3,5;5;2,9;2;1;1
252856971308;252856971309;1;0,1,2,3,5;5;2,9;2;1;1
252856971309;252856971313;4;0,1,2,3,5;5;2,9;2;1;1
252856971313;252856971316;3;0,1,2,3,5;5;2,9;2;1;1
252856971316;252856971327;11;0,1,2,3,5;5;2,9;2;1;1
252856971327;252856971332;5;0,1,2,3,5;5;2,9;2;1;1
252856971332;252856971339;7;0,1,2,3,5;5;2,9;2;1;1
252856971339;252856971348;9;0,1,2,3,5;5;2,9;2;1;1
252856971348;252856971352;4;0,1,2,3,5;5;2,9;2;1;1
252856971352;252856971354;2;0,1,2,3,5;5;2,9;2;1;1
252856971354;252856971372;18;0,1,2,3,5;5;2,9;2;1;1
252856971372;252856971382;10;0,1,2,3,5;5;2,9;2;1;1
252856971382;252856971383;1;0,1,2,3,5;5;2,9;2;1;1
252856971383;252856971401;18;0,1,2,3,5;5;2,9;2;1;1
252856971401;252856971407;6;0,1,2,3,5;5;2,9;2;1;1
252856971407;252856971413;6;0,1,2,3,5;5;2,9;2;1;1
252856971413;252856971421;8;0,1,2,3,5;5;2,9;2;1;1
252856971421;252856971431;10;0,1,2,3,5;5;2,9;2;1;1
252856971431;252856971441;10;0,1,2,3,5;5;2,9;2;1;1
252856971441;252856971448;7;0,1,2,3,5;5;2,9;2;1;1
252856971448;252856971451;3;0,1,2,3,5;5;2,9;2;1;1
252856971451;252856971458;7;0,1,2,3,5;5;2,9;2;1;1
252856971458;252856971480;22;0,1,2,3,5;5;2,9;2;1;1
252856971480;252856971481;1;0,1,2,3,5;5;2,9;2;1;1
252856971481;252856971482;1;0,1,2,3,5;5;2,9;2;1;1
252856971482;252856971487;5;0,1,2,3,5;5;2,9;2;1;1
252856971487;252856971492;5;0,1,2,3,5;5;2,9;2;1;1
252856971492;252856971498;6;0,1,2,3,5;5;2,9;2;1;1
252856971498;252856971508;10;0,1,2,3,5;5;2,9;2;1;1
252856971508;252856971514;6;0,1,2,3,5;5;2,9;2;1;1
252856971514;252856971534;20;0,1,2,3,5;5;2,9;2;1;1
252856971534;252856971537;3;0,1,2,3,5;5;2,9;2;1;1
252856971537;252856971541;4;0,1,2,3,5;5;2,9;2;1;1
252856971541;252856971546;5;0,1,2,3,5;5;2,9;2;1;1
252856971546;252856971562;16;0,1,2,3,5;5;2,9;2;1;1
252856971562;252856971567;5;0,1,2,3,5;5;2,9;2;1;1
252856971567;252856971571;4;0,1,2,3,5;5;2,9;2;1;1
252856971571;252856971582;11;0,1,2,3,5;5;2,9;2;1;1
252856971582;252856971613;31;0,1,2,3,5;5;2,9;2;1;1
252856971613;252856971623;10;0,1,2,3,5;5;2,9;2;1;1
252856971623;252856971632;9;0,1,2,3,5;5;2,9;2;1;1
252856971632;252856971645;13;0,1,2,3,5;5;2,9;2;1;1
252856971645;252856971651;6;0,1,2,3,5;5;2,9;2;1;1
252856971651;252856971677;26;0,1,2,3,5;5;2,9;2;1;1
252856971677;252856971703;26;0,1,2,3,5;5;2,9;2;1;1
252856971703;252856971705;2;0,1,2,3,5;5;2,9;2;1;1
252856971705;252856971710;5;0,1,2,3,5;5;2,9;2;1;1
252856971710;252856971715;5;0,1,2,3,5;5;2,9;2;1;1
252856971715;252856971746;31;0,1,2,3,5;5;2,9;2;1;1
252856971746;252856971755;9;0,1,2,3,5;5;2,9;2;1;1
252856971755;252856971759;4;0,1,2,3,5;5;2,9;2;1;1
252856971759;252856971764;5;0,1,2,3,5;5;2,9;2;1;1
252856971764;252856971768;4;0,1,2,3,5;5;2,9;2;1;1
252856971768;252856971786;18;0,1,2,3,5;5;2,9;2;1;1
252856971786;252856971793;7;0,1,2,3,5;5;2,9;2;1;1
252856971793;252856971807;14;0,1,2,3,5;5;2,9;2;1;1
252856971807;252856971809;2;0,1,2,3,5;5;2,9;2;1;1
252856971809;252856971820;11;0,1,2,3,5;5;2,9;2;1;1
252856971820;252856971825;5;0,1,2,3,5;5;2,9;2;1;1
252856971825;252856971843;18;0,1,2,3,5;5;2,9;2;1;1
252856971843;252856971848;5;0,1,2,3,5;5;2,9;2;1;1
252856971848;252856971861;13;0,1,2,3,5;5;2,9;2;1;1
252856971861;252856971871;10;0,1,2,3,5;5;2,9;2;1;1
252856971871;252856971875;4;0,1,2,3,5;5;2,9;2;1;1
252856971875;252856971879;4;0,1,2,3,5;5;2,9;2;1;1
252856971879;252856971887;8;0,1,2,3,5;5;2,9;2;1;1
252856971887;252856971893;6;0,1,2,3,5;5;2,9;2;1;1
252856971893;252856971900;7;0,1,2,3,5;5;2,9;2;1;1
252856971900;252856971921;21;0,1,2,3,5;5;2,9;2;1;1
252856971921;252856971923;2;0,1,2,3,5;5;2,9;2;1;1
252856971923;252856971930;7;0,1,2,3,5;5;2,9;2;1;1
252856971930;252856971933;3;0,1,2,3,5;5;2,9;2;1;1
252856971933;252856971943;10;0,1,2,3,5;5;2,9;2;1;1
252856971943;252856971949;6;0,1,2,3,5;5;2,9;2;1;1
252856971949;252856971952;3;0,1,2,3,5;5;2,9;2;1;1
252856971952;252856971953;1;0,1,2,3,5;5;2,9;2;1;1
252856971953;252856971959;6;0,1,2,3,5;5;2,9;2;1;1
252856971959;252856971969;10;0,1,2,3,5;5;2,9;2;1;1
252856971969;252856971989;20;0,1,2,3,5;5;2,9;2;1;1
252856971989;252856971997;8;0,1,2,3,5;5;2,9;2;1;1
252856971997;252856972006;9;0,1,2,3,5;5;2,9;2;1;1
252856972006;252856972013;7;0,1,2,3,5;5;2,9;2;1;1
252856972013;252856972036;23;0,1,2,3,5;5;2,9;2;1;1
252856972036;252856972041;5;0,1,2,3,5;5;2,9;2;1;1
252856972041;252856972044;3;0,1,2,3,5;5;2,9;2;1;1
252856972044;252856972061;17;0,1,2,3,5;5;2,9;2;1;1
252856972061;252856972071;10;0,1,2,3,5;5;2,9;2;1;1
252856972071;252856972079;8;0,1,2,3,5;5;2,9;2;1;1
252856972079;252856972083;4;0,1,2,3,5;5;2,9;2;1;1
252856972083;252856972084;1;0,1,2,3,5;5;2,9;2;1;1
252856972084;252856972097;13;0,1,2,3,5;5;2,9;2;1;1
252856972097;252856972109;12;0,1,2,3,5;5;2,9;2;1;1
252856972109;252856972116;7;0,1,2,3,5;5;2,9;2;1;1
252856972116;252856972117;1;0,1,2,3,5;5;2,9;2;1;1
252856972117;252856972123;6;0,1,2,3,5;5;2,9;2;1;1
252856972123;252856972141;18;0,1,2,3,5;5;2,9;2;1;1
252856972141;252856972150;9;0,1,2,3,5;5;2,9;2;1;1
252856972150;252856972161;11;0,1,2,3,5;5;2,9;2;1;1
252856972161;252856972170;9;0,1,2,3,5;5;2,9;2;1;1
252856972170;252856972176;6;0,1,2,3,5;5;2,9;2;1;1
252856972176;252856972189;13;0,1,2,3,5;5;2,9;2;1;1
252856972189;252856972197;8;0,1,2,3,5;5;2,9;2;1;1
252856972197;252856972198;1;0,1,2,3,5;5;2,9;2;1;1
252856972198;252856972204;6;0,1,2,3,5;5;2,9;2;1;1
252856972204;252856972219;15;0,1,2,3,5;5;2,9;2;1;1
252856972219;252856972227;8;0,1,2,3,5;5;2,9;2;1;1
252856972227;252856972229;2;0,1,2,3,5;5;2,9;2;1;1
252856972229;252856972230;1;0,1,2,3,5;5;2,9;2;1;1
252856972230;252856972235;5;0,1,2,3,5;5;2,9;2;1;1
252856972235;252856972247;12;0,1,2,3,5;5;2,9;2;1;1
252856972247;252856972248;1;0,1,2,3,5;5;2,9;2;1;1
252856972248;252856972252;4;0,1,2,3,5;5;2,9;2;1;1
252856972252;252856972258;6;0,1,2,3,5;5;2,9;2;1;1
252856972258;252856972264;6;0,1,2,3,5;5;2,9;2;1;1
252856972264;252856972278;14;0,1,2,3,5;5;2,9;2;1;1
252856972278;252856972294;16;0,1,2,3,5;5;2,9;2;1;1
252856972294;252856972299;5;0,1,2,3,5;5;2,9;2;1;1
252856972299;252856972306;7;0,1,2,3,5;5;2,9;2;1;1
252856972306;252856972334;28;0,1,2,3,5;5;2,9;2;1;1
252856972334;252856972335;1;0,1,2,3,5;5;2,9;2;1;1
252856972335;252856972342;7;0,1,2,3,5;5;2,9;2;1;1
252856972342;252856972356;14;0,1,2,3,5;5;2,9;2;1;1
252856972356;252856972359;3;0,1,2,3,5;5;2,9;2;1;1
252856972359;252856972362;3;0,1,2,3,5;5;2,9;2;1;1
252856972362;252856972363;1;0,1,2,3,5;5;2,9;2;1;1
252856972363;252856972366;3;0,1,2,3,5;5;2,9;2;1;1
252856972366;252856972395;29;0,1,2,3,5;5;2,9;2;1;1
252856972395;252856972398;3;0,1,2,3,5;5;2,9;2;1;1
252856972398;252856972420;22;0,1,2,3,5;5;2,9;2;1;1
252856972420;252856972426;6;0,1,2,3,5;5;2,9;2;1;1
252856972426;252856972437;11;0,1,2,3,5;5;2,9;2;1;1
252856972437;252856972440;3;0,1,2,3,5;5;2,9;2;1;1
252856972440;252856972450;10;0,1,2,3,5;5;2,9;2;1;1
252856972450;252856972462;12;0,1,2,3,5;5;2,9;2;1;1
252856972462;252856972465;3;0,1,2,3,5;5;2,9;2;1;1
252856972465;252856972496;31;0,1,2,3,5;5;2,9;2;1;1
252856972496;252856972498;2;0,1,2,3,5;5;2,9;2;1;1
252856972498;252856972513;15;0,1,2,3,5;5;2,9;2;1;1
252856972513;252856972515;2;0,1,2,3,5;5;2,9;2;1;1
252856972515;252856972523;8;0,1,2,3,5;5;2,9;2;1;1
252856972523;252856972533;10;0,1,2,3,5;5;2,9;2;1;1
252856972533;252856972538;5;0,1,2,3,5;5;2,9;2;1;1
252856972538;252856972540;2;0,1,2,3,5;5;2,9;2;1;1
252856972540;252856972549;9;0,1,2,3,5;5;2,9;2;1;1
252856972549;252856972551;2;0,1,2,3,5;5;2,9;2;1;1
252856972551;252856972562;11;0,1,2,3,5;5;2,9;2;1;1
252856972562;252856972566;4;0,1,2,3,5;5;2,9;2;1;1
252856972566;252856972569;3;0,1,2,3,5;5;2,9;2;1;1
252856972569;252856972579;10;0,1,2,3,5;5;2,9;2;1;1
252856972579;252856972589;10;0,1,2,3,5;5;2,9;2;1;1
252856972589;252856972610;21;0,1,2,3,5;5;2,9;2;1;1
252856972610;252856972613;3;0,1,2,3,5;5;2,9;2;1;1
252856972613;252856972623;10;0,1,2,3,5;5;2,9;2;1;1
252856972623;252856972626;3;0,1,2,3,5;5;2,9;2;1;1
252856972626;252856972641;15;0,1,2,3,5;5;2,9;2;1;1
252856972641;252856972642;1;0,1,2,3,5;5;2,9;2;1;1
252856972642;252856972656;14;0,1,2,3,5;5;2,9;2;1;1
252856972656;252856972660;4;0,1,2,3,5;5;2,9;2;1;1
252856972660;252856972661;1;0,1,2,3,5;5;2,9;2;1;1
252856972661;252856972679;18;0,1,2,3,5;5;2,9;2;1;1
252856972679;252856972680;1;0,1,2,3,5;5;2,9;2;1;1
252856972680;252856972701;21;0,1,2,3,5;5;2,9;2;1;1
252856972701;252856972706;5;0,1,2,3,5;5;2,9;2;1;1
252856972706;252856972720;14;0,1,2,3,5;5;2,9;2;1;1
252856972720;252856972724;4;0,1,2,3,5;5;2,9;2;1;1
252856972724;252856972728;4;0,1,2,3,5;5;2,9;2;1;1
252856972728;252856972731;3;0,1,2,3,5;5;2,9;2;1;1
252856972731;252856972738;7;0,1,2,3,5;5;2,9;2;1;1
252856972738;252856972739;1;0,1,2,3,5;5;2,9;2;1;1
252856972739;252856972742;3;0,1,2,3,5;5;2,9;2;1;1
252856972742;252856972754;12;0,1,2,3,5;5;2,9;2;1;1
252856972754;252856972776;22;0,1,2,3,5;5;2,9;2;1;1
252856972776;252856972777;1;0,1,2,3,5;5;2,9;2;1;1
252856972777;252856972778;1;0,1,2,3,5;5;2,9;2;1;1
252856972778;252856972779;1;0,1,2,3,5;5;2,9;2;1;1
252856972779;252856972783;4;0,1,2,3,5;5;2,9;2;1;1
252856972783;252856972793;10;0,1,2,3,5;5;2,9;2;1;1
252856972793;252856972804;11;0,1,2,3,5;5;2,9;2;1;1
252856972804;252856972806;2;0,1,2,3,5;5;2,9;2;1;1
252856972806;252856972823;17;0,1,2,3,5;5;2,9;2;1;1
252856972823;252856972829;6;0,1,2,3,5;5;2,9;2;1;1
252856972829;252856972836;7;0,1,2,3,5;5;2,9;2;1;1
252856972836;252856972844;8;0,1,2,3,5;5;2,9;2;1;1
252856972844;252856972847;3;0,1,2,3,5;5;2,9;2;1;1
252856972847;252856972848;1;0,1,2,3,5;5;2,9;2;1;1
252856972848;252856972859;11;0,1,2,3,5;5;2,9;2;1;1
252856972859;252856972863;4;0,1,2,3,5;5;2,9;2;1;1
252856972863;252856972870;7;0,1,2,3,5;5;2,9;2;1;1
252856972870;252856972877;7;0,1,2,3,5;5;2,9;2;1;1
252856972877;252856972885;8;0,1,2,3,5;5;2,9;2;1;1
252856972885;252856972890;5;0,1,2,3,5;5;2,9;2;1;1
252856972890;252856972898;8;0,1,2,3,5;5;2,9;2;1;1
252856972898;252856972902;4;0,1,2,3,5;5;2,9;2;1;1
252856972902;252856972906;4;0,1,2,3,5;5;2,9;2;1;1
252856972906;252856972919;13;0,1,2,3,5;5;2,9;2;1;1
252856972919;252856972927;8;0,1,2,3,5;5;2,9;2;1;1
252856972927;252856972928;1;0,1,2,3,5;5;2,9;2;1;1
252856972928;252856972932;4;0,1,2,3,5;5;2,9;2;1;1
252856972932;252856972935;3;0,1,2,3,5;5;2,9;2;1;1
252856972935;252856972942;7;0,1,2,3,5;5;2,9;2;1;1
252856972942;252856972944;2;0,1,2,3,5;5;2,9;2;1;1
252856972944;252856972961;17;0,1,2,3,5;5;2,9;2;1;1
252856972961;252856972968;7;0,1,2,3,5;5;2,9;2;1;1
252856972968;252856972970;2;0,1,2,3,5;5;2,9;2;1;1
252856972970;252856972977;7;0,1,2,3,5;5;2,9;2;1;1
252856972977;252856972984;7;0,1,2,3,5;5;2,9;2;1;1
252856972984;252856972988;4;0,1,2,3,5;5;2,9;2;1;1
252856972988;252856972989;1;0,1,2,3,5;5;2,9;2;1;1
252856972989;252856972996;7;0,1,2,3,5;5;2,9;2;1;1
252856972996;252856973000;4;0,1,2,3,5;5;2,9;2;1;1
252856973000;252856973003;3;0,1,2,3,5;5;2,9;2;1;1
252856973003;252856973007;4;0,1,2,3,5;5;2,9;2;1;1
252856973007;252856973025;18;0,1,2,3,5;5;2,9;2;1;1
252856973025;252856973042;17;0,1,2,3,5;5;2,9;2;1;1
252856973042;252856973046;4;0,1,2,3,5;5;2,9;2;1;1
252856973046;252856973047;1;0,1,2,3,5;5;2,9;2;1;1
252856973047;252856973055;8;0,1,2,3,5;5;2,9;2;1;1
252856973055;252856973059;4;0,1,2,3,5;5;2,9;2;1;1
252856973059;252856973062;3;0,1,2,3,5;5;2,9;2;1;1
252856973062;252856973073;11;0,1,2,3,5;5;2,9;2;1;1
252856973073;252856973077;4;0,1,2,3,5;5;2,9;2;1;1
252856973077;252856973087;10;0,1,2,3,5;5;2,9;2;1;1
252856973087;252856973090;3;0,1,2,3,5;5;2,9;2;1;1
252856973090;252856973092;2;0,1,2,3,5;5;2,9;2;1;1
252856973092;252856973095;3;0,1,2,3,5;5;2,9;2;1;1
252856973095;252856973099;4;0,1,2,3,5;5;2,9;2;1;1
252856973099;252856973105;6;0,1,2,3,5;5;2,9;2;1;1
252856973105;252856973116;11;0,1,2,3,5;5;2,9;2;1;1
252856973116;252856973133;17;0,1,2,3,5;5;2,9;2;1;1
252856973133;252856973141;8;0,1,2,3,5;5;2,9;2;1;1
252856973141;252856973142;1;0,1,2,3,5;5;2,9;2;1;1
252856973142;252856973144;2;0,1,2,3,5;5;2,9;2;1;1
252856973144;252856973158;14;0,1,2,3,5;5;2,9;2;1;1
252856973158;252856973160;2;0,1,2,3,5;5;2,9;2;1;1
252856973160;252856973168;8;0,1,2,3,5;5;2,9;2;1;1
252856973168;252856973170;2;0,1,2,3,5;5;2,9;2;1;1
252856973170;252856973172;2;0,1,2,3,5;5;2,9;2;1;1
252856973172;252856973182;10;0,1,2,3,5;5;2,9;2;1;1
252856973182;252856973197;15;0,1,2,3,5;5;2,9;2;1;1
252856973197;252856973208;11;0,1,2,3,5;5;2,9;2;1;1
252856973208;252856973219;11;0,1,2,3,5;5;2,9;2;1;1
252856973219;252856973220;1;0,1,2,3,5;5;2,9;2;1;1
252856973220;252856973226;6;0,1,2,3,5;5;2,9;2;1;1
252856973226;252856973227;1;0,1,2,3,5;5;2,9;2;1;1
252856973227;252856973236;9;0,1,2,3,5;5;2,9;2;1;1
252856973236;252856973248;12;0,1,2,3,5;5;2,9;2;1;1
252856973248;252856973252;4;0,1,2,3,5;5;2,9;2;1;1
252856973252;252856973254;2;0,1,2,3,5;5;2,9;2;1;1
252856973254;252856973268;14;0,1,2,3,5;5;2,9;2;1;1
252856973268;252856973274;6;0,1,2,3,5;5;2,9;2;1;1
252856973274;252856973279;5;0,1,2,3,5;5;2,9;2;1;1
252856973279;252856973299;20;0,1,2,3,5;5;2,9;2;1;1
252856973299;252856973311;12;0,1,2,3,5;5;2,9;2;1;1
252856973311;252856973322;11;0,1,2,3,5;5;2,9;2;1;1
252856973322;252856973323;1;0,1,2,3,5;5;2,9;2;1;1
252856973323;252856973332;9;0,1,2,3,5;5;2,9;2;1;1
252856973332;252856973359;27;0,1,2,3,5;5;2,9;2;1;1
252856973359;252856973360;1;0,1,2,3,5;5;2,9;2;1;1
252856973360;252856973362;2;0,1,2,3,5;5;2,9;2;1;1
252856973362;252856973396;34;0,1,2,3,5;5;2,9;2;1;1
252856973396;252856973398;2;0,1,2,3,5;5;2,9;2;1;1
252856973398;252856973441;43;0,1,2,3,5;5;2,9;2;1;1
252856973441;252856973458;17;0,1,2,3,5;5;2,9;2;1;1
252856973458;252856973459;1;0,1,2,3,5;5;2,9;2;1;1
252856973459;252856973466;7;0,1,2,3,5;5;2,9;2;1;1
252856973466;252856973468;2;0,1,2,3,5;5;2,9;2;1;1
252856973468;252856973471;3;0,1,2,3,5;5;2,9;2;1;1
252856973471;252856973488;17;0,1,2,3,5;5;2,9;2;1;1
252856973488;252856973501;13;0,1,2,3,5;5;2,9;2;1;1
252856973501;252856973505;4;0,1,2,3,5;5;2,9;2;1;1
252856973505;252856973516;11;0,1,2,3,5;5;2,9;2;1;1
252856973516;252856973537;21;0,1,2,3,5;5;2,9;2;1;1
252856973537;252856973544;7;0,1,2,3,5;5;2,9;2;1;1
252856973544;252856973551;7;0,1,2,3,5;5;2,9;2;1;1
252856973551;252856973572;21;0,1,2,3,5;5;2,9;2;1;1
252856973572;252856973591;19;0,1,2,3,5;5;2,9;2;1;1
252856973591;252856973596;5;0,1,2,3,5;5;2,9;2;1;1
252856973596;252856973599;3;0,1,2,3,5;5;2,9;2;1;1
252856973599;252856973606;7;0,1,2,3,5;5;2,9;2;1;1
252856973606;252856973616;10;0,1,2,3,5;5;2,9;2;1;1
252856973616;252856973625;9;0,1,2,3,5;5;2,9;2;1;1
252856973625;252856973629;4;0,1,2,3,5;5;2,9;2;1;1
252856973629;252856973639;10;0,1,2,3,5;5;2,9;2;1;1
252856973639;252856973647;8;0,1,2,3,5;5;2,9;2;1;1
252856973647;252856973655;8;0,1,2,3,5;5;2,9;2;1;1
252856973655;252856973664;9;0,1,2,3,5;5;2,9;2;1;1
252856973664;252856973683;19;0,1,2,3,5;5;2,9;2;1;1
252856973683;252856973705;22;0,1,2,3,5;5;2,9;2;1;1
252856973705;252856973714;9;0,1,2,3,5;5;2,9;2;1;1
252856973714;252856973718;4;0,1,2,3,5;5;2,9;2;1;1
252856973718;252856973729;11;0,1,2,3,5;5;2,9;2;1;1
252856973729;252856973732;3;0,1,2,3,5;5;2,9;2;1;1
252856973732;252856973738;6;0,1,2,3,5;5;2,9;2;1;1
252856973738;252856973741;3;0,1,2,3,5;5;2,9;2;1;1
252856973741;252856973755;14;0,1,2,3,5;5;2,9;2;1;1
252856973755;252856973761;6;0,1,2,3,5;5;2,9;2;1;1
252856973761;252856973764;3;0,1,2,3,5;5;2,9;2;1;1
252856973764;252856973792;28;0,1,2,3,5;5;2,9;2;1;1
252856973792;252856973818;26;0,1,2,3,5;5;2,9;2;1;1
252856973818;252856973823;5;0,1,2,3,5;5;2,9;2;1;1
252856973823;252856973830;7;0,1,2,3,5;5;2,9;2;1;1
252856973830;252856973840;10;0,1,2,3,5;5;2,9;2;1;1
252856973840;252856973851;11;0,1,2,3,5;5;2,9;2;1;1
252856973851;252856973855;4;0,1,2,3,5;5;2,9;2;1;1
252856973855;252856973878;23;0,1,2,3,5;5;2,9;2;1;1
252856973878;252856973889;11;0,1,2,3,5;5;2,9;2;1;1
252856973889;252856973922;33;0,1,2,3,5;5;2,9;2;1;1
252856973922;252856973932;10;0,1,2,3,5;5;2,9;2;1;1
252856973932;252856973951;19;0,1,2,3,5;5;2,9;2;1;1
252856973951;252856973962;11;0,1,2,3,5;5;2,9;2;1;1
252856973962;252856973966;4;0,1,2,3,5;5;2,9;2;1;1
252856973966;252856973979;13;0,1,2,3,5;5;2,9;2;1;1
252856973979;252856974026;47;0,1,2,3,5;5;2,9;2;1;1
252856974026;252856974041;15;0,1,2,3,5;5;2,9;2;1;1
252856974041;252856974054;13;0,1,2,3,5;5;2,9;2;1;1
252856974054;252856974080;26;0,1,2,3,5;5;2,9;2;1;1
252856974080;252856974083;3;0,1,2,3,5;5;2,9;2;1;1
252856974083;252856974084;1;0,1,2,3,5;5;2,9;2;1;1
252856974084;252856974116;32;0,1,2,3,5;5;2,9;2;1;1
252856974116;252856974132;16;0,1,2,3,5;5;2,9;2;1;1
252856974132;252856974186;54;0,1,2,3,5;5;2,9;2;1;1
252856974186;252856974216;30;0,1,2,3,5;5;2,9;2;1;1
252856974216;252856974230;14;0,1,2,3,5;5;2,9;2;1;1
252856974230;252856974276;46;0,1,2,3,5;5;2,9;2;1;1
252856974276;252856974287;11;0,1,2,3,5;5;2,9;2;1;1
252856974287;252856974298;11;0,1,2,3,5;5;2,9;2;1;1
252856974298;252856974303;5;0,1,2,3,5;5;2,9;2;1;1
252856974303;252856974311;8;0,1,2,3,5;5;2,9;2;1;1
252856974311;252856974331;20;0,1,2,3,5;5;2,9;2;1;1
252856974331;252856974343;12;0,1,2,3,5;5;2,9;2;1;1
252856974343;252856974348;5;0,1,2,3,5;5;2,9;2;1;1
252856974348;252856974365;17;0,1,2,3,5;5;2,9;2;1;1
252856974365;252856974366;1;0,1,2,3,5;5;2,9;2;1;1
252856974366;252856974371;5;0,1,2,3,5;5;2,9;2;1;1
252856974371;252856974400;29;0,1,2,3,5;5;2,9;2;1;1
252856974400;252856974407;7;0,1,2,3,5;5;2,9;2;1;1
252856974407;252856974410;3;0,1,2,3,5;5;2,9;2;1;1
252856974410;252856974432;22;0,1,2,3,5;5;2,9;2;1;1
252856974432;252856974433;1;0,1,2,3,5;5;2,9;2;1;1
252856974433;252856974435;2;0,1,2,3,5;5;2,9;2;1;1
252856974435;252856974441;6;0,1,2,3,5;5;2,9;2;1;1
252856974441;252856974455;14;0,1,2,3,5;5;2,9;2;1;1
252856974455;252856974458;3;0,1,2,3,5;5;2,9;2;1;1
252856974458;252856974470;12;0,1,2,3,5;5;2,9;2;1;1
252856974470;252856974474;4;0,1,2,3,5;5;2,9;2;1;1
252856974474;252856974480;6;0,1,2,3,5;5;2,9;2;1;1
252856974480;252856974497;17;0,1,2,3,5;5;2,9;2;1;1
252856974497;252856974523;26;0,1,2,3,5;5;2,9;2;1;1
252856974523;252856974527;4;0,1,2,3,5;5;2,9;2;1;1
252856974527;252856974544;17;0,1,2,3,5;5;2,9;2;1;1
252856974544;252856974564;20;0,1,2,3,5;5;2,9;2;1;1
252856974564;252856974566;2;0,1,2,3,5;5;2,9;2;1;1
252856974566;252856974570;4;0,1,2,3,5;5;2,9;2;1;1
252856974570;252856974591;21;0,1,2,3,5;5;2,9;2;1;1
252856974591;252856974594;3;0,1,2,3,5;5;2,9;2;1;1
252856974594;252856974603;9;0,1,2,3,5;5;2,9;2;1;1
252856974603;252856974614;11;0,1,2,3,5;5;2,9;2;1;1
252856974614;252856974625;11;0,1,2,3,5;5;2,9;2;1;1
252856974625;252856974641;16;0,1,2,3,5;5;2,9;2;1;1
252856974641;252856974664;23;0,1,2,3,5;5;2,9;2;1;1
252856974664;252856974674;10;0,1,2,3,5;5;2,9;2;1;1
252856974674;252856974686;12;0,1,2,3,5;5;2,9;2;1;1
252856974686;252856974688;2;0,1,2,3,5;5;2,9;2;1;1
252856974688;252856974690;2;0,1,2,3,5;5;2,9;2;1;1
252856974690;252856974708;18;0,1,2,3,5;5;2,9;2;1;1
252856974708;252856974710;2;0,1,2,3,5;5;2,9;2;1;1
252856974710;252856974712;2;0,1,2,3,5;5;2,9;2;1;1
252856974712;252856974723;11;0,1,2,3,5;5;2,9;2;1;1
252856974723;252856974754;31;0,1,2,3,5;5;2,9;2;1;1
252856974754;252856974757;3;0,1,2,3,5;5;2,9;2;1;1
252856974757;252856974791;34;0,1,2,3,5;5;2,9;2;1;1
252856974791;252856974793;2;0,1,2,3,5;5;2,9;2;1;1
252856974793;252856974801;8;0,1,2,3,5;5;2,9;2;1;1
252856974801;252856974811;10;0,1,2,3,5;5;2,9;2;1;1
252856974811;252856974817;6;0,1,2,3,5;5;2,9;2;1;1
252856974817;252856974820;3;0,1,2,3,5;5;2,9;2;1;1
252856974820;252856974854;34;0,1,2,3,5;5;2,9;2;1;1
252856974854;252856974856;2;0,1,2,3,5;5;2,9;2;1;1
252856974856;252856974866;10;0,1,2,3,5;5;2,9;2;1;1
252856974866;252856974889;23;0,1,2,3,5;5;2,9;2;1;1
252856974889;252856974899;10;0,1,2,3,5;5;2,9;2;1;1
252856974899;252856974916;17;0,1,2,3,5;5;2,9;2;1;1
252856974916;252856974919;3;0,1,2,3,5;5;2,9;2;1;1
252856974919;252856974927;8;0,1,2,3,5;5;2,9;2;1;1
252856974927;252856974933;6;0,1,2,3,5;5;2,9;2;1;1
252856974933;252856974944;11;0,1,2,3,5;5;2,9;2;1;1
252856974944;252856974948;4;0,1,2,3,5;5;2,9;2;1;1
252856974948;252856974951;3;0,1,2,3,5;5;2,9;2;1;1
252856974951;252856974952;1;0,1,2,3,5;5;2,9;2;1;1
252856974952;252856974958;6;0,1,2,3,5;5;2,9;2;1;1
252856974958;252856974968;10;0,1,2,3,5;5;2,9;2;1;1
252856974968;252856974970;2;0,1,2,3,5;5;2,9;2;1;1
252856974970;252856974990;20;0,1,2,3,5;5;2,9;2;1;1
252856974990;252856974991;1;0,1,2,3,5;5;2,9;2;1;1
252856974991;252856974992;1;0,1,2,3,5;5;2,9;2;1;1
252856974992;252856974994;2;0,1,2,3,5;5;2,9;2;1;1
252856974994;252856974996;2;0,1,2,3,5;5;2,9;2;1;1
252856974996;252856975000;4;0,1,2,3,5;5;2,9;2;1;1
252856975000;252856975018;18;0,1,2,3,5;5;2,9;2;1;1
252856975018;252856975024;6;0,1,2,3,5;5;2,9;2;1;1
252856975024;252856975029;5;0,1,2,3,5;5;2,9;2;1;1
252856975029;252856975034;5;0,1,2,3,5;5;2,9;2;1;1
252856975034;252856975035;1;0,1,2,3,5;5;2,9;2;1;1
252856975035;252856975038;3;0,1,2,3,5;5;2,9;2;1;1
252856975038;252856975053;15;0,1,2,3,5;5;2,9;2;1;1
252856975053;252856975070;17;0,1,2,3,5;5;2,9;2;1;1
252856975070;252856975073;3;0,1,2,3,5;5;2,9;2;1;1
252856975073;252856975078;5;0,1,2,3,5;5;2,9;2;1;1
252856975078;252856975112;34;0,1,2,3,5;5;2,9;2;1;1
252856975112;252856975127;15;0,1,2,3,5;5;2,9;2;1;1
252856975127;252856975130;3;0,1,2,3,5;5;2,9;2;1;1
252856975130;252856975136;6;0,1,2,3,5;5;2,9;2;1;1
252856975136;252856975142;6;0,1,2,3,5;5;2,9;2;1;1
252856975142;252856975157;15;0,1,2,3,5;5;2,9;2;1;1
252856975157;252856975176;19;0,1,2,3,5;5;2,9;2;1;1
252856975176;252856975183;7;0,1,2,3,5;5;2,9;2;1;1
252856975183;252856975196;13;0,1,2,3,5;5;2,9;2;1;1
252856975196;252856975209;13;0,1,2,3,5;5;2,9;2;1;1
252856975209;252856975221;12;0,1,2,3,5;5;2,9;2;1;1
252856975221;252856975233;12;0,1,2,3,5;5;2,9;2;1;1
252856975233;252856975251;18;0,1,2,3,5;5;2,9;2;1;1
252856975251;252856975253;2;0,1,2,3,5;5;2,9;2;1;1
252856975253;252856975255;2;0,1,2,3,5;5;2,9;2;1;1
252856975255;252856975260;5;0,1,2,3,5;5;2,9;2;1;1
252856975260;252856975289;29;0,1,2,3,5;5;2,9;2;1;1
252856975289;252856975293;4;0,1,2,3,5;5;2,9;2;1;1
252856975293;252856975309;16;0,1,2,3,5;5;2,9;2;1;1
252856975309;252856975312;3;0,1,2,3,5;5;2,9;2;1;1
252856975312;252856975317;5;0,1,2,3,5;5;2,9;2;1;1
252856975317;252856975329;12;0,1,2,3,5;5;2,9;2;1;1
252856975329;252856975331;2;0,1,2,3,5;5;2,9;2;1;1
252856975331;252856975332;1;0,1,2,3,5;5;2,9;2;1;1
252856975332;252856975336;4;0,1,2,3,5;5;2,9;2;1;1
252856975336;252856975343;7;0,1,2,3,5;5;2,9;2;1;1
252856975343;252856975348;5;0,1,2,3,5;5;2,9;2;1;1
252856975348;252856975366;18;0,1,2,3,5;5;2,9;2;1;1
252856975366;252856975367;1;0,1,2,3,5;5;2,9;2;1;1
252856975367;252856975370;3;0,1,2,3,5;5;2,9;2;1;1
252856975370;252856975373;3;0,1,2,3,5;5;2,9;2;1;1
252856975373;252856975378;5;0,1,2,3,5;5;2,9;2;1;1
252856975378;252856975386;8;0,1,2,3,5;5;2,9;2;1;1
252856975386;252856975387;1;0,1,2,3,5;5;2,9;2;1;1
252856975387;252856975389;2;0,1,2,3,5;5;2,9;2;1;1
252856975389;252856975404;15;0,1,2,3,5;5;2,9;2;1;1
252856975404;252856975411;7;0,1,2,3,5;5;2,9;2;1;1
252856975411;252856975412;1;0,1,2,3,5;5;2,9;2;1;1
252856975412;252856975415;3;0,1,2,3,5;5;2,9;2;1;1
252856975415;252856975423;8;0,1,2,3,5;5;2,9;2;1;1
252856975423;252856975426;3;0,1,2,3,5;5;2,9;2;1;1
252856975426;252856975427;1;0,1,2,3,5;5;2,9;2;1;1
252856975427;252856975429;2;0,1,2,3,5;5;2,9;2;1;1
252856975429;252856975437;8;0,1,2,3,5;5;2,9;2;1;1
252856975437;252856975438;1;0,1,2,3,5;5;2,9;2;1;1
252856975438;252856975444;6;0,1,2,3,5;5;2,9;2;1;1
252856975444;252856975450;6;0,1,2,3,5;5;2,9;2;1;1
252856975450;252856975453;3;0,1,2,3,5;5;2,9;2;1;1
252856975453;252856975455;2;0,1,2,3,5;5;2,9;2;1;1
252856975455;252856975456;1;0,1,2,3,5;5;2,9;2;1;1
252856975456;252856975467;11;0,1,2,3,5;5;2,9;2;1;1
252856975467;252856975469;2;0,1,2,3,5;5;2,9;2;1;1
252856975469;252856975479;10;0,1,2,3,5;5;2,9;2;1;1
252856975479;252856975484;5;0,1,2,3,5;5;2,9;2;1;1
252856975484;252856975490;6;0,1,2,3,5;5;2,9;2;1;1
252856975490;252856975497;7;0,1,2,3,5;5;2,9;2;1;1
252856975497;252856975512;15;0,1,2,3,5;5;2,9;2;1;1
252856975512;252856975513;1;0,1,2,3,5;5;2,9;2;1;1
252856975513;252856975536;23;0,1,2,3,5;5;2,9;2;1;1
252856975536;252856975559;23;0,1,2,3,5;5;2,9;2;1;1
252856975559;252856975575;16;0,1,2,3,5;5;2,9;2;1;1
252856975575;252856975586;11;0,1,2,3,5;5;2,9;2;1;1
252856975586;252856975597;11;0,1,2,3,5;5;2,9;2;1;1
252856975597;252856975601;4;0,1,2,3,5;5;2,9;2;1;1
252856975601;252856975622;21;0,1,2,3,5;5;2,9;2;1;1
252856975622;252856975630;8;0,1,2,3,5;5;2,9;2;1;1
252856975630;252856975642;12;0,1,2,3,5;5;2,9;2;1;1
252856975642;252856975647;5;0,1,2,3,5;5;2,9;2;1;1
252856975647;252856975650;3;0,1,2,3,5;5;2,9;2;1;1
252856975650;252856975657;7;0,1,2,3,5;5;2,9;2;1;1
252856975657;252856975661;4;0,1,2,3,5;5;2,9;2;1;1
252856975661;252856975669;8;0,1,2,3,5;5;2,9;2;1;1
252856975669;252856975672;3;0,1,2,3,5;5;2,9;2;1;1
252856975672;252856975682;10;0,1,2,3,5;5;2,9;2;1;1
252856975682;252856975689;7;0,1,2,3,5;5;2,9;2;1;1
252856975689;252856975696;7;0,1,2,3,5;5;2,9;2;1;1
252856975696;252856975698;2;0,1,2,3,5;5;2,9;2;1;1
252856975698;252856975702;4;0,1,2,3,5;5;2,9;2;1;1
252856975702;252856975713;11;0,1,2,3,5;5;2,9;2;1;1
252856975713;252856975718;5;0,1,2,3,5;5;2,9;2;1;1
252856975718;252856975729;11;0,1,2,3,5;5;2,9;2;1;1
252856975729;252856975734;5;0,1,2,3,5;5;2,9;2;1;1
252856975734;252856975743;9;0,1,2,3,5;5;2,9;2;1;1
252856975743;252856975744;1;0,1,2,3,5;5;2,9;2;1;1
252856975744;252856975751;7;0,1,2,3,5;5;2,9;2;1;1
252856975751;252856975764;13;0,1,2,3,5;5;2,9;2;1;1
252856975764;252856975766;2;0,1,2,3,5;5;2,9;2;1;1
252856975766;252856975770;4;0,1,2,3,5;5;2,9;2;1;1
252856975770;252856975778;8;0,1,2,3,5;5;2,9;2;1;1
252856975778;252856975786;8;0,1,2,3,5;5;2,9;2;1;1
252856975786;252856975788;2;0,1,2,3,5;5;2,9;2;1;1
252856975788;252856975797;9;0,1,2,3,5;5;2,9;2;1;1
252856975797;252856975809;12;0,1,2,3,5;5;2,9;2;1;1
252856975809;252856975813;4;0,1,2,3,5;5;2,9;2;1;1
252856975813;252856975824;11;0,1,2,3,5;5;2,9;2;1;1
252856975824;252856975829;5;0,1,2,3,5;5;2,9;2;1;1
252856975829;252856975849;20;0,1,2,3,5;5;2,9;2;1;1
252856975849;252856975850;1;0,1,2,3,5;5;2,9;2;1;1
252856975850;252856975853;3;0,1,2,3,5;5;2,9;2;1;1
252856975853;252856975870;17;0,1,2,3,5;5;2,9;2;1;1
252856975870;252856975872;2;0,1,2,3,5;5;2,9;2;1;1
252856975872;252856975876;4;0,1,2,3,5;5;2,9;2;1;1
252856975876;252856975879;3;0,1,2,3,5;5;2,9;2;1;1
252856975879;252856975883;4;0,1,2,3,5;5;2,9;2;1;1
252856975883;252856975890;7;0,1,2,3,5;5;2,9;2;1;1
252856975890;252856975894;4;0,1,2,3,5;5;2,9;2;1;1
252856975894;252856975901;7;0,1,2,3,5;5;2,9;2;1;1
252856975901;252856975902;1;0,1,2,3,5;5;2,9;2;1;1
252856975902;252856975904;2;0,1,2,3,5;5;2,9;2;1;1
252856975904;252856975913;9;0,1,2,3,5;5;2,9;2;1;1
252856975913;252856975919;6;0,1,2,3,5;5;2,9;2;1;1
252856975919;252856975928;9;0,1,2,3,5;5;2,9;2;1;1
252856975928;252856975929;1;0,1,2,3,5;5;2,9;2;1;1
252856975929;252856975939;10;0,1,2,3,5;5;2,9;2;1;1
252856975939;252856975944;5;0,1,2,3,5;5;2,9;2;1;1
252856975944;252856975952;8;0,1,2,3,5;5;2,9;2;1;1
252856975952;252856975955;3;0,1,2,3,5;5;2,9;2;1;1
252856975955;252856975959;4;0,1,2,3,5;5;2,9;2;1;1
252856975959;252856975965;6;0,1,2,3,5;5;2,9;2;1;1
252856975965;252856975970;5;0,1,2,3,5;5;2,9;2;1;1
252856975970;252856975973;3;0,1,2,3,5;5;2,9;2;1;1
252856975973;252856975974;1;0,1,2,3,5;5;2,9;2;1;1
252856975974;252856975988;14;0,1,2,3,5;5;2,9;2;1;1
252856975988;252856975994;6;0,1,2,3,5;5;2,9;2;1;1
252856975994;252856976004;10;0,1,2,3,5;5;2,9;2;1;1
252856976004;252856976019;15;0,1,2,3,5;5;2,9;2;1;1
252856976019;252856976020;1;0,1,2,3,5;5;2,9;2;1;1
252856976020;252856976021;1;0,1,2,3,5;5;2,9;2;1;1
252856976021;252856976027;6;0,1,2,3,5;5;2,9;2;1;1
252856976027;252856976030;3;0,1,2,3,5;5;2,9;2;1;1
252856976030;252856976031;1;0,1,2,3,5;5;2,9;2;1;1
252856976031;252856976037;6;0,1,2,3,5;5;2,9;2;1;1
252856976037;252856976044;7;0,1,2,3,5;5;2,9;2;1;1
252856976044;252856976050;6;0,1,2,3,5;5;2,9;2;1;1
252856976050;252856976055;5;0,1,2,3,5;5;2,9;2;1;1
252856976055;252856976056;1;0,1,2,3,5;5;2,9;2;1;1
252856976056;252856976062;6;0,1,2,3,5;5;2,9;2;1;1
252856976062;252856976064;2;0,1,2,3,5;5;2,9;2;1;1
252856976064;252856976065;1;0,1,2,3,5;5;2,9;2;1;1
252856976065;252856976082;17;0,1,2,3,5;5;2,9;2;1;1
252856976082;252856976091;9;0,1,2,3,5;5;2,9;2;1;1
252856976091;252856976093;2;0,1,2,3,5;5;2,9;2;1;1
252856976093;252856976103;10;0,1,2,3,5;5;2,9;2;1;1
252856976103;252856976107;4;0,1,2,3,5;5;2,9;2;1;1
252856976107;252856976110;3;0,1,2,3,5;5;2,9;2;1;1
252856976110;252856976113;3;0,1,2,3,5;5;2,9;2;1;1
252856976113;252856976124;11;0,1,2,3,5;5;2,9;2;1;1
252856976124;252856976127;3;0,1,2,3,5;5;2,9;2;1;1
252856976127;252856976130;3;0,1,2,3,5;5;2,9;2;1;1
252856976130;252856976145;15;0,1,2,3,5;5;2,9;2;1;1
252856976145;252856976150;5;0,1,2,3,5;5;2,9;2;1;1
252856976150;252856976159;9;0,1,2,3,5;5;2,9;2;1;1
252856976159;252856976164;5;0,1,2,3,5;5;2,9;2;1;1
252856976164;252856976166;2;0,1,2,3,5;5;2,9;2;1;1
252856976166;252856976167;1;0,1,2,3,5;5;2,9;2;1;1
252856976167;252856976168;1;0,1,2,3,5;5;2,9;2;1;1
252856976168;252856976180;12;0,1,2,3,5;5;2,9;2;1;1
252856976180;252856976184;4;0,1,2,3,5;5;2,9;2;1;1
252856976184;252856976193;9;0,1,2,3,5;5;2,9;2;1;1
252856976193;252856976197;4;0,1,2,3,5;5;2,9;2;1;1
252856976197;252856976198;1;0,1,2,3,5;5;2,9;2;1;1
252856976198;252856976203;5;0,1,2,3,5;5;2,9;2;1;1
252856976203;252856976204;1;0,1,2,3,5;5;2,9;2;1;1
252856976204;252856976210;6;0,1,2,3,5;5;2,9;2;1;1
252856976210;252856976214;4;0,1,2,3,5;5;2,9;2;1;1
252856976214;252856976219;5;0,1,2,3,5;5;2,9;2;1;1
252856976219;252856976220;1;0,1,2,3,5;5;2,9;2;1;1
252856976220;252856976232;12;0,1,2,3,5;5;2,9;2;1;1
252856976232;252856976242;10;0,1,2,3,5;5;2,9;2;1;1
252856976242;252856976245;3;0,1,2,3,5;5;2,9;2;1;1
252856976245;252856976246;1;0,1,2,3,5;5;2,9;2;1;1
252856976246;252856976259;13;0,1,2,3,5;5;2,9;2;1;1
252856976259;252856976260;1;0,1,2,3,5;5;2,9;2;1;1
252856976260;252856976261;1;0,1,2,3,5;5;2,9;2;1;1
252856976261;252856976269;8;0,1,2,3,5;5;2,9;2;1;1
252856976269;252856976275;6;0,1,2,3,5;5;2,9;2;1;1
252856976275;252856976282;7;0,1,2,3,5;5;2,9;2;1;1
252856976282;252856976287;5;0,1,2,3,5;5;2,9;2;1;1
252856976287;252856976291;4;0,1,2,3,5;5;2,9;2;1;1
252856976291;252856976300;9;0,1,2,3,5;5;2,9;2;1;1
252856976300;252856976302;2;0,1,2,3,5;5;2,9;2;1;1
252856976302;252856976303;1;0,1,2,3,5;5;2,9;2;1;1
252856976303;252856976311;8;0,1,2,3,5;5;2,9;2;1;1
252856976311;252856976315;4;0,1,2,3,5;5;2,9;2;1;1
252856976315;252856976326;11;0,1,2,3,5;5;2,9;2;1;1
252856976326;252856976329;3;0,1,2,3,5;5;2,9;2;1;1
252856976329;252856976346;17;0,1,2,3,5;5;2,9;2;1;1
252856976346;252856976347;1;0,1,2,3,5;5;2,9;2;1;1
252856976347;252856976349;2;0,1,2,3,5;5;2,9;2;1;1
252856976349;252856976353;4;0,1,2,3,5;5;2,9;2;1;1
252856976353;252856976355;2;0,1,2,3,5;5;2,9;2;1;1
252856976355;252856976367;12;0,1,2,3,5;5;2,9;2;1;1
252856976367;252856976371;4;0,1,2,3,5;5;2,9;2;1;1
252856976371;252856976375;4;0,1,2,3,5;5;2,9;2;1;1
252856976375;252856976377;2;0,1,2,3,5;5;2,9;2;1;1
252856976377;252856976378;1;0,1,2,3,5;5;2,9;2;1;1
252856976378;252856976383;5;0,1,2,3,5;5;2,9;2;1;1
252856976383;252856976387;4;0,1,2,3,5;5;2,9;2;1;1
252856976387;252856976389;2;0,1,2,3,5;5;2,9;2;1;1
252856976389;252856976396;7;0,1,2,3,5;5;2,9;2;1;1
252856976396;252856976402;6;0,1,2,3,5;5;2,9;2;1;1
252856976402;252856976405;3;0,1,2,3,5;5;2,9;2;1;1
252856976405;252856976408;3;0,1,2,3,5;5;2,9;2;1;1
252856976408;252856976426;18;0,1,2,3,5;5;2,9;2;1;1
252856976426;252856976429;3;0,1,2,3,5;5;2,9;2;1;1
252856976429;252856976431;2;0,1,2,3,5;5;2,9;2;1;1
252856976431;252856976439;8;0,1,2,3,5;5;2,9;2;1;1
252856976439;252856976440;1;0,1,2,3,5;5;2,9;2;1;1
252856976440;252856976443;3;0,1,2,3,5;5;2,9;2;1;1
252856976443;252856976450;7;0,1,2,3,5;5;2,9;2;1;1
252856976450;252856976455;5;0,1,2,3,5;5;2,9;2;1;1
252856976455;252856976470;15;0,1,2,3,5;5;2,9;2;1;1
252856976470;252856976473;3;0,1,2,3,5;5;2,9;2;1;1
252856976473;252856976479;6;0,1,2,3,5;5;2,9;2;1;1
252856976479;252856976487;8;0,1,2,3,5;5;2,9;2;1;1
252856976487;252856976489;2;0,1,2,3,5;5;2,9;2;1;1
252856976489;252856976495;6;0,1,2,3,5;5;2,9;2;1;1
252856976495;252856976499;4;0,1,2,3,5;5;2,9;2;1;1
252856976499;252856976501;2;0,1,2,3,5;5;2,9;2;1;1
252856976501;252856976509;8;0,1,2,3,5;5;2,9;2;1;1
252856976509;252856976511;2;0,1,2,3,5;5;2,9;2;1;1
252856976511;252856976519;8;0,1,2,3,5;5;2,9;2;1;1
252856976519;252856976521;2;0,1,2,3,5;5;2,9;2;1;1
252856976521;252856976524;3;0,1,2,3,5;5;2,9;2;1;1
252856976524;252856976529;5;0,1,2,3,5;5;2,9;2;1;1
252856976529;252856976545;16;0,1,2,3,5;5;2,9;2;1;1
252856976545;252856976551;6;0,1,2,3,5;5;2,9;2;1;1
252856976551;252856976552;1;0,1,2,3,5;5;2,9;2;1;1
252856976552;252856976556;4;0,1,2,3,5;5;2,9;2;1;1
252856976556;252856976558;2;0,1,2,3,5;5;2,9;2;1;1
252856976558;252856976561;3;0,1,2,3,5;5;2,9;2;1;1
252856976561;252856976563;2;0,1,2,3,5;5;2,9;2;1;1
252856976563;252856976573;10;0,1,2,3,5;5;2,9;2;1;1
252856976573;252856976578;5;0,1,2,3,5;5;2,9;2;1;1
252856976578;252856976581;3;0,1,2,3,5;5;2,9;2;1;1
252856976581;252856976582;1;0,1,2,3,5;5;2,9;2;1;1
252856976582;252856976586;4;0,1,2,3,5;5;2,9;2;1;1
252856976586;252856976602;16;0,1,2,3,5;5;2,9;2;1;1
252856976602;252856976603;1;0,1,2,3,5;5;2,9;2;1;1
252856976603;252856976605;2;0,1,2,3,5;5;2,9;2;1;1
252856976605;252856976608;3;0,1,2,3,5;5;2,9;2;1;1
252856976608;252856976615;7;0,1,2,3,5;5;2,9;2;1;1
252856976615;252856976616;1;0,1,2,3,5;5;2,9;2;1;1
252856976616;252856976619;3;0,1,2,3,5;5;2,9;2;1;1
252856976619;252856976626;7;0,1,2,3,5;5;2,9;2;1;1
252856976626;252856976633;7;0,1,2,3,5;5;2,9;2;1;1
252856976633;252856976648;15;0,1,2,3,5;5;2,9;2;1;1
252856976648;252856976661;13;0,1,2,3,5;5;2,9;2;1;1
252856976661;252856976662;1;0,1,2,3,5;5;2,9;2;1;1
252856976662;252856976666;4;0,1,2,3,5;5;2,9;2;1;1
252856976666;252856976667;1;0,1,2,3,5;5;2,9;2;1;1
252856976667;252856976670;3;0,1,2,3,5;5;2,9;2;1;1
252856976670;252856976677;7;0,1,2,3,5;5;2,9;2;1;1
252856976677;252856976693;16;0,1,2,3,5;5;2,9;2;1;1
252856976693;252856976698;5;0,1,2,3,5;5;2,9;2;1;1
252856976698;252856976705;7;0,1,2,3,5;5;2,9;2;1;1
252856976705;252856976721;16;0,1,2,3,5;5;2,9;2;1;1
252856976721;252856976726;5;0,1,2,3,5;5;2,9;2;1;1
252856976726;252856976728;2;0,1,2,3,5;5;2,9;2;1;1
252856976728;252856976735;7;0,1,2,3,5;5;2,9;2;1;1
252856976735;252856976736;1;0,1,2,3,5;5;2,9;2;1;1
252856976736;252856976762;26;0,1,2,3,5;5;2,9;2;1;1
252856976762;252856976776;14;0,1,2,3,5;5;2,9;2;1;1
252856976776;252856976777;1;0,1,2,3,5;5;2,9;2;1;1
252856976777;252856976793;16;0,1,2,3,5;5;2,9;2;1;1
252856976793;252856976795;2;0,1,2,3,5;5;2,9;2;1;1
252856976795;252856976797;2;0,1,2,3,5;5;2,9;2;1;1
252856976797;252856976801;4;0,1,2,3,5;5;2,9;2;1;1
252856976801;252856976812;11;0,1,2,3,5;5;2,9;2;1;1
252856976812;252856976825;13;0,1,2,3,5;5;2,9;2;1;1
252856976825;252856976833;8;0,1,2,3,5;5;2,9;2;1;1
252856976833;252856976843;10;0,1,2,3,5;5;2,9;2;1;1
252856976843;252856976855;12;0,1,2,3,5;5;2,9;2;1;1
252856976855;252856976857;2;0,1,2,3,5;5;2,9;2;1;1
252856976857;252856976860;3;0,1,2,3,5;5;2,9;2;1;1
252856976860;252856976868;8;0,1,2,3,5;5;2,9;2;1;1
252856976868;252856976873;5;0,1,2,3,5;5;2,9;2;1;1
252856976873;252856976879;6;0,1,2,3,5;5;2,9;2;1;1
252856976879;252856976884;5;0,1,2,3,5;5;2,9;2;1;1
252856976884;252856976893;9;0,1,2,3,5;5;2,9;2;1;1
252856976893;252856976895;2;0,1,2,3,5;5;2,9;2;1;1
252856976895;252856976899;4;0,1,2,3,5;5;2,9;2;1;1
252856976899;252856976906;7;0,1,2,3,5;5;2,9;2;1;1
252856976906;252856976914;8;0,1,2,3,5;5;2,9;2;1;1
252856976914;252856976916;2;0,1,2,3,5;5;2,9;2;1;1
252856976916;252856976919;3;0,1,2,3,5;5;2,9;2;1;1
252856976919;252856976921;2;0,1,2,3,5;5;2,9;2;1;1
252856976921;252856976925;4;0,1,2,3,5;5;2,9;2;1;1
252856976925;252856976929;4;0,1,2,3,5;5;2,9;2;1;1
252856976929;252856976943;14;0,1,2,3,5;5;2,9;2;1;1
252856976943;252856976950;7;0,1,2,3,5;5;2,9;2;1;1
252856976950;252856976958;8;0,1,2,3,5;5;2,9;2;1;1
252856976958;252856976970;12;0,1,2,3,5;5;2,9;2;1;1
252856976970;252856976972;2;0,1,2,3,5;5;2,9;2;1;1
252856976972;252856976980;8;0,1,2,3,5;5;2,9;2;1;1
252856976980;252856976983;3;0,1,2,3,5;5;2,9;2;1;1
252856976983;252856976984;1;0,1,2,3,5;5;2,9;2;1;1
252856976984;252856977011;27;0,1,2,3,5;5;2,9;2;1;1
252856977011;252856977018;7;0,1,2,3,5;5;2,9;2;1;1
252856977018;252856977036;18;0,1,2,3,5;5;2,9;2;1;1
252856977036;252856977041;5;0,1,2,3,5;5;2,9;2;1;1
252856977041;252856977082;41;0,1,2,3,5;5;2,9;2;1;1
252856977082;252856977086;4;0,1,2,3,5;5;2,9;2;1;1
252856977086;252856977096;10;0,1,2,3,5;5;2,9;2;1;1
252856977096;252856977122;26;0,1,2,3,5;5;2,9;2;1;1
252856977122;252856977125;3;0,1,2,3,5;5;2,9;2;1;1
252856977125;252856977131;6;0,1,2,3,5;5;2,9;2;1;1
252856977131;252856977141;10;0,1,2,3,5;5;2,9;2;1;1
252856977141;252856977163;22;0,1,2,3,5;5;2,9;2;1;1
252856977163;252856977183;20;0,1,2,3,5;5;2,9;2;1;1
252856977183;252856977186;3;0,1,2,3,5;5;2,9;2;1;1
252856977186;252856977190;4;0,1,2,3,5;5;2,9;2;1;1
252856977190;252856977196;6;0,1,2,3,5;5;2,9;2;1;1
252856977196;252856977201;5;0,1,2,3,5;5;2,9;2;1;1
252856977201;252856977202;1;0,1,2,3,5;5;2,9;2;1;1
252856977202;252856977204;2;0,1,2,3,5;5;2,9;2;1;1
252856977204;252856977207;3;0,1,2,3,5;5;2,9;2;1;1
252856977207;252856977214;7;0,1,2,3,5;5;2,9;2;1;1
252856977214;252856977220;6;0,1,2,3,5;5;2,9;2;1;1
252856977220;252856977235;15;0,1,2,3,5;5;2,9;2;1;1
252856977235;252856977252;17;0,1,2,3,5;5;2,9;2;1;1
252856977252;252856977278;26;0,1,2,3,5;5;2,9;2;1;1
252856977278;252856977280;2;0,1,2,3,5;5;2,9;2;1;1
252856977280;252856977287;7;0,1,2,3,5;5;2,9;2;1;1
252856977287;252856977297;10;0,1,2,3,5;5;2,9;2;1;1
252856977297;252856977304;7;0,1,2,3,5;5;2,9;2;1;1
252856977304;252856977311;7;0,1,2,3,5;5;2,9;2;1;1
252856977311;252856977331;20;0,1,2,3,5;5;2,9;2;1;1
252856977331;252856977333;2;0,1,2,3,5;5;2,9;2;1;1
252856977333;252856977340;7;0,1,2,3,5;5;2,9;2;1;1
252856977340;252856977349;9;0,1,2,3,5;5;2,9;2;1;1
252856977349;252856977352;3;0,1,2,3,5;5;2,9;2;1;1
252856977352;252856977353;1;0,1,2,3,5;5;2,9;2;1;1
252856977353;252856977366;13;0,1,2,3,5;5;2,9;2;1;1
252856977366;252856977368;2;0,1,2,3,5;5;2,9;2;1;1
252856977368;252856977369;1;0,1,2,3,5;5;2,9;2;1;1
252856977369;252856977379;10;0,1,2,3,5;5;2,9;2;1;1
252856977379;252856977386;7;0,1,2,3,5;5;2,9;2;1;1
252856977386;252856977403;17;0,1,2,3,5;5;2,9;2;1;1
252856977403;252856977405;2;0,1,2,3,5;5;2,9;2;1;1
252856977405;252856977417;12;0,1,2,3,5;5;2,9;2;1;1
252856977417;252856977422;5;0,1,2,3,5;5;2,9;2;1;1
252856977422;252856977426;4;0,1,2,3,5;5;2,9;2;1;1
252856977426;252856977433;7;0,1,2,3,5;5;2,9;2;1;1
252856977433;252856977435;2;0,1,2,3,5;5;2,9;2;1;1
252856977435;252856977439;4;0,1,2,3,5;5;2,9;2;1;1
252856977439;252856977444;5;0,1,2,3,5;5;2,9;2;1;1
252856977444;252856977456;12;0,1,2,3,5;5;2,9;2;1;1
252856977456;252856977458;2;0,1,2,3,5;5;2,9;2;1;1
252856977458;252856977461;3;0,1,2,3,5;5;2,9;2;1;1
252856977461;252856977480;19;0,1,2,3,5;5;2,9;2;1;1
252856977480;252856977483;3;0,1,2,3,5;5;2,9;2;1;1
252856977483;252856977488;5;0,1,2,3,5;5;2,9;2;1;1
252856977488;252856977507;19;0,1,2,3,5;5;2,9;2;1;1
252856977507;252856977521;14;0,1,2,3,5;5;2,9;2;1;1
252856977521;252856977522;1;0,1,2,3,5;5;2,9;2;1;1
252856977522;252856977523;1;0,1,2,3,5;5;2,9;2;1;1
252856977523;252856977530;7;0,1,2,3,5;5;2,9;2;1;1
252856977530;252856977532;2;0,1,2,3,5;5;2,9;2;1;1
252856977532;252856977538;6;0,1,2,3,5;5;2,9;2;1;1
252856977538;252856977551;13;0,1,2,3,5;5;2,9;2;1;1
252856977551;252856977560;9;0,1,2,3,5;5;2,9;2;1;1
252856977560;252856977565;5;0,1,2,3,5;5;2,9;2;1;1
252856977565;252856977568;3;0,1,2,3,5;5;2,9;2;1;1
252856977568;252856977571;3;0,1,2,3,5;5;2,9;2;1;1
252856977571;252856977585;14;0,1,2,3,5;5;2,9;2;1;1
252856977585;252856977587;2;0,1,2,3,5;5;2,9;2;1;1
252856977587;252856977588;1;0,1,2,3,5;5;2,9;2;1;1
252856977588;252856977592;4;0,1,2,3,5;5;2,9;2;1;1
252856977592;252856977623;31;0,1,2,3,5;5;2,9;2;1;1
252856977623;252856977625;2;0,1,2,3,5;5;2,9;2;1;1
252856977625;252856977649;24;0,1,2,3,5;5;2,9;2;1;1
252856977649;252856977655;6;0,1,2,3,5;5;2,9;2;1;1
252856977655;252856977656;1;0,1,2,3,5;5;2,9;2;1;1
252856977656;252856977661;5;0,1,2,3,5;5;2,9;2;1;1
252856977661;252856977662;1;0,1,2,3,5;5;2,9;2;1;1
252856977662;252856977664;2;0,1,2,3,5;5;2,9;2;1;1
252856977664;252856977665;1;0,1,2,3,5;5;2,9;2;1;1
252856977665;252856977679;14;0,1,2,3,5;5;2,9;2;1;1
252856977679;252856977706;27;0,1,2,3,5;5;2,9;2;1;1
252856977706;252856977721;15;0,1,2,3,5;5;2,9;2;1;1
252856977721;252856977725;4;0,1,2,3,5;5;2,9;2;1;1
252856977725;252856977736;11;0,1,2,3,5;5;2,9;2;1;1
252856977736;252856977743;7;0,1,2,3,5;5;2,9;2;1;1
252856977743;252856977746;3;0,1,2,3,5;5;2,9;2;1;1
252856977746;252856977761;15;0,1,2,3,5;5;2,9;2;1;1
252856977761;252856977767;6;0,1,2,3,5;5;2,9;2;1;1
252856977767;252856977787;20;0,1,2,3,5;5;2,9;2;1;1
252856977787;252856977803;16;0,1,2,3,5;5;2,9;2;1;1
252856977803;252856977808;5;0,1,2,3,5;5;2,9;2;1;1
252856977808;252856977812;4;0,1,2,3,5;5;2,9;2;1;1
252856977812;252856977825;13;0,1,2,3,5;5;2,9;2;1;1
252856977825;252856977826;1;0,1,2,3,5;5;2,9;2;1;1
252856977826;252856977828;2;0,1,2,3,5;5;2,9;2;1;1
252856977828;252856977830;2;0,1,2,3,5;5;2,9;2;1;1
252856977830;252856977835;5;0,1,2,3,5;5;2,9;2;1;1
252856977835;252856977839;4;0,1,2,3,5;5;2,9;2;1;1
252856977839;252856977854;15;0,1,2,3,5;5;2,9;2;1;1
252856977854;252856977856;2;0,1,2,3,5;5;2,9;2;1;1
252856977856;252856977862;6;0,1,2,3,5;5;2,9;2;1;1
252856977862;252856977883;21;0,1,2,3,5;5;2,9;2;1;1
252856977883;252856977887;4;0,1,2,3,5;5;2,9;2;1;1
252856977887;252856977897;10;0,1,2,3,5;5;2,9;2;1;1
252856977897;252856977904;7;0,1,2,3,5;5;2,9;2;1;1
252856977904;252856977927;23;0,1,2,3,5;5;2,9;2;1;1
252856977927;252856977928;1;0,1,2,3,5;5;2,9;2;1;1
252856977928;252856977937;9;0,1,2,3,5;5;2,9;2;1;1
252856977937;252856977944;7;0,1,2,3,5;5;2,9;2;1;1
252856977944;252856977952;8;0,1,2,3,5;5;2,9;2;1;1
252856977952;252856977971;19;0,1,2,3,5;5;2,9;2;1;1
252856977971;252856977972;1;0,1,2,3,5;5;2,9;2;1;1
252856977972;252856977979;7;0,1,2,3,5;5;2,9;2;1;1
252856977979;252856977983;4;0,1,2,3,5;5;2,9;2;1;1
252856977983;252856977986;3;0,1,2,3,5;5;2,9;2;1;1
252856977986;252856977993;7;0,1,2,3,5;5;2,9;2;1;1
252856977993;252856978005;12;0,1,2,3,5;5;2,9;2;1;1
252856978005;252856978009;4;0,1,2,3,5;5;2,9;2;1;1
252856978009;252856978014;5;0,1,2,3,5;5;2,9;2;1;1
252856978014;252856978015;1;0,1,2,3,5;5;2,9;2;1;1
252856978015;252856978023;8;0,1,2,3,5;5;2,9;2;1;1
252856978023;252856978032;9;0,1,2,3,5;5;2,9;2;1;1
252856978032;252856978042;10;0,1,2,3,5;5;2,9;2;1;1
252856978042;252856978052;10;0,1,2,3,5;5;2,9;2;1;1
252856978052;252856978053;1;0,1,2,3,5;5;2,9;2;1;1
252856978053;252856978058;5;0,1,2,3,5;5;2,9;2;1;1
252856978058;252856978064;6;0,1,2,3,5;5;2,9;2;1;1
252856978064;252856978068;4;0,1,2,3,5;5;2,9;2;1;1
252856978068;252856978070;2;0,1,2,3,5;5;2,9;2;1;1
252856978070;252856978077;7;0,1,2,3,5;5;2,9;2;1;1
252856978077;252856978089;12;0,1,2,3,5;5;2,9;2;1;1
252856978089;252856978102;13;0,1,2,3,5;5;2,9;2;1;1
252856978102;252856978112;10;0,1,2,3,5;5;2,9;2;1;1
252856978112;252856978113;1;0,1,2,3,5;5;2,9;2;1;1
252856978113;252856978118;5;0,1,2,3,5;5;2,9;2;1;1
252856978118;252856978119;1;0,1,2,3,5;5;2,9;2;1;1
252856978119;252856978133;14;0,1,2,3,5;5;2,9;2;1;1
252856978133;252856978142;9;0,1,2,3,5;5;2,9;2;1;1
252856978142;252856978145;3;0,1,2,3,5;5;2,9;2;1;1
252856978145;252856978148;3;0,1,2,3,5;5;2,9;2;1;1
252856978148;252856978149;1;0,1,2,3,5;5;2,9;2;1;1
252856978149;252856978158;9;0,1,2,3,5;5;2,9;2;1;1
252856978158;252856978159;1;0,1,2,3,5;5;2,9;2;1;1
252856978159;252856978160;1;0,1,2,3,5;5;2,9;2;1;1
252856978160;252856978169;9;0,1,2,3,5;5;2,9;2;1;1
252856978169;252856978180;11;0,1,2,3,5;5;2,9;2;1;1
252856978180;252856978185;5;0,1,2,3,5;5;2,9;2;1;1
252856978185;252856978186;1;0,1,2,3,5;5;2,9;2;1;1
252856978186;252856978192;6;0,1,2,3,5;5;2,9;2;1;1
252856978192;252856978197;5;0,1,2,3,5;5;2,9;2;1;1
252856978197;252856978199;2;0,1,2,3,5;5;2,9;2;1;1
252856978199;252856978201;2;0,1,2,3,5;5;2,9;2;1;1
252856978201;252856978213;12;0,1,2,3,5;5;2,9;2;1;1
252856978213;252856978219;6;0,1,2,3,5;5;2,9;2;1;1
252856978219;252856978225;6;0,1,2,3,5;5;2,9;2;1;1
252856978225;252856978228;3;0,1,2,3,5;5;2,9;2;1;1
252856978228;252856978234;6;0,1,2,3,5;5;2,9;2;1;1
252856978234;252856978241;7;0,1,2,3,5;5;2,9;2;1;1
252856978241;252856978244;3;0,1,2,3,5;5;2,9;2;1;1
252856978244;252856978247;3;0,1,2,3,5;5;2,9;2;1;1
252856978247;252856978251;4;0,1,2,3,5;5;2,9;2;1;1
252856978251;252856978256;5;0,1,2,3,5;5;2,9;2;1;1
252856978256;252856978261;5;0,1,2,3,5;5;2,9;2;1;1
252856978261;252856978278;17;0,1,2,3,5;5;2,9;2;1;1
252856978278;252856978291;13;0,1,2,3,5;5;2,9;2;1;1
252856978291;252856978297;6;0,1,2,3,5;5;2,9;2;1;1
252856978297;252856978299;2;0,1,2,3,5;5;2,9;2;1;1
252856978299;252856978303;4;0,1,2,3,5;5;2,9;2;1;1
252856978303;252856978315;12;0,1,2,3,5;5;2,9;2;1;1
252856978315;252856978316;1;0,1,2,3,5;5;2,9;2;1;1
252856978316;252856978329;13;0,1,2,3,5;5;2,9;2;1;1
252856978329;252856978333;4;0,1,2,3,5;5;2,9;2;1;1
252856978333;252856978337;4;0,1,2,3,5;5;2,9;2;1;1
252856978337;252856978352;15;0,1,2,3,5;5;2,9;2;1;1
252856978352;252856978353;1;0,1,2,3,5;5;2,9;2;1;1
252856978353;252856978354;1;0,1,2,3,5;5;2,9;2;1;1
252856978354;252856978365;11;0,1,2,3,5;5;2,9;2;1;1
252856978365;252856978366;1;0,1,2,3,5;5;2,9;2;1;1
252856978366;252856978385;19;0,1,2,3,5;5;2,9;2;1;1
252856978385;252856978389;4;0,1,2,3,5;5;2,9;2;1;1
252856978389;252856978391;2;0,1,2,3,5;5;2,9;2;1;1
252856978391;252856978395;4;0,1,2,3,5;5;2,9;2;1;1
252856978395;252856978398;3;0,1,2,3,5;5;2,9;2;1;1
252856978398;252856978411;13;0,1,2,3,5;5;2,9;2;1;1
252856978411;252856978417;6;0,1,2,3,5;5;2,9;2;1;1
252856978417;252856978429;12;0,1,2,3,5;5;2,9;2;1;1
252856978429;252856978434;5;0,1,2,3,5;5;2,9;2;1;1
252856978434;252856978455;21;0,1,2,3,5;5;2,9;2;1;1
252856978455;252856978460;5;0,1,2,3,5;5;2,9;2;1;1
252856978460;252856978462;2;0,1,2,3,5;5;2,9;2;1;1
252856978462;252856978479;17;0,1,2,3,5;5;2,9;2;1;1
252856978479;252856978486;7;0,1,2,3,5;5;2,9;2;1;1
252856978486;252856978487;1;0,1,2,3,5;5;2,9;2;1;1
252856978487;252856978492;5;0,1,2,3,5;5;2,9;2;1;1
252856978492;252856978496;4;0,1,2,3,5;5;2,9;2;1;1
252856978496;252856978499;3;0,1,2,3,5;5;2,9;2;1;1
252856978499;252856978500;1;0,1,2,3,5;5;2,9;2;1;1
252856978500;252856978518;18;0,1,2,3,5;5;2,9;2;1;1
252856978518;252856978522;4;0,1,2,3,5;5;2,9;2;1;1
252856978522;252856978530;8;0,1,2,3,5;5;2,9;2;1;1
252856978530;252856978532;2;0,1,2,3,5;5;2,9;2;1;1
252856978532;252856978535;3;0,1,2,3,5;5;2,9;2;1;1
252856978535;252856978547;12;0,1,2,3,5;5;2,9;2;1;1
252856978547;252856978549;2;0,1,2,3,5;5;2,9;2;1;1
252856978549;252856978563;14;0,1,2,3,5;5;2,9;2;1;1
252856978563;252856978573;10;0,1,2,3,5;5;2,9;2;1;1
252856978573;252856978577;4;0,1,2,3,5;5;2,9;2;1;1
252856978577;252856978599;22;0,1,2,3,5;5;2,9;2;1;1
252856978599;252856978600;1;0,1,2,3,5;5;2,9;2;1;1
252856978600;252856978608;8;0,1,2,3,5;5;2,9;2;1;1
252856978608;252856978609;1;0,1,2,3,5;5;2,9;2;1;1
252856978609;252856978610;1;0,1,2,3,5;5;2,9;2;1;1
252856978610;252856978614;4;0,1,2,3,5;5;2,9;2;1;1
252856978614;252856978620;6;0,1,2,3,5;5;2,9;2;1;1
252856978620;252856978625;5;0,1,2,3,5;5;2,9;2;1;1
252856978625;252856978632;7;0,1,2,3,5;5;2,9;2;1;1
252856978632;252856978637;5;0,1,2,3,5;5;2,9;2;1;1
252856978637;252856978644;7;0,1,2,3,5;5;2,9;2;1;1
252856978644;252856978654;10;0,1,2,3,5;5;2,9;2;1;1
252856978654;252856978664;10;0,1,2,3,5;5;2,9;2;1;1
252856978664;252856978667;3;0,1,2,3,5;5;2,9;2;1;1
252856978667;252856978674;7;0,1,2,3,5;5;2,9;2;1;1
252856978674;252856978680;6;0,1,2,3,5;5;2,9;2;1;1
252856978680;252856978683;3;0,1,2,3,5;5;2,9;2;1;1
252856978683;252856978685;2;0,1,2,3,5;5;2,9;2;1;1
252856978685;252856978703;18;0,1,2,3,5;5;2,9;2;1;1
252856978703;252856978704;1;0,1,2,3,5;5;2,9;2;1;1
252856978704;252856978706;2;0,1,2,3,5;5;2,9;2;1;1
252856978706;252856978711;5;0,1,2,3,5;5;2,9;2;1;1
252856978711;252856978713;2;0,1,2,3,5;5;2,9;2;1;1
252856978713;252856978714;1;0,1,2,3,5;5;2,9;2;1;1
252856978714;252856978716;2;0,1,2,3,5;5;2,9;2;1;1
252856978716;252856978725;9;0,1,2,3,5;5;2,9;2;1;1
252856978725;252856978726;1;0,1,2,3,5;5;2,9;2;1;1
252856978726;252856978728;2;0,1,2,3,5;5;2,9;2;1;1
252856978728;252856978756;28;0,1,2,3,5;5;2,9;2;1;1
252856978756;252856978786;30;0,1,2,3,5;5;2,9;2;1;1
252856978786;252856978789;3;0,1,2,3,5;5;2,9;2;1;1
252856978789;252856978793;4;0,1,2,3,5;5;2,9;2;1;1
252856978793;252856978795;2;0,1,2,3,5;5;2,9;2;1;1
252856978795;252856978796;1;0,1,2,3,5;5;2,9;2;1;1
252856978796;252856978797;1;0,1,2,3,5;5;2,9;2;1;1
252856978797;252856978821;24;0,1,2,3,5;5;2,9;2;1;1
252856978821;252856978828;7;0,1,2,3,5;5;2,9;2;1;1
252856978828;252856978829;1;0,1,2,3,5;5;2,9;2;1;1
252856978829;252856978860;31;0,1,2,3,5;5;2,9;2;1;1
252856978860;252856978863;3;0,1,2,3,5;5;2,9;2;1;1
252856978863;252856978872;9;0,1,2,3,5;5;2,9;2;1;1
252856978872;252856978874;2;0,1,2,3,5;5;2,9;2;1;1
252856978874;252856978886;12;0,1,2,3,5;5;2,9;2;1;1
252856978886;252856978893;7;0,1,2,3,5;5;2,9;2;1;1
252856978893;252856978898;5;0,1,2,3,5;5;2,9;2;1;1
252856978898;252856978914;16;0,1,2,3,5;5;2,9;2;1;1
252856978914;252856978951;37;0,1,2,3,5;5;2,9;2;1;1
252856978951;252856978952;1;0,1,2,3,5;5;2,9;2;1;1
252856978952;252856978961;9;0,1,2,3,5;5;2,9;2;1;1
252856978961;252856978974;13;0,1,2,3,5;5;2,9;2;1;1
252856978974;252856978977;3;0,1,2,3,5;5;2,9;2;1;1
252856978977;252856978981;4;0,1,2,3,5;5;2,9;2;1;1
252856978981;252856978984;3;0,1,2,3,5;5;2,9;2;1;1
252856978984;252856978987;3;0,1,2,3,5;5;2,9;2;1;1
252856978987;252856978992;5;0,1,2,3,5;5;2,9;2;1;1
252856978992;252856978994;2;0,1,2,3,5;5;2,9;2;1;1
252856978994;252856979009;15;0,1,2,3,5;5;2,9;2;1;1
252856979009;252856979012;3;0,1,2,3,5;5;2,9;2;1;1
252856979012;252856979017;5;0,1,2,3,5;5;2,9;2;1;1
252856979017;252856979021;4;0,1,2,3,5;5;2,9;2;1;1
252856979021;252856979031;10;0,1,2,3,5;5;2,9;2;1;1
252856979031;252856979049;18;0,1,2,3,5;5;2,9;2;1;1
252856979049;252856979079;30;0,1,2,3,5;5;2,9;2;1;1
252856979079;252856979081;2;0,1,2,3,5;5;2,9;2;1;1
252856979081;252856979092;11;0,1,2,3,5;5;2,9;2;1;1
252856979092;252856979093;1;0,1,2,3,5;5;2,9;2;1;1
252856979093;252856979094;1;0,1,2,3,5;5;2,9;2;1;1
252856979094;252856979096;2;0,1,2,3,5;5;2,9;2;1;1
252856979096;252856979130;34;0,1,2,3,5;5;2,9;2;1;1
252856979130;252856979147;17;0,1,2,3,5;5;2,9;2;1;1
252856979147;252856979149;2;0,1,2,3,5;5;2,9;2;1;1
252856979149;252856979160;11;0,1,2,3,5;5;2,9;2;1;1
252856979160;252856979164;4;0,1,2,3,5;5;2,9;2;1;1
252856979164;252856979171;7;0,1,2,3,5;5;2,9;2;1;1
252856979171;252856979173;2;0,1,2,3,5;5;2,9;2;1;1
252856979173;252856979190;17;0,1,2,3,5;5;2,9;2;1;1
252856979190;252856979196;6;0,1,2,3,5;5;2,9;2;1;1
252856979196;252856979221;25;0,1,2,3,5;5;2,9;2;1;1
252856979221;252856979228;7;0,1,2,3,5;5;2,9;2;1;1
252856979228;252856979234;6;0,1,2,3,5;5;2,9;2;1;1
252856979234;252856979250;16;0,1,2,3,5;5;2,9;2;1;1
252856979250;252856979252;2;0,1,2,3,5;5;2,9;2;1;1
252856979252;252856979257;5;0,1,2,3,5;5;2,9;2;1;1
252856979257;252856979264;7;0,1,2,3,5;5;2,9;2;1;1
252856979264;252856979271;7;0,1,2,3,5;5;2,9;2;1;1
252856979271;252856979279;8;0,1,2,3,5;5;2,9;2;1;1
252856979279;252856979290;11;0,1,2,3,5;5;2,9;2;1;1
252856979290;252856979315;25;0,1,2,3,5;5;2,9;2;1;1
252856979315;252856979318;3;0,1,2,3,5;5;2,9;2;1;1
252856979318;252856979384;66;0,1,2,3,5;5;2,9;2;1;1
252856979384;252856979387;3;0,1,2,3,5;5;2,9;2;1;1
252856979387;252856979391;4;0,1,2,3,5;5;2,9;2;1;1
252856979391;252856979398;7;0,1,2,3,5;5;2,9;2;1;1
252856979398;252856979415;17;0,1,2,3,5;5;2,9;2;1;1
252856979415;252856979429;14;0,1,2,3,5;5;2,9;2;1;1
252856979429;252856979472;43;0,1,2,3,5;5;2,9;2;1;1
252856979472;252856979491;19;0,1,2,3,5;5;2,9;2;1;1
252856979491;252856979493;2;0,1,2,3,5;5;2,9;2;1;1
252856979493;252856979504;11;0,1,2,3,5;5;2,9;2;1;1
252856979504;252856979510;6;0,1,2,3,5;5;2,9;2;1;1
252856979510;252856979518;8;0,1,2,3,5;5;2,9;2;1;1
252856979518;252856979526;8;0,1,2,3,5;5;2,9;2;1;1
252856979526;252856979542;16;0,1,2,3,5;5;2,9;2;1;1
252856979542;252856979554;12;0,1,2,3,5;5;2,9;2;1;1
252856979554;252856979555;1;0,1,2,3,5;5;2,9;2;1;1
252856979555;252856979560;5;0,1,2,3,5;5;2,9;2;1;1
252856979560;252856979566;6;0,1,2,3,5;5;2,9;2;1;1
252856979566;252856979568;2;0,1,2,3,5;5;2,9;2;1;1
252856979568;252856979583;15;0,1,2,3,5;5;2,9;2;1;1
252856979583;252856979584;1;0,1,2,3,5;5;2,9;2;1;1
252856979584;252856979586;2;0,1,2,3,5;5;2,9;2;1;1
252856979586;252856979596;10;0,1,2,3,5;5;2,9;2;1;1
252856979596;252856979627;31;0,1,2,3,5;5;2,9;2;1;1
252856979627;252856979631;4;0,1,2,3,5;5;2,9;2;1;1
252856979631;252856979637;6;0,1,2,3,5;5;2,9;2;1;1
252856979637;252856979640;3;0,1,2,3,5;5;2,9;2;1;1
252856979640;252856979641;1;0,1,2,3,5;5;2,9;2;1;1
252856979641;252856979652;11;0,1,2,3,5;5;2,9;2;1;1
252856979652;252856979653;1;0,1,2,3,5;5;2,9;2;1;1
252856979653;252856979662;9;0,1,2,3,5;5;2,9;2;1;1
252856979662;252856979664;2;0,1,2,3,5;5;2,9;2;1;1
252856979664;252856979667;3;0,1,2,3,5;5;2,9;2;1;1
252856979667;252856979669;2;0,1,2,3,5;5;2,9;2;1;1
252856979669;252856979670;1;0,1,2,3,5;5;2,9;2;1;1
252856979670;252856979679;9;0,1,2,3,5;5;2,9;2;1;1
252856979679;252856979681;2;0,1,2,3,5;5;2,9;2;1;1
252856979681;252856979694;13;0,1,2,3,5;5;2,9;2;1;1
252856979694;252856979695;1;0,1,2,3,5;5;2,9;2;1;1
252856979695;252856979699;4;0,1,2,3,5;5;2,9;2;1;1
252856979699;252856979708;9;0,1,2,3,5;5;2,9;2;1;1
252856979708;252856979709;1;0,1,2,3,5;5;2,9;2;1;1
252856979709;252856979711;2;0,1,2,3,5;5;2,9;2;1;1
252856979711;252856979716;5;0,1,2,3,5;5;2,9;2;1;1
252856979716;252856979740;24;0,1,2,3,5;5;2,9;2;1;1
252856979740;252856979743;3;0,1,2,3,5;5;2,9;2;1;1
252856979743;252856979747;4;0,1,2,3,5;5;2,9;2;1;1
252856979747;252856979748;1;0,1,2,3,5;5;2,9;2;1;1
252856979748;252856979750;2;0,1,2,3,5;5;2,9;2;1;1
252856979750;252856979756;6;0,1,2,3,5;5;2,9;2;1;1
252856979756;252856979760;4;0,1,2,3,5;5;2,9;2;1;1
252856979760;252856979769;9;0,1,2,3,5;5;2,9;2;1;1
252856979769;252856979777;8;0,1,2,3,5;5;2,9;2;1;1
252856979777;252856979778;1;0,1,2,3,5;5;2,9;2;1;1
252856979778;252856979784;6;0,1,2,3,5;5;2,9;2;1;1
252856979784;252856979794;10;0,1,2,3,5;5;2,9;2;1;1
252856979794;252856979802;8;0,1,2,3,5;5;2,9;2;1;1
252856979802;252856979804;2;0,1,2,3,5;5;2,9;2;1;1
252856979804;252856979811;7;0,1,2,3,5;5;2,9;2;1;1
252856979811;252856979825;14;0,1,2,3,5;5;2,9;2;1;1
252856979825;252856979826;1;0,1,2,3,5;5;2,9;2;1;1
252856979826;252856979835;9;0,1,2,3,5;5;2,9;2;1;1
252856979835;252856979836;1;0,1,2,3,5;5;2,9;2;1;1
252856979836;252856979844;8;0,1,2,3,5;5;2,9;2;1;1
252856979844;252856979846;2;0,1,2,3,5;5;2,9;2;1;1
252856979846;252856979850;4;0,1,2,3,5;5;2,9;2;1;1
252856979850;252856979853;3;0,1,2,3,5;5;2,9;2;1;1
252856979853;252856979863;10;0,1,2,3,5;5;2,9;2;1;1
252856979863;252856979864;1;0,1,2,3,5;5;2,9;2;1;1
252856979864;252856979868;4;0,1,2,3,5;5;2,9;2;1;1
252856979868;252856979873;5;0,1,2,3,5;5;2,9;2;1;1
252856979873;252856979874;1;0,1,2,3,5;5;2,9;2;1;1
252856979874;252856979885;11;0,1,2,3,5;5;2,9;2;1;1
252856979885;252856979888;3;0,1,2,3,5;5;2,9;2;1;1
252856979888;252856979889;1;0,1,2,3,5;5;2,9;2;1;1
252856979889;252856979890;1;0,1,2,3,5;5;2,9;2;1;1
252856979890;252856979895;5;0,1,2,3,5;5;2,9;2;1;1
252856979895;252856979896;1;0,1,2,3,5;5;2,9;2;1;1
252856979896;252856979911;15;0,1,2,3,5;5;2,9;2;1;1
252856979911;252856979916;5;0,1,2,3,5;5;2,9;2;1;1
252856979916;252856979917;1;0,1,2,3,5;5;2,9;2;1;1
252856979917;252856979946;29;0,1,2,3,5;5;2,9;2;1;1
252856979946;252856979955;9;0,1,2,3,5;5;2,9;2;1;1
252856979955;252856979962;7;0,1,2,3,5;5;2,9;2;1;1
252856979962;252856979973;11;0,1,2,3,5;5;2,9;2;1;1
252856979973;252856979979;6;0,1,2,3,5;5;2,9;2;1;1
252856979979;252856979985;6;0,1,2,3,5;5;2,9;2;1;1
252856979985;252856979989;4;0,1,2,3,5;5;2,9;2;1;1
252856979989;252856980016;27;0,1,2,3,5;5;2,9;2;1;1
252856980016;252856980038;22;0,1,2,3,5;5;2,9;2;1;1
252856980038;252856980044;6;0,1,2,3,5;5;2,9;2;1;1
252856980044;252856980059;15;0,1,2,3,5;5;2,9;2;1;1
252856980059;252856980066;7;0,1,2,3,5;5;2,9;2;1;1
252856980066;252856980075;9;0,1,2,3,5;5;2,9;2;1;1
252856980075;252856980090;15;0,1,2,3,5;5;2,9;2;1;1
252856980090;252856980104;14;0,1,2,3,5;5;2,9;2;1;1
252856980104;252856980109;5;0,1,2,3,5;5;2,9;2;1;1
252856980109;252856980116;7;0,1,2,3,5;5;2,9;2;1;1
252856980116;252856980126;10;0,1,2,3,5;5;2,9;2;1;1
252856980126;252856980131;5;0,1,2,3,5;5;2,9;2;1;1
252856980131;252856980158;27;0,1,2,3,5;5;2,9;2;1;1
252856980158;252856980163;5;0,1,2,3,5;5;2,9;2;1;1
252856980163;252856980174;11;0,1,2,3,5;5;2,9;2;1;1
252856980174;252856980220;46;0,1,2,3,5;5;2,9;2;1;1
252856980220;252856980221;1;0,1,2,3,5;5;2,9;2;1;1
252856980221;252856980228;7;0,1,2,3,5;5;2,9;2;1;1
252856980228;252856980229;1;0,1,2,3,5;5;2,9;2;1;1
252856980229;252856980230;1;0,1,2,3,5;5;2,9;2;1;1
252856980230;252856980237;7;0,1,2,3,5;5;2,9;2;1;1
252856980237;252856980240;3;0,1,2,3,5;5;2,9;2;1;1
252856980240;252856980242;2;0,1,2,3,5;5;2,9;2;1;1
252856980242;252856980243;1;0,1,2,3,5;5;2,9;2;1;1
252856980243;252856980256;13;0,1,2,3,5;5;2,9;2;1;1
252856980256;252856980269;13;0,1,2,3,5;5;2,9;2;1;1
252856980269;252856980285;16;0,1,2,3,5;5;2,9;2;1;1
252856980285;252856980296;11;0,1,2,3,5;5;2,9;2;1;1
252856980296;252856980297;1;0,1,2,3,5;5;2,9;2;1;1
252856980297;252856980301;4;0,1,2,3,5;5;2,9;2;1;1
252856980301;252856980337;36;0,1,2,3,5;5;2,9;2;1;1
252856980337;252856980353;16;0,1,2,3,5;5;2,9;2;1;1
252856980353;252856980354;1;0,1,2,3,5;5;2,9;2;1;1
252856980354;252856980364;10;0,1,2,3,5;5;2,9;2;1;1
252856980364;252856980371;7;0,1,2,3,5;5;2,9;2;1;1
252856980371;252856980373;2;0,1,2,3,5;5;2,9;2;1;1
252856980373;252856980388;15;0,1,2,3,5;5;2,9;2;1;1
252856980388;252856980401;13;0,1,2,3,5;5;2,9;2;1;1
252856980401;252856980403;2;0,1,2,3,5;5;2,9;2;1;1
252856980403;252856980407;4;0,1,2,3,5;5;2,9;2;1;1
252856980407;252856980416;9;0,1,2,3,5;5;2,9;2;1;1
252856980416;252856980423;7;0,1,2,3,5;5;2,9;2;1;1
252856980423;252856980431;8;0,1,2,3,5;5;2,9;2;1;1
252856980431;252856980450;19;0,1,2,3,5;5;2,9;2;1;1
252856980450;252856980452;2;0,1,2,3,5;5;2,9;2;1;1
252856980452;252856980475;23;0,1,2,3,5;5;2,9;2;1;1
252856980475;252856980478;3;0,1,2,3,5;5;2,9;2;1;1
252856980478;252856980480;2;0,1,2,3,5;5;2,9;2;1;1
252856980480;252856980494;14;0,1,2,3,5;5;2,9;2;1;1
252856980494;252856980503;9;0,1,2,3,5;5;2,9;2;1;1
252856980503;252856980506;3;0,1,2,3,5;5;2,9;2;1;1
252856980506;252856980519;13;0,1,2,3,5;5;2,9;2;1;1
252856980519;252856980525;6;0,1,2,3,5;5;2,9;2;1;1
252856980525;252856980561;36;0,1,2,3,5;5;2,9;2;1;1
252856980561;252856980568;7;0,1,2,3,5;5;2,9;2;1;1
252856980568;252856980570;2;0,1,2,3,5;5;2,9;2;1;1
252856980570;252856980576;6;0,1,2,3,5;5;2,9;2;1;1
252856980576;252856980587;11;0,1,2,3,5;5;2,9;2;1;1
252856980587;252856980588;1;0,1,2,3,5;5;2,9;2;1;1
252856980588;252856980596;8;0,1,2,3,5;5;2,9;2;1;1
252856980596;252856980598;2;0,1,2,3,5;5;2,9;2;1;1
252856980598;252856980600;2;0,1,2,3,5;5;2,9;2;1;1
252856980600;252856980616;16;0,1,2,3,5;5;2,9;2;1;1
252856980616;252856980618;2;0,1,2,3,5;5;2,9;2;1;1
252856980618;252856980626;8;0,1,2,3,5;5;2,9;2;1;1
252856980626;252856980645;19;0,1,2,3,5;5;2,9;2;1;1
252856980645;252856980651;6;0,1,2,3,5;5;2,9;2;1;1
252856980651;252856980660;9;0,1,2,3,5;5;2,9;2;1;1
252856980660;252856980663;3;0,1,2,3,5;5;2,9;2;1;1
252856980663;252856980672;9;0,1,2,3,5;5;2,9;2;1;1
252856980672;252856980681;9;0,1,2,3,5;5;2,9;2;1;1
252856980681;252856980682;1;0,1,2,3,5;5;2,9;2;1;1
252856980682;252856980690;8;0,1,2,3,5;5;2,9;2;1;1
252856980690;252856980692;2;0,1,2,3,5;5;2,9;2;1;1
252856980692;252856980708;16;0,1,2,3,5;5;2,9;2;1;1
252856980708;252856980711;3;0,1,2,3,5;5;2,9;2;1;1
252856980711;252856980719;8;0,1,2,3,5;5;2,9;2;1;1
252856980719;252856980723;4;0,1,2,3,5;5;2,9;2;1;1
252856980723;252856980739;16;0,1,2,3,5;5;2,9;2;1;1
252856980739;252856980742;3;0,1,2,3,5;5;2,9;2;1;1
252856980742;252856980746;4;0,1,2,3,5;5;2,9;2;1;1
252856980746;252856980751;5;0,1,2,3,5;5;2,9;2;1;1
252856980751;252856980760;9;0,1,2,3,5;5;2,9;2;1;1
252856980760;252856980766;6;0,1,2,3,5;5;2,9;2;1;1
252856980766;252856980767;1;0,1,2,3,5;5;2,9;2;1;1
252856980767;252856980771;4;0,1,2,3,5;5;2,9;2;1;1
252856980771;252856980774;3;0,1,2,3,5;5;2,9;2;1;1
252856980774;252856980778;4;0,1,2,3,5;5;2,9;2;1;1
252856980778;252856980784;6;0,1,2,3,5;5;2,9;2;1;1
252856980784;252856980786;2;0,1,2,3,5;5;2,9;2;1;1
252856980786;252856980790;4;0,1,2,3,5;5;2,9;2;1;1
252856980790;252856980813;23;0,1,2,3,5;5;2,9;2;1;1
252856980813;252856980822;9;0,1,2,3,5;5;2,9;2;1;1
252856980822;252856980825;3;0,1,2,3,5;5;2,9;2;1;1
252856980825;252856980833;8;0,1,2,3,5;5;2,9;2;1;1
252856980833;252856980851;18;0,1,2,3,5;5;2,9;2;1;1
252856980851;252856980856;5;0,1,2,3,5;5;2,9;2;1;1
252856980856;252856980859;3;0,1,2,3,5;5;2,9;2;1;1
252856980859;252856980863;4;0,1,2,3,5;5;2,9;2;1;1
252856980863;252856980865;2;0,1,2,3,5;5;2,9;2;1;1
252856980865;252856980881;16;0,1,2,3,5;5;2,9;2;1;1
252856980881;252856980895;14;0,1,2,3,5;5;2,9;2;1;1
252856980895;252856980899;4;0,1,2,3,5;5;2,9;2;1;1
252856980899;252856980908;9;0,1,2,3,5;5;2,9;2;1;1
252856980908;252856980916;8;0,1,2,3,5;5;2,9;2;1;1
252856980916;252856980923;7;0,1,2,3,5;5;2,9;2;1;1
252856980923;252856980926;3;0,1,2,3,5;5;2,9;2;1;1
252856980926;252856980927;1;0,1,2,3,5;5;2,9;2;1;1
252856980927;252856980934;7;0,1,2,3,5;5;2,9;2;1;1
252856980934;252856980943;9;0,1,2,3,5;5;2,9;2;1;1
252856980943;252856980946;3;0,1,2,3,5;5;2,9;2;1;1
252856980946;252856980957;11;0,1,2,3,5;5;2,9;2;1;1
252856980957;252856980973;16;0,1,2,3,5;5;2,9;2;1;1
252856980973;252856980983;10;0,1,2,3,5;5;2,9;2;1;1
252856980983;252856980984;1;0,1,2,3,5;5;2,9;2;1;1
252856980984;252856980986;2;0,1,2,3,5;5;2,9;2;1;1
252856980986;252856981002;16;0,1,2,3,5;5;2,9;2;1;1
252856981002;252856981005;3;0,1,2,3,5;5;2,9;2;1;1
252856981005;252856981009;4;0,1,2,3,5;5;2,9;2;1;1
252856981009;252856981017;8;0,1,2,3,5;5;2,9;2;1;1
252856981017;252856981038;21;0,1,2,3,5;5;2,9;2;1;1
252856981038;252856981053;15;0,1,2,3,5;5;2,9;2;1;1
252856981053;252856981056;3;0,1,2,3,5;5;2,9;2;1;1
252856981056;252856981069;13;0,1,2,3,5;5;2,9;2;1;1
252856981069;252856981075;6;0,1,2,3,5;5;2,9;2;1;1
252856981075;252856981076;1;0,1,2,3,5;5;2,9;2;1;1
252856981076;252856981080;4;0,1,2,3,5;5;2,9;2;1;1
252856981080;252856981088;8;0,1,2,3,5;5;2,9;2;1;1
252856981088;252856981107;19;0,1,2,3,5;5;2,9;2;1;1
252856981107;252856981108;1;0,1,2,3,5;5;2,9;2;1;1
252856981108;252856981114;6;0,1,2,3,5;5;2,9;2;1;1
252856981114;252856981115;1;0,1,2,3,5;5;2,9;2;1;1
252856981115;252856981124;9;0,1,2,3,5;5;2,9;2;1;1
252856981124;252856981125;1;0,1,2,3,5;5;2,9;2;1;1
252856981125;252856981128;3;0,1,2,3,5;5;2,9;2;1;1
252856981128;252856981135;7;0,1,2,3,5;5;2,9;2;1;1
252856981135;252856981136;1;0,1,2,3,5;5;2,9;2;1;1
252856981136;252856981141;5;0,1,2,3,5;5;2,9;2;1;1
252856981141;252856981152;11;0,1,2,3,5;5;2,9;2;1;1
252856981152;252856981170;18;0,1,2,3,5;5;2,9;2;1;1
252856981170;252856981184;14;0,1,2,3,5;5;2,9;2;1;1
252856981184;252856981187;3;0,1,2,3,5;5;2,9;2;1;1
252856981187;252856981204;17;0,1,2,3,5;5;2,9;2;1;1
252856981204;252856981205;1;0,1,2,3,5;5;2,9;2;1;1
252856981205;252856981211;6;0,1,2,3,5;5;2,9;2;1;1
252856981211;252856981215;4;0,1,2,3,5;5;2,9;2;1;1
252856981215;252856981224;9;0,1,2,3,5;5;2,9;2;1;1
252856981224;252856981227;3;0,1,2,3,5;5;2,9;2;1;1
252856981227;252856981231;4;0,1,2,3,5;5;2,9;2;1;1
252856981231;252856981232;1;0,1,2,3,5;5;2,9;2;1;1
252856981232;252856981242;10;0,1,2,3,5;5;2,9;2;1;1
252856981242;252856981244;2;0,1,2,3,5;5;2,9;2;1;1
252856981244;252856981245;1;0,1,2,3,5;5;2,9;2;1;1
252856981245;252856981251;6;0,1,2,3,5;5;2,9;2;1;1
252856981251;252856981260;9;0,1,2,3,5;5;2,9;2;1;1
252856981260;252856981266;6;0,1,2,3,5;5;2,9;2;1;1
252856981266;252856981279;13;0,1,2,3,5;5;2,9;2;1;1
252856981279;252856981281;2;0,1,2,3,5;5;2,9;2;1;1
252856981281;252856981282;1;0,1,2,3,5;5;2,9;2;1;1
252856981282;252856981309;27;0,1,2,3,5;5;2,9;2;1;1
252856981309;252856981310;1;0,1,2,3,5;5;2,9;2;1;1
252856981310;252856981315;5;0,1,2,3,5;5;2,9;2;1;1
252856981315;252856981337;22;0,1,2,3,5;5;2,9;2;1;1
252856981337;252856981338;1;0,1,2,3,5;5;2,9;2;1;1
252856981338;252856981345;7;0,1,2,3,5;5;2,9;2;1;1
252856981345;252856981361;16;0,1,2,3,5;5;2,9;2;1;1
252856981361;252856981364;3;0,1,2,3,5;5;2,9;2;1;1
252856981364;252856981372;8;0,1,2,3,5;5;2,9;2;1;1
252856981372;252856981377;5;0,1,2,3,5;5;2,9;2;1;1
252856981377;252856981384;7;0,1,2,3,5;5;2,9;2;1;1
252856981384;252856981415;31;0,1,2,3,5;5;2,9;2;1;1
252856981415;252856981418;3;0,1,2,3,5;5;2,9;2;1;1
252856981418;252856981427;9;0,1,2,3,5;5;2,9;2;1;1
252856981427;252856981432;5;0,1,2,3,5;5;2,9;2;1;1
252856981432;252856981434;2;0,1,2,3,5;5;2,9;2;1;1
252856981434;252856981445;11;0,1,2,3,5;5;2,9;2;1;1
252856981445;252856981446;1;0,1,2,3,5;5;2,9;2;1;1
252856981446;252856981456;10;0,1,2,3,5;5;2,9;2;1;1
252856981456;252856981470;14;0,1,2,3,5;5;2,9;2;1;1
252856981470;252856981472;2;0,1,2,3,5;5;2,9;2;1;1
252856981472;252856981474;2;0,1,2,3,5;5;2,9;2;1;1
252856981474;252856981495;21;0,1,2,3,5;5;2,9;2;1;1
252856981495;252856981501;6;0,1,2,3,5;5;2,9;2;1;1
252856981501;252856981505;4;0,1,2,3,5;5;2,9;2;1;1
252856981505;252856981512;7;0,1,2,3,5;5;2,9;2;1;1
252856981512;252856981514;2;0,1,2,3,5;5;2,9;2;1;1
252856981514;252856981522;8;0,1,2,3,5;5;2,9;2;1;1
252856981522;252856981532;10;0,1,2,3,5;5;2,9;2;1;1
252856981532;252856981539;7;0,1,2,3,5;5;2,9;2;1;1
252856981539;252856981544;5;0,1,2,3,5;5;2,9;2;1;1
252856981544;252856981547;3;0,1,2,3,5;5;2,9;2;1;1
252856981547;252856981560;13;0,1,2,3,5;5;2,9;2;1;1
252856981560;252856981564;4;0,1,2,3,5;5;2,9;2;1;1
252856981564;252856981586;22;0,1,2,3,5;5;2,9;2;1;1
252856981586;252856981612;26;0,1,2,3,5;5;2,9;2;1;1
252856981612;252856981613;1;0,1,2,3,5;5;2,9;2;1;1
252856981613;252856981651;38;0,1,2,3,5;5;2,9;2;1;1
252856981651;252856981663;12;0,1,2,3,5;5;2,9;2;1;1
252856981663;252856981673;10;0,1,2,3,5;5;2,9;2;1;1
252856981673;252856981704;31;0,1,2,3,5;5;2,9;2;1;1
252856981704;252856981708;4;0,1,2,3,5;5;2,9;2;1;1
252856981708;252856981715;7;0,1,2,3,5;5;2,9;2;1;1
252856981715;252856981717;2;0,1,2,3,5;5;2,9;2;1;1
252856981717;252856981733;16;0,1,2,3,5;5;2,9;2;1;1
252856981733;252856981740;7;0,1,2,3,5;5;2,9;2;1;1
252856981740;252856981745;5;0,1,2,3,5;5;2,9;2;1;1
252856981745;252856981752;7;0,1,2,3,5;5;2,9;2;1;1
252856981752;252856981768;16;0,1,2,3,5;5;2,9;2;1;1
252856981768;252856981774;6;0,1,2,3,5;5;2,9;2;1;1
252856981774;252856981775;1;0,1,2,3,5;5;2,9;2;1;1
252856981775;252856981784;9;0,1,2,3,5;5;2,9;2;1;1
252856981784;252856981802;18;0,1,2,3,5;5;2,9;2;1;1
252856981802;252856981813;11;0,1,2,3,5;5;2,9;2;1;1
252856981813;252856981832;19;0,1,2,3,5;5;2,9;2;1;1
252856981832;252856981839;7;0,1,2,3,5;5;2,9;2;1;1
252856981839;252856981861;22;0,1,2,3,5;5;2,9;2;1;1
252856981861;252856981867;6;0,1,2,3,5;5;2,9;2;1;1
252856981867;252856981874;7;0,1,2,3,5;5;2,9;2;1;1
252856981874;252856981890;16;0,1,2,3,5;5;2,9;2;1;1
252856981890;252856981911;21;0,1,2,3,5;5;2,9;2;1;1
252856981911;252856981917;6;0,1,2,3,5;5;2,9;2;1;1
252856981917;252856981920;3;0,1,2,3,5;5;2,9;2;1;1
252856981920;252856981932;12;0,1,2,3,5;5;2,9;2;1;1
252856981932;252856981948;16;0,1,2,3,5;5;2,9;2;1;1
252856981948;252856981960;12;0,1,2,3,5;5;2,9;2;1;1
252856981960;252856981970;10;0,1,2,3,5;5;2,9;2;1;1
252856981970;252856981975;5;0,1,2,3,5;5;2,9;2;1;1
252856981975;252856981983;8;0,1,2,3,5;5;2,9;2;1;1
252856981983;252856981987;4;0,1,2,3,5;5;2,9;2;1;1
252856981987;252856981993;6;0,1,2,3,5;5;2,9;2;1;1
252856981993;252856982001;8;0,1,2,3,5;5;2,9;2;1;1
252856982001;252856982008;7;0,1,2,3,5;5;2,9;2;1;1
252856982008;252856982009;1;0,1,2,3,5;5;2,9;2;1;1
252856982009;252856982014;5;0,1,2,3,5;5;2,9;2;1;1
252856982014;252856982019;5;0,1,2,3,5;5;2,9;2;1;1
252856982019;252856982026;7;0,1,2,3,5;5;2,9;2;1;1
252856982026;252856982027;1;0,1,2,3,5;5;2,9;2;1;1
252856982027;252856982030;3;0,1,2,3,5;5;2,9;2;1;1
252856982030;252856982034;4;0,1,2,3,5;5;2,9;2;1;1
252856982034;252856982040;6;0,1,2,3,5;5;2,9;2;1;1
252856982040;252856982047;7;0,1,2,3,5;5;2,9;2;1;1
252856982047;252856982049;2;0,1,2,3,5;5;2,9;2;1;1
252856982049;252856982051;2;0,1,2,3,5;5;2,9;2;1;1
252856982051;252856982058;7;0,1,2,3,5;5;2,9;2;1;1
252856982058;252856982065;7;0,1,2,3,5;5;2,9;2;1;1
252856982065;252856982066;1;0,1,2,3,5;5;2,9;2;1;1
252856982066;252856982070;4;0,1,2,3,5;5;2,9;2;1;1
252856982070;252856982071;1;0,1,2,3,5;5;2,9;2;1;1
252856982071;252856982079;8;0,1,2,3,5;5;2,9;2;1;1
252856982079;252856982080;1;0,1,2,3,5;5;2,9;2;1;1
252856982080;252856982086;6;0,1,2,3,5;5;2,9;2;1;1
252856982086;252856982087;1;0,1,2,3,5;5;2,9;2;1;1
252856982087;252856982095;8;0,1,2,3,5;5;2,9;2;1;1
252856982095;252856982105;10;0,1,2,3,5;5;2,9;2;1;1
252856982105;252856982114;9;0,1,2,3,5;5;2,9;2;1;1
252856982114;252856982123;9;0,1,2,3,5;5;2,9;2;1;1
252856982123;252856982132;9;0,1,2,3,5;5;2,9;2;1;1
252856982132;252856982143;11;0,1,2,3,5;5;2,9;2;1;1
252856982143;252856982148;5;0,1,2,3,5;5;2,9;2;1;1
252856982148;252856982149;1;0,1,2,3,5;5;2,9;2;1;1
252856982149;252856982166;17;0,1,2,3,5;5;2,9;2;1;1
252856982166;252856982169;3;0,1,2,3,5;5;2,9;2;1;1
252856982169;252856982190;21;0,1,2,3,5;5;2,9;2;1;1
252856982190;252856982197;7;0,1,2,3,5;5;2,9;2;1;1
252856982197;252856982198;1;0,1,2,3,5;5;2,9;2;1;1
252856982198;252856982205;7;0,1,2,3,5;5;2,9;2;1;1
252856982205;252856982212;7;0,1,2,3,5;5;2,9;2;1;1
252856982212;252856982214;2;0,1,2,3,5;5;2,9;2;1;1
252856982214;252856982217;3;0,1,2,3,5;5;2,9;2;1;1
252856982217;252856982231;14;0,1,2,3,5;5;2,9;2;1;1
252856982231;252856982232;1;0,1,2,3,5;5;2,9;2;1;1
252856982232;252856982239;7;0,1,2,3,5;5;2,9;2;1;1
252856982239;252856982245;6;0,1,2,3,5;5;2,9;2;1;1
252856982245;252856982261;16;0,1,2,3,5;5;2,9;2;1;1
252856982261;252856982271;10;0,1,2,3,5;5;2,9;2;1;1
252856982271;252856982277;6;0,1,2,3,5;5;2,9;2;1;1
252856982277;252856982280;3;0,1,2,3,5;5;2,9;2;1;1
252856982280;252856982296;16;0,1,2,3,5;5;2,9;2;1;1
252856982296;252856982300;4;0,1,2,3,5;5;2,9;2;1;1
252856982300;252856982313;13;0,1,2,3,5;5;2,9;2;1;1
252856982313;252856982314;1;0,1,2,3,5;5;2,9;2;1;1
252856982314;252856982326;12;0,1,2,3,5;5;2,9;2;1;1
252856982326;252856982328;2;0,1,2,3,5;5;2,9;2;1;1
252856982328;252856982335;7;0,1,2,3,5;5;2,9;2;1;1
252856982335;252856982351;16;0,1,2,3,5;5;2,9;2;1;1
252856982351;252856982374;23;0,1,2,3,5;5;2,9;2;1;1
252856982374;252856982378;4;0,1,2,3,5;5;2,9;2;1;1
252856982378;252856982393;15;0,1,2,3,5;5;2,9;2;1;1
252856982393;252856982397;4;0,1,2,3,5;5;2,9;2;1;1
252856982397;252856982401;4;0,1,2,3,5;5;2,9;2;1;1
252856982401;252856982407;6;0,1,2,3,5;5;2,9;2;1;1
252856982407;252856982413;6;0,1,2,3,5;5;2,9;2;1;1
252856982413;252856982419;6;0,1,2,3,5;5;2,9;2;1;1
252856982419;252856982430;11;0,1,2,3,5;5;2,9;2;1;1
252856982430;252856982446;16;0,1,2,3,5;5;2,9;2;1;1
252856982446;252856982457;11;0,1,2,3,5;5;2,9;2;1;1
252856982457;252856982458;1;0,1,2,3,5;5;2,9;2;1;1
252856982458;252856982464;6;0,1,2,3,5;5;2,9;2;1;1
252856982464;252856982478;14;0,1,2,3,5;5;2,9;2;1;1
252856982478;252856982494;16;0,1,2,3,5;5;2,9;2;1;1
252856982494;252856982499;5;0,1,2,3,5;5;2,9;2;1;1
252856982499;252856982500;1;0,1,2,3,5;5;2,9;2;1;1
252856982500;252856982506;6;0,1,2,3,5;5;2,9;2;1;1
252856982506;252856982518;12;0,1,2,3,5;5;2,9;2;1;1
252856982518;252856982523;5;0,1,2,3,5;5;2,9;2;1;1
252856982523;252856982542;19;0,1,2,3,5;5;2,9;2;1;1
252856982542;252856982552;10;0,1,2,3,5;5;2,9;2;1;1
252856982552;252856982553;1;0,1,2,3,5;5;2,9;2;1;1
252856982553;252856982566;13;0,1,2,3,5;5;2,9;2;1;1
252856982566;252856982579;13;0,1,2,3,5;5;2,9;2;1;1
252856982579;252856982585;6;0,1,2,3,5;5;2,9;2;1;1
252856982585;252856982600;15;0,1,2,3,5;5;2,9;2;1;1
252856982600;252856982605;5;0,1,2,3,5;5;2,9;2;1;1
252856982605;252856982609;4;0,1,2,3,5;5;2,9;2;1;1
252856982609;252856982611;2;0,1,2,3,5;5;2,9;2;1;1
252856982611;252856982618;7;0,1,2,3,5;5;2,9;2;1;1
252856982618;252856982619;1;0,1,2,3,5;5;2,9;2;1;1
252856982619;252856982633;14;0,1,2,3,5;5;2,9;2;1;1
252856982633;252856982639;6;0,1,2,3,5;5;2,9;2;1;1
252856982639;252856982676;37;0,1,2,3,5;5;2,9;2;1;1
252856982676;252856982680;4;0,1,2,3,5;5;2,9;2;1;1
252856982680;252856982689;9;0,1,2,3,5;5;2,9;2;1;1
252856982689;252856982693;4;0,1,2,3,5;5;2,9;2;1;1
252856982693;252856982707;14;0,1,2,3,5;5;2,9;2;1;1
252856982707;252856982708;1;0,1,2,3,5;5;2,9;2;1;1
252856982708;252856982712;4;0,1,2,3,5;5;2,9;2;1;1
252856982712;252856982724;12;0,1,2,3,5;5;2,9;2;1;1
252856982724;252856982726;2;0,1,2,3,5;5;2,9;2;1;1
252856982726;252856982728;2;0,1,2,3,5;5;2,9;2;1;1
252856982728;252856982739;11;0,1,2,3,5;5;2,9;2;1;1
252856982739;252856982756;17;0,1,2,3,5;5;2,9;2;1;1
252856982756;252856982758;2;0,1,2,3,5;5;2,9;2;1;1
252856982758;252856982767;9;0,1,2,3,5;5;2,9;2;1;1
252856982767;252856982768;1;0,1,2,3,5;5;2,9;2;1;1
252856982768;252856982785;17;0,1,2,3,5;5;2,9;2;1;1
252856982785;252856982789;4;0,1,2,3,5;5;2,9;2;1;1
252856982789;252856982803;14;0,1,2,3,5;5;2,9;2;1;1
252856982803;252856982805;2;0,1,2,3,5;5;2,9;2;1;1
252856982805;252856982810;5;0,1,2,3,5;5;2,9;2;1;1
252856982810;252856982821;11;0,1,2,3,5;5;2,9;2;1;1
252856982821;252856982841;20;0,1,2,3,5;5;2,9;2;1;1
252856982841;252856982845;4;0,1,2,3,5;5;2,9;2;1;1
252856982845;252856982847;2;0,1,2,3,5;5;2,9;2;1;1
252856982847;252856982871;24;0,1,2,3,5;5;2,9;2;1;1
252856982871;252856982872;1;0,1,2,3,5;5;2,9;2;1;1
252856982872;252856982878;6;0,1,2,3,5;5;2,9;2;1;1
252856982878;252856982882;4;0,1,2,3,5;5;2,9;2;1;1
252856982882;252856982890;8;0,1,2,3,5;5;2,9;2;1;1
252856982890;252856982896;6;0,1,2,3,5;5;2,9;2;1;1
252856982896;252856982907;11;0,1,2,3,5;5;2,9;2;1;1
252856982907;252856982908;1;0,1,2,3,5;5;2,9;2;1;1
252856982908;252856982910;2;0,1,2,3,5;5;2,9;2;1;1
252856982910;252856982917;7;0,1,2,3,5;5;2,9;2;1;1
252856982917;252856982918;1;0,1,2,3,5;5;2,9;2;1;1
252856982918;252856982936;18;0,1,2,3,5;5;2,9;2;1;1
252856982936;252856982939;3;0,1,2,3,5;5;2,9;2;1;1
252856982939;252856982960;21;0,1,2,3,5;5;2,9;2;1;1
252856982960;252856982965;5;0,1,2,3,5;5;2,9;2;1;1
252856982965;252856982983;18;0,1,2,3,5;5;2,9;2;1;1
252856982983;252856982984;1;0,1,2,3,5;5;2,9;2;1;1
252856982984;252856983002;18;0,1,2,3,5;5;2,9;2;1;1
252856983002;252856983004;2;0,1,2,3,5;5;2,9;2;1;1
252856983004;252856983008;4;0,1,2,3,5;5;2,9;2;1;1
252856983008;252856983021;13;0,1,2,3,5;5;2,9;2;1;1
252856983021;252856983028;7;0,1,2,3,5;5;2,9;2;1;1
252856983028;252856983041;13;0,1,2,3,5;5;2,9;2;1;1
252856983041;252856983044;3;0,1,2,3,5;5;2,9;2;1;1
252856983044;252856983045;1;0,1,2,3,5;5;2,9;2;1;1
252856983045;252856983057;12;0,1,2,3,5;5;2,9;2;1;1
252856983057;252856983064;7;0,1,2,3,5;5;2,9;2;1;1
252856983064;252856983073;9;0,1,2,3,5;5;2,9;2;1;1
252856983073;252856983077;4;0,1,2,3,5;5;2,9;2;1;1
252856983077;252856983119;42;0,1,2,3,5;5;2,9;2;1;1
252856983119;252856983120;1;0,1,2,3,5;5;2,9;2;1;1
252856983120;252856983126;6;0,1,2,3,5;5;2,9;2;1;1
252856983126;252856983139;13;0,1,2,3,5;5;2,9;2;1;1
252856983139;252856983140;1;0,1,2,3,5;5;2,9;2;1;1
252856983140;252856983142;2;0,1,2,3,5;5;2,9;2;1;1
252856983142;252856983146;4;0,1,2,3,5;5;2,9;2;1;1
252856983146;252856983150;4;0,1,2,3,5;5;2,9;2;1;1
252856983150;252856983151;1;0,1,2,3,5;5;2,9;2;1;1
252856983151;252856983155;4;0,1,2,3,5;5;2,9;2;1;1
252856983155;252856983167;12;0,1,2,3,5;5;2,9;2;1;1
252856983167;252856983172;5;0,1,2,3,5;5;2,9;2;1;1
252856983172;252856983174;2;0,1,2,3,5;5;2,9;2;1;1
252856983174;252856983189;15;0,1,2,3,5;5;2,9;2;1;1
252856983189;252856983205;16;0,1,2,3,5;5;2,9;2;1;1
252856983205;252856983223;18;0,1,2,3,5;5;2,9;2;1;1
252856983223;252856983235;12;0,1,2,3,5;5;2,9;2;1;1
252856983235;252856983238;3;0,1,2,3,5;5;2,9;2;1;1
252856983238;252856983239;1;0,1,2,3,5;5;2,9;2;1;1
252856983239;252856983241;2;0,1,2,3,5;5;2,9;2;1;1
252856983241;252856983251;10;0,1,2,3,5;5;2,9;2;1;1
252856983251;252856983265;14;0,1,2,3,5;5;2,9;2;1;1
252856983265;252856983271;6;0,1,2,3,5;5;2,9;2;1;1
252856983271;252856983291;20;0,1,2,3,5;5;2,9;2;1;1
252856983291;252856983294;3;0,1,2,3,5;5;2,9;2;1;1
252856983294;252856983300;6;0,1,2,3,5;5;2,9;2;1;1
252856983300;252856983311;11;0,1,2,3,5;5;2,9;2;1;1
252856983311;252856983329;18;0,1,2,3,5;5;2,9;2;1;1
252856983329;252856983332;3;0,1,2,3,5;5;2,9;2;1;1
252856983332;252856983336;4;0,1,2,3,5;5;2,9;2;1;1
252856983336;252856983343;7;0,1,2,3,5;5;2,9;2;1;1
252856983343;252856983365;22;0,1,2,3,5;5;2,9;2;1;1
252856983365;252856983366;1;0,1,2,3,5;5;2,9;2;1;1
252856983366;252856983377;11;0,1,2,3,5;5;2,9;2;1;1
252856983377;252856983391;14;0,1,2,3,5;5;2,9;2;1;1
252856983391;252856983401;10;0,1,2,3,5;5;2,9;2;1;1
252856983401;252856983420;19;0,1,2,3,5;5;2,9;2;1;1
252856983420;252856983421;1;0,1,2,3,5;5;2,9;2;1;1
252856983421;252856983428;7;0,1,2,3,5;5;2,9;2;1;1
252856983428;252856983448;20;0,1,2,3,5;5;2,9;2;1;1
252856983448;252856983467;19;0,1,2,3,5;5;2,9;2;1;1
252856983467;252856983471;4;0,1,2,3,5;5;2,9;2;1;1
252856983471;252856983474;3;0,1,2,3,5;5;2,9;2;1;1
252856983474;252856983503;29;0,1,2,3,5;5;2,9;2;1;1
252856983503;252856983504;1;0,1,2,3,5;5;2,9;2;1;1
252856983504;252856983506;2;0,1,2,3,5;5;2,9;2;1;1
252856983506;252856983511;5;0,1,2,3,5;5;2,9;2;1;1
252856983511;252856983517;6;0,1,2,3,5;5;2,9;2;1;1
252856983517;252856983537;20;0,1,2,3,5;5;2,9;2;1;1
252856983537;252856983538;1;0,1,2,3,5;5;2,9;2;1;1
252856983538;252856983544;6;0,1,2,3,5;5;2,9;2;1;1
252856983544;252856983564;20;0,1,2,3,5;5;2,9;2;1;1
252856983564;252856983570;6;0,1,2,3,5;5;2,9;2;1;1
252856983570;252856983573;3;0,1,2,3,5;5;2,9;2;1;1
252856983573;252856983579;6;0,1,2,3,5;5;2,9;2;1;1
252856983579;252856983596;17;0,1,2,3,5;5;2,9;2;1;1
252856983596;252856983603;7;0,1,2,3,5;5;2,9;2;1;1
252856983603;252856983609;6;0,1,2,3,5;5;2,9;2;1;1
252856983609;252856983613;4;0,1,2,3,5;5;2,9;2;1;1
252856983613;252856983617;4;0,1,2,3,5;5;2,9;2;1;1
252856983617;252856983634;17;0,1,2,3,5;5;2,9;2;1;1
252856983634;252856983635;1;0,1,2,3,5;5;2,9;2;1;1
252856983635;252856983646;11;0,1,2,3,5;5;2,9;2;1;1
252856983646;252856983666;20;0,1,2,3,5;5;2,9;2;1;1
252856983666;252856983670;4;0,1,2,3,5;5;2,9;2;1;1
252856983670;252856983675;5;0,1,2,3,5;5;2,9;2;1;1
252856983675;252856983690;15;0,1,2,3,5;5;2,9;2;1;1
252856983690;252856983698;8;0,1,2,3,5;5;2,9;2;1;1
252856983698;252856983736;38;0,1,2,3,5;5;2,9;2;1;1
252856983736;252856983757;21;0,1,2,3,5;5;2,9;2;1;1
252856983757;252856983760;3;0,1,2,3,5;5;2,9;2;1;1
252856983760;252856983787;27;0,1,2,3,5;5;2,9;2;1;1
252856983787;252856983812;25;0,1,2,3,5;5;2,9;2;1;1
252856983812;252856983818;6;0,1,2,3,5;5;2,9;2;1;1
252856983818;252856983820;2;0,1,2,3,5;5;2,9;2;1;1
252856983820;252856983831;11;0,1,2,3,5;5;2,9;2;1;1
252856983831;252856983835;4;0,1,2,3,5;5;2,9;2;1;1
252856983835;252856983848;13;0,1,2,3,5;5;2,9;2;1;1
252856983848;252856983854;6;0,1,2,3,5;5;2,9;2;1;1
252856983854;252856983867;13;0,1,2,3,5;5;2,9;2;1;1
252856983867;252856983881;14;0,1,2,3,5;5;2,9;2;1;1
252856983881;252856983896;15;0,1,2,3,5;5;2,9;2;1;1
252856983896;252856983899;3;0,1,2,3,5;5;2,9;2;1;1
252856983899;252856983905;6;0,1,2,3,5;5;2,9;2;1;1
252856983905;252856983906;1;0,1,2,3,5;5;2,9;2;1;1
252856983906;252856983924;18;0,1,2,3,5;5;2,9;2;1;1
252856983924;252856983927;3;0,1,2,3,5;5;2,9;2;1;1
252856983927;252856983935;8;0,1,2,3,5;5;2,9;2;1;1
252856983935;252856983955;20;0,1,2,3,5;5;2,9;2;1;1
252856983955;252856983963;8;0,1,2,3,5;5;2,9;2;1;1
252856983963;252856983977;14;0,1,2,3,5;5;2,9;2;1;1
252856983977;252856983987;10;0,1,2,3,5;5;2,9;2;1;1
252856983987;252856983989;2;0,1,2,3,5;5;2,9;2;1;1
252856983989;252856983993;4;0,1,2,3,5;5;2,9;2;1;1
252856983993;252856984009;16;0,1,2,3,5;5;2,9;2;1;1
252856984009;252856984011;2;0,1,2,3,5;5;2,9;2;1;1
252856984011;252856984018;7;0,1,2,3,5;5;2,9;2;1;1
252856984018;252856984026;8;0,1,2,3,5;5;2,9;2;1;1
252856984026;252856984037;11;0,1,2,3,5;5;2,9;2;1;1
252856984037;252856984049;12;0,1,2,3,5;5;2,9;2;1;1
252856984049;252856984052;3;0,1,2,3,5;5;2,9;2;1;1
252856984052;252856984053;1;0,1,2,3,5;5;2,9;2;1;1
252856984053;252856984061;8;0,1,2,3,5;5;2,9;2;1;1
252856984061;252856984072;11;0,1,2,3,5;5;2,9;2;1;1
252856984072;252856984074;2;0,1,2,3,5;5;2,9;2;1;1
252856984074;252856984081;7;0,1,2,3,5;5;2,9;2;1;1
252856984081;252856984083;2;0,1,2,3,5;5;2,9;2;1;1
252856984083;252856984104;21;0,1,2,3,5;5;2,9;2;1;1
252856984104;252856984109;5;0,1,2,3,5;5;2,9;2;1;1
252856984109;252856984110;1;0,1,2,3,5;5;2,9;2;1;1
252856984110;252856984123;13;0,1,2,3,5;5;2,9;2;1;1
252856984123;252856984126;3;0,1,2,3,5;5;2,9;2;1;1
252856984126;252856984134;8;0,1,2,3,5;5;2,9;2;1;1
252856984134;252856984153;19;0,1,2,3,5;5;2,9;2;1;1
252856984153;252856984173;20;0,1,2,3,5;5;2,9;2;1;1
252856984173;252856984196;23;0,1,2,3,5;5;2,9;2;1;1
252856984196;252856984201;5;0,1,2,3,5;5;2,9;2;1;1
252856984201;252856984213;12;0,1,2,3,5;5;2,9;2;1;1
252856984213;252856984215;2;0,1,2,3,5;5;2,9;2;1;1
252856984215;252856984217;2;0,1,2,3,5;5;2,9;2;1;1
252856984217;252856984230;13;0,1,2,3,5;5;2,9;2;1;1
252856984230;252856984239;9;0,1,2,3,5;5;2,9;2;1;1
252856984239;252856984249;10;0,1,2,3,5;5;2,9;2;1;1
252856984249;252856984262;13;0,1,2,3,5;5;2,9;2;1;1
252856984262;252856984283;21;0,1,2,3,5;5;2,9;2;1;1
252856984283;252856984284;1;0,1,2,3,5;5;2,9;2;1;1
252856984284;252856984316;32;0,1,2,3,5;5;2,9;2;1;1
252856984316;252856984348;32;0,1,2,3,5;5;2,9;2;1;1
252856984348;252856984358;10;0,1,2,3,5;5;2,9;2;1;1
252856984358;252856984371;13;0,1,2,3,5;5;2,9;2;1;1
252856984371;252856984393;22;0,1,2,3,5;5;2,9;2;1;1
252856984393;252856984397;4;0,1,2,3,5;5;2,9;2;1;1
252856984397;252856984418;21;0,1,2,3,5;5;2,9;2;1;1
252856984418;252856984424;6;0,1,2,3,5;5;2,9;2;1;1
252856984424;252856984435;11;0,1,2,3,5;5;2,9;2;1;1
252856984435;252856984472;37;0,1,2,3,5;5;2,9;2;1;1
252856984472;252856984478;6;0,1,2,3,5;5;2,9;2;1;1
252856984478;252856984495;17;0,1,2,3,5;5;2,9;2;1;1
252856984495;252856984540;45;0,1,2,3,5;5;2,9;2;1;1
252856984540;252856984541;1;0,1,2,3,5;5;2,9;2;1;1
252856984541;252856984542;1;0,1,2,3,5;5;2,9;2;1;1
252856984542;252856984548;6;0,1,2,3,5;5;2,9;2;1;1
252856984548;252856984563;15;0,1,2,3,5;5;2,9;2;1;1
252856984563;252856984570;7;0,1,2,3,5;5;2,9;2;1;1
252856984570;252856984575;5;0,1,2,3,5;5;2,9;2;1;1
252856984575;252856984583;8;0,1,2,3,5;5;2,9;2;1;1
252856984583;252856984589;6;0,1,2,3,5;5;2,9;2;1;1
252856984589;252856984622;33;0,1,2,3,5;5;2,9;2;1;1
252856984622;252856984660;38;0,1,2,3,5;5;2,9;2;1;1
252856984660;252856984670;10;0,1,2,3,5;5;2,9;2;1;1
252856984670;252856984744;74;0,1,2,3,5;5;2,9;2;1;1
252856984744;252856984810;66;0,1,2,3,5;5;2,9;2;1;1
252856984810;252856984837;27;0,1,2,3,5;5;2,9;2;1;1
252856984837;252856984845;8;0,1,2,3,5;5;2,9;2;1;1
252856984845;252856984891;46;0,1,2,3,5;5;2,9;2;1;1
252856984891;252856984893;2;0,1,2,3,5;5;2,9;2;1;1
252856984893;252856984917;24;0,1,2,3,5;5;2,9;2;1;1
252856984917;252856984919;2;0,1,2,3,5;5;2,9;2;1;1
252856984919;252856984959;40;0,1,2,3,5;5;2,9;2;1;1
252856984959;252856984961;2;0,1,2,3,5;5;2,9;2;1;1
252856984961;252856984969;8;0,1,2,3,5;5;2,9;2;1;1
252856984969;252856984977;8;0,1,2,3,5;5;2,9;2;1;1
252856984977;252856984979;2;0,1,2,3,5;5;2,9;2;1;1
252856984979;252856984989;10;0,1,2,3,5;5;2,9;2;1;1
252856984989;252856984996;7;0,1,2,3,5;5;2,9;2;1;1
252856984996;252856984999;3;0,1,2,3,5;5;2,9;2;1;1
252856984999;252856985009;10;0,1,2,3,5;5;2,9;2;1;1
252856985009;252856985053;44;0,1,2,3,5;5;2,9;2;1;1
252856985053;252856985057;4;0,1,2,3,5;5;2,9;2;1;1
252856985057;252856985058;1;0,1,2,3,5;5;2,9;2;1;1
252856985058;252856985081;23;0,1,2,3,5;5;2,9;2;1;1
252856985081;252856985086;5;0,1,2,3,5;5;2,9;2;1;1
252856985086;252856985087;1;0,1,2,3,5;5;2,9;2;1;1
252856985087;252856985091;4;0,1,2,3,5;5;2,9;2;1;1
252856985091;252856985119;28;0,1,2,3,5;5;2,9;2;1;1
252856985119;252856985122;3;0,1,2,3,5;5;2,9;2;1;1
252856985122;252856985127;5;0,1,2,3,5;5;2,9;2;1;1
252856985127;252856985147;20;0,1,2,3,5;5;2,9;2;1;1
252856985147;252856985163;16;0,1,2,3,5;5;2,9;2;1;1
252856985163;252856985174;11;0,1,2,3,5;5;2,9;2;1;1
252856985174;252856985182;8;0,1,2,3,5;5;2,9;2;1;1
252856985182;252856985190;8;0,1,2,3,5;5;2,9;2;1;1
252856985190;252856985202;12;0,1,2,3,5;5;2,9;2;1;1
252856985202;252856985204;2;0,1,2,3,5;5;2,9;2;1;1
252856985204;252856985206;2;0,1,2,3,5;5;2,9;2;1;1
252856985206;252856985229;23;0,1,2,3,5;5;2,9;2;1;1
252856985229;252856985232;3;0,1,2,3,5;5;2,9;2;1;1
252856985232;252856985237;5;0,1,2,3,5;5;2,9;2;1;1
252856985237;252856985243;6;0,1,2,3,5;5;2,9;2;1;1
252856985243;252856985250;7;0,1,2,3,5;5;2,9;2;1;1
252856985250;252856985256;6;0,1,2,3,5;5;2,9;2;1;1
252856985256;252856985283;27;0,1,2,3,5;5;2,9;2;1;1
252856985283;252856985284;1;0,1,2,3,5;5;2,9;2;1;1
252856985284;252856985289;5;0,1,2,3,5;5;2,9;2;1;1
252856985289;252856985299;10;0,1,2,3,5;5;2,9;2;1;1
252856985299;252856985317;18;0,1,2,3,5;5;2,9;2;1;1
252856985317;252856985332;15;0,1,2,3,5;5;2,9;2;1;1
252856985332;252856985339;7;0,1,2,3,5;5;2,9;2;1;1
252856985339;252856985340;1;0,1,2,3,5;5;2,9;2;1;1
252856985340;252856985348;8;0,1,2,3,5;5;2,9;2;1;1
252856985348;252856985373;25;0,1,2,3,5;5;2,9;2;1;1
252856985373;252856985378;5;0,1,2,3,5;5;2,9;2;1;1
252856985378;252856985385;7;0,1,2,3,5;5;2,9;2;1;1
252856985385;252856985387;2;0,1,2,3,5;5;2,9;2;1;1
252856985387;252856985398;11;0,1,2,3,5;5;2,9;2;1;1
252856985398;252856985406;8;0,1,2,3,5;5;2,9;2;1;1
252856985406;252856985412;6;0,1,2,3,5;5;2,9;2;1;1
252856985412;252856985420;8;0,1,2,3,5;5;2,9;2;1;1
252856985420;252856985424;4;0,1,2,3,5;5;2,9;2;1;1
252856985424;252856985427;3;0,1,2,3,5;5;2,9;2;1;1
252856985427;252856985451;24;0,1,2,3,5;5;2,9;2;1;1
252856985451;252856985454;3;0,1,2,3,5;5;2,9;2;1;1
252856985454;252856985455;1;0,1,2,3,5;5;2,9;2;1;1
252856985455;252856985463;8;0,1,2,3,5;5;2,9;2;1;1
252856985463;252856985481;18;0,1,2,3,5;5;2,9;2;1;1
252856985481;252856985482;1;0,1,2,3,5;5;2,9;2;1;1
252856985482;252856985493;11;0,1,2,3,5;5;2,9;2;1;1
252856985493;252856985508;15;0,1,2,3,5;5;2,9;2;1;1
252856985508;252856985511;3;0,1,2,3,5;5;2,9;2;1;1
252856985511;252856985539;28;0,1,2,3,5;5;2,9;2;1;1
252856985539;252856985561;22;0,1,2,3,5;5;2,9;2;1;1
252856985561;252856985565;4;0,1,2,3,5;5;2,9;2;1;1
252856985565;252856985573;8;0,1,2,3,5;5;2,9;2;1;1
252856985573;252856985580;7;0,1,2,3,5;5;2,9;2;1;1
252856985580;252856985595;15;0,1,2,3,5;5;2,9;2;1;1
252856985595;252856985606;11;0,1,2,3,5;5;2,9;2;1;1
252856985606;252856985623;17;0,1,2,3,5;5;2,9;2;1;1
252856985623;252856985639;16;0,1,2,3,5;5;2,9;2;1;1
252856985639;252856985642;3;0,1,2,3,5;5;2,9;2;1;1
252856985642;252856985661;19;0,1,2,3,5;5;2,9;2;1;1
252856985661;252856985663;2;0,1,2,3,5;5;2,9;2;1;1
252856985663;252856985669;6;0,1,2,3,5;5;2,9;2;1;1
252856985669;252856985671;2;0,1,2,3,5;5;2,9;2;1;1
252856985671;252856985689;18;0,1,2,3,5;5;2,9;2;1;1
252856985689;252856985708;19;0,1,2,3,5;5;2,9;2;1;1
252856985708;252856985728;20;0,1,2,3,5;5;2,9;2;1;1
252856985728;252856985742;14;0,1,2,3,5;5;2,9;2;1;1
252856985742;252856985747;5;0,1,2,3,5;5;2,9;2;1;1
252856985747;252856985768;21;0,1,2,3,5;5;2,9;2;1;1
252856985768;252856985772;4;0,1,2,3,5;5;2,9;2;1;1
252856985772;252856985775;3;0,1,2,3,5;5;2,9;2;1;1
252856985775;252856985779;4;0,1,2,3,5;5;2,9;2;1;1
252856985779;252856985797;18;0,1,2,3,5;5;2,9;2;1;1
252856985797;252856985799;2;0,1,2,3,5;5;2,9;2;1;1
252856985799;252856985811;12;0,1,2,3,5;5;2,9;2;1;1
252856985811;252856985822;11;0,1,2,3,5;5;2,9;2;1;1
252856985822;252856985837;15;0,1,2,3,5;5;2,9;2;1;1
252856985837;252856985838;1;0,1,2,3,5;5;2,9;2;1;1
252856985838;252856985856;18;0,1,2,3,5;5;2,9;2;1;1
252856985856;252856985858;2;0,1,2,3,5;5;2,9;2;1;1
252856985858;252856985884;26;0,1,2,3,5;5;2,9;2;1;1
252856985884;252856985885;1;0,1,2,3,5;5;2,9;2;1;1
252856985885;252856985902;17;0,1,2,3,5;5;2,9;2;1;1
252856985902;252856985910;8;0,1,2,3,5;5;2,9;2;1;1
252856985910;252856985911;1;0,1,2,3,5;5;2,9;2;1;1
252856985911;252856985918;7;0,1,2,3,5;5;2,9;2;1;1
252856985918;252856985936;18;0,1,2,3,5;5;2,9;2;1;1
252856985936;252856985945;9;0,1,2,3,5;5;2,9;2;1;1
252856985945;252856985951;6;0,1,2,3,5;5;2,9;2;1;1
252856985951;252856985957;6;0,1,2,3,5;5;2,9;2;1;1
252856985957;252856985958;1;0,1,2,3,5;5;2,9;2;1;1
252856985958;252856985973;15;0,1,2,3,5;5;2,9;2;1;1
252856985973;252856985996;23;0,1,2,3,5;5;2,9;2;1;1
252856985996;252856985998;2;0,1,2,3,5;5;2,9;2;1;1
252856985998;252856985999;1;0,1,2,3,5;5;2,9;2;1;1
252856985999;252856986001;2;0,1,2,3,5;5;2,9;2;1;1
252856986001;252856986012;11;0,1,2,3,5;5;2,9;2;1;1
252856986012;252856986025;13;0,1,2,3,5;5;2,9;2;1;1
252856986025;252856986040;15;0,1,2,3,5;5;2,9;2;1;1
252856986040;252856986041;1;0,1,2,3,5;5;2,9;2;1;1
252856986041;252856986042;1;0,1,2,3,5;5;2,9;2;1;1
252856986042;252856986046;4;0,1,2,3,5;5;2,9;2;1;1
252856986046;252856986048;2;0,1,2,3,5;5;2,9;2;1;1
252856986048;252856986054;6;0,1,2,3,5;5;2,9;2;1;1
252856986054;252856986056;2;0,1,2,3,5;5;2,9;2;1;1
252856986056;252856986085;29;0,1,2,3,5;5;2,9;2;1;1
252856986085;252856986087;2;0,1,2,3,5;5;2,9;2;1;1
252856986087;252856986090;3;0,1,2,3,5;5;2,9;2;1;1
252856986090;252856986096;6;0,1,2,3,5;5;2,9;2;1;1
252856986096;252856986108;12;0,1,2,3,5;5;2,9;2;1;1
252856986108;252856986129;21;0,1,2,3,5;5;2,9;2;1;1
252856986129;252856986131;2;0,1,2,3,5;5;2,9;2;1;1
252856986131;252856986136;5;0,1,2,3,5;5;2,9;2;1;1
252856986136;252856986148;12;0,1,2,3,5;5;2,9;2;1;1
252856986148;252856986149;1;0,1,2,3,5;5;2,9;2;1;1
252856986149;252856986152;3;0,1,2,3,5;5;2,9;2;1;1
252856986152;252856986185;33;0,1,2,3,5;5;2,9;2;1;1
252856986185;252856986194;9;0,1,2,3,5;5;2,9;2;1;1
252856986194;252856986221;27;0,1,2,3,5;5;2,9;2;1;1
252856986221;252856986246;25;0,1,2,3,5;5;2,9;2;1;1
252856986246;252856986277;31;0,1,2,3,5;5;2,9;2;1;1
252856986277;252856986284;7;0,1,2,3,5;5;2,9;2;1;1
252856986284;252856986289;5;0,1,2,3,5;5;2,9;2;1;1
252856986289;252856986294;5;0,1,2,3,5;5;2,9;2;1;1
252856986294;252856986314;20;0,1,2,3,5;5;2,9;2;1;1
252856986314;252856986316;2;0,1,2,3,5;5;2,9;2;1;1
252856986316;252856986360;44;0,1,2,3,5;5;2,9;2;1;1
252856986360;252856986371;11;0,1,2,3,5;5;2,9;2;1;1
252856986371;252856986374;3;0,1,2,3,5;5;2,9;2;1;1
252856986374;252856986392;18;0,1,2,3,5;5;2,9;2;1;1
252856986392;252856986402;10;0,1,2,3,5;5;2,9;2;1;1
252856986402;252856986406;4;0,1,2,3,5;5;2,9;2;1;1
252856986406;252856986432;26;0,1,2,3,5;5;2,9;2;1;1
252856986432;252856986443;11;0,1,2,3,5;5;2,9;2;1;1
252856986443;252856986444;1;0,1,2,3,5;5;2,9;2;1;1
252856986444;252856986464;20;0,1,2,3,5;5;2,9;2;1;1
252856986464;252856986470;6;0,1,2,3,5;5;2,9;2;1;1
252856986470;252856986480;10;0,1,2,3,5;5;2,9;2;1;1
252856986480;252856986482;2;0,1,2,3,5;5;2,9;2;1;1
252856986482;252856986514;32;0,1,2,3,5;5;2,9;2;1;1
252856986514;252856986520;6;0,1,2,3,5;5;2,9;2;1;1
252856986520;252856986523;3;0,1,2,3,5;5;2,9;2;1;1
252856986523;252856986538;15;0,1,2,3,5;5;2,9;2;1;1
252856986538;252856986539;1;0,1,2,3,5;5;2,9;2;1;1
252856986539;252856986560;21;0,1,2,3,5;5;2,9;2;1;1
252856986560;252856986562;2;0,1,2,3,5;5;2,9;2;1;1
252856986562;252856986568;6;0,1,2,3,5;5;2,9;2;1;1
252856986568;252856986587;19;0,1,2,3,5;5;2,9;2;1;1
252856986587;252856986598;11;0,1,2,3,5;5;2,9;2;1;1
252856986598;252856986599;1;0,1,2,3,5;5;2,9;2;1;1
252856986599;252856986613;14;0,1,2,3,5;5;2,9;2;1;1
252856986613;252856986648;35;0,1,2,3,5;5;2,9;2;1;1
252856986648;252856986659;11;0,1,2,3,5;5;2,9;2;1;1
252856986659;252856986660;1;0,1,2,3,5;5;2,9;2;1;1
252856986660;252856986671;11;0,1,2,3,5;5;2,9;2;1;1
252856986671;252856986680;9;0,1,2,3,5;5;2,9;2;1;1
252856986680;252856986684;4;0,1,2,3,5;5;2,9;2;1;1
252856986684;252856986706;22;0,1,2,3,5;5;2,9;2;1;1
252856986706;252856986708;2;0,1,2,3,5;5;2,9;2;1;1
252856986708;252856986710;2;0,1,2,3,5;5;2,9;2;1;1
252856986710;252856986730;20;0,1,2,3,5;5;2,9;2;1;1
252856986730;252856986751;21;0,1,2,3,5;5;2,9;2;1;1
252856986751;252856986754;3;0,1,2,3,5;5;2,9;2;1;1
252856986754;252856986792;38;0,1,2,3,5;5;2,9;2;1;1
252856986792;252856986807;15;0,1,2,3,5;5;2,9;2;1;1
252856986807;252856986811;4;0,1,2,3,5;5;2,9;2;1;1
252856986811;252856986815;4;0,1,2,3,5;5;2,9;2;1;1
252856986815;252856986819;4;0,1,2,3,5;5;2,9;2;1;1
252856986819;252856986831;12;0,1,2,3,5;5;2,9;2;1;1
252856986831;252856986844;13;0,1,2,3,5;5;2,9;2;1;1
252856986844;252856986849;5;0,1,2,3,5;5;2,9;2;1;1
252856986849;252856986869;20;0,1,2,3,5;5;2,9;2;1;1
252856986869;252856986872;3;0,1,2,3,5;5;2,9;2;1;1
252856986872;252856986903;31;0,1,2,3,5;5;2,9;2;1;1
252856986903;252856986905;2;0,1,2,3,5;5;2,9;2;1;1
252856986905;252856986928;23;0,1,2,3,5;5;2,9;2;1;1
252856986928;252856986931;3;0,1,2,3,5;5;2,9;2;1;1
252856986931;252856986945;14;0,1,2,3,5;5;2,9;2;1;1
252856986945;252856986952;7;0,1,2,3,5;5;2,9;2;1;1
252856986952;252856986956;4;0,1,2,3,5;5;2,9;2;1;1
252856986956;252856986971;15;0,1,2,3,5;5;2,9;2;1;1
252856986971;252856986984;13;0,1,2,3,5;5;2,9;2;1;1
252856986984;252856986993;9;0,1,2,3,5;5;2,9;2;1;1
252856986993;252856987003;10;0,1,2,3,5;5;2,9;2;1;1
252856987003;252856987046;43;0,1,2,3,5;5;2,9;2;1;1
252856987046;252856987064;18;0,1,2,3,5;5;2,9;2;1;1
252856987064;252856987085;21;0,1,2,3,5;5;2,9;2;1;1
252856987085;252856987096;11;0,1,2,3,5;5;2,9;2;1;1
252856987096;252856987119;23;0,1,2,3,5;5;2,9;2;1;1
252856987119;252856987121;2;0,1,2,3,5;5;2,9;2;1;1
252856987121;252856987123;2;0,1,2,3,5;5;2,9;2;1;1
252856987123;252856987124;1;0,1,2,3,5;5;2,9;2;1;1
252856987124;252856987129;5;0,1,2,3,5;5;2,9;2;1;1
252856987129;252856987156;27;0,1,2,3,5;5;2,9;2;1;1
252856987156;252856987160;4;0,1,2,3,5;5;2,9;2;1;1
252856987160;252856987163;3;0,1,2,3,5;5;2,9;2;1;1
252856987163;252856987192;29;0,1,2,3,5;5;2,9;2;1;1
252856987192;252856987206;14;0,1,2,3,5;5;2,9;2;1;1
252856987206;252856987226;20;0,1,2,3,5;5;2,9;2;1;1
252856987226;252856987238;12;0,1,2,3,5;5;2,9;2;1;1
252856987238;252856987247;9;0,1,2,3,5;5;2,9;2;1;1
252856987247;252856987251;4;0,1,2,3,5;5;2,9;2;1;1
252856987251;252856987269;18;0,1,2,3,5;5;2,9;2;1;1
252856987269;252856987276;7;0,1,2,3,5;5;2,9;2;1;1
252856987276;252856987282;6;0,1,2,3,5;5;2,9;2;1;1
252856987282;252856987285;3;0,1,2,3,5;5;2,9;2;1;1
252856987285;252856987325;40;0,1,2,3,5;5;2,9;2;1;1
252856987325;252856987326;1;0,1,2,3,5;5;2,9;2;1;1
252856987326;252856987334;8;0,1,2,3,5;5;2,9;2;1;1
252856987334;252856987345;11;0,1,2,3,5;5;2,9;2;1;1
252856987345;252856987355;10;0,1,2,3,5;5;2,9;2;1;1
252856987355;252856987364;9;0,1,2,3,5;5;2,9;2;1;1
252856987364;252856987370;6;0,1,2,3,5;5;2,9;2;1;1
252856987370;252856987372;2;0,1,2,3,5;5;2,9;2;1;1
252856987372;252856987393;21;0,1,2,3,5;5;2,9;2;1;1
252856987393;252856987394;1;0,1,2,3,5;5;2,9;2;1;1
252856987394;252856987421;27;0,1,2,3,5;5;2,9;2;1;1
252856987421;252856987446;25;0,1,2,3,5;5;2,9;2;1;1
252856987446;252856987451;5;0,1,2,3,5;5;2,9;2;1;1
252856987451;252856987459;8;0,1,2,3,5;5;2,9;2;1;1
252856987459;252856987480;21;0,1,2,3,5;5;2,9;2;1;1
252856987480;252856987482;2;0,1,2,3,5;5;2,9;2;1;1
252856987482;252856987514;32;0,1,2,3,5;5;2,9;2;1;1
252856987514;252856987528;14;0,1,2,3,5;5;2,9;2;1;1
252856987528;252856987551;23;0,1,2,3,5;5;2,9;2;1;1
252856987551;252856987565;14;0,1,2,3,5;5;2,9;2;1;1
252856987565;252856987586;21;0,1,2,3,5;5;2,9;2;1;1
252856987586;252856987617;31;0,1,2,3,5;5;2,9;2;1;1
252856987617;252856987627;10;0,1,2,3,5;5;2,9;2;1;1
252856987627;252856987629;2;0,1,2,3,5;5;2,9;2;1;1
252856987629;252856987646;17;0,1,2,3,5;5;2,9;2;1;1
252856987646;252856987671;25;0,1,2,3,5;5;2,9;2;1;1
252856987671;252856987688;17;0,1,2,3,5;5;2,9;2;1;1
252856987688;252856987690;2;0,1,2,3,5;5;2,9;2;1;1
252856987690;252856987692;2;0,1,2,3,5;5;2,9;2;1;1
252856987692;252856987700;8;0,1,2,3,5;5;2,9;2;1;1
252856987700;252856987722;22;0,1,2,3,5;5;2,9;2;1;1
252856987722;252856987738;16;0,1,2,3,5;5;2,9;2;1;1
252856987738;252856987766;28;0,1,2,3,5;5;2,9;2;1;1
252856987766;252856987778;12;0,1,2,3,5;5;2,9;2;1;1
252856987778;252856987800;22;0,1,2,3,5;5;2,9;2;1;1
252856987800;252856987820;20;0,1,2,3,5;5;2,9;2;1;1
252856987820;252856987856;36;0,1,2,3,5;5;2,9;2;1;1
252856987856;252856987871;15;0,1,2,3,5;5;2,9;2;1;1
252856987871;252856987880;9;0,1,2,3,5;5;2,9;2;1;1
252856987880;252856987882;2;0,1,2,3,5;5;2,9;2;1;1
252856987882;252856987919;37;0,1,2,3,5;5;2,9;2;1;1
252856987919;252856987960;41;0,1,2,3,5;5;2,9;2;1;1
252856987960;252856987999;39;0,1,2,3,5;5;2,9;2;1;1
252856987999;252856988010;11;0,1,2,3,5;5;2,9;2;1;1
252856988010;252856988028;18;0,1,2,3,5;5;2,9;2;1;1
252856988028;252856988037;9;0,1,2,3,5;5;2,9;2;1;1
252856988037;252856988039;2;0,1,2,3,5;5;2,9;2;1;1
252856988039;252856988063;24;0,1,2,3,5;5;2,9;2;1;1
252856988063;252856988065;2;0,1,2,3,5;5;2,9;2;1;1
252856988065;252856988119;54;0,1,2,3,5;5;2,9;2;1;1
252856988119;252856988168;49;0,1,2,3,5;5;2,9;2;1;1
252856988168;252856988240;72;0,1,2,3,5;5;2,9;2;1;1
252856988240;252856988269;29;0,1,2,3,5;5;2,9;2;1;1
252856988269;252856988303;34;0,1,2,3,5;5;2,9;2;1;1
252856988303;252856988341;38;0,1,2,3,5;5;2,9;2;1;1
252856988341;252856988368;27;0,1,2,3,5;5;2,9;2;1;1
252856988368;252856988393;25;0,1,2,3,5;5;2,9;2;1;1
252856988393;252856988451;58;0,1,2,3,5;5;2,9;2;1;1
252856988451;252856988499;48;0,1,2,3,5;5;2,9;2;1;1
252856988499;252856988533;34;0,1,2,3,5;5;2,9;2;1;1
252856988533;252856988548;15;0,1,2,3,5;5;2,9;2;1;1
252856988548;252856988559;11;0,1,2,3,5;5;2,9;2;1;1
252856988559;252856988603;44;0,1,2,3,5;5;2,9;2;1;1
252856988603;252856988605;2;0,1,2,3,5;5;2,9;2;1;1
252856988605;252856988606;1;0,1,2,3,5;5;2,9;2;1;1
252856988606;252856988634;28;0,1,2,3,5;5;2,9;2;1;1
252856988634;252856988662;28;0,1,2,3,5;5;2,9;2;1;1
252856988662;252856988688;26;0,1,2,3,5;5;2,9;2;1;1
252856988688;252856988699;11;0,1,2,3,5;5;2,9;2;1;1
252856988699;252856988710;11;0,1,2,3,5;5;2,9;2;1;1
252856988710;252856988727;17;0,1,2,3,5;5;2,9;2;1;1
252856988727;252856988768;41;0,1,2,3,5;5;2,9;2;1;1
252856988768;252856988778;10;0,1,2,3,5;5;2,9;2;1;1
252856988778;252856988796;18;0,1,2,3,5;5;2,9;2;1;1
252856988796;252856988797;1;0,1,2,3,5;5;2,9;2;1;1
252856988797;252856988801;4;0,1,2,3,5;5;2,9;2;1;1
252856988801;252856988816;15;0,1,2,3,5;5;2,9;2;1;1
252856988816;252856988818;2;0,1,2,3,5;5;2,9;2;1;1
252856988818;252856988824;6;0,1,2,3,5;5;2,9;2;1;1
252856988824;252856988829;5;0,1,2,3,5;5;2,9;2;1;1
252856988829;252856988835;6;0,1,2,3,5;5;2,9;2;1;1
252856988835;252856988859;24;0,1,2,3,5;5;2,9;2;1;1
252856988859;252856988868;9;0,1,2,3,5;5;2,9;2;1;1
252856988868;252856988895;27;0,1,2,3,5;5;2,9;2;1;1
252856988895;252856988908;13;0,1,2,3,5;5;2,9;2;1;1
252856988908;252856988934;26;0,1,2,3,5;5;2,9;2;1;1
252856988934;252856988935;1;0,1,2,3,5;5;2,9;2;1;1
252856988935;252856988954;19;0,1,2,3,5;5;2,9;2;1;1
252856988954;252856988990;36;0,1,2,3,5;5;2,9;2;1;1
252856988990;252856989025;35;0,1,2,3,5;5;2,9;2;1;1
252856989025;252856989054;29;0,1,2,3,5;5;2,9;2;1;1
252856989054;252856989059;5;0,1,2,3,5;5;2,9;2;1;1
252856989059;252856989083;24;0,1,2,3,5;5;2,9;2;1;1
252856989083;252856989087;4;0,1,2,3,5;5;2,9;2;1;1
252856989087;252856989093;6;0,1,2,3,5;5;2,9;2;1;1
252856989093;252856989114;21;0,1,2,3,5;5;2,9;2;1;1
252856989114;252856989124;10;0,1,2,3,5;5;2,9;2;1;1
252856989124;252856989142;18;0,1,2,3,5;5;2,9;2;1;1
252856989142;252856989160;18;0,1,2,3,5;5;2,9;2;1;1
252856989160;252856989175;15;0,1,2,3,5;5;2,9;2;1;1
252856989175;252856989191;16;0,1,2,3,5;5;2,9;2;1;1
252856989191;252856989205;14;0,1,2,3,5;5;2,9;2;1;1
252856989205;252856989216;11;0,1,2,3,5;5;2,9;2;1;1
252856989216;252856989220;4;0,1,2,3,5;5;2,9;2;1;1
252856989220;252856989243;23;0,1,2,3,5;5;2,9;2;1;1
252856989243;252856989261;18;0,1,2,3,5;5;2,9;2;1;1
252856989261;252856989287;26;0,1,2,3,5;5;2,9;2;1;1
252856989287;252856989376;89;0,1,2,3,5;5;2,9;2;1;1
252856989376;252856989394;18;0,1,2,3,5;5;2,9;2;1;1
252856989394;252856989422;28;0,1,2,3,5;5;2,9;2;1;1
252856989422;252856989455;33;0,1,2,3,5;5;2,9;2;1;1
252856989455;252856989481;26;0,1,2,3,5;5;2,9;2;1;1
252856989481;252856989523;42;0,1,2,3,5;5;2,9;2;1;1
252856989523;252856989546;23;0,1,2,3,5;5;2,9;2;1;1
252856989546;252856989646;100;0,1,2,3,5;5;2,9;2;1;1
252856989646;252856989665;19;0,1,2,3,5;5;2,9;2;1;1
252856989665;252856989705;40;0,1,2,3,5;5;2,9;2;1;1
252856989705;252856989755;50;0,1,2,3,5;5;2,9;2;1;1
252856989755;252856989774;19;0,1,2,3,5;5;2,9;2;1;1
252856989774;252856989804;30;0,1,2,3,5;5;2,9;2;1;1
252856989804;252856989864;60;0,1,2,3,5;5;2,9;2;1;1
252856989864;252856989901;37;0,1,2,3,5;5;2,9;2;1;1
252856989901;252856989978;77;0,1,2,3,5;5;2,9;2;1;1
252856989978;252856990009;31;0,1,2,3,5;5;2,9;2;1;1
252856990009;252856990011;2;0,1,2,3,5;5;2,9;2;1;1
252856990011;252856990038;27;0,1,2,3,5;5;2,9;2;1;1
252856990038;252856990086;48;0,1,2,3,5;5;2,9;2;1;1
252856990086;252856990942;856;0,1,2,3,5;5;2,9;2;1;1
252856990942;252856990971;29;0,1,2,3,5;5;2,9;2;1;1
252856990971;252856991078;107;0,1,2,3,5;5;2,9;2;1;1
252856991078;252856991178;100;0,1,2,3,5;5;2,9;2;1;1
252856991178;252856991218;40;0,1,2,3,5;5;2,9;2;1;1
252856991218;252856991245;27;0,1,2,3,5;5;2,9;2;1;1
252856991245;252856991288;43;0,1,2,3,5;5;2,9;2;1;1
252856991288;252856991350;62;0,1,2,3,5;5;2,9;2;1;1
252856991350;252856991378;28;0,1,2,3,5;5;2,9;2;1;1
252856991378;252856991402;24;0,1,2,3,5;5;2,9;2;1;1
252856991402;252856991428;26;0,1,2,3,5;5;2,9;2;1;1
252856991428;252856991648;220;0,1,2,3,5;5;2,9;2;1;1
252856991648;252856991690;42;0,1,2,3,5;5;2,9;2;1;1
252856991690;252856991721;31;0,1,2,3,5;5;2,9;2;1;1
252856991721;252856991774;53;0,1,2,3,5;5;2,9;2;1;1
252856991774;252856991806;32;0,1,2,3,5;5;2,9;2;1;1
252856991806;252856991862;56;0,1,2,3,5;5;2,9;2;1;1
252856991862;252856991889;27;0,1,2,3,5;5;2,9;2;1;1
252856991889;252856991918;29;0,1,2,3,5;5;2,9;2;1;1
252856991918;252857000692;8774;0,1,2,3,5;5;2,9;2;1;1
252857000692;252857000732;40;0,1,2,3,5;5;2,9;2;1;1
252857000732;252857000780;48;0,1,2,3,5;5;2,9;2;1;1
252857000780;252857001057;277;0,1,2,3,5;5;2,9;2;1;1
252857001057;252857004387;3330;0,1,2,3,5;5;2,9;2;1;1
252857004387;252857004675;288;0,1,2,3,5;5;2,9;2;1;1
252857004675;252857005017;342;0,1,2,3,5;5;2,9;2;1;1
252857005017;252857005183;166;0,1,2,3,5;5;2,9;2;1;1
252857005183;252857005321;138;0,1,2,3,5;5;2,9;2;1;1
252857005321;252857005359;38;0,1,2,3,5;5;2,9;2;1;1
252857005359;252857005412;53;0,1,2,3,5;5;2,9;2;1;1
252857005412;252857005492;80;0,1,2,3,5;5;2,9;2;1;1
252857005492;252857005536;44;0,1,2,3,5;5;2,9;2;1;1
252857005536;252857005719;183;0,1,2,3,5;5;2,9;2;1;1
252857005719;252857005759;40;0,1,2,3,5;5;2,9;2;1;1
252857005759;252857005806;47;0,1,2,3,5;5;2,9;2;1;1
252857005806;252857005834;28;0,1,2,3,5;5;2,9;2;1;1
252857005834;252857005879;45;0,1,2,3,5;5;2,9;2;1;1
252857005879;252857005921;42;0,1,2,3,5;5;2,9;2;1;1
252857005921;252857005960;39;0,1,2,3,5;5;2,9;2;1;1
252857005960;252857005991;31;0,1,2,3,5;5;2,9;2;1;1
252857005991;252857006034;43;0,1,2,3,5;5;2,9;2;1;1
252857006034;252857006199;165;0,1,2,3,5;5;2,9;2;1;1
252857006199;252857006243;44;0,1,2,3,5;5;2,9;2;1;1
252857006243;252857006283;40;0,1,2,3,5;5;2,9;2;1;1
252857006283;252857006328;45;0,1,2,3,5;5;2,9;2;1;1
252857006328;252857006395;67;0,1,2,3,5;5;2,9;2;1;1
252857006395;252857006432;37;0,1,2,3,5;5;2,9;2;1;1
252857006432;252857006479;47;0,1,2,3,5;5;2,9;2;1;1
252857006479;252857007016;537;0,1,2,3,5;5;2,9;2;1;1
252857007016;252857007666;650;0,1,2,3,5;5;2,9;2;1;1
252857007666;252857007743;77;0,1,2,3,5;5;2,9;2;1;1
252857007743;252857007771;28;0,1,2,3,5;5;2,9;2;1;1
252857007771;252857008344;573;0,1,2,3,5;5;2,9;2;1;1
252857008344;252857008441;97;0,1,2,3,5;5;2,9;2;1;1
252857008441;252857008509;68;0,1,2,3,5;5;2,9;2;1;1
252857008509;252857008550;41;0,1,2,3,5;5;2,9;2;1;1
252857008550;252857008565;15;0,1,2,3,5;5;2,9;2;1;1
252857008565;252857008619;54;0,1,2,3,5;5;2,9;2;1;1
252857008619;252857008673;54;0,1,2,3,5;5;2,9;2;1;1
252857008673;252857008728;55;0,1,2,3,5;5;2,9;2;1;1
252857008728;252857008782;54;0,1,2,3,5;5;2,9;2;1;1
252857008782;252857008835;53;0,1,2,3,5;5;2,9;2;1;1
252857008835;252857008890;55;0,1,2,3,5;5;2,9;2;1;1
252857008890;252857008946;56;0,1,2,3,5;5;2,9;2;1;1
252857008946;252857009004;58;0,1,2,3,5;5;2,9;2;1;1
252857009004;252857009103;99;0,1,2,3,5;5;2,9;2;1;1
252857009103;252857009155;52;0,1,2,3,5;5;2,9;2;1;1
252857009155;252857009205;50;0,1,2,3,5;5;2,9;2;1;1
252857009205;252857044593;35388;0,1,2,3,5;5;2,9;2;1;1
252857044593;252857044916;323;0,1,2,3,5;5;2,9;2;1;1
252857044916;252857045060;144;0,1,2,3,5;5;2,9;2;1;1
252857045060;252857045167;107;0,1,2,3,5;5;2,9;2;1;1
252857045167;252857045256;89;0,1,2,3,5;5;2,9;2;1;1
252857045256;252857045352;96;0,1,2,3,5;5;2,9;2;1;1
252857045352;252857045405;53;0,1,2,3,5;5;2,9;2;1;1
252857045405;252857045622;217;0,1,2,3,5;5;2,9;2;1;1
252857045622;252857045765;143;0,1,2,3,5;5;2,9;2;1;1
252857045765;252857046004;239;0,1,2,3,5;5;2,9;2;1;1
252857046004;252857046238;234;0,1,2,3,5;5;2,9;2;1;1
252857046238;252857046296;58;0,1,2,3,5;5;2,9;2;1;1
252857046296;252857046437;141;0,1,2,3,5;5;2,9;2;1;1
252857046437;252857046778;341;0,1,2,3,5;5;2,9;2;1;1
252857046778;252857046959;181;0,1,2,3,5;5;2,9;2;1;1
252857046959;252857047312;353;0,1,2,3,5;5;2,9;2;1;1
252857047312;252857047500;188;0,1,2,3,5;5;2,9;2;1;1
252857047500;252857047537;37;0,1,2,3,5;5;2,9;2;1;1
252857047537;252857047587;50;0,1,2,3,5;5;2,9;2;1;1
252857047587;252857047642;55;0,1,2,3,5;5;2,9;2;1;1
252857047642;252857047679;37;0,1,2,3,5;5;2,9;2;1;1
252857047679;252857048101;422;0,1,2,3,5;5;2,9;2;1;1
252857048101;252857048230;129;0,1,2,3,5;5;2,9;2;1;1
252857048230;252857048281;51;0,1,2,3,5;5;2,9;2;1;1
252857048281;252857048349;68;0,1,2,3,5;5;2,9;2;1;1
252857048349;252857048379;30;0,1,2,3,5;5;2,9;2;1;1
252857048379;252857048415;36;0,1,2,3,5;5;2,9;2;1;1
252857048415;252857048563;148;0,1,2,3,5;5;2,9;2;1;1
252857048563;252857048689;126;0,1,2,3,5;5;2,9;2;1;1
252857048689;252857048723;34;0,1,2,3,5;5;2,9;2;1;1
252857048723;252857048903;180;0,1,2,3,5;5;2,9;2;1;1
252857048903;252857048991;88;0,1,2,3,5;5;2,9;2;1;1
252857048991;252857049097;106;0,1,2,3,5;5;2,9;2;1;1
252857049097;252857049189;92;0,1,2,3,5;5;2,9;2;1;1
252857049189;252857049225;36;0,1,2,3,5;5;2,9;2;1;1
252857049225;252857049340;115;0,1,2,3,5;5;2,9;2;1;1
252857049340;252857049452;112;0,1,2,3,5;5;2,9;2;1;1
252857049452;252857049740;288;0,1,2,3,5;5;2,9;2;1;1
252857049740;252857049834;94;0,1,2,3,5;5;2,9;2;1;1
252857049834;252857049870;36;0,1,2,3,5;5;2,9;2;1;1
252857049870;252857049933;63;0,1,2,3,5;5;2,9;2;1;1
252857049933;252857049967;34;0,1,2,3,5;5;2,9;2;1;1
252857049967;252857050210;243;0,1,2,3,5;5;2,9;2;1;1
252857050210;252857050307;97;0,1,2,3,5;5;2,9;2;1;1
252857050307;252857050950;643;0,1,2,3,5;5;2,9;2;1;1
252857050950;252857051142;192;0,1,2,3,5;5;2,9;2;1;1
252857051142;252857051338;196;0,1,2,3,5;5;2,9;2;1;1
252857051338;252857051606;268;0,1,2,3,5;5;2,9;2;1;1
252857051606;252857051795;189;0,1,2,3,5;5;2,9;2;1;1
252857051795;252857052063;268;0,1,2,3,5;5;2,9;2;1;1
252857052063;252857052157;94;0,1,2,3,5;5;2,9;2;1;1
252857052157;252857052254;97;0,1,2,3,5;5;2,9;2;1;1
252857052254;252857052311;57;0,1,2,3,5;5;2,9;2;1;1
252857052311;252857052346;35;0,1,2,3,5;5;2,9;2;1;1
252857052346;252857052411;65;0,1,2,3,5;5;2,9;2;1;1
252857052411;252857052482;71;0,1,2,3,5;5;2,9;2;1;1
252857052482;252857052539;57;0,1,2,3,5;5;2,9;2;1;1
252857052539;252857052626;87;0,1,2,3,5;5;2,9;2;1;1
252857052626;252857052664;38;0,1,2,3,5;5;2,9;2;1;1
252857052664;252857052765;101;0,1,2,3,5;5;2,9;2;1;1
252857052765;252857052839;74;0,1,2,3,5;5;2,9;2;1;1
252857052839;252857052877;38;0,1,2,3,5;5;2,9;2;1;1
252857052877;252857052939;62;0,1,2,3,5;5;2,9;2;1;1
252857052939;252857052976;37;0,1,2,3,5;5;2,9;2;1;1
252857052976;252857063308;10332;0,1,2,3,5;5;2,9;2;1;1
252857063308;252857063466;158;0,1,2,3,5;5;2,9;2;1;1
252857063466;252857063720;254;0,1,2,3,5;5;2,9;2;1;1
252857063720;252857063729;9;0,1,2,3,5;5;2,9;2;1;1
252857063729;252857063758;29;0,1,2,3,5;5;2,9;2;1;1
252857063758;252857064098;340;0,1,2,3,5;5;2,9;2;1;1
252857064098;252857064292;194;0,1,2,3,5;5;2,9;2;1;1
252857064292;252857064297;5;0,1,2,3,5;5;2,9;2;1;1
252857064297;252857064304;7;0,1,2,3,5;5;2,9;2;1;1
252857064304;252857064333;29;0,1,2,3,5;5;2,9;2;1;1
252857064333;252857064354;21;0,1,2,3,5;5;2,9;2;1;1
252857064354;252857064379;25;0,1,2,3,5;5;2,9;2;1;1
252857064379;252857064445;66;0,1,2,3,5;5;2,9;2;1;1
252857064445;252857064502;57;0,1,2,3,5;5;2,9;2;1;1
252857064502;252857064540;38;0,1,2,3,5;5;2,9;2;1;1
252857064540;252857064551;11;0,1,2,3,5;5;2,9;2;1;1
252857064551;252857064571;20;0,1,2,3,5;5;2,9;2;1;1
252857064571;252857064583;12;0,1,2,3,5;5;2,9;2;1;1
252857064583;252857064589;6;0,1,2,3,5;5;2,9;2;1;1
252857064589;252857064622;33;0,1,2,3,5;5;2,9;2;1;1
252857064622;252857064641;19;0,1,2,3,5;5;2,9;2;1;1
252857064641;252857064642;1;0,1,2,3,5;5;2,9;2;1;1
252857064642;252857064671;29;0,1,2,3,5;5;2,9;2;1;1
252857064671;252857064689;18;0,1,2,3,5;5;2,9;2;1;1
252857064689;252857064726;37;0,1,2,3,5;5;2,9;2;1;1
252857064726;252857064731;5;0,1,2,3,5;5;2,9;2;1;1
252857064731;252857064762;31;0,1,2,3,5;5;2,9;2;1;1
252857064762;252857064768;6;0,1,2,3,5;5;2,9;2;1;1
252857064768;252857064792;24;0,1,2,3,5;5;2,9;2;1;1
252857064792;252857064793;1;0,1,2,3,5;5;2,9;2;1;1
252857064793;252857064809;16;0,1,2,3,5;5;2,9;2;1;1
252857064809;252857064828;19;0,1,2,3,5;5;2,9;2;1;1
252857064828;252857064842;14;0,1,2,3,5;5;2,9;2;1;1
252857064842;252857064844;2;0,1,2,3,5;5;2,9;2;1;1
252857064844;252857064862;18;0,1,2,3,5;5;2,9;2;1;1
252857064862;252857064868;6;0,1,2,3,5;5;2,9;2;1;1
252857064868;252857064892;24;0,1,2,3,5;5;2,9;2;1;1
252857064892;252857064904;12;0,1,2,3,5;5;2,9;2;1;1
252857064904;252857064936;32;0,1,2,3,5;5;2,9;2;1;1
252857064936;252857064977;41;0,1,2,3,5;5;2,9;2;1;1
252857064977;252857064987;10;0,1,2,3,5;5;2,9;2;1;1
252857064987;252857065040;53;0,1,2,3,5;5;2,9;2;1;1
252857065040;252857065073;33;0,1,2,3,5;5;2,9;2;1;1
252857065073;252857065095;22;0,1,2,3,5;5;2,9;2;1;1
252857065095;252857065098;3;0,1,2,3,5;5;2,9;2;1;1
252857065098;252857065108;10;0,1,2,3,5;5;2,9;2;1;1
252857065108;252857065114;6;0,1,2,3,5;5;2,9;2;1;1
252857065114;252857065137;23;0,1,2,3,5;5;2,9;2;1;1
252857065137;252857065197;60;0,1,2,3,5;5;2,9;2;1;1
252857065197;252857065248;51;0,1,2,3,5;5;2,9;2;1;1
252857065248;252857065257;9;0,1,2,3,5;5;2,9;2;1;1
252857065257;252857065276;19;0,1,2,3,5;5;2,9;2;1;1
252857065276;252857065296;20;0,1,2,3,5;5;2,9;2;1;1
252857065296;252857065332;36;0,1,2,3,5;5;2,9;2;1;1
252857065332;252857065344;12;0,1,2,3,5;5;2,9;2;1;1
252857065344;252857065348;4;0,1,2,3,5;5;2,9;2;1;1
252857065348;252857065371;23;0,1,2,3,5;5;2,9;2;1;1
252857065371;252857065397;26;0,1,2,3,5;5;2,9;2;1;1
252857065397;252857065403;6;0,1,2,3,5;5;2,9;2;1;1
252857065403;252857065458;55;0,1,2,3,5;5;2,9;2;1;1
252857065458;252857065467;9;0,1,2,3,5;5;2,9;2;1;1
252857065467;252857065485;18;0,1,2,3,5;5;2,9;2;1;1
252857065485;252857065495;10;0,1,2,3,5;5;2,9;2;1;1
252857065495;252857065505;10;0,1,2,3,5;5;2,9;2;1;1
252857065505;252857065506;1;0,1,2,3,5;5;2,9;2;1;1
252857065506;252857065526;20;0,1,2,3,5;5;2,9;2;1;1
252857065526;252857065535;9;0,1,2,3,5;5;2,9;2;1;1
252857065535;252857065585;50;0,1,2,3,5;5;2,9;2;1;1
252857065585;252857065600;15;0,1,2,3,5;5;2,9;2;1;1
252857065600;252857065611;11;0,1,2,3,5;5;2,9;2;1;1
252857065611;252857065629;18;0,1,2,3,5;5;2,9;2;1;1
252857065629;252857065658;29;0,1,2,3,5;5;2,9;2;1;1
252857065658;252857065660;2;0,1,2,3,5;5;2,9;2;1;1
252857065660;252857065672;12;0,1,2,3,5;5;2,9;2;1;1
252857065672;252857065816;144;0,1,2,3,5;5;2,9;2;1;1
252857065816;252857065855;39;0,1,2,3,5;5;2,9;2;1;1
252857065855;252857065872;17;0,1,2,3,5;5;2,9;2;1;1
252857065872;252857065896;24;0,1,2,3,5;5;2,9;2;1;1
252857065896;252857065932;36;0,1,2,3,5;5;2,9;2;1;1
252857065932;252857065953;21;0,1,2,3,5;5;2,9;2;1;1
252857065953;252857065990;37;0,1,2,3,5;5;2,9;2;1;1
252857065990;252857066032;42;0,1,2,3,5;5;2,9;2;1;1
252857066032;252857066069;37;0,1,2,3,5;5;2,9;2;1;1
252857066069;252857066156;87;0,1,2,3,5;5;2,9;2;1;1
252857066156;252857066194;38;0,1,2,3,5;5;2,9;2;1;1
252857066194;252857066200;6;0,1,2,3,5;5;2,9;2;1;1
252857066200;252857066206;6;0,1,2,3,5;5;2,9;2;1;1
252857066206;252857066225;19;0,1,2,3,5;5;2,9;2;1;1
252857066225;252857066226;1;0,1,2,3,5;5;2,9;2;1;1
252857066226;252857066227;1;0,1,2,3,5;5;2,9;2;1;1
252857066227;252857066232;5;0,1,2,3,5;5;2,9;2;1;1
252857066232;252857066245;13;0,1,2,3,5;5;2,9;2;1;1
252857066245;252857066249;4;0,1,2,3,5;5;2,9;2;1;1
252857066249;252857066279;30;0,1,2,3,5;5;2,9;2;1;1
252857066279;252857066286;7;0,1,2,3,5;5;2,9;2;1;1
252857066286;252857066295;9;0,1,2,3,5;5;2,9;2;1;1
252857066295;252857066356;61;0,1,2,3,5;5;2,9;2;1;1
252857066356;252857066362;6;0,1,2,3,5;5;2,9;2;1;1
252857066362;252857066382;20;0,1,2,3,5;5;2,9;2;1;1
252857066382;252857066387;5;0,1,2,3,5;5;2,9;2;1;1
252857066387;252857066403;16;0,1,2,3,5;5;2,9;2;1;1
252857066403;252857066426;23;0,1,2,3,5;5;2,9;2;1;1
252857066426;252857066428;2;0,1,2,3,5;5;2,9;2;1;1
252857066428;252857066439;11;0,1,2,3,5;5;2,9;2;1;1
252857066439;252857066451;12;0,1,2,3,5;5;2,9;2;1;1
252857066451;252857066466;15;0,1,2,3,5;5;2,9;2;1;1
252857066466;252857066475;9;0,1,2,3,5;5;2,9;2;1;1
252857066475;252857066504;29;0,1,2,3,5;5;2,9;2;1;1
252857066504;252857066513;9;0,1,2,3,5;5;2,9;2;1;1
252857066513;252857066515;2;0,1,2,3,5;5;2,9;2;1;1
252857066515;252857066527;12;0,1,2,3,5;5;2,9;2;1;1
252857066527;252857066555;28;0,1,2,3,5;5;2,9;2;1;1
252857066555;252857066556;1;0,1,2,3,5;5;2,9;2;1;1
252857066556;252857066598;42;0,1,2,3,5;5;2,9;2;1;1
252857066598;252857066648;50;0,1,2,3,5;5;2,9;2;1;1
252857066648;252857066675;27;0,1,2,3,5;5;2,9;2;1;1
252857066675;252857066676;1;0,1,2,3,5;5;2,9;2;1;1
252857066676;252857066690;14;0,1,2,3,5;5;2,9;2;1;1
252857066690;252857066697;7;0,1,2,3,5;5;2,9;2;1;1
252857066697;252857066704;7;0,1,2,3,5;5;2,9;2;1;1
252857066704;252857066709;5;0,1,2,3,5;5;2,9;2;1;1
252857066709;252857066718;9;0,1,2,3,5;5;2,9;2;1;1
252857066718;252857066724;6;0,1,2,3,5;5;2,9;2;1;1
252857066724;252857066726;2;0,1,2,3,5;5;2,9;2;1;1
252857066726;252857066735;9;0,1,2,3,5;5;2,9;2;1;1
252857066735;252857066758;23;0,1,2,3,5;5;2,9;2;1;1
252857066758;252857066759;1;0,1,2,3,5;5;2,9;2;1;1
252857066759;252857066762;3;0,1,2,3,5;5;2,9;2;1;1
252857066762;252857066821;59;0,1,2,3,5;5;2,9;2;1;1
252857066821;252857066843;22;0,1,2,3,5;5;2,9;2;1;1
252857066843;252857066875;32;0,1,2,3,5;5;2,9;2;1;1
252857066875;252857066877;2;0,1,2,3,5;5;2,9;2;1;1
252857066877;252857066918;41;0,1,2,3,5;5;2,9;2;1;1
252857066918;252857066921;3;0,1,2,3,5;5;2,9;2;1;1
252857066921;252857066931;10;0,1,2,3,5;5;2,9;2;1;1
252857066931;252857066939;8;0,1,2,3,5;5;2,9;2;1;1
252857066939;252857066943;4;0,1,2,3,5;5;2,9;2;1;1
252857066943;252857066959;16;0,1,2,3,5;5;2,9;2;1;1
252857066959;252857066963;4;0,1,2,3,5;5;2,9;2;1;1
252857066963;252857066968;5;0,1,2,3,5;5;2,9;2;1;1
252857066968;252857066989;21;0,1,2,3,5;5;2,9;2;1;1
252857066989;252857066997;8;0,1,2,3,5;5;2,9;2;1;1
252857066997;252857067010;13;0,1,2,3,5;5;2,9;2;1;1
252857067010;252857067016;6;0,1,2,3,5;5;2,9;2;1;1
252857067016;252857067028;12;0,1,2,3,5;5;2,9;2;1;1
252857067028;252857067038;10;0,1,2,3,5;5;2,9;2;1;1
252857067038;252857067048;10;0,1,2,3,5;5;2,9;2;1;1
252857067048;252857067105;57;0,1,2,3,5;5;2,9;2;1;1
252857067105;252857067128;23;0,1,2,3,5;5;2,9;2;1;1
252857067128;252857067180;52;0,1,2,3,5;5;2,9;2;1;1
252857067180;252857067196;16;0,1,2,3,5;5;2,9;2;1;1
252857067196;252857067209;13;0,1,2,3,5;5;2,9;2;1;1
252857067209;252857067223;14;0,1,2,3,5;5;2,9;2;1;1
252857067223;252857067266;43;0,1,2,3,5;5;2,9;2;1;1
252857067266;252857067268;2;0,1,2,3,5;5;2,9;2;1;1
252857067268;252857067296;28;0,1,2,3,5;5;2,9;2;1;1
252857067296;252857067416;120;0,1,2,3,5;5;2,9;2;1;1
252857067416;252857067421;5;0,1,2,3,5;5;2,9;2;1;1
252857067421;252857067455;34;0,1,2,3,5;5;2,9;2;1;1
252857067455;252857067481;26;0,1,2,3,5;5;2,9;2;1;1
252857067481;252857067511;30;0,1,2,3,5;5;2,9;2;1;1
252857067511;252857067532;21;0,1,2,3,5;5;2,9;2;1;1
252857067532;252857067551;19;0,1,2,3,5;5;2,9;2;1;1
252857067551;252857067557;6;0,1,2,3,5;5;2,9;2;1;1
252857067557;252857067569;12;0,1,2,3,5;5;2,9;2;1;1
252857067569;252857067611;42;0,1,2,3,5;5;2,9;2;1;1
252857067611;252857067636;25;0,1,2,3,5;5;2,9;2;1;1
252857067636;252857067643;7;0,1,2,3,5;5;2,9;2;1;1
252857067643;252857067688;45;0,1,2,3,5;5;2,9;2;1;1
252857067688;252857067737;49;0,1,2,3,5;5;2,9;2;1;1
252857067737;252857067739;2;0,1,2,3,5;5;2,9;2;1;1
252857067739;252857067767;28;0,1,2,3,5;5;2,9;2;1;1
252857067767;252857067772;5;0,1,2,3,5;5;2,9;2;1;1
252857067772;252857067777;5;0,1,2,3,5;5;2,9;2;1;1
252857067777;252857067793;16;0,1,2,3,5;5;2,9;2;1;1
252857067793;252857067797;4;0,1,2,3,5;5;2,9;2;1;1
252857067797;252857067800;3;0,1,2,3,5;5;2,9;2;1;1
252857067800;252857067802;2;0,1,2,3,5;5;2,9;2;1;1
252857067802;252857067816;14;0,1,2,3,5;5;2,9;2;1;1
252857067816;252857067837;21;0,1,2,3,5;5;2,9;2;1;1
252857067837;252857067858;21;0,1,2,3,5;5;2,9;2;1;1
252857067858;252857067911;53;0,1,2,3,5;5;2,9;2;1;1
252857067911;252857067921;10;0,1,2,3,5;5;2,9;2;1;1
252857067921;252857067938;17;0,1,2,3,5;5;2,9;2;1;1
252857067938;252857067941;3;0,1,2,3,5;5;2,9;2;1;1
252857067941;252857067953;12;0,1,2,3,5;5;2,9;2;1;1
252857067953;252857067961;8;0,1,2,3,5;5;2,9;2;1;1
252857067961;252857067968;7;0,1,2,3,5;5;2,9;2;1;1
252857067968;252857067979;11;0,1,2,3,5;5;2,9;2;1;1
252857067979;252857068005;26;0,1,2,3,5;5;2,9;2;1;1
252857068005;252857068008;3;0,1,2,3,5;5;2,9;2;1;1
252857068008;252857068014;6;0,1,2,3,5;5;2,9;2;1;1
252857068014;252857068037;23;0,1,2,3,5;5;2,9;2;1;1
252857068037;252857068047;10;0,1,2,3,5;5;2,9;2;1;1
252857068047;252857068066;19;0,1,2,3,5;5;2,9;2;1;1
252857068066;252857068086;20;0,1,2,3,5;5;2,9;2;1;1
252857068086;252857068128;42;0,1,2,3,5;5;2,9;2;1;1
252857068128;252857068163;35;0,1,2,3,5;5;2,9;2;1;1
252857068163;252857068183;20;0,1,2,3,5;5;2,9;2;1;1
252857068183;252857068187;4;0,1,2,3,5;5;2,9;2;1;1
252857068187;252857068230;43;0,1,2,3,5;5;2,9;2;1;1
252857068230;252857068231;1;0,1,2,3,5;5;2,9;2;1;1
252857068231;252857068241;10;0,1,2,3,5;5;2,9;2;1;1
252857068241;252857068277;36;0,1,2,3,5;5;2,9;2;1;1
252857068277;252857068287;10;0,1,2,3,5;5;2,9;2;1;1
252857068287;252857068321;34;0,1,2,3,5;5;2,9;2;1;1
252857068321;252857068349;28;0,1,2,3,5;5;2,9;2;1;1
252857068349;252857068368;19;0,1,2,3,5;5;2,9;2;1;1
252857068368;252857068373;5;0,1,2,3,5;5;2,9;2;1;1
252857068373;252857068428;55;0,1,2,3,5;5;2,9;2;1;1
252857068428;252857068442;14;0,1,2,3,5;5;2,9;2;1;1
252857068442;252857068462;20;0,1,2,3,5;5;2,9;2;1;1
252857068462;252857068473;11;0,1,2,3,5;5;2,9;2;1;1
252857068473;252857068476;3;0,1,2,3,5;5;2,9;2;1;1
252857068476;252857068477;1;0,1,2,3,5;5;2,9;2;1;1
252857068477;252857068485;8;0,1,2,3,5;5;2,9;2;1;1
252857068485;252857068500;15;0,1,2,3,5;5;2,9;2;1;1
252857068500;252857068508;8;0,1,2,3,5;5;2,9;2;1;1
252857068508;252857068509;1;0,1,2,3,5;5;2,9;2;1;1
252857068509;252857068516;7;0,1,2,3,5;5;2,9;2;1;1
252857068516;252857068524;8;0,1,2,3,5;5;2,9;2;1;1
252857068524;252857068530;6;0,1,2,3,5;5;2,9;2;1;1
252857068530;252857068532;2;0,1,2,3,5;5;2,9;2;1;1
252857068532;252857068544;12;0,1,2,3,5;5;2,9;2;1;1
252857068544;252857068568;24;0,1,2,3,5;5;2,9;2;1;1
252857068568;252857068571;3;0,1,2,3,5;5;2,9;2;1;1
252857068571;252857068572;1;0,1,2,3,5;5;2,9;2;1;1
252857068572;252857068583;11;0,1,2,3,5;5;2,9;2;1;1
252857068583;252857068585;2;0,1,2,3,5;5;2,9;2;1;1
252857068585;252857068597;12;0,1,2,3,5;5;2,9;2;1;1
252857068597;252857068618;21;0,1,2,3,5;5;2,9;2;1;1
252857068618;252857068622;4;0,1,2,3,5;5;2,9;2;1;1
252857068622;252857068629;7;0,1,2,3,5;5;2,9;2;1;1
252857068629;252857068635;6;0,1,2,3,5;5;2,9;2;1;1
252857068635;252857068638;3;0,1,2,3,5;5;2,9;2;1;1
252857068638;252857068639;1;0,1,2,3,5;5;2,9;2;1;1
252857068639;252857068640;1;0,1,2,3,5;5;2,9;2;1;1
252857068640;252857068652;12;0,1,2,3,5;5;2,9;2;1;1
252857068652;252857068662;10;0,1,2,3,5;5;2,9;2;1;1
252857068662;252857068665;3;0,1,2,3,5;5;2,9;2;1;1
252857068665;252857068670;5;0,1,2,3,5;5;2,9;2;1;1
252857068670;252857068674;4;0,1,2,3,5;5;2,9;2;1;1
252857068674;252857068675;1;0,1,2,3,5;5;2,9;2;1;1
252857068675;252857068678;3;0,1,2,3,5;5;2,9;2;1;1
252857068678;252857068681;3;0,1,2,3,5;5;2,9;2;1;1
252857068681;252857068684;3;0,1,2,3,5;5;2,9;2;1;1
252857068684;252857068706;22;0,1,2,3,5;5;2,9;2;1;1
252857068706;252857068711;5;0,1,2,3,5;5;2,9;2;1;1
252857068711;252857068722;11;0,1,2,3,5;5;2,9;2;1;1
252857068722;252857068728;6;0,1,2,3,5;5;2,9;2;1;1
252857068728;252857068733;5;0,1,2,3,5;5;2,9;2;1;1
252857068733;252857068736;3;0,1,2,3,5;5;2,9;2;1;1
252857068736;252857068741;5;0,1,2,3,5;5;2,9;2;1;1
252857068741;252857068744;3;0,1,2,3,5;5;2,9;2;1;1
252857068744;252857068751;7;0,1,2,3,5;5;2,9;2;1;1
252857068751;252857068754;3;0,1,2,3,5;5;2,9;2;1;1
252857068754;252857068762;8;0,1,2,3,5;5;2,9;2;1;1
252857068762;252857068772;10;0,1,2,3,5;5;2,9;2;1;1
252857068772;252857068783;11;0,1,2,3,5;5;2,9;2;1;1
252857068783;252857068785;2;0,1,2,3,5;5;2,9;2;1;1
252857068785;252857068787;2;0,1,2,3,5;5;2,9;2;1;1
252857068787;252857068792;5;0,1,2,3,5;5;2,9;2;1;1
252857068792;252857068802;10;0,1,2,3,5;5;2,9;2;1;1
252857068802;252857068803;1;0,1,2,3,5;5;2,9;2;1;1
252857068803;252857068815;12;0,1,2,3,5;5;2,9;2;1;1
252857068815;252857068817;2;0,1,2,3,5;5;2,9;2;1;1
252857068817;252857068838;21;0,1,2,3,5;5;2,9;2;1;1
252857068838;252857068845;7;0,1,2,3,5;5;2,9;2;1;1
252857068845;252857068848;3;0,1,2,3,5;5;2,9;2;1;1
252857068848;252857068867;19;0,1,2,3,5;5;2,9;2;1;1
252857068867;252857068871;4;0,1,2,3,5;5;2,9;2;1;1
252857068871;252857068896;25;0,1,2,3,5;5;2,9;2;1;1
252857068896;252857068904;8;0,1,2,3,5;5;2,9;2;1;1
252857068904;252857068923;19;0,1,2,3,5;5;2,9;2;1;1
252857068923;252857068929;6;0,1,2,3,5;5;2,9;2;1;1
252857068929;252857068942;13;0,1,2,3,5;5;2,9;2;1;1
252857068942;252857068944;2;0,1,2,3,5;5;2,9;2;1;1
252857068944;252857068945;1;0,1,2,3,5;5;2,9;2;1;1
252857068945;252857068972;27;0,1,2,3,5;5;2,9;2;1;1
252857068972;252857068973;1;0,1,2,3,5;5;2,9;2;1;1
252857068973;252857068975;2;0,1,2,3,5;5;2,9;2;1;1
252857068975;252857068988;13;0,1,2,3,5;5;2,9;2;1;1
252857068988;252857068993;5;0,1,2,3,5;5;2,9;2;1;1
252857068993;252857068995;2;0,1,2,3,5;5;2,9;2;1;1
252857068995;252857068997;2;0,1,2,3,5;5;2,9;2;1;1
252857068997;252857069027;30;0,1,2,3,5;5;2,9;2;1;1
252857069027;252857069028;1;0,1,2,3,5;5;2,9;2;1;1
252857069028;252857069036;8;0,1,2,3,5;5;2,9;2;1;1
252857069036;252857069046;10;0,1,2,3,5;5;2,9;2;1;1
252857069046;252857069052;6;0,1,2,3,5;5;2,9;2;1;1
252857069052;252857069056;4;0,1,2,3,5;5;2,9;2;1;1
252857069056;252857069075;19;0,1,2,3,5;5;2,9;2;1;1
252857069075;252857069079;4;0,1,2,3,5;5;2,9;2;1;1
252857069079;252857069081;2;0,1,2,3,5;5;2,9;2;1;1
252857069081;252857069096;15;0,1,2,3,5;5;2,9;2;1;1
252857069096;252857069104;8;0,1,2,3,5;5;2,9;2;1;1
252857069104;252857069116;12;0,1,2,3,5;5;2,9;2;1;1
252857069116;252857069133;17;0,1,2,3,5;5;2,9;2;1;1
252857069133;252857069160;27;0,1,2,3,5;5;2,9;2;1;1
252857069160;252857069168;8;0,1,2,3,5;5;2,9;2;1;1
252857069168;252857069220;52;0,1,2,3,5;5;2,9;2;1;1
252857069220;252857069224;4;0,1,2,3,5;5;2,9;2;1;1
252857069224;252857069233;9;0,1,2,3,5;5;2,9;2;1;1
252857069233;252857069247;14;0,1,2,3,5;5;2,9;2;1;1
252857069247;252857069266;19;0,1,2,3,5;5;2,9;2;1;1
252857069266;252857069280;14;0,1,2,3,5;5;2,9;2;1;1
252857069280;252857069290;10;0,1,2,3,5;5;2,9;2;1;1
252857069290;252857069300;10;0,1,2,3,5;5;2,9;2;1;1
252857069300;252857069304;4;0,1,2,3,5;5;2,9;2;1;1
252857069304;252857069313;9;0,1,2,3,5;5;2,9;2;1;1
252857069313;252857069318;5;0,1,2,3,5;5;2,9;2;1;1
252857069318;252857069330;12;0,1,2,3,5;5;2,9;2;1;1
252857069330;252857069338;8;0,1,2,3,5;5;2,9;2;1;1
252857069338;252857069347;9;0,1,2,3,5;5;2,9;2;1;1
252857069347;252857069377;30;0,1,2,3,5;5;2,9;2;1;1
252857069377;252857069380;3;0,1,2,3,5;5;2,9;2;1;1
252857069380;252857069389;9;0,1,2,3,5;5;2,9;2;1;1
252857069389;252857069397;8;0,1,2,3,5;5;2,9;2;1;1
252857069397;252857069400;3;0,1,2,3,5;5;2,9;2;1;1
252857069400;252857069406;6;0,1,2,3,5;5;2,9;2;1;1
252857069406;252857069407;1;0,1,2,3,5;5;2,9;2;1;1
252857069407;252857069420;13;0,1,2,3,5;5;2,9;2;1;1
252857069420;252857069421;1;0,1,2,3,5;5;2,9;2;1;1
252857069421;252857069431;10;0,1,2,3,5;5;2,9;2;1;1
252857069431;252857069435;4;0,1,2,3,5;5;2,9;2;1;1
252857069435;252857069474;39;0,1,2,3,5;5;2,9;2;1;1
252857069474;252857069510;36;0,1,2,3,5;5;2,9;2;1;1
252857069510;252857069514;4;0,1,2,3,5;5;2,9;2;1;1
252857069514;252857069519;5;0,1,2,3,5;5;2,9;2;1;1
252857069519;252857069522;3;0,1,2,3,5;5;2,9;2;1;1
252857069522;252857069530;8;0,1,2,3,5;5;2,9;2;1;1
252857069530;252857069542;12;0,1,2,3,5;5;2,9;2;1;1
252857069542;252857069554;12;0,1,2,3,5;5;2,9;2;1;1
252857069554;252857069557;3;0,1,2,3,5;5;2,9;2;1;1
252857069557;252857069565;8;0,1,2,3,5;5;2,9;2;1;1
252857069565;252857069569;4;0,1,2,3,5;5;2,9;2;1;1
252857069569;252857069579;10;0,1,2,3,5;5;2,9;2;1;1
252857069579;252857069581;2;0,1,2,3,5;5;2,9;2;1;1
252857069581;252857069600;19;0,1,2,3,5;5;2,9;2;1;1
252857069600;252857069606;6;0,1,2,3,5;5;2,9;2;1;1
252857069606;252857069626;20;0,1,2,3,5;5;2,9;2;1;1
252857069626;252857069635;9;0,1,2,3,5;5;2,9;2;1;1
252857069635;252857069639;4;0,1,2,3,5;5;2,9;2;1;1
252857069639;252857069661;22;0,1,2,3,5;5;2,9;2;1;1
252857069661;252857069664;3;0,1,2,3,5;5;2,9;2;1;1
252857069664;252857069682;18;0,1,2,3,5;5;2,9;2;1;1
252857069682;252857069688;6;0,1,2,3,5;5;2,9;2;1;1
252857069688;252857069691;3;0,1,2,3,5;5;2,9;2;1;1
252857069691;252857069699;8;0,1,2,3,5;5;2,9;2;1;1
252857069699;252857069701;2;0,1,2,3,5;5;2,9;2;1;1
252857069701;252857069728;27;0,1,2,3,5;5;2,9;2;1;1
252857069728;252857069740;12;0,1,2,3,5;5;2,9;2;1;1
252857069740;252857069746;6;0,1,2,3,5;5;2,9;2;1;1
252857069746;252857069751;5;0,1,2,3,5;5;2,9;2;1;1
252857069751;252857069773;22;0,1,2,3,5;5;2,9;2;1;1
252857069773;252857069789;16;0,1,2,3,5;5;2,9;2;1;1
252857069789;252857069794;5;0,1,2,3,5;5;2,9;2;1;1
252857069794;252857069797;3;0,1,2,3,5;5;2,9;2;1;1
252857069797;252857069801;4;0,1,2,3,5;5;2,9;2;1;1
252857069801;252857069804;3;0,1,2,3,5;5;2,9;2;1;1
252857069804;252857069820;16;0,1,2,3,5;5;2,9;2;1;1
252857069820;252857069826;6;0,1,2,3,5;5;2,9;2;1;1
252857069826;252857069835;9;0,1,2,3,5;5;2,9;2;1;1
252857069835;252857069839;4;0,1,2,3,5;5;2,9;2;1;1
252857069839;252857069850;11;0,1,2,3,5;5;2,9;2;1;1
252857069850;252857069855;5;0,1,2,3,5;5;2,9;2;1;1
252857069855;252857069864;9;0,1,2,3,5;5;2,9;2;1;1
252857069864;252857069878;14;0,1,2,3,5;5;2,9;2;1;1
252857069878;252857069907;29;0,1,2,3,5;5;2,9;2;1;1
252857069907;252857069908;1;0,1,2,3,5;5;2,9;2;1;1
252857069908;252857069920;12;0,1,2,3,5;5;2,9;2;1;1
252857069920;252857069925;5;0,1,2,3,5;5;2,9;2;1;1
252857069925;252857069947;22;0,1,2,3,5;5;2,9;2;1;1
252857069947;252857069954;7;0,1,2,3,5;5;2,9;2;1;1
252857069954;252857069963;9;0,1,2,3,5;5;2,9;2;1;1
252857069963;252857069964;1;0,1,2,3,5;5;2,9;2;1;1
252857069964;252857069980;16;0,1,2,3,5;5;2,9;2;1;1
252857069980;252857069985;5;0,1,2,3,5;5;2,9;2;1;1
252857069985;252857069987;2;0,1,2,3,5;5;2,9;2;1;1
252857069987;252857069992;5;0,1,2,3,5;5;2,9;2;1;1
252857069992;252857070011;19;0,1,2,3,5;5;2,9;2;1;1
252857070011;252857070017;6;0,1,2,3,5;5;2,9;2;1;1
252857070017;252857070018;1;0,1,2,3,5;5;2,9;2;1;1
252857070018;252857070027;9;0,1,2,3,5;5;2,9;2;1;1
252857070027;252857070040;13;0,1,2,3,5;5;2,9;2;1;1
252857070040;252857070049;9;0,1,2,3,5;5;2,9;2;1;1
252857070049;252857070052;3;0,1,2,3,5;5;2,9;2;1;1
252857070052;252857070056;4;0,1,2,3,5;5;2,9;2;1;1
252857070056;252857070069;13;0,1,2,3,5;5;2,9;2;1;1
252857070069;252857070075;6;0,1,2,3,5;5;2,9;2;1;1
252857070075;252857070076;1;0,1,2,3,5;5;2,9;2;1;1
252857070076;252857070077;1;0,1,2,3,5;5;2,9;2;1;1
252857070077;252857070098;21;0,1,2,3,5;5;2,9;2;1;1
252857070098;252857070101;3;0,1,2,3,5;5;2,9;2;1;1
252857070101;252857070108;7;0,1,2,3,5;5;2,9;2;1;1
252857070108;252857070121;13;0,1,2,3,5;5;2,9;2;1;1
252857070121;252857070128;7;0,1,2,3,5;5;2,9;2;1;1
252857070128;252857070140;12;0,1,2,3,5;5;2,9;2;1;1
252857070140;252857070162;22;0,1,2,3,5;5;2,9;2;1;1
252857070162;252857070181;19;0,1,2,3,5;5;2,9;2;1;1
252857070181;252857070186;5;0,1,2,3,5;5;2,9;2;1;1
252857070186;252857070187;1;0,1,2,3,5;5;2,9;2;1;1
252857070187;252857070191;4;0,1,2,3,5;5;2,9;2;1;1
252857070191;252857070196;5;0,1,2,3,5;5;2,9;2;1;1
252857070196;252857070201;5;0,1,2,3,5;5;2,9;2;1;1
252857070201;252857070209;8;0,1,2,3,5;5;2,9;2;1;1
252857070209;252857070215;6;0,1,2,3,5;5;2,9;2;1;1
252857070215;252857070218;3;0,1,2,3,5;5;2,9;2;1;1
252857070218;252857070219;1;0,1,2,3,5;5;2,9;2;1;1
252857070219;252857070221;2;0,1,2,3,5;5;2,9;2;1;1
252857070221;252857070237;16;0,1,2,3,5;5;2,9;2;1;1
252857070237;252857070239;2;0,1,2,3,5;5;2,9;2;1;1
252857070239;252857070242;3;0,1,2,3,5;5;2,9;2;1;1
252857070242;252857070243;1;0,1,2,3,5;5;2,9;2;1;1
252857070243;252857070245;2;0,1,2,3,5;5;2,9;2;1;1
252857070245;252857070248;3;0,1,2,3,5;5;2,9;2;1;1
252857070248;252857070251;3;0,1,2,3,5;5;2,9;2;1;1
252857070251;252857070255;4;0,1,2,3,5;5;2,9;2;1;1
252857070255;252857070259;4;0,1,2,3,5;5;2,9;2;1;1
252857070259;252857070265;6;0,1,2,3,5;5;2,9;2;1;1
252857070265;252857070273;8;0,1,2,3,5;5;2,9;2;1;1
252857070273;252857070275;2;0,1,2,3,5;5;2,9;2;1;1
252857070275;252857070280;5;0,1,2,3,5;5;2,9;2;1;1
252857070280;252857070284;4;0,1,2,3,5;5;2,9;2;1;1
252857070284;252857070293;9;0,1,2,3,5;5;2,9;2;1;1
252857070293;252857070295;2;0,1,2,3,5;5;2,9;2;1;1
252857070295;252857070299;4;0,1,2,3,5;5;2,9;2;1;1
252857070299;252857070306;7;0,1,2,3,5;5;2,9;2;1;1
252857070306;252857070307;1;0,1,2,3,5;5;2,9;2;1;1
252857070307;252857070319;12;0,1,2,3,5;5;2,9;2;1;1
252857070319;252857070324;5;0,1,2,3,5;5;2,9;2;1;1
252857070324;252857070336;12;0,1,2,3,5;5;2,9;2;1;1
252857070336;252857070340;4;0,1,2,3,5;5;2,9;2;1;1
252857070340;252857070345;5;0,1,2,3,5;5;2,9;2;1;1
252857070345;252857070351;6;0,1,2,3,5;5;2,9;2;1;1
252857070351;252857070356;5;0,1,2,3,5;5;2,9;2;1;1
252857070356;252857070359;3;0,1,2,3,5;5;2,9;2;1;1
252857070359;252857070367;8;0,1,2,3,5;5;2,9;2;1;1
252857070367;252857070379;12;0,1,2,3,5;5;2,9;2;1;1
252857070379;252857070389;10;0,1,2,3,5;5;2,9;2;1;1
252857070389;252857070391;2;0,1,2,3,5;5;2,9;2;1;1
252857070391;252857070396;5;0,1,2,3,5;5;2,9;2;1;1
252857070396;252857070413;17;0,1,2,3,5;5;2,9;2;1;1
252857070413;252857070417;4;0,1,2,3,5;5;2,9;2;1;1
252857070417;252857070421;4;0,1,2,3,5;5;2,9;2;1;1
252857070421;252857070422;1;0,1,2,3,5;5;2,9;2;1;1
252857070422;252857070426;4;0,1,2,3,5;5;2,9;2;1;1
252857070426;252857070432;6;0,1,2,3,5;5;2,9;2;1;1
252857070432;252857070438;6;0,1,2,3,5;5;2,9;2;1;1
252857070438;252857070441;3;0,1,2,3,5;5;2,9;2;1;1
252857070441;252857070442;1;0,1,2,3,5;5;2,9;2;1;1
252857070442;252857070447;5;0,1,2,3,5;5;2,9;2;1;1
252857070447;252857070450;3;0,1,2,3,5;5;2,9;2;1;1
252857070450;252857070460;10;0,1,2,3,5;5;2,9;2;1;1
252857070460;252857070461;1;0,1,2,3,5;5;2,9;2;1;1
252857070461;252857070475;14;0,1,2,3,5;5;2,9;2;1;1
252857070475;252857070485;10;0,1,2,3,5;5;2,9;2;1;1
252857070485;252857070495;10;0,1,2,3,5;5;2,9;2;1;1
252857070495;252857070498;3;0,1,2,3,5;5;2,9;2;1;1
252857070498;252857070502;4;0,1,2,3,5;5;2,9;2;1;1
252857070502;252857070538;36;0,1,2,3,5;5;2,9;2;1;1
252857070538;252857070539;1;0,1,2,3,5;5;2,9;2;1;1
252857070539;252857070549;10;0,1,2,3,5;5;2,9;2;1;1
252857070549;252857070550;1;0,1,2,3,5;5;2,9;2;1;1
252857070550;252857070551;1;0,1,2,3,5;5;2,9;2;1;1
252857070551;252857070552;1;0,1,2,3,5;5;2,9;2;1;1
252857070552;252857070556;4;0,1,2,3,5;5;2,9;2;1;1
252857070556;252857070567;11;0,1,2,3,5;5;2,9;2;1;1
252857070567;252857070578;11;0,1,2,3,5;5;2,9;2;1;1
252857070578;252857070581;3;0,1,2,3,5;5;2,9;2;1;1
252857070581;252857070585;4;0,1,2,3,5;5;2,9;2;1;1
252857070585;252857070597;12;0,1,2,3,5;5;2,9;2;1;1
252857070597;252857070606;9;0,1,2,3,5;5;2,9;2;1;1
252857070606;252857070607;1;0,1,2,3,5;5;2,9;2;1;1
252857070607;252857070617;10;0,1,2,3,5;5;2,9;2;1;1
252857070617;252857070627;10;0,1,2,3,5;5;2,9;2;1;1
252857070627;252857070628;1;0,1,2,3,5;5;2,9;2;1;1
252857070628;252857070631;3;0,1,2,3,5;5;2,9;2;1;1
252857070631;252857070634;3;0,1,2,3,5;5;2,9;2;1;1
252857070634;252857070639;5;0,1,2,3,5;5;2,9;2;1;1
252857070639;252857070652;13;0,1,2,3,5;5;2,9;2;1;1
252857070652;252857070660;8;0,1,2,3,5;5;2,9;2;1;1
252857070660;252857070663;3;0,1,2,3,5;5;2,9;2;1;1
252857070663;252857070670;7;0,1,2,3,5;5;2,9;2;1;1
252857070670;252857070678;8;0,1,2,3,5;5;2,9;2;1;1
252857070678;252857070683;5;0,1,2,3,5;5;2,9;2;1;1
252857070683;252857070688;5;0,1,2,3,5;5;2,9;2;1;1
252857070688;252857070701;13;0,1,2,3,5;5;2,9;2;1;1
252857070701;252857070715;14;0,1,2,3,5;5;2,9;2;1;1
252857070715;252857070716;1;0,1,2,3,5;5;2,9;2;1;1
252857070716;252857070721;5;0,1,2,3,5;5;2,9;2;1;1
252857070721;252857070724;3;0,1,2,3,5;5;2,9;2;1;1
252857070724;252857070729;5;0,1,2,3,5;5;2,9;2;1;1
252857070729;252857070739;10;0,1,2,3,5;5;2,9;2;1;1
252857070739;252857070746;7;0,1,2,3,5;5;2,9;2;1;1
252857070746;252857070762;16;0,1,2,3,5;5;2,9;2;1;1
252857070762;252857070764;2;0,1,2,3,5;5;2,9;2;1;1
252857070764;252857070768;4;0,1,2,3,5;5;2,9;2;1;1
252857070768;252857070769;1;0,1,2,3,5;5;2,9;2;1;1
252857070769;252857070787;18;0,1,2,3,5;5;2,9;2;1;1
252857070787;252857070789;2;0,1,2,3,5;5;2,9;2;1;1
252857070789;252857070804;15;0,1,2,3,5;5;2,9;2;1;1
252857070804;252857070806;2;0,1,2,3,5;5;2,9;2;1;1
252857070806;252857070812;6;0,1,2,3,5;5;2,9;2;1;1
252857070812;252857070828;16;0,1,2,3,5;5;2,9;2;1;1
252857070828;252857070831;3;0,1,2,3,5;5;2,9;2;1;1
252857070831;252857070839;8;0,1,2,3,5;5;2,9;2;1;1
252857070839;252857070840;1;0,1,2,3,5;5;2,9;2;1;1
252857070840;252857070846;6;0,1,2,3,5;5;2,9;2;1;1
252857070846;252857070854;8;0,1,2,3,5;5;2,9;2;1;1
252857070854;252857070855;1;0,1,2,3,5;5;2,9;2;1;1
252857070855;252857070856;1;0,1,2,3,5;5;2,9;2;1;1
252857070856;252857070874;18;0,1,2,3,5;5;2,9;2;1;1
252857070874;252857070882;8;0,1,2,3,5;5;2,9;2;1;1
252857070882;252857070890;8;0,1,2,3,5;5;2,9;2;1;1
252857070890;252857070891;1;0,1,2,3,5;5;2,9;2;1;1
252857070891;252857070908;17;0,1,2,3,5;5;2,9;2;1;1
252857070908;252857070933;25;0,1,2,3,5;5;2,9;2;1;1
252857070933;252857070944;11;0,1,2,3,5;5;2,9;2;1;1
252857070944;252857070953;9;0,1,2,3,5;5;2,9;2;1;1
252857070953;252857070980;27;0,1,2,3,5;5;2,9;2;1;1
252857070980;252857070982;2;0,1,2,3,5;5;2,9;2;1;1
252857070982;252857070986;4;0,1,2,3,5;5;2,9;2;1;1
252857070986;252857071004;18;0,1,2,3,5;5;2,9;2;1;1
252857071004;252857071008;4;0,1,2,3,5;5;2,9;2;1;1
252857071008;252857071021;13;0,1,2,3,5;5;2,9;2;1;1
252857071021;252857071026;5;0,1,2,3,5;5;2,9;2;1;1
252857071026;252857071027;1;0,1,2,3,5;5;2,9;2;1;1
252857071027;252857071037;10;0,1,2,3,5;5;2,9;2;1;1
252857071037;252857071038;1;0,1,2,3,5;5;2,9;2;1;1
252857071038;252857071060;22;0,1,2,3,5;5;2,9;2;1;1
252857071060;252857071063;3;0,1,2,3,5;5;2,9;2;1;1
252857071063;252857071064;1;0,1,2,3,5;5;2,9;2;1;1
252857071064;252857071066;2;0,1,2,3,5;5;2,9;2;1;1
252857071066;252857071077;11;0,1,2,3,5;5;2,9;2;1;1
252857071077;252857071082;5;0,1,2,3,5;5;2,9;2;1;1
252857071082;252857071084;2;0,1,2,3,5;5;2,9;2;1;1
252857071084;252857071112;28;0,1,2,3,5;5;2,9;2;1;1
252857071112;252857071124;12;0,1,2,3,5;5;2,9;2;1;1
252857071124;252857071137;13;0,1,2,3,5;5;2,9;2;1;1
252857071137;252857071147;10;0,1,2,3,5;5;2,9;2;1;1
252857071147;252857071148;1;0,1,2,3,5;5;2,9;2;1;1
252857071148;252857071155;7;0,1,2,3,5;5;2,9;2;1;1
252857071155;252857071164;9;0,1,2,3,5;5;2,9;2;1;1
252857071164;252857071168;4;0,1,2,3,5;5;2,9;2;1;1
252857071168;252857071169;1;0,1,2,3,5;5;2,9;2;1;1
252857071169;252857071174;5;0,1,2,3,5;5;2,9;2;1;1
252857071174;252857071184;10;0,1,2,3,5;5;2,9;2;1;1
252857071184;252857071195;11;0,1,2,3,5;5;2,9;2;1;1
252857071195;252857071198;3;0,1,2,3,5;5;2,9;2;1;1
252857071198;252857071203;5;0,1,2,3,5;5;2,9;2;1;1
252857071203;252857071211;8;0,1,2,3,5;5;2,9;2;1;1
252857071211;252857071214;3;0,1,2,3,5;5;2,9;2;1;1
252857071214;252857071222;8;0,1,2,3,5;5;2,9;2;1;1
252857071222;252857071239;17;0,1,2,3,5;5;2,9;2;1;1
252857071239;252857071245;6;0,1,2,3,5;5;2,9;2;1;1
252857071245;252857071246;1;0,1,2,3,5;5;2,9;2;1;1
252857071246;252857071249;3;0,1,2,3,5;5;2,9;2;1;1
252857071249;252857071257;8;0,1,2,3,5;5;2,9;2;1;1
252857071257;252857071265;8;0,1,2,3,5;5;2,9;2;1;1
252857071265;252857071270;5;0,1,2,3,5;5;2,9;2;1;1
252857071270;252857071271;1;0,1,2,3,5;5;2,9;2;1;1
252857071271;252857071280;9;0,1,2,3,5;5;2,9;2;1;1
252857071280;252857071294;14;0,1,2,3,5;5;2,9;2;1;1
252857071294;252857071297;3;0,1,2,3,5;5;2,9;2;1;1
252857071297;252857071300;3;0,1,2,3,5;5;2,9;2;1;1
252857071300;252857071304;4;0,1,2,3,5;5;2,9;2;1;1
252857071304;252857071311;7;0,1,2,3,5;5;2,9;2;1;1
252857071311;252857071318;7;0,1,2,3,5;5;2,9;2;1;1
252857071318;252857071339;21;0,1,2,3,5;5;2,9;2;1;1
252857071339;252857071351;12;0,1,2,3,5;5;2,9;2;1;1
252857071351;252857071353;2;0,1,2,3,5;5;2,9;2;1;1
252857071353;252857071375;22;0,1,2,3,5;5;2,9;2;1;1
252857071375;252857071376;1;0,1,2,3,5;5;2,9;2;1;1
252857071376;252857071384;8;0,1,2,3,5;5;2,9;2;1;1
252857071384;252857071391;7;0,1,2,3,5;5;2,9;2;1;1
252857071391;252857071397;6;0,1,2,3,5;5;2,9;2;1;1
252857071397;252857071408;11;0,1,2,3,5;5;2,9;2;1;1
252857071408;252857071411;3;0,1,2,3,5;5;2,9;2;1;1
252857071411;252857071431;20;0,1,2,3,5;5;2,9;2;1;1
252857071431;252857071433;2;0,1,2,3,5;5;2,9;2;1;1
252857071433;252857071450;17;0,1,2,3,5;5;2,9;2;1;1
252857071450;252857071451;1;0,1,2,3,5;5;2,9;2;1;1
252857071451;252857071456;5;0,1,2,3,5;5;2,9;2;1;1
252857071456;252857071473;17;0,1,2,3,5;5;2,9;2;1;1
252857071473;252857071474;1;0,1,2,3,5;5;2,9;2;1;1
252857071474;252857071481;7;0,1,2,3,5;5;2,9;2;1;1
252857071481;252857071487;6;0,1,2,3,5;5;2,9;2;1;1
252857071487;252857071514;27;0,1,2,3,5;5;2,9;2;1;1
252857071514;252857071517;3;0,1,2,3,5;5;2,9;2;1;1
252857071517;252857071533;16;0,1,2,3,5;5;2,9;2;1;1
252857071533;252857071536;3;0,1,2,3,5;5;2,9;2;1;1
252857071536;252857071542;6;0,1,2,3,5;5;2,9;2;1;1
252857071542;252857071543;1;0,1,2,3,5;5;2,9;2;1;1
252857071543;252857071546;3;0,1,2,3,5;5;2,9;2;1;1
252857071546;252857071555;9;0,1,2,3,5;5;2,9;2;1;1
252857071555;252857071563;8;0,1,2,3,5;5;2,9;2;1;1
252857071563;252857071575;12;0,1,2,3,5;5;2,9;2;1;1
252857071575;252857071576;1;0,1,2,3,5;5;2,9;2;1;1
252857071576;252857071581;5;0,1,2,3,5;5;2,9;2;1;1
252857071581;252857071591;10;0,1,2,3,5;5;2,9;2;1;1
252857071591;252857071598;7;0,1,2,3,5;5;2,9;2;1;1
252857071598;252857071599;1;0,1,2,3,5;5;2,9;2;1;1
252857071599;252857071603;4;0,1,2,3,5;5;2,9;2;1;1
252857071603;252857071609;6;0,1,2,3,5;5;2,9;2;1;1
252857071609;252857071614;5;0,1,2,3,5;5;2,9;2;1;1
252857071614;252857071615;1;0,1,2,3,5;5;2,9;2;1;1
252857071615;252857071616;1;0,1,2,3,5;5;2,9;2;1;1
252857071616;252857071630;14;0,1,2,3,5;5;2,9;2;1;1
252857071630;252857071642;12;0,1,2,3,5;5;2,9;2;1;1
252857071642;252857071649;7;0,1,2,3,5;5;2,9;2;1;1
252857071649;252857071650;1;0,1,2,3,5;5;2,9;2;1;1
252857071650;252857071653;3;0,1,2,3,5;5;2,9;2;1;1
252857071653;252857071665;12;0,1,2,3,5;5;2,9;2;1;1
252857071665;252857071671;6;0,1,2,3,5;5;2,9;2;1;1
252857071671;252857071675;4;0,1,2,3,5;5;2,9;2;1;1
252857071675;252857071676;1;0,1,2,3,5;5;2,9;2;1;1
252857071676;252857071680;4;0,1,2,3,5;5;2,9;2;1;1
252857071680;252857071696;16;0,1,2,3,5;5;2,9;2;1;1
252857071696;252857071697;1;0,1,2,3,5;5;2,9;2;1;1
252857071697;252857071709;12;0,1,2,3,5;5;2,9;2;1;1
252857071709;252857071729;20;0,1,2,3,5;5;2,9;2;1;1
252857071729;252857071730;1;0,1,2,3,5;5;2,9;2;1;1
252857071730;252857071735;5;0,1,2,3,5;5;2,9;2;1;1
252857071735;252857071738;3;0,1,2,3,5;5;2,9;2;1;1
252857071738;252857071739;1;0,1,2,3,5;5;2,9;2;1;1
252857071739;252857071749;10;0,1,2,3,5;5;2,9;2;1;1
252857071749;252857071759;10;0,1,2,3,5;5;2,9;2;1;1
252857071759;252857071766;7;0,1,2,3,5;5;2,9;2;1;1
252857071766;252857071767;1;0,1,2,3,5;5;2,9;2;1;1
252857071767;252857071772;5;0,1,2,3,5;5;2,9;2;1;1
252857071772;252857071773;1;0,1,2,3,5;5;2,9;2;1;1
252857071773;252857071777;4;0,1,2,3,5;5;2,9;2;1;1
252857071777;252857071807;30;0,1,2,3,5;5;2,9;2;1;1
252857071807;252857071816;9;0,1,2,3,5;5;2,9;2;1;1
252857071816;252857071818;2;0,1,2,3,5;5;2,9;2;1;1
252857071818;252857071819;1;0,1,2,3,5;5;2,9;2;1;1
252857071819;252857071826;7;0,1,2,3,5;5;2,9;2;1;1
252857071826;252857071827;1;0,1,2,3,5;5;2,9;2;1;1
252857071827;252857071837;10;0,1,2,3,5;5;2,9;2;1;1
252857071837;252857071847;10;0,1,2,3,5;5;2,9;2;1;1
252857071847;252857071850;3;0,1,2,3,5;5;2,9;2;1;1
252857071850;252857071851;1;0,1,2,3,5;5;2,9;2;1;1
252857071851;252857071853;2;0,1,2,3,5;5;2,9;2;1;1
252857071853;252857071855;2;0,1,2,3,5;5;2,9;2;1;1
252857071855;252857071866;11;0,1,2,3,5;5;2,9;2;1;1
252857071866;252857071877;11;0,1,2,3,5;5;2,9;2;1;1
252857071877;252857071884;7;0,1,2,3,5;5;2,9;2;1;1
252857071884;252857071888;4;0,1,2,3,5;5;2,9;2;1;1
252857071888;252857071892;4;0,1,2,3,5;5;2,9;2;1;1
252857071892;252857071900;8;0,1,2,3,5;5;2,9;2;1;1
252857071900;252857071906;6;0,1,2,3,5;5;2,9;2;1;1
252857071906;252857071913;7;0,1,2,3,5;5;2,9;2;1;1
252857071913;252857071915;2;0,1,2,3,5;5;2,9;2;1;1
252857071915;252857071916;1;0,1,2,3,5;5;2,9;2;1;1
252857071916;252857071920;4;0,1,2,3,5;5;2,9;2;1;1
252857071920;252857071925;5;0,1,2,3,5;5;2,9;2;1;1
252857071925;252857071928;3;0,1,2,3,5;5;2,9;2;1;1
252857071928;252857071930;2;0,1,2,3,5;5;2,9;2;1;1
252857071930;252857071934;4;0,1,2,3,5;5;2,9;2;1;1
252857071934;252857071939;5;0,1,2,3,5;5;2,9;2;1;1
252857071939;252857071945;6;0,1,2,3,5;5;2,9;2;1;1
252857071945;252857071947;2;0,1,2,3,5;5;2,9;2;1;1
252857071947;252857071952;5;0,1,2,3,5;5;2,9;2;1;1
252857071952;252857071955;3;0,1,2,3,5;5;2,9;2;1;1
252857071955;252857071965;10;0,1,2,3,5;5;2,9;2;1;1
252857071965;252857071969;4;0,1,2,3,5;5;2,9;2;1;1
252857071969;252857071972;3;0,1,2,3,5;5;2,9;2;1;1
252857071972;252857071974;2;0,1,2,3,5;5;2,9;2;1;1
252857071974;252857071979;5;0,1,2,3,5;5;2,9;2;1;1
252857071979;252857071980;1;0,1,2,3,5;5;2,9;2;1;1
252857071980;252857071982;2;0,1,2,3,5;5;2,9;2;1;1
252857071982;252857071989;7;0,1,2,3,5;5;2,9;2;1;1
252857071989;252857072004;15;0,1,2,3,5;5;2,9;2;1;1
252857072004;252857072010;6;0,1,2,3,5;5;2,9;2;1;1
252857072010;252857072015;5;0,1,2,3,5;5;2,9;2;1;1
252857072015;252857072016;1;0,1,2,3,5;5;2,9;2;1;1
252857072016;252857072017;1;0,1,2,3,5;5;2,9;2;1;1
252857072017;252857072021;4;0,1,2,3,5;5;2,9;2;1;1
252857072021;252857072024;3;0,1,2,3,5;5;2,9;2;1;1
252857072024;252857072027;3;0,1,2,3,5;5;2,9;2;1;1
252857072027;252857072031;4;0,1,2,3,5;5;2,9;2;1;1
252857072031;252857072032;1;0,1,2,3,5;5;2,9;2;1;1
252857072032;252857072039;7;0,1,2,3,5;5;2,9;2;1;1
252857072039;252857072041;2;0,1,2,3,5;5;2,9;2;1;1
252857072041;252857072044;3;0,1,2,3,5;5;2,9;2;1;1
252857072044;252857072045;1;0,1,2,3,5;5;2,9;2;1;1
252857072045;252857072048;3;0,1,2,3,5;5;2,9;2;1;1
252857072048;252857072054;6;0,1,2,3,5;5;2,9;2;1;1
252857072054;252857072063;9;0,1,2,3,5;5;2,9;2;1;1
252857072063;252857072066;3;0,1,2,3,5;5;2,9;2;1;1
252857072066;252857072070;4;0,1,2,3,5;5;2,9;2;1;1
252857072070;252857072071;1;0,1,2,3,5;5;2,9;2;1;1
252857072071;252857072078;7;0,1,2,3,5;5;2,9;2;1;1
252857072078;252857072080;2;0,1,2,3,5;5;2,9;2;1;1
252857072080;252857072094;14;0,1,2,3,5;5;2,9;2;1;1
252857072094;252857072097;3;0,1,2,3,5;5;2,9;2;1;1
252857072097;252857072100;3;0,1,2,3,5;5;2,9;2;1;1
252857072100;252857072103;3;0,1,2,3,5;5;2,9;2;1;1
252857072103;252857072119;16;0,1,2,3,5;5;2,9;2;1;1
252857072119;252857072125;6;0,1,2,3,5;5;2,9;2;1;1
252857072125;252857072131;6;0,1,2,3,5;5;2,9;2;1;1
252857072131;252857072133;2;0,1,2,3,5;5;2,9;2;1;1
252857072133;252857072134;1;0,1,2,3,5;5;2,9;2;1;1
252857072134;252857072150;16;0,1,2,3,5;5;2,9;2;1;1
252857072150;252857072154;4;0,1,2,3,5;5;2,9;2;1;1
252857072154;252857072161;7;0,1,2,3,5;5;2,9;2;1;1
252857072161;252857072180;19;0,1,2,3,5;5;2,9;2;1;1
252857072180;252857072188;8;0,1,2,3,5;5;2,9;2;1;1
252857072188;252857072195;7;0,1,2,3,5;5;2,9;2;1;1
252857072195;252857072196;1;0,1,2,3,5;5;2,9;2;1;1
252857072196;252857072202;6;0,1,2,3,5;5;2,9;2;1;1
252857072202;252857072208;6;0,1,2,3,5;5;2,9;2;1;1
252857072208;252857072212;4;0,1,2,3,5;5;2,9;2;1;1
252857072212;252857072214;2;0,1,2,3,5;5;2,9;2;1;1
252857072214;252857072215;1;0,1,2,3,5;5;2,9;2;1;1
252857072215;252857072222;7;0,1,2,3,5;5;2,9;2;1;1
252857072222;252857072228;6;0,1,2,3,5;5;2,9;2;1;1
252857072228;252857072237;9;0,1,2,3,5;5;2,9;2;1;1
252857072237;252857072243;6;0,1,2,3,5;5;2,9;2;1;1
252857072243;252857072247;4;0,1,2,3,5;5;2,9;2;1;1
252857072247;252857072248;1;0,1,2,3,5;5;2,9;2;1;1
252857072248;252857072249;1;0,1,2,3,5;5;2,9;2;1;1
252857072249;252857072251;2;0,1,2,3,5;5;2,9;2;1;1
252857072251;252857072252;1;0,1,2,3,5;5;2,9;2;1;1
252857072252;252857072259;7;0,1,2,3,5;5;2,9;2;1;1
252857072259;252857072269;10;0,1,2,3,5;5;2,9;2;1;1
252857072269;252857072271;2;0,1,2,3,5;5;2,9;2;1;1
252857072271;252857072273;2;0,1,2,3,5;5;2,9;2;1;1
252857072273;252857072275;2;0,1,2,3,5;5;2,9;2;1;1
252857072275;252857072280;5;0,1,2,3,5;5;2,9;2;1;1
252857072280;252857072281;1;0,1,2,3,5;5;2,9;2;1;1
252857072281;252857072297;16;0,1,2,3,5;5;2,9;2;1;1
252857072297;252857072298;1;0,1,2,3,5;5;2,9;2;1;1
252857072298;252857072303;5;0,1,2,3,5;5;2,9;2;1;1
252857072303;252857072311;8;0,1,2,3,5;5;2,9;2;1;1
252857072311;252857072312;1;0,1,2,3,5;5;2,9;2;1;1
252857072312;252857072313;1;0,1,2,3,5;5;2,9;2;1;1
252857072313;252857072314;1;0,1,2,3,5;5;2,9;2;1;1
252857072314;252857072329;15;0,1,2,3,5;5;2,9;2;1;1
252857072329;252857072331;2;0,1,2,3,5;5;2,9;2;1;1
252857072331;252857072339;8;0,1,2,3,5;5;2,9;2;1;1
252857072339;252857072340;1;0,1,2,3,5;5;2,9;2;1;1
252857072340;252857072342;2;0,1,2,3,5;5;2,9;2;1;1
252857072342;252857072353;11;0,1,2,3,5;5;2,9;2;1;1
252857072353;252857072357;4;0,1,2,3,5;5;2,9;2;1;1
252857072357;252857072386;29;0,1,2,3,5;5;2,9;2;1;1
252857072386;252857072398;12;0,1,2,3,5;5;2,9;2;1;1
252857072398;252857072399;1;0,1,2,3,5;5;2,9;2;1;1
252857072399;252857072404;5;0,1,2,3,5;5;2,9;2;1;1
252857072404;252857072410;6;0,1,2,3,5;5;2,9;2;1;1
252857072410;252857072422;12;0,1,2,3,5;5;2,9;2;1;1
252857072422;252857072425;3;0,1,2,3,5;5;2,9;2;1;1
252857072425;252857072436;11;0,1,2,3,5;5;2,9;2;1;1
252857072436;252857072446;10;0,1,2,3,5;5;2,9;2;1;1
252857072446;252857072462;16;0,1,2,3,5;5;2,9;2;1;1
252857072462;252857072463;1;0,1,2,3,5;5;2,9;2;1;1
252857072463;252857072485;22;0,1,2,3,5;5;2,9;2;1;1
252857072485;252857072495;10;0,1,2,3,5;5;2,9;2;1;1
252857072495;252857072496;1;0,1,2,3,5;5;2,9;2;1;1
252857072496;252857072516;20;0,1,2,3,5;5;2,9;2;1;1
252857072516;252857072517;1;0,1,2,3,5;5;2,9;2;1;1
252857072517;252857072528;11;0,1,2,3,5;5;2,9;2;1;1
252857072528;252857072545;17;0,1,2,3,5;5;2,9;2;1;1
252857072545;252857072558;13;0,1,2,3,5;5;2,9;2;1;1
252857072558;252857072564;6;0,1,2,3,5;5;2,9;2;1;1
252857072564;252857072567;3;0,1,2,3,5;5;2,9;2;1;1
252857072567;252857072583;16;0,1,2,3,5;5;2,9;2;1;1
252857072583;252857072584;1;0,1,2,3,5;5;2,9;2;1;1
252857072584;252857072587;3;0,1,2,3,5;5;2,9;2;1;1
252857072587;252857072598;11;0,1,2,3,5;5;2,9;2;1;1
252857072598;252857072606;8;0,1,2,3,5;5;2,9;2;1;1
252857072606;252857072611;5;0,1,2,3,5;5;2,9;2;1;1
252857072611;252857072614;3;0,1,2,3,5;5;2,9;2;1;1
252857072614;252857072617;3;0,1,2,3,5;5;2,9;2;1;1
252857072617;252857072618;1;0,1,2,3,5;5;2,9;2;1;1
252857072618;252857072619;1;0,1,2,3,5;5;2,9;2;1;1
252857072619;252857072628;9;0,1,2,3,5;5;2,9;2;1;1
252857072628;252857072629;1;0,1,2,3,5;5;2,9;2;1;1
252857072629;252857072632;3;0,1,2,3,5;5;2,9;2;1;1
252857072632;252857072643;11;0,1,2,3,5;5;2,9;2;1;1
252857072643;252857072646;3;0,1,2,3,5;5;2,9;2;1;1
252857072646;252857072648;2;0,1,2,3,5;5;2,9;2;1;1
252857072648;252857072660;12;0,1,2,3,5;5;2,9;2;1;1
252857072660;252857072661;1;0,1,2,3,5;5;2,9;2;1;1
252857072661;252857072668;7;0,1,2,3,5;5;2,9;2;1;1
252857072668;252857072671;3;0,1,2,3,5;5;2,9;2;1;1
252857072671;252857072672;1;0,1,2,3,5;5;2,9;2;1;1
252857072672;252857072677;5;0,1,2,3,5;5;2,9;2;1;1
252857072677;252857072680;3;0,1,2,3,5;5;2,9;2;1;1
252857072680;252857072686;6;0,1,2,3,5;5;2,9;2;1;1
252857072686;252857072692;6;0,1,2,3,5;5;2,9;2;1;1
252857072692;252857072694;2;0,1,2,3,5;5;2,9;2;1;1
252857072694;252857072698;4;0,1,2,3,5;5;2,9;2;1;1
252857072698;252857072702;4;0,1,2,3,5;5;2,9;2;1;1
252857072702;252857072705;3;0,1,2,3,5;5;2,9;2;1;1
252857072705;252857072725;20;0,1,2,3,5;5;2,9;2;1;1
252857072725;252857072726;1;0,1,2,3,5;5;2,9;2;1;1
252857072726;252857072731;5;0,1,2,3,5;5;2,9;2;1;1
252857072731;252857072736;5;0,1,2,3,5;5;2,9;2;1;1
252857072736;252857072740;4;0,1,2,3,5;5;2,9;2;1;1
252857072740;252857072744;4;0,1,2,3,5;5;2,9;2;1;1
252857072744;252857072756;12;0,1,2,3,5;5;2,9;2;1;1
252857072756;252857072758;2;0,1,2,3,5;5;2,9;2;1;1
252857072758;252857072766;8;0,1,2,3,5;5;2,9;2;1;1
252857072766;252857072780;14;0,1,2,3,5;5;2,9;2;1;1
252857072780;252857072781;1;0,1,2,3,5;5;2,9;2;1;1
252857072781;252857072782;1;0,1,2,3,5;5;2,9;2;1;1
252857072782;252857072790;8;0,1,2,3,5;5;2,9;2;1;1
252857072790;252857072792;2;0,1,2,3,5;5;2,9;2;1;1
252857072792;252857072793;1;0,1,2,3,5;5;2,9;2;1;1
252857072793;252857072794;1;0,1,2,3,5;5;2,9;2;1;1
252857072794;252857072798;4;0,1,2,3,5;5;2,9;2;1;1
252857072798;252857072801;3;0,1,2,3,5;5;2,9;2;1;1
252857072801;252857072802;1;0,1,2,3,5;5;2,9;2;1;1
252857072802;252857072812;10;0,1,2,3,5;5;2,9;2;1;1
252857072812;252857072817;5;0,1,2,3,5;5;2,9;2;1;1
252857072817;252857072819;2;0,1,2,3,5;5;2,9;2;1;1
252857072819;252857072826;7;0,1,2,3,5;5;2,9;2;1;1
252857072826;252857072830;4;0,1,2,3,5;5;2,9;2;1;1
252857072830;252857072833;3;0,1,2,3,5;5;2,9;2;1;1
252857072833;252857072842;9;0,1,2,3,5;5;2,9;2;1;1
252857072842;252857072855;13;0,1,2,3,5;5;2,9;2;1;1
252857072855;252857072856;1;0,1,2,3,5;5;2,9;2;1;1
252857072856;252857072865;9;0,1,2,3,5;5;2,9;2;1;1
252857072865;252857072867;2;0,1,2,3,5;5;2,9;2;1;1
252857072867;252857072871;4;0,1,2,3,5;5;2,9;2;1;1
252857072871;252857072881;10;0,1,2,3,5;5;2,9;2;1;1
252857072881;252857072882;1;0,1,2,3,5;5;2,9;2;1;1
252857072882;252857072891;9;0,1,2,3,5;5;2,9;2;1;1
252857072891;252857072893;2;0,1,2,3,5;5;2,9;2;1;1
252857072893;252857072901;8;0,1,2,3,5;5;2,9;2;1;1
252857072901;252857072902;1;0,1,2,3,5;5;2,9;2;1;1
252857072902;252857072905;3;0,1,2,3,5;5;2,9;2;1;1
252857072905;252857072907;2;0,1,2,3,5;5;2,9;2;1;1
252857072907;252857072910;3;0,1,2,3,5;5;2,9;2;1;1
252857072910;252857072917;7;0,1,2,3,5;5;2,9;2;1;1
252857072917;252857072927;10;0,1,2,3,5;5;2,9;2;1;1
252857072927;252857072936;9;0,1,2,3,5;5;2,9;2;1;1
252857072936;252857072937;1;0,1,2,3,5;5;2,9;2;1;1
252857072937;252857072945;8;0,1,2,3,5;5;2,9;2;1;1
252857072945;252857072948;3;0,1,2,3,5;5;2,9;2;1;1
252857072948;252857072959;11;0,1,2,3,5;5;2,9;2;1;1
252857072959;252857072970;11;0,1,2,3,5;5;2,9;2;1;1
252857072970;252857072977;7;0,1,2,3,5;5;2,9;2;1;1
252857072977;252857072979;2;0,1,2,3,5;5;2,9;2;1;1
252857072979;252857072980;1;0,1,2,3,5;5;2,9;2;1;1
252857072980;252857072983;3;0,1,2,3,5;5;2,9;2;1;1
252857072983;252857072985;2;0,1,2,3,5;5;2,9;2;1;1
252857072985;252857072987;2;0,1,2,3,5;5;2,9;2;1;1
252857072987;252857072988;1;0,1,2,3,5;5;2,9;2;1;1
252857072988;252857073012;24;0,1,2,3,5;5;2,9;2;1;1
252857073012;252857073014;2;0,1,2,3,5;5;2,9;2;1;1
252857073014;252857073015;1;0,1,2,3,5;5;2,9;2;1;1
252857073015;252857073026;11;0,1,2,3,5;5;2,9;2;1;1
252857073026;252857073027;1;0,1,2,3,5;5;2,9;2;1;1
252857073027;252857073031;4;0,1,2,3,5;5;2,9;2;1;1
252857073031;252857073034;3;0,1,2,3,5;5;2,9;2;1;1
252857073034;252857073040;6;0,1,2,3,5;5;2,9;2;1;1
252857073040;252857073043;3;0,1,2,3,5;5;2,9;2;1;1
252857073043;252857073053;10;0,1,2,3,5;5;2,9;2;1;1
252857073053;252857073054;1;0,1,2,3,5;5;2,9;2;1;1
252857073054;252857073056;2;0,1,2,3,5;5;2,9;2;1;1
252857073056;252857073062;6;0,1,2,3,5;5;2,9;2;1;1
252857073062;252857073063;1;0,1,2,3,5;5;2,9;2;1;1
252857073063;252857073066;3;0,1,2,3,5;5;2,9;2;1;1
252857073066;252857073081;15;0,1,2,3,5;5;2,9;2;1;1
252857073081;252857073086;5;0,1,2,3,5;5;2,9;2;1;1
252857073086;252857073087;1;0,1,2,3,5;5;2,9;2;1;1
252857073087;252857073096;9;0,1,2,3,5;5;2,9;2;1;1
252857073096;252857073103;7;0,1,2,3,5;5;2,9;2;1;1
252857073103;252857073107;4;0,1,2,3,5;5;2,9;2;1;1
252857073107;252857073109;2;0,1,2,3,5;5;2,9;2;1;1
252857073109;252857073122;13;0,1,2,3,5;5;2,9;2;1;1
252857073122;252857073132;10;0,1,2,3,5;5;2,9;2;1;1
252857073132;252857073134;2;0,1,2,3,5;5;2,9;2;1;1
252857073134;252857073135;1;0,1,2,3,5;5;2,9;2;1;1
252857073135;252857073149;14;0,1,2,3,5;5;2,9;2;1;1
252857073149;252857073156;7;0,1,2,3,5;5;2,9;2;1;1
252857073156;252857073159;3;0,1,2,3,5;5;2,9;2;1;1
252857073159;252857073163;4;0,1,2,3,5;5;2,9;2;1;1
252857073163;252857073166;3;0,1,2,3,5;5;2,9;2;1;1
252857073166;252857073168;2;0,1,2,3,5;5;2,9;2;1;1
252857073168;252857073175;7;0,1,2,3,5;5;2,9;2;1;1
252857073175;252857073176;1;0,1,2,3,5;5;2,9;2;1;1
252857073176;252857073184;8;0,1,2,3,5;5;2,9;2;1;1
252857073184;252857073192;8;0,1,2,3,5;5;2,9;2;1;1
252857073192;252857073201;9;0,1,2,3,5;5;2,9;2;1;1
252857073201;252857073205;4;0,1,2,3,5;5;2,9;2;1;1
252857073205;252857073214;9;0,1,2,3,5;5;2,9;2;1;1
252857073214;252857073217;3;0,1,2,3,5;5;2,9;2;1;1
252857073217;252857073223;6;0,1,2,3,5;5;2,9;2;1;1
252857073223;252857073224;1;0,1,2,3,5;5;2,9;2;1;1
252857073224;252857073231;7;0,1,2,3,5;5;2,9;2;1;1
252857073231;252857073233;2;0,1,2,3,5;5;2,9;2;1;1
252857073233;252857073244;11;0,1,2,3,5;5;2,9;2;1;1
252857073244;252857073245;1;0,1,2,3,5;5;2,9;2;1;1
252857073245;252857073246;1;0,1,2,3,5;5;2,9;2;1;1
252857073246;252857073264;18;0,1,2,3,5;5;2,9;2;1;1
252857073264;252857073267;3;0,1,2,3,5;5;2,9;2;1;1
252857073267;252857073272;5;0,1,2,3,5;5;2,9;2;1;1
252857073272;252857073275;3;0,1,2,3,5;5;2,9;2;1;1
252857073275;252857073287;12;0,1,2,3,5;5;2,9;2;1;1
252857073287;252857073288;1;0,1,2,3,5;5;2,9;2;1;1
252857073288;252857073296;8;0,1,2,3,5;5;2,9;2;1;1
252857073296;252857073298;2;0,1,2,3,5;5;2,9;2;1;1
252857073298;252857073306;8;0,1,2,3,5;5;2,9;2;1;1
252857073306;252857073317;11;0,1,2,3,5;5;2,9;2;1;1
252857073317;252857073322;5;0,1,2,3,5;5;2,9;2;1;1
252857073322;252857073325;3;0,1,2,3,5;5;2,9;2;1;1
252857073325;252857073327;2;0,1,2,3,5;5;2,9;2;1;1
252857073327;252857073334;7;0,1,2,3,5;5;2,9;2;1;1
252857073334;252857073336;2;0,1,2,3,5;5;2,9;2;1;1
252857073336;252857073347;11;0,1,2,3,5;5;2,9;2;1;1
252857073347;252857073351;4;0,1,2,3,5;5;2,9;2;1;1
252857073351;252857073352;1;0,1,2,3,5;5;2,9;2;1;1
252857073352;252857073358;6;0,1,2,3,5;5;2,9;2;1;1
252857073358;252857073365;7;0,1,2,3,5;5;2,9;2;1;1
252857073365;252857073369;4;0,1,2,3,5;5;2,9;2;1;1
252857073369;252857073392;23;0,1,2,3,5;5;2,9;2;1;1
252857073392;252857073395;3;0,1,2,3,5;5;2,9;2;1;1
252857073395;252857073400;5;0,1,2,3,5;5;2,9;2;1;1
252857073400;252857073403;3;0,1,2,3,5;5;2,9;2;1;1
252857073403;252857073415;12;0,1,2,3,5;5;2,9;2;1;1
252857073415;252857073427;12;0,1,2,3,5;5;2,9;2;1;1
252857073427;252857073428;1;0,1,2,3,5;5;2,9;2;1;1
252857073428;252857073435;7;0,1,2,3,5;5;2,9;2;1;1
252857073435;252857073440;5;0,1,2,3,5;5;2,9;2;1;1
252857073440;252857073443;3;0,1,2,3,5;5;2,9;2;1;1
252857073443;252857073453;10;0,1,2,3,5;5;2,9;2;1;1
252857073453;252857073465;12;0,1,2,3,5;5;2,9;2;1;1
252857073465;252857073469;4;0,1,2,3,5;5;2,9;2;1;1
252857073469;252857073484;15;0,1,2,3,5;5;2,9;2;1;1
252857073484;252857073485;1;0,1,2,3,5;5;2,9;2;1;1
252857073485;252857073494;9;0,1,2,3,5;5;2,9;2;1;1
252857073494;252857073517;23;0,1,2,3,5;5;2,9;2;1;1
252857073517;252857073522;5;0,1,2,3,5;5;2,9;2;1;1
252857073522;252857073531;9;0,1,2,3,5;5;2,9;2;1;1
252857073531;252857073552;21;0,1,2,3,5;5;2,9;2;1;1
252857073552;252857073569;17;0,1,2,3,5;5;2,9;2;1;1
252857073569;252857073570;1;0,1,2,3,5;5;2,9;2;1;1
252857073570;252857073573;3;0,1,2,3,5;5;2,9;2;1;1
252857073573;252857073574;1;0,1,2,3,5;5;2,9;2;1;1
252857073574;252857073585;11;0,1,2,3,5;5;2,9;2;1;1
252857073585;252857073604;19;0,1,2,3,5;5;2,9;2;1;1
252857073604;252857073610;6;0,1,2,3,5;5;2,9;2;1;1
252857073610;252857073611;1;0,1,2,3,5;5;2,9;2;1;1
252857073611;252857073622;11;0,1,2,3,5;5;2,9;2;1;1
252857073622;252857073624;2;0,1,2,3,5;5;2,9;2;1;1
252857073624;252857073640;16;0,1,2,3,5;5;2,9;2;1;1
252857073640;252857073657;17;0,1,2,3,5;5;2,9;2;1;1
252857073657;252857073667;10;0,1,2,3,5;5;2,9;2;1;1
252857073667;252857073672;5;0,1,2,3,5;5;2,9;2;1;1
252857073672;252857073675;3;0,1,2,3,5;5;2,9;2;1;1
252857073675;252857073680;5;0,1,2,3,5;5;2,9;2;1;1
252857073680;252857073685;5;0,1,2,3,5;5;2,9;2;1;1
252857073685;252857073701;16;0,1,2,3,5;5;2,9;2;1;1
252857073701;252857073702;1;0,1,2,3,5;5;2,9;2;1;1
252857073702;252857073704;2;0,1,2,3,5;5;2,9;2;1;1
252857073704;252857073719;15;0,1,2,3,5;5;2,9;2;1;1
252857073719;252857073723;4;0,1,2,3,5;5;2,9;2;1;1
252857073723;252857073728;5;0,1,2,3,5;5;2,9;2;1;1
252857073728;252857073739;11;0,1,2,3,5;5;2,9;2;1;1
252857073739;252857073746;7;0,1,2,3,5;5;2,9;2;1;1
252857073746;252857073755;9;0,1,2,3,5;5;2,9;2;1;1
252857073755;252857073756;1;0,1,2,3,5;5;2,9;2;1;1
252857073756;252857073757;1;0,1,2,3,5;5;2,9;2;1;1
252857073757;252857073758;1;0,1,2,3,5;5;2,9;2;1;1
252857073758;252857073770;12;0,1,2,3,5;5;2,9;2;1;1
252857073770;252857073777;7;0,1,2,3,5;5;2,9;2;1;1
252857073777;252857073780;3;0,1,2,3,5;5;2,9;2;1;1
252857073780;252857073782;2;0,1,2,3,5;5;2,9;2;1;1
252857073782;252857073783;1;0,1,2,3,5;5;2,9;2;1;1
252857073783;252857073793;10;0,1,2,3,5;5;2,9;2;1;1
252857073793;252857073798;5;0,1,2,3,5;5;2,9;2;1;1
252857073798;252857073809;11;0,1,2,3,5;5;2,9;2;1;1
252857073809;252857073813;4;0,1,2,3,5;5;2,9;2;1;1
252857073813;252857073824;11;0,1,2,3,5;5;2,9;2;1;1
252857073824;252857073830;6;0,1,2,3,5;5;2,9;2;1;1
252857073830;252857073833;3;0,1,2,3,5;5;2,9;2;1;1
252857073833;252857073836;3;0,1,2,3,5;5;2,9;2;1;1
252857073836;252857073838;2;0,1,2,3,5;5;2,9;2;1;1
252857073838;252857073839;1;0,1,2,3,5;5;2,9;2;1;1
252857073839;252857073848;9;0,1,2,3,5;5;2,9;2;1;1
252857073848;252857073850;2;0,1,2,3,5;5;2,9;2;1;1
252857073850;252857073852;2;0,1,2,3,5;5;2,9;2;1;1
252857073852;252857073873;21;0,1,2,3,5;5;2,9;2;1;1
252857073873;252857073882;9;0,1,2,3,5;5;2,9;2;1;1
252857073882;252857073887;5;0,1,2,3,5;5;2,9;2;1;1
252857073887;252857073889;2;0,1,2,3,5;5;2,9;2;1;1
252857073889;252857073890;1;0,1,2,3,5;5;2,9;2;1;1
252857073890;252857073893;3;0,1,2,3,5;5;2,9;2;1;1
252857073893;252857073895;2;0,1,2,3,5;5;2,9;2;1;1
252857073895;252857073899;4;0,1,2,3,5;5;2,9;2;1;1
252857073899;252857073911;12;0,1,2,3,5;5;2,9;2;1;1
252857073911;252857073913;2;0,1,2,3,5;5;2,9;2;1;1
252857073913;252857073917;4;0,1,2,3,5;5;2,9;2;1;1
252857073917;252857073923;6;0,1,2,3,5;5;2,9;2;1;1
252857073923;252857073927;4;0,1,2,3,5;5;2,9;2;1;1
252857073927;252857073931;4;0,1,2,3,5;5;2,9;2;1;1
252857073931;252857073938;7;0,1,2,3,5;5;2,9;2;1;1
252857073938;252857073939;1;0,1,2,3,5;5;2,9;2;1;1
252857073939;252857073950;11;0,1,2,3,5;5;2,9;2;1;1
252857073950;252857073964;14;0,1,2,3,5;5;2,9;2;1;1
252857073964;252857073978;14;0,1,2,3,5;5;2,9;2;1;1
252857073978;252857073988;10;0,1,2,3,5;5;2,9;2;1;1
252857073988;252857073992;4;0,1,2,3,5;5;2,9;2;1;1
252857073992;252857073994;2;0,1,2,3,5;5;2,9;2;1;1
252857073994;252857074016;22;0,1,2,3,5;5;2,9;2;1;1
252857074016;252857074018;2;0,1,2,3,5;5;2,9;2;1;1
252857074018;252857074022;4;0,1,2,3,5;5;2,9;2;1;1
252857074022;252857074035;13;0,1,2,3,5;5;2,9;2;1;1
252857074035;252857074039;4;0,1,2,3,5;5;2,9;2;1;1
252857074039;252857074050;11;0,1,2,3,5;5;2,9;2;1;1
252857074050;252857074059;9;0,1,2,3,5;5;2,9;2;1;1
252857074059;252857074064;5;0,1,2,3,5;5;2,9;2;1;1
252857074064;252857074068;4;0,1,2,3,5;5;2,9;2;1;1
252857074068;252857074089;21;0,1,2,3,5;5;2,9;2;1;1
252857074089;252857074097;8;0,1,2,3,5;5;2,9;2;1;1
252857074097;252857074102;5;0,1,2,3,5;5;2,9;2;1;1
252857074102;252857074113;11;0,1,2,3,5;5;2,9;2;1;1
252857074113;252857074121;8;0,1,2,3,5;5;2,9;2;1;1
252857074121;252857074137;16;0,1,2,3,5;5;2,9;2;1;1
252857074137;252857074138;1;0,1,2,3,5;5;2,9;2;1;1
252857074138;252857074145;7;0,1,2,3,5;5;2,9;2;1;1
252857074145;252857074149;4;0,1,2,3,5;5;2,9;2;1;1
252857074149;252857074153;4;0,1,2,3,5;5;2,9;2;1;1
252857074153;252857074157;4;0,1,2,3,5;5;2,9;2;1;1
252857074157;252857074167;10;0,1,2,3,5;5;2,9;2;1;1
252857074167;252857074174;7;0,1,2,3,5;5;2,9;2;1;1
252857074174;252857074177;3;0,1,2,3,5;5;2,9;2;1;1
252857074177;252857074184;7;0,1,2,3,5;5;2,9;2;1;1
252857074184;252857074194;10;0,1,2,3,5;5;2,9;2;1;1
252857074194;252857074197;3;0,1,2,3,5;5;2,9;2;1;1
252857074197;252857074202;5;0,1,2,3,5;5;2,9;2;1;1
252857074202;252857074219;17;0,1,2,3,5;5;2,9;2;1;1
252857074219;252857074247;28;0,1,2,3,5;5;2,9;2;1;1
252857074247;252857074260;13;0,1,2,3,5;5;2,9;2;1;1
252857074260;252857074262;2;0,1,2,3,5;5;2,9;2;1;1
252857074262;252857074266;4;0,1,2,3,5;5;2,9;2;1;1
252857074266;252857074280;14;0,1,2,3,5;5;2,9;2;1;1
252857074280;252857074293;13;0,1,2,3,5;5;2,9;2;1;1
252857074293;252857074304;11;0,1,2,3,5;5;2,9;2;1;1
252857074304;252857074312;8;0,1,2,3,5;5;2,9;2;1;1
252857074312;252857074318;6;0,1,2,3,5;5;2,9;2;1;1
252857074318;252857074320;2;0,1,2,3,5;5;2,9;2;1;1
252857074320;252857074324;4;0,1,2,3,5;5;2,9;2;1;1
252857074324;252857074334;10;0,1,2,3,5;5;2,9;2;1;1
252857074334;252857074340;6;0,1,2,3,5;5;2,9;2;1;1
252857074340;252857074347;7;0,1,2,3,5;5;2,9;2;1;1
252857074347;252857074350;3;0,1,2,3,5;5;2,9;2;1;1
252857074350;252857074362;12;0,1,2,3,5;5;2,9;2;1;1
252857074362;252857074363;1;0,1,2,3,5;5;2,9;2;1;1
252857074363;252857074373;10;0,1,2,3,5;5;2,9;2;1;1
252857074373;252857074403;30;0,1,2,3,5;5;2,9;2;1;1
252857074403;252857074407;4;0,1,2,3,5;5;2,9;2;1;1
252857074407;252857074414;7;0,1,2,3,5;5;2,9;2;1;1
252857074414;252857074419;5;0,1,2,3,5;5;2,9;2;1;1
252857074419;252857074450;31;0,1,2,3,5;5;2,9;2;1;1
252857074450;252857074470;20;0,1,2,3,5;5;2,9;2;1;1
252857074470;252857074492;22;0,1,2,3,5;5;2,9;2;1;1
252857074492;252857074507;15;0,1,2,3,5;5;2,9;2;1;1
252857074507;252857074512;5;0,1,2,3,5;5;2,9;2;1;1
252857074512;252857074514;2;0,1,2,3,5;5;2,9;2;1;1
252857074514;252857074532;18;0,1,2,3,5;5;2,9;2;1;1
252857074532;252857074535;3;0,1,2,3,5;5;2,9;2;1;1
252857074535;252857074536;1;0,1,2,3,5;5;2,9;2;1;1
252857074536;252857074543;7;0,1,2,3,5;5;2,9;2;1;1
252857074543;252857074565;22;0,1,2,3,5;5;2,9;2;1;1
252857074565;252857074567;2;0,1,2,3,5;5;2,9;2;1;1
252857074567;252857074581;14;0,1,2,3,5;5;2,9;2;1;1
252857074581;252857074583;2;0,1,2,3,5;5;2,9;2;1;1
252857074583;252857074584;1;0,1,2,3,5;5;2,9;2;1;1
252857074584;252857074599;15;0,1,2,3,5;5;2,9;2;1;1
252857074599;252857074608;9;0,1,2,3,5;5;2,9;2;1;1
252857074608;252857074621;13;0,1,2,3,5;5;2,9;2;1;1
252857074621;252857074623;2;0,1,2,3,5;5;2,9;2;1;1
252857074623;252857074634;11;0,1,2,3,5;5;2,9;2;1;1
252857074634;252857074636;2;0,1,2,3,5;5;2,9;2;1;1
252857074636;252857074646;10;0,1,2,3,5;5;2,9;2;1;1
252857074646;252857074654;8;0,1,2,3,5;5;2,9;2;1;1
252857074654;252857074656;2;0,1,2,3,5;5;2,9;2;1;1
252857074656;252857074657;1;0,1,2,3,5;5;2,9;2;1;1
252857074657;252857074668;11;0,1,2,3,5;5;2,9;2;1;1
252857074668;252857074678;10;0,1,2,3,5;5;2,9;2;1;1
252857074678;252857074684;6;0,1,2,3,5;5;2,9;2;1;1
252857074684;252857074689;5;0,1,2,3,5;5;2,9;2;1;1
252857074689;252857074706;17;0,1,2,3,5;5;2,9;2;1;1
252857074706;252857074718;12;0,1,2,3,5;5;2,9;2;1;1
252857074718;252857074722;4;0,1,2,3,5;5;2,9;2;1;1
252857074722;252857074738;16;0,1,2,3,5;5;2,9;2;1;1
252857074738;252857074741;3;0,1,2,3,5;5;2,9;2;1;1
252857074741;252857074760;19;0,1,2,3,5;5;2,9;2;1;1
252857074760;252857074778;18;0,1,2,3,5;5;2,9;2;1;1
252857074778;252857074797;19;0,1,2,3,5;5;2,9;2;1;1
252857074797;252857074804;7;0,1,2,3,5;5;2,9;2;1;1
252857074804;252857074805;1;0,1,2,3,5;5;2,9;2;1;1
252857074805;252857074815;10;0,1,2,3,5;5;2,9;2;1;1
252857074815;252857074825;10;0,1,2,3,5;5;2,9;2;1;1
252857074825;252857074841;16;0,1,2,3,5;5;2,9;2;1;1
252857074841;252857074846;5;0,1,2,3,5;5;2,9;2;1;1
252857074846;252857074853;7;0,1,2,3,5;5;2,9;2;1;1
252857074853;252857074870;17;0,1,2,3,5;5;2,9;2;1;1
252857074870;252857074884;14;0,1,2,3,5;5;2,9;2;1;1
252857074884;252857074886;2;0,1,2,3,5;5;2,9;2;1;1
252857074886;252857074892;6;0,1,2,3,5;5;2,9;2;1;1
252857074892;252857074924;32;0,1,2,3,5;5;2,9;2;1;1
252857074924;252857074932;8;0,1,2,3,5;5;2,9;2;1;1
252857074932;252857074933;1;0,1,2,3,5;5;2,9;2;1;1
252857074933;252857074952;19;0,1,2,3,5;5;2,9;2;1;1
252857074952;252857074953;1;0,1,2,3,5;5;2,9;2;1;1
252857074953;252857074977;24;0,1,2,3,5;5;2,9;2;1;1
252857074977;252857074978;1;0,1,2,3,5;5;2,9;2;1;1
252857074978;252857074989;11;0,1,2,3,5;5;2,9;2;1;1
252857074989;252857075014;25;0,1,2,3,5;5;2,9;2;1;1
252857075014;252857075026;12;0,1,2,3,5;5;2,9;2;1;1
252857075026;252857075040;14;0,1,2,3,5;5;2,9;2;1;1
252857075040;252857075042;2;0,1,2,3,5;5;2,9;2;1;1
252857075042;252857075055;13;0,1,2,3,5;5;2,9;2;1;1
252857075055;252857075058;3;0,1,2,3,5;5;2,9;2;1;1
252857075058;252857075067;9;0,1,2,3,5;5;2,9;2;1;1
252857075067;252857075071;4;0,1,2,3,5;5;2,9;2;1;1
252857075071;252857075072;1;0,1,2,3,5;5;2,9;2;1;1
252857075072;252857075077;5;0,1,2,3,5;5;2,9;2;1;1
252857075077;252857075078;1;0,1,2,3,5;5;2,9;2;1;1
252857075078;252857075088;10;0,1,2,3,5;5;2,9;2;1;1
252857075088;252857075096;8;0,1,2,3,5;5;2,9;2;1;1
252857075096;252857075098;2;0,1,2,3,5;5;2,9;2;1;1
252857075098;252857075106;8;0,1,2,3,5;5;2,9;2;1;1
252857075106;252857075117;11;0,1,2,3,5;5;2,9;2;1;1
252857075117;252857075118;1;0,1,2,3,5;5;2,9;2;1;1
252857075118;252857075119;1;0,1,2,3,5;5;2,9;2;1;1
252857075119;252857075130;11;0,1,2,3,5;5;2,9;2;1;1
252857075130;252857075141;11;0,1,2,3,5;5;2,9;2;1;1
252857075141;252857075147;6;0,1,2,3,5;5;2,9;2;1;1
252857075147;252857075150;3;0,1,2,3,5;5;2,9;2;1;1
252857075150;252857075157;7;0,1,2,3,5;5;2,9;2;1;1
252857075157;252857075160;3;0,1,2,3,5;5;2,9;2;1;1
252857075160;252857075161;1;0,1,2,3,5;5;2,9;2;1;1
252857075161;252857075162;1;0,1,2,3,5;5;2,9;2;1;1
252857075162;252857075168;6;0,1,2,3,5;5;2,9;2;1;1
252857075168;252857075170;2;0,1,2,3,5;5;2,9;2;1;1
252857075170;252857075173;3;0,1,2,3,5;5;2,9;2;1;1
252857075173;252857075176;3;0,1,2,3,5;5;2,9;2;1;1
252857075176;252857075177;1;0,1,2,3,5;5;2,9;2;1;1
252857075177;252857075179;2;0,1,2,3,5;5;2,9;2;1;1
252857075179;252857075186;7;0,1,2,3,5;5;2,9;2;1;1
252857075186;252857075193;7;0,1,2,3,5;5;2,9;2;1;1
252857075193;252857075202;9;0,1,2,3,5;5;2,9;2;1;1
252857075202;252857075203;1;0,1,2,3,5;5;2,9;2;1;1
252857075203;252857075206;3;0,1,2,3,5;5;2,9;2;1;1
252857075206;252857075207;1;0,1,2,3,5;5;2,9;2;1;1
252857075207;252857075219;12;0,1,2,3,5;5;2,9;2;1;1
252857075219;252857075220;1;0,1,2,3,5;5;2,9;2;1;1
252857075220;252857075227;7;0,1,2,3,5;5;2,9;2;1;1
252857075227;252857075228;1;0,1,2,3,5;5;2,9;2;1;1
252857075228;252857075229;1;0,1,2,3,5;5;2,9;2;1;1
252857075229;252857075231;2;0,1,2,3,5;5;2,9;2;1;1
252857075231;252857075235;4;0,1,2,3,5;5;2,9;2;1;1
252857075235;252857075245;10;0,1,2,3,5;5;2,9;2;1;1
252857075245;252857075251;6;0,1,2,3,5;5;2,9;2;1;1
252857075251;252857075255;4;0,1,2,3,5;5;2,9;2;1;1
252857075255;252857075264;9;0,1,2,3,5;5;2,9;2;1;1
252857075264;252857075268;4;0,1,2,3,5;5;2,9;2;1;1
252857075268;252857075280;12;0,1,2,3,5;5;2,9;2;1;1
252857075280;252857075284;4;0,1,2,3,5;5;2,9;2;1;1
252857075284;252857075293;9;0,1,2,3,5;5;2,9;2;1;1
252857075293;252857075297;4;0,1,2,3,5;5;2,9;2;1;1
252857075297;252857075304;7;0,1,2,3,5;5;2,9;2;1;1
252857075304;252857075306;2;0,1,2,3,5;5;2,9;2;1;1
252857075306;252857075311;5;0,1,2,3,5;5;2,9;2;1;1
252857075311;252857075313;2;0,1,2,3,5;5;2,9;2;1;1
252857075313;252857075318;5;0,1,2,3,5;5;2,9;2;1;1
252857075318;252857075321;3;0,1,2,3,5;5;2,9;2;1;1
252857075321;252857075322;1;0,1,2,3,5;5;2,9;2;1;1
252857075322;252857075323;1;0,1,2,3,5;5;2,9;2;1;1
252857075323;252857075334;11;0,1,2,3,5;5;2,9;2;1;1
252857075334;252857075337;3;0,1,2,3,5;5;2,9;2;1;1
252857075337;252857075341;4;0,1,2,3,5;5;2,9;2;1;1
252857075341;252857075350;9;0,1,2,3,5;5;2,9;2;1;1
252857075350;252857075352;2;0,1,2,3,5;5;2,9;2;1;1
252857075352;252857075356;4;0,1,2,3,5;5;2,9;2;1;1
252857075356;252857075357;1;0,1,2,3,5;5;2,9;2;1;1
252857075357;252857075359;2;0,1,2,3,5;5;2,9;2;1;1
252857075359;252857075368;9;0,1,2,3,5;5;2,9;2;1;1
252857075368;252857075377;9;0,1,2,3,5;5;2,9;2;1;1
252857075377;252857075384;7;0,1,2,3,5;5;2,9;2;1;1
252857075384;252857075392;8;0,1,2,3,5;5;2,9;2;1;1
252857075392;252857075397;5;0,1,2,3,5;5;2,9;2;1;1
252857075397;252857075400;3;0,1,2,3,5;5;2,9;2;1;1
252857075400;252857075402;2;0,1,2,3,5;5;2,9;2;1;1
252857075402;252857075404;2;0,1,2,3,5;5;2,9;2;1;1
252857075404;252857075412;8;0,1,2,3,5;5;2,9;2;1;1
252857075412;252857075422;10;0,1,2,3,5;5;2,9;2;1;1
252857075422;252857075426;4;0,1,2,3,5;5;2,9;2;1;1
252857075426;252857075429;3;0,1,2,3,5;5;2,9;2;1;1
252857075429;252857075434;5;0,1,2,3,5;5;2,9;2;1;1
252857075434;252857075437;3;0,1,2,3,5;5;2,9;2;1;1
252857075437;252857075446;9;0,1,2,3,5;5;2,9;2;1;1
252857075446;252857075458;12;0,1,2,3,5;5;2,9;2;1;1
252857075458;252857075465;7;0,1,2,3,5;5;2,9;2;1;1
252857075465;252857075466;1;0,1,2,3,5;5;2,9;2;1;1
252857075466;252857075482;16;0,1,2,3,5;5;2,9;2;1;1
252857075482;252857075485;3;0,1,2,3,5;5;2,9;2;1;1
252857075485;252857075498;13;0,1,2,3,5;5;2,9;2;1;1
252857075498;252857075506;8;0,1,2,3,5;5;2,9;2;1;1
252857075506;252857075509;3;0,1,2,3,5;5;2,9;2;1;1
252857075509;252857075534;25;0,1,2,3,5;5;2,9;2;1;1
252857075534;252857075538;4;0,1,2,3,5;5;2,9;2;1;1
252857075538;252857075547;9;0,1,2,3,5;5;2,9;2;1;1
252857075547;252857075564;17;0,1,2,3,5;5;2,9;2;1;1
252857075564;252857075566;2;0,1,2,3,5;5;2,9;2;1;1
252857075566;252857075572;6;0,1,2,3,5;5;2,9;2;1;1
252857075572;252857075573;1;0,1,2,3,5;5;2,9;2;1;1
252857075573;252857075580;7;0,1,2,3,5;5;2,9;2;1;1
252857075580;252857075581;1;0,1,2,3,5;5;2,9;2;1;1
252857075581;252857075594;13;0,1,2,3,5;5;2,9;2;1;1
252857075594;252857075600;6;0,1,2,3,5;5;2,9;2;1;1
252857075600;252857075615;15;0,1,2,3,5;5;2,9;2;1;1
252857075615;252857075616;1;0,1,2,3,5;5;2,9;2;1;1
252857075616;252857075621;5;0,1,2,3,5;5;2,9;2;1;1
252857075621;252857075622;1;0,1,2,3,5;5;2,9;2;1;1
252857075622;252857075636;14;0,1,2,3,5;5;2,9;2;1;1
252857075636;252857075643;7;0,1,2,3,5;5;2,9;2;1;1
252857075643;252857075644;1;0,1,2,3,5;5;2,9;2;1;1
252857075644;252857075650;6;0,1,2,3,5;5;2,9;2;1;1
252857075650;252857075671;21;0,1,2,3,5;5;2,9;2;1;1
252857075671;252857075672;1;0,1,2,3,5;5;2,9;2;1;1
252857075672;252857075674;2;0,1,2,3,5;5;2,9;2;1;1
252857075674;252857075684;10;0,1,2,3,5;5;2,9;2;1;1
252857075684;252857075693;9;0,1,2,3,5;5;2,9;2;1;1
252857075693;252857075697;4;0,1,2,3,5;5;2,9;2;1;1
252857075697;252857075705;8;0,1,2,3,5;5;2,9;2;1;1
252857075705;252857075710;5;0,1,2,3,5;5;2,9;2;1;1
252857075710;252857075722;12;0,1,2,3,5;5;2,9;2;1;1
252857075722;252857075724;2;0,1,2,3,5;5;2,9;2;1;1
252857075724;252857075726;2;0,1,2,3,5;5;2,9;2;1;1
252857075726;252857075730;4;0,1,2,3,5;5;2,9;2;1;1
252857075730;252857075742;12;0,1,2,3,5;5;2,9;2;1;1
252857075742;252857075749;7;0,1,2,3,5;5;2,9;2;1;1
252857075749;252857075761;12;0,1,2,3,5;5;2,9;2;1;1
252857075761;252857075763;2;0,1,2,3,5;5;2,9;2;1;1
252857075763;252857075767;4;0,1,2,3,5;5;2,9;2;1;1
252857075767;252857075776;9;0,1,2,3,5;5;2,9;2;1;1
252857075776;252857075784;8;0,1,2,3,5;5;2,9;2;1;1
252857075784;252857075792;8;0,1,2,3,5;5;2,9;2;1;1
252857075792;252857075797;5;0,1,2,3,5;5;2,9;2;1;1
252857075797;252857075804;7;0,1,2,3,5;5;2,9;2;1;1
252857075804;252857075809;5;0,1,2,3,5;5;2,9;2;1;1
252857075809;252857075815;6;0,1,2,3,5;5;2,9;2;1;1
252857075815;252857075817;2;0,1,2,3,5;5;2,9;2;1;1
252857075817;252857075829;12;0,1,2,3,5;5;2,9;2;1;1
252857075829;252857075831;2;0,1,2,3,5;5;2,9;2;1;1
252857075831;252857075837;6;0,1,2,3,5;5;2,9;2;1;1
252857075837;252857075847;10;0,1,2,3,5;5;2,9;2;1;1
252857075847;252857075849;2;0,1,2,3,5;5;2,9;2;1;1
252857075849;252857075872;23;0,1,2,3,5;5;2,9;2;1;1
252857075872;252857075875;3;0,1,2,3,5;5;2,9;2;1;1
252857075875;252857075882;7;0,1,2,3,5;5;2,9;2;1;1
252857075882;252857075889;7;0,1,2,3,5;5;2,9;2;1;1
252857075889;252857075907;18;0,1,2,3,5;5;2,9;2;1;1
252857075907;252857075910;3;0,1,2,3,5;5;2,9;2;1;1
252857075910;252857075912;2;0,1,2,3,5;5;2,9;2;1;1
252857075912;252857075930;18;0,1,2,3,5;5;2,9;2;1;1
252857075930;252857075951;21;0,1,2,3,5;5;2,9;2;1;1
252857075951;252857075952;1;0,1,2,3,5;5;2,9;2;1;1
252857075952;252857075957;5;0,1,2,3,5;5;2,9;2;1;1
252857075957;252857075958;1;0,1,2,3,5;5;2,9;2;1;1
252857075958;252857075965;7;0,1,2,3,5;5;2,9;2;1;1
252857075965;252857075979;14;0,1,2,3,5;5;2,9;2;1;1
252857075979;252857075982;3;0,1,2,3,5;5;2,9;2;1;1
252857075982;252857075983;1;0,1,2,3,5;5;2,9;2;1;1
252857075983;252857075993;10;0,1,2,3,5;5;2,9;2;1;1
252857075993;252857075998;5;0,1,2,3,5;5;2,9;2;1;1
252857075998;252857075999;1;0,1,2,3,5;5;2,9;2;1;1
252857075999;252857076007;8;0,1,2,3,5;5;2,9;2;1;1
252857076007;252857076023;16;0,1,2,3,5;5;2,9;2;1;1
252857076023;252857076025;2;0,1,2,3,5;5;2,9;2;1;1
252857076025;252857076026;1;0,1,2,3,5;5;2,9;2;1;1
252857076026;252857076028;2;0,1,2,3,5;5;2,9;2;1;1
252857076028;252857076038;10;0,1,2,3,5;5;2,9;2;1;1
252857076038;252857076053;15;0,1,2,3,5;5;2,9;2;1;1
252857076053;252857076056;3;0,1,2,3,5;5;2,9;2;1;1
252857076056;252857076064;8;0,1,2,3,5;5;2,9;2;1;1
252857076064;252857076068;4;0,1,2,3,5;5;2,9;2;1;1
252857076068;252857076083;15;0,1,2,3,5;5;2,9;2;1;1
252857076083;252857076097;14;0,1,2,3,5;5;2,9;2;1;1
252857076097;252857076108;11;0,1,2,3,5;5;2,9;2;1;1
252857076108;252857076109;1;0,1,2,3,5;5;2,9;2;1;1
252857076109;252857076113;4;0,1,2,3,5;5;2,9;2;1;1
252857076113;252857076119;6;0,1,2,3,5;5;2,9;2;1;1
252857076119;252857076140;21;0,1,2,3,5;5;2,9;2;1;1
252857076140;252857076163;23;0,1,2,3,5;5;2,9;2;1;1
252857076163;252857076167;4;0,1,2,3,5;5;2,9;2;1;1
252857076167;252857076169;2;0,1,2,3,5;5;2,9;2;1;1
252857076169;252857076184;15;0,1,2,3,5;5;2,9;2;1;1
252857076184;252857076192;8;0,1,2,3,5;5;2,9;2;1;1
252857076192;252857076199;7;0,1,2,3,5;5;2,9;2;1;1
252857076199;252857076219;20;0,1,2,3,5;5;2,9;2;1;1
252857076219;252857076220;1;0,1,2,3,5;5;2,9;2;1;1
252857076220;252857076221;1;0,1,2,3,5;5;2,9;2;1;1
252857076221;252857076223;2;0,1,2,3,5;5;2,9;2;1;1
252857076223;252857076246;23;0,1,2,3,5;5;2,9;2;1;1
252857076246;252857076251;5;0,1,2,3,5;5;2,9;2;1;1
252857076251;252857076261;10;0,1,2,3,5;5;2,9;2;1;1
252857076261;252857076266;5;0,1,2,3,5;5;2,9;2;1;1
252857076266;252857076274;8;0,1,2,3,5;5;2,9;2;1;1
252857076274;252857076279;5;0,1,2,3,5;5;2,9;2;1;1
252857076279;252857076299;20;0,1,2,3,5;5;2,9;2;1;1
252857076299;252857076315;16;0,1,2,3,5;5;2,9;2;1;1
252857076315;252857076319;4;0,1,2,3,5;5;2,9;2;1;1
252857076319;252857076357;38;0,1,2,3,5;5;2,9;2;1;1
252857076357;252857076373;16;0,1,2,3,5;5;2,9;2;1;1
252857076373;252857076380;7;0,1,2,3,5;5;2,9;2;1;1
252857076380;252857076382;2;0,1,2,3,5;5;2,9;2;1;1
252857076382;252857076385;3;0,1,2,3,5;5;2,9;2;1;1
252857076385;252857076404;19;0,1,2,3,5;5;2,9;2;1;1
252857076404;252857076408;4;0,1,2,3,5;5;2,9;2;1;1
252857076408;252857076409;1;0,1,2,3,5;5;2,9;2;1;1
252857076409;252857076432;23;0,1,2,3,5;5;2,9;2;1;1
252857076432;252857076455;23;0,1,2,3,5;5;2,9;2;1;1
252857076455;252857076473;18;0,1,2,3,5;5;2,9;2;1;1
252857076473;252857076475;2;0,1,2,3,5;5;2,9;2;1;1
252857076475;252857076484;9;0,1,2,3,5;5;2,9;2;1;1
252857076484;252857076488;4;0,1,2,3,5;5;2,9;2;1;1
252857076488;252857076493;5;0,1,2,3,5;5;2,9;2;1;1
252857076493;252857076526;33;0,1,2,3,5;5;2,9;2;1;1
252857076526;252857076530;4;0,1,2,3,5;5;2,9;2;1;1
252857076530;252857076531;1;0,1,2,3,5;5;2,9;2;1;1
252857076531;252857076572;41;0,1,2,3,5;5;2,9;2;1;1
252857076572;252857076578;6;0,1,2,3,5;5;2,9;2;1;1
252857076578;252857076606;28;0,1,2,3,5;5;2,9;2;1;1
252857076606;252857076616;10;0,1,2,3,5;5;2,9;2;1;1
252857076616;252857076644;28;0,1,2,3,5;5;2,9;2;1;1
252857076644;252857076648;4;0,1,2,3,5;5;2,9;2;1;1
252857076648;252857076665;17;0,1,2,3,5;5;2,9;2;1;1
252857076665;252857076673;8;0,1,2,3,5;5;2,9;2;1;1
252857076673;252857076684;11;0,1,2,3,5;5;2,9;2;1;1
252857076684;252857076691;7;0,1,2,3,5;5;2,9;2;1;1
252857076691;252857076693;2;0,1,2,3,5;5;2,9;2;1;1
252857076693;252857076704;11;0,1,2,3,5;5;2,9;2;1;1
252857076704;252857076711;7;0,1,2,3,5;5;2,9;2;1;1
252857076711;252857076713;2;0,1,2,3,5;5;2,9;2;1;1
252857076713;252857076714;1;0,1,2,3,5;5;2,9;2;1;1
252857076714;252857076725;11;0,1,2,3,5;5;2,9;2;1;1
252857076725;252857076752;27;0,1,2,3,5;5;2,9;2;1;1
252857076752;252857076754;2;0,1,2,3,5;5;2,9;2;1;1
252857076754;252857076760;6;0,1,2,3,5;5;2,9;2;1;1
252857076760;252857076773;13;0,1,2,3,5;5;2,9;2;1;1
252857076773;252857076780;7;0,1,2,3,5;5;2,9;2;1;1
252857076780;252857076801;21;0,1,2,3,5;5;2,9;2;1;1
252857076801;252857076803;2;0,1,2,3,5;5;2,9;2;1;1
252857076803;252857076806;3;0,1,2,3,5;5;2,9;2;1;1
252857076806;252857076820;14;0,1,2,3,5;5;2,9;2;1;1
252857076820;252857076835;15;0,1,2,3,5;5;2,9;2;1;1
252857076835;252857076846;11;0,1,2,3,5;5;2,9;2;1;1
252857076846;252857076852;6;0,1,2,3,5;5;2,9;2;1;1
252857076852;252857076869;17;0,1,2,3,5;5;2,9;2;1;1
252857076869;252857076871;2;0,1,2,3,5;5;2,9;2;1;1
252857076871;252857076876;5;0,1,2,3,5;5;2,9;2;1;1
252857076876;252857076882;6;0,1,2,3,5;5;2,9;2;1;1
252857076882;252857076892;10;0,1,2,3,5;5;2,9;2;1;1
252857076892;252857076896;4;0,1,2,3,5;5;2,9;2;1;1
252857076896;252857076915;19;0,1,2,3,5;5;2,9;2;1;1
252857076915;252857076955;40;0,1,2,3,5;5;2,9;2;1;1
252857076955;252857076981;26;0,1,2,3,5;5;2,9;2;1;1
252857076981;252857077010;29;0,1,2,3,5;5;2,9;2;1;1
252857077010;252857077040;30;0,1,2,3,5;5;2,9;2;1;1
252857077040;252857077089;49;0,1,2,3,5;5;2,9;2;1;1
252857077089;252857077100;11;0,1,2,3,5;5;2,9;2;1;1
252857077100;252857077111;11;0,1,2,3,5;5;2,9;2;1;1
252857077111;252857077142;31;0,1,2,3,5;5;2,9;2;1;1
252857077142;252857077158;16;0,1,2,3,5;5;2,9;2;1;1
252857077158;252857077177;19;0,1,2,3,5;5;2,9;2;1;1
252857077177;252857077187;10;0,1,2,3,5;5;2,9;2;1;1
252857077187;252857077215;28;0,1,2,3,5;5;2,9;2;1;1
252857077215;252857077216;1;0,1,2,3,5;5;2,9;2;1;1
252857077216;252857077218;2;0,1,2,3,5;5;2,9;2;1;1
252857077218;252857077231;13;0,1,2,3,5;5;2,9;2;1;1
252857077231;252857077236;5;0,1,2,3,5;5;2,9;2;1;1
252857077236;252857077251;15;0,1,2,3,5;5;2,9;2;1;1
252857077251;252857077261;10;0,1,2,3,5;5;2,9;2;1;1
252857077261;252857077264;3;0,1,2,3,5;5;2,9;2;1;1
252857077264;252857077280;16;0,1,2,3,5;5;2,9;2;1;1
252857077280;252857077305;25;0,1,2,3,5;5;2,9;2;1;1
252857077305;252857077309;4;0,1,2,3,5;5;2,9;2;1;1
252857077309;252857077330;21;0,1,2,3,5;5;2,9;2;1;1
252857077330;252857077343;13;0,1,2,3,5;5;2,9;2;1;1
252857077343;252857077360;17;0,1,2,3,5;5;2,9;2;1;1
252857077360;252857077371;11;0,1,2,3,5;5;2,9;2;1;1
252857077371;252857077383;12;0,1,2,3,5;5;2,9;2;1;1
252857077383;252857077394;11;0,1,2,3,5;5;2,9;2;1;1
252857077394;252857077396;2;0,1,2,3,5;5;2,9;2;1;1
252857077396;252857077403;7;0,1,2,3,5;5;2,9;2;1;1
252857077403;252857077424;21;0,1,2,3,5;5;2,9;2;1;1
252857077424;252857077425;1;0,1,2,3,5;5;2,9;2;1;1
252857077425;252857077426;1;0,1,2,3,5;5;2,9;2;1;1
252857077426;252857077445;19;0,1,2,3,5;5;2,9;2;1;1
252857077445;252857077458;13;0,1,2,3,5;5;2,9;2;1;1
252857077458;252857077474;16;0,1,2,3,5;5;2,9;2;1;1
252857077474;252857077477;3;0,1,2,3,5;5;2,9;2;1;1
252857077477;252857077498;21;0,1,2,3,5;5;2,9;2;1;1
252857077498;252857077517;19;0,1,2,3,5;5;2,9;2;1;1
252857077517;252857077547;30;0,1,2,3,5;5;2,9;2;1;1
252857077547;252857077574;27;0,1,2,3,5;5;2,9;2;1;1
252857077574;252857077595;21;0,1,2,3,5;5;2,9;2;1;1
252857077595;252857077622;27;0,1,2,3,5;5;2,9;2;1;1
252857077622;252857077667;45;0,1,2,3,5;5;2,9;2;1;1
252857077667;252857077698;31;0,1,2,3,5;5;2,9;2;1;1
252857077698;252857077713;15;0,1,2,3,5;5;2,9;2;1;1
252857077713;252857077718;5;0,1,2,3,5;5;2,9;2;1;1
252857077718;252857077736;18;0,1,2,3,5;5;2,9;2;1;1
252857077736;252857077749;13;0,1,2,3,5;5;2,9;2;1;1
252857077749;252857077768;19;0,1,2,3,5;5;2,9;2;1;1
252857077768;252857077781;13;0,1,2,3,5;5;2,9;2;1;1
252857077781;252857077790;9;0,1,2,3,5;5;2,9;2;1;1
252857077790;252857077810;20;0,1,2,3,5;5;2,9;2;1;1
252857077810;252857077818;8;0,1,2,3,5;5;2,9;2;1;1
252857077818;252857077843;25;0,1,2,3,5;5;2,9;2;1;1
252857077843;252857077846;3;0,1,2,3,5;5;2,9;2;1;1
252857077846;252857077864;18;0,1,2,3,5;5;2,9;2;1;1
252857077864;252857077879;15;0,1,2,3,5;5;2,9;2;1;1
252857077879;252857077882;3;0,1,2,3,5;5;2,9;2;1;1
252857077882;252857077917;35;0,1,2,3,5;5;2,9;2;1;1
252857077917;252857077937;20;0,1,2,3,5;5;2,9;2;1;1
252857077937;252857077938;1;0,1,2,3,5;5;2,9;2;1;1
252857077938;252857077956;18;0,1,2,3,5;5;2,9;2;1;1
252857077956;252857077957;1;0,1,2,3,5;5;2,9;2;1;1
252857077957;252857077980;23;0,1,2,3,5;5;2,9;2;1;1
252857077980;252857077986;6;0,1,2,3,5;5;2,9;2;1;1
252857077986;252857078007;21;0,1,2,3,5;5;2,9;2;1;1
252857078007;252857078010;3;0,1,2,3,5;5;2,9;2;1;1
252857078010;252857078026;16;0,1,2,3,5;5;2,9;2;1;1
252857078026;252857078032;6;0,1,2,3,5;5;2,9;2;1;1
252857078032;252857078050;18;0,1,2,3,5;5;2,9;2;1;1
252857078050;252857078052;2;0,1,2,3,5;5;2,9;2;1;1
252857078052;252857078069;17;0,1,2,3,5;5;2,9;2;1;1
252857078069;252857078090;21;0,1,2,3,5;5;2,9;2;1;1
252857078090;252857078116;26;0,1,2,3,5;5;2,9;2;1;1
252857078116;252857078136;20;0,1,2,3,5;5;2,9;2;1;1
252857078136;252857078153;17;0,1,2,3,5;5;2,9;2;1;1
252857078153;252857081228;3075;0,1,2,3,5;5;2,9;2;1;1
252857081228;252857081345;117;0,1,2,3,5;5;2,9;2;1;1
252857081345;252857081406;61;0,1,2,3,5;5;2,9;2;1;1
252857081406;252857081407;1;0,1,2,3,5;5;2,9;2;1;1
252857081407;252857081539;132;0,1,2,3,5;5;2,9;2;1;1
252857081539;252857081599;60;0,1,2,3,5;5;2,9;2;1;1
252857081599;252857081605;6;0,1,2,3,5;5;2,9;2;1;1
252857081605;252857081638;33;0,1,2,3,5;5;2,9;2;1;1
252857081638;252857081639;1;0,1,2,3,5;5;2,9;2;1;1
252857081639;252857081740;101;0,1,2,3,5;5;2,9;2;1;1
252857081740;252857081815;75;0,1,2,3,5;5;2,9;2;1;1
252857081815;252857081820;5;0,1,2,3,5;5;2,9;2;1;1
252857081820;252857081851;31;0,1,2,3,5;5;2,9;2;1;1
252857081851;252857081866;15;0,1,2,3,5;5;2,9;2;1;1
252857081866;252857081875;9;0,1,2,3,5;5;2,9;2;1;1
252857081875;252857081895;20;0,1,2,3,5;5;2,9;2;1;1
252857081895;252857081917;22;0,1,2,3,5;5;2,9;2;1;1
252857081917;252857081971;54;0,1,2,3,5;5;2,9;2;1;1
252857081971;252857081986;15;0,1,2,3,5;5;2,9;2;1;1
252857081986;252857082007;21;0,1,2,3,5;5;2,9;2;1;1
252857082007;252857082014;7;0,1,2,3,5;5;2,9;2;1;1
252857082014;252857082020;6;0,1,2,3,5;5;2,9;2;1;1
252857082020;252857082041;21;0,1,2,3,5;5;2,9;2;1;1
252857082041;252857082055;14;0,1,2,3,5;5;2,9;2;1;1
252857082055;252857082056;1;0,1,2,3,5;5;2,9;2;1;1
252857082056;252857082063;7;0,1,2,3,5;5;2,9;2;1;1
252857082063;252857082064;1;0,1,2,3,5;5;2,9;2;1;1
252857082064;252857082073;9;0,1,2,3,5;5;2,9;2;1;1
252857082073;252857082074;1;0,1,2,3,5;5;2,9;2;1;1
252857082074;252857082101;27;0,1,2,3,5;5;2,9;2;1;1
252857082101;252857082104;3;0,1,2,3,5;5;2,9;2;1;1
252857082104;252857082106;2;0,1,2,3,5;5;2,9;2;1;1
252857082106;252857082107;1;0,1,2,3,5;5;2,9;2;1;1
252857082107;252857082151;44;0,1,2,3,5;5;2,9;2;1;1
252857082151;252857082171;20;0,1,2,3,5;5;2,9;2;1;1
252857082171;252857082177;6;0,1,2,3,5;5;2,9;2;1;1
252857082177;252857082183;6;0,1,2,3,5;5;2,9;2;1;1
252857082183;252857082194;11;0,1,2,3,5;5;2,9;2;1;1
252857082194;252857082203;9;0,1,2,3,5;5;2,9;2;1;1
252857082203;252857082230;27;0,1,2,3,5;5;2,9;2;1;1
252857082230;252857082246;16;0,1,2,3,5;5;2,9;2;1;1
252857082246;252857082270;24;0,1,2,3,5;5;2,9;2;1;1
252857082270;252857082276;6;0,1,2,3,5;5;2,9;2;1;1
252857082276;252857082288;12;0,1,2,3,5;5;2,9;2;1;1
252857082288;252857082306;18;0,1,2,3,5;5;2,9;2;1;1
252857082306;252857082307;1;0,1,2,3,5;5;2,9;2;1;1
252857082307;252857082314;7;0,1,2,3,5;5;2,9;2;1;1
252857082314;252857082323;9;0,1,2,3,5;5;2,9;2;1;1
252857082323;252857082329;6;0,1,2,3,5;5;2,9;2;1;1
252857082329;252857082331;2;0,1,2,3,5;5;2,9;2;1;1
252857082331;252857082340;9;0,1,2,3,5;5;2,9;2;1;1
252857082340;252857082355;15;0,1,2,3,5;5;2,9;2;1;1
252857082355;252857082361;6;0,1,2,3,5;5;2,9;2;1;1
252857082361;252857082375;14;0,1,2,3,5;5;2,9;2;1;1
252857082375;252857082377;2;0,1,2,3,5;5;2,9;2;1;1
252857082377;252857082383;6;0,1,2,3,5;5;2,9;2;1;1
252857082383;252857082400;17;0,1,2,3,5;5;2,9;2;1;1
252857082400;252857082405;5;0,1,2,3,5;5;2,9;2;1;1
252857082405;252857082447;42;0,1,2,3,5;5;2,9;2;1;1
252857082447;252857082448;1;0,1,2,3,5;5;2,9;2;1;1
252857082448;252857082517;69;0,1,2,3,5;5;2,9;2;1;1
252857082517;252857082519;2;0,1,2,3,5;5;2,9;2;1;1
252857082519;252857082529;10;0,1,2,3,5;5;2,9;2;1;1
252857082529;252857082533;4;0,1,2,3,5;5;2,9;2;1;1
252857082533;252857082543;10;0,1,2,3,5;5;2,9;2;1;1
252857082543;252857082544;1;0,1,2,3,5;5;2,9;2;1;1
252857082544;252857082552;8;0,1,2,3,5;5;2,9;2;1;1
252857082552;252857082564;12;0,1,2,3,5;5;2,9;2;1;1
252857082564;252857082569;5;0,1,2,3,5;5;2,9;2;1;1
252857082569;252857082587;18;0,1,2,3,5;5;2,9;2;1;1
252857082587;252857082588;1;0,1,2,3,5;5;2,9;2;1;1
252857082588;252857082590;2;0,1,2,3,5;5;2,9;2;1;1
252857082590;252857082593;3;0,1,2,3,5;5;2,9;2;1;1
252857082593;252857082609;16;0,1,2,3,5;5;2,9;2;1;1
252857082609;252857082624;15;0,1,2,3,5;5;2,9;2;1;1
252857082624;252857082625;1;0,1,2,3,5;5;2,9;2;1;1
252857082625;252857082638;13;0,1,2,3,5;5;2,9;2;1;1
252857082638;252857082644;6;0,1,2,3,5;5;2,9;2;1;1
252857082644;252857082652;8;0,1,2,3,5;5;2,9;2;1;1
252857082652;252857082670;18;0,1,2,3,5;5;2,9;2;1;1
252857082670;252857082685;15;0,1,2,3,5;5;2,9;2;1;1
252857082685;252857082695;10;0,1,2,3,5;5;2,9;2;1;1
252857082695;252857082720;25;0,1,2,3,5;5;2,9;2;1;1
252857082720;252857082722;2;0,1,2,3,5;5;2,9;2;1;1
252857082722;252857082748;26;0,1,2,3,5;5;2,9;2;1;1
252857082748;252857082754;6;0,1,2,3,5;5;2,9;2;1;1
252857082754;252857082783;29;0,1,2,3,5;5;2,9;2;1;1
252857082783;252857082794;11;0,1,2,3,5;5;2,9;2;1;1
252857082794;252857082802;8;0,1,2,3,5;5;2,9;2;1;1
252857082802;252857082811;9;0,1,2,3,5;5;2,9;2;1;1
252857082811;252857082818;7;0,1,2,3,5;5;2,9;2;1;1
252857082818;252857082826;8;0,1,2,3,5;5;2,9;2;1;1
252857082826;252857082839;13;0,1,2,3,5;5;2,9;2;1;1
252857082839;252857082842;3;0,1,2,3,5;5;2,9;2;1;1
252857082842;252857082845;3;0,1,2,3,5;5;2,9;2;1;1
252857082845;252857082864;19;0,1,2,3,5;5;2,9;2;1;1
252857082864;252857082882;18;0,1,2,3,5;5;2,9;2;1;1
252857082882;252857082887;5;0,1,2,3,5;5;2,9;2;1;1
252857082887;252857082890;3;0,1,2,3,5;5;2,9;2;1;1
252857082890;252857082895;5;0,1,2,3,5;5;2,9;2;1;1
252857082895;252857082899;4;0,1,2,3,5;5;2,9;2;1;1
252857082899;252857082915;16;0,1,2,3,5;5;2,9;2;1;1
252857082915;252857082942;27;0,1,2,3,5;5;2,9;2;1;1
252857082942;252857082950;8;0,1,2,3,5;5;2,9;2;1;1
252857082950;252857082954;4;0,1,2,3,5;5;2,9;2;1;1
252857082954;252857082966;12;0,1,2,3,5;5;2,9;2;1;1
252857082966;252857082969;3;0,1,2,3,5;5;2,9;2;1;1
252857082969;252857082983;14;0,1,2,3,5;5;2,9;2;1;1
252857082983;252857082990;7;0,1,2,3,5;5;2,9;2;1;1
252857082990;252857082996;6;0,1,2,3,5;5;2,9;2;1;1
252857082996;252857083000;4;0,1,2,3,5;5;2,9;2;1;1
252857083000;252857083001;1;0,1,2,3,5;5;2,9;2;1;1
252857083001;252857083020;19;0,1,2,3,5;5;2,9;2;1;1
252857083020;252857083049;29;0,1,2,3,5;5;2,9;2;1;1
252857083049;252857083053;4;0,1,2,3,5;5;2,9;2;1;1
252857083053;252857083056;3;0,1,2,3,5;5;2,9;2;1;1
252857083056;252857083057;1;0,1,2,3,5;5;2,9;2;1;1
252857083057;252857083062;5;0,1,2,3,5;5;2,9;2;1;1
252857083062;252857083065;3;0,1,2,3,5;5;2,9;2;1;1
252857083065;252857083072;7;0,1,2,3,5;5;2,9;2;1;1
252857083072;252857083075;3;0,1,2,3,5;5;2,9;2;1;1
252857083075;252857083079;4;0,1,2,3,5;5;2,9;2;1;1
252857083079;252857083086;7;0,1,2,3,5;5;2,9;2;1;1
252857083086;252857083097;11;0,1,2,3,5;5;2,9;2;1;1
252857083097;252857083105;8;0,1,2,3,5;5;2,9;2;1;1
252857083105;252857083109;4;0,1,2,3,5;5;2,9;2;1;1
252857083109;252857083121;12;0,1,2,3,5;5;2,9;2;1;1
252857083121;252857083125;4;0,1,2,3,5;5;2,9;2;1;1
252857083125;252857083129;4;0,1,2,3,5;5;2,9;2;1;1
252857083129;252857083148;19;0,1,2,3,5;5;2,9;2;1;1
252857083148;252857083158;10;0,1,2,3,5;5;2,9;2;1;1
252857083158;252857083165;7;0,1,2,3,5;5;2,9;2;1;1
252857083165;252857083176;11;0,1,2,3,5;5;2,9;2;1;1
252857083176;252857083184;8;0,1,2,3,5;5;2,9;2;1;1
252857083184;252857083186;2;0,1,2,3,5;5;2,9;2;1;1
252857083186;252857083189;3;0,1,2,3,5;5;2,9;2;1;1
252857083189;252857083203;14;0,1,2,3,5;5;2,9;2;1;1
252857083203;252857083208;5;0,1,2,3,5;5;2,9;2;1;1
252857083208;252857083214;6;0,1,2,3,5;5;2,9;2;1;1
252857083214;252857083218;4;0,1,2,3,5;5;2,9;2;1;1
252857083218;252857083219;1;0,1,2,3,5;5;2,9;2;1;1
252857083219;252857083226;7;0,1,2,3,5;5;2,9;2;1;1
252857083226;252857083240;14;0,1,2,3,5;5;2,9;2;1;1
252857083240;252857083252;12;0,1,2,3,5;5;2,9;2;1;1
252857083252;252857083280;28;0,1,2,3,5;5;2,9;2;1;1
252857083280;252857083303;23;0,1,2,3,5;5;2,9;2;1;1
252857083303;252857083316;13;0,1,2,3,5;5;2,9;2;1;1
252857083316;252857083320;4;0,1,2,3,5;5;2,9;2;1;1
252857083320;252857083346;26;0,1,2,3,5;5;2,9;2;1;1
252857083346;252857083347;1;0,1,2,3,5;5;2,9;2;1;1
252857083347;252857083349;2;0,1,2,3,5;5;2,9;2;1;1
252857083349;252857083370;21;0,1,2,3,5;5;2,9;2;1;1
252857083370;252857083377;7;0,1,2,3,5;5;2,9;2;1;1
252857083377;252857083398;21;0,1,2,3,5;5;2,9;2;1;1
252857083398;252857083403;5;0,1,2,3,5;5;2,9;2;1;1
252857083403;252857083407;4;0,1,2,3,5;5;2,9;2;1;1
252857083407;252857083422;15;0,1,2,3,5;5;2,9;2;1;1
252857083422;252857083430;8;0,1,2,3,5;5;2,9;2;1;1
252857083430;252857083447;17;0,1,2,3,5;5;2,9;2;1;1
252857083447;252857083456;9;0,1,2,3,5;5;2,9;2;1;1
252857083456;252857083475;19;0,1,2,3,5;5;2,9;2;1;1
252857083475;252857083492;17;0,1,2,3,5;5;2,9;2;1;1
252857083492;252857083495;3;0,1,2,3,5;5;2,9;2;1;1
252857083495;252857083506;11;0,1,2,3,5;5;2,9;2;1;1
252857083506;252857083514;8;0,1,2,3,5;5;2,9;2;1;1
252857083514;252857083515;1;0,1,2,3,5;5;2,9;2;1;1
252857083515;252857083521;6;0,1,2,3,5;5;2,9;2;1;1
252857083521;252857083522;1;0,1,2,3,5;5;2,9;2;1;1
252857083522;252857083523;1;0,1,2,3,5;5;2,9;2;1;1
252857083523;252857083528;5;0,1,2,3,5;5;2,9;2;1;1
252857083528;252857083531;3;0,1,2,3,5;5;2,9;2;1;1
252857083531;252857083553;22;0,1,2,3,5;5;2,9;2;1;1
252857083553;252857083555;2;0,1,2,3,5;5;2,9;2;1;1
252857083555;252857083571;16;0,1,2,3,5;5;2,9;2;1;1
252857083571;252857083572;1;0,1,2,3,5;5;2,9;2;1;1
252857083572;252857083574;2;0,1,2,3,5;5;2,9;2;1;1
252857083574;252857083575;1;0,1,2,3,5;5;2,9;2;1;1
252857083575;252857083578;3;0,1,2,3,5;5;2,9;2;1;1
252857083578;252857083581;3;0,1,2,3,5;5;2,9;2;1;1
252857083581;252857083596;15;0,1,2,3,5;5;2,9;2;1;1
252857083596;252857083616;20;0,1,2,3,5;5;2,9;2;1;1
252857083616;252857083620;4;0,1,2,3,5;5;2,9;2;1;1
252857083620;252857083622;2;0,1,2,3,5;5;2,9;2;1;1
252857083622;252857083638;16;0,1,2,3,5;5;2,9;2;1;1
252857083638;252857083642;4;0,1,2,3,5;5;2,9;2;1;1
252857083642;252857083666;24;0,1,2,3,5;5;2,9;2;1;1
252857083666;252857083679;13;0,1,2,3,5;5;2,9;2;1;1
252857083679;252857083692;13;0,1,2,3,5;5;2,9;2;1;1
252857083692;252857083695;3;0,1,2,3,5;5;2,9;2;1;1
252857083695;252857083705;10;0,1,2,3,5;5;2,9;2;1;1
252857083705;252857083724;19;0,1,2,3,5;5;2,9;2;1;1
252857083724;252857083739;15;0,1,2,3,5;5;2,9;2;1;1
252857083739;252857083742;3;0,1,2,3,5;5;2,9;2;1;1
252857083742;252857083753;11;0,1,2,3,5;5;2,9;2;1;1
252857083753;252857083765;12;0,1,2,3,5;5;2,9;2;1;1
252857083765;252857083784;19;0,1,2,3,5;5;2,9;2;1;1
252857083784;252857083791;7;0,1,2,3,5;5;2,9;2;1;1
252857083791;252857083793;2;0,1,2,3,5;5;2,9;2;1;1
252857083793;252857083805;12;0,1,2,3,5;5;2,9;2;1;1
252857083805;252857083810;5;0,1,2,3,5;5;2,9;2;1;1
252857083810;252857083811;1;0,1,2,3,5;5;2,9;2;1;1
252857083811;252857083816;5;0,1,2,3,5;5;2,9;2;1;1
252857083816;252857083828;12;0,1,2,3,5;5;2,9;2;1;1
252857083828;252857083829;1;0,1,2,3,5;5;2,9;2;1;1
252857083829;252857083840;11;0,1,2,3,5;5;2,9;2;1;1
252857083840;252857083845;5;0,1,2,3,5;5;2,9;2;1;1
252857083845;252857083858;13;0,1,2,3,5;5;2,9;2;1;1
252857083858;252857083860;2;0,1,2,3,5;5;2,9;2;1;1
252857083860;252857083863;3;0,1,2,3,5;5;2,9;2;1;1
252857083863;252857083864;1;0,1,2,3,5;5;2,9;2;1;1
252857083864;252857083869;5;0,1,2,3,5;5;2,9;2;1;1
252857083869;252857083872;3;0,1,2,3,5;5;2,9;2;1;1
252857083872;252857083880;8;0,1,2,3,5;5;2,9;2;1;1
252857083880;252857083886;6;0,1,2,3,5;5;2,9;2;1;1
252857083886;252857083887;1;0,1,2,3,5;5;2,9;2;1;1
252857083887;252857083888;1;0,1,2,3,5;5;2,9;2;1;1
252857083888;252857083898;10;0,1,2,3,5;5;2,9;2;1;1
252857083898;252857083908;10;0,1,2,3,5;5;2,9;2;1;1
252857083908;252857083918;10;0,1,2,3,5;5;2,9;2;1;1
252857083918;252857083928;10;0,1,2,3,5;5;2,9;2;1;1
252857083928;252857083947;19;0,1,2,3,5;5;2,9;2;1;1
252857083947;252857083957;10;0,1,2,3,5;5;2,9;2;1;1
252857083957;252857083958;1;0,1,2,3,5;5;2,9;2;1;1
252857083958;252857083959;1;0,1,2,3,5;5;2,9;2;1;1
252857083959;252857083964;5;0,1,2,3,5;5;2,9;2;1;1
252857083964;252857083992;28;0,1,2,3,5;5;2,9;2;1;1
252857083992;252857083996;4;0,1,2,3,5;5;2,9;2;1;1
252857083996;252857084008;12;0,1,2,3,5;5;2,9;2;1;1
252857084008;252857084009;1;0,1,2,3,5;5;2,9;2;1;1
252857084009;252857084015;6;0,1,2,3,5;5;2,9;2;1;1
252857084015;252857084017;2;0,1,2,3,5;5;2,9;2;1;1
252857084017;252857084018;1;0,1,2,3,5;5;2,9;2;1;1
252857084018;252857084042;24;0,1,2,3,5;5;2,9;2;1;1
252857084042;252857084043;1;0,1,2,3,5;5;2,9;2;1;1
252857084043;252857084044;1;0,1,2,3,5;5;2,9;2;1;1
252857084044;252857084052;8;0,1,2,3,5;5;2,9;2;1;1
252857084052;252857084059;7;0,1,2,3,5;5;2,9;2;1;1
252857084059;252857084060;1;0,1,2,3,5;5;2,9;2;1;1
252857084060;252857084067;7;0,1,2,3,5;5;2,9;2;1;1
252857084067;252857084068;1;0,1,2,3,5;5;2,9;2;1;1
252857084068;252857084072;4;0,1,2,3,5;5;2,9;2;1;1
252857084072;252857084074;2;0,1,2,3,5;5;2,9;2;1;1
252857084074;252857084079;5;0,1,2,3,5;5;2,9;2;1;1
252857084079;252857084080;1;0,1,2,3,5;5;2,9;2;1;1
252857084080;252857084097;17;0,1,2,3,5;5;2,9;2;1;1
252857084097;252857084099;2;0,1,2,3,5;5;2,9;2;1;1
252857084099;252857084104;5;0,1,2,3,5;5;2,9;2;1;1
252857084104;252857084118;14;0,1,2,3,5;5;2,9;2;1;1
252857084118;252857084137;19;0,1,2,3,5;5;2,9;2;1;1
252857084137;252857084138;1;0,1,2,3,5;5;2,9;2;1;1
252857084138;252857084150;12;0,1,2,3,5;5;2,9;2;1;1
252857084150;252857084155;5;0,1,2,3,5;5;2,9;2;1;1
252857084155;252857084156;1;0,1,2,3,5;5;2,9;2;1;1
252857084156;252857084157;1;0,1,2,3,5;5;2,9;2;1;1
252857084157;252857084170;13;0,1,2,3,5;5;2,9;2;1;1
252857084170;252857084172;2;0,1,2,3,5;5;2,9;2;1;1
252857084172;252857084174;2;0,1,2,3,5;5;2,9;2;1;1
252857084174;252857084175;1;0,1,2,3,5;5;2,9;2;1;1
252857084175;252857084178;3;0,1,2,3,5;5;2,9;2;1;1
252857084178;252857084180;2;0,1,2,3,5;5;2,9;2;1;1
252857084180;252857084187;7;0,1,2,3,5;5;2,9;2;1;1
252857084187;252857084209;22;0,1,2,3,5;5;2,9;2;1;1
252857084209;252857084228;19;0,1,2,3,5;5;2,9;2;1;1
252857084228;252857084236;8;0,1,2,3,5;5;2,9;2;1;1
252857084236;252857084242;6;0,1,2,3,5;5;2,9;2;1;1
252857084242;252857084252;10;0,1,2,3,5;5;2,9;2;1;1
252857084252;252857084253;1;0,1,2,3,5;5;2,9;2;1;1
252857084253;252857084262;9;0,1,2,3,5;5;2,9;2;1;1
252857084262;252857084267;5;0,1,2,3,5;5;2,9;2;1;1
252857084267;252857084278;11;0,1,2,3,5;5;2,9;2;1;1
252857084278;252857084286;8;0,1,2,3,5;5;2,9;2;1;1
252857084286;252857084289;3;0,1,2,3,5;5;2,9;2;1;1
252857084289;252857084290;1;0,1,2,3,5;5;2,9;2;1;1
252857084290;252857084293;3;0,1,2,3,5;5;2,9;2;1;1
252857084293;252857084305;12;0,1,2,3,5;5;2,9;2;1;1
252857084305;252857084311;6;0,1,2,3,5;5;2,9;2;1;1
252857084311;252857084314;3;0,1,2,3,5;5;2,9;2;1;1
252857084314;252857084317;3;0,1,2,3,5;5;2,9;2;1;1
252857084317;252857084323;6;0,1,2,3,5;5;2,9;2;1;1
252857084323;252857084328;5;0,1,2,3,5;5;2,9;2;1;1
252857084328;252857084329;1;0,1,2,3,5;5;2,9;2;1;1
252857084329;252857084339;10;0,1,2,3,5;5;2,9;2;1;1
252857084339;252857084344;5;0,1,2,3,5;5;2,9;2;1;1
252857084344;252857084359;15;0,1,2,3,5;5;2,9;2;1;1
252857084359;252857084371;12;0,1,2,3,5;5;2,9;2;1;1
252857084371;252857084373;2;0,1,2,3,5;5;2,9;2;1;1
252857084373;252857084378;5;0,1,2,3,5;5;2,9;2;1;1
252857084378;252857084387;9;0,1,2,3,5;5;2,9;2;1;1
252857084387;252857084389;2;0,1,2,3,5;5;2,9;2;1;1
252857084389;252857084391;2;0,1,2,3,5;5;2,9;2;1;1
252857084391;252857084394;3;0,1,2,3,5;5;2,9;2;1;1
252857084394;252857084399;5;0,1,2,3,5;5;2,9;2;1;1
252857084399;252857084405;6;0,1,2,3,5;5;2,9;2;1;1
252857084405;252857084407;2;0,1,2,3,5;5;2,9;2;1;1
252857084407;252857084410;3;0,1,2,3,5;5;2,9;2;1;1
252857084410;252857084414;4;0,1,2,3,5;5;2,9;2;1;1
252857084414;252857084452;38;0,1,2,3,5;5;2,9;2;1;1
252857084452;252857084457;5;0,1,2,3,5;5;2,9;2;1;1
252857084457;252857084460;3;0,1,2,3,5;5;2,9;2;1;1
252857084460;252857084470;10;0,1,2,3,5;5;2,9;2;1;1
252857084470;252857084478;8;0,1,2,3,5;5;2,9;2;1;1
252857084478;252857084482;4;0,1,2,3,5;5;2,9;2;1;1
252857084482;252857084486;4;0,1,2,3,5;5;2,9;2;1;1
252857084486;252857084492;6;0,1,2,3,5;5;2,9;2;1;1
252857084492;252857084497;5;0,1,2,3,5;5;2,9;2;1;1
252857084497;252857084502;5;0,1,2,3,5;5;2,9;2;1;1
252857084502;252857084505;3;0,1,2,3,5;5;2,9;2;1;1
252857084505;252857084520;15;0,1,2,3,5;5;2,9;2;1;1
252857084520;252857084529;9;0,1,2,3,5;5;2,9;2;1;1
252857084529;252857084538;9;0,1,2,3,5;5;2,9;2;1;1
252857084538;252857084539;1;0,1,2,3,5;5;2,9;2;1;1
252857084539;252857084552;13;0,1,2,3,5;5;2,9;2;1;1
252857084552;252857084558;6;0,1,2,3,5;5;2,9;2;1;1
252857084558;252857084566;8;0,1,2,3,5;5;2,9;2;1;1
252857084566;252857084568;2;0,1,2,3,5;5;2,9;2;1;1
252857084568;252857084569;1;0,1,2,3,5;5;2,9;2;1;1
252857084569;252857084571;2;0,1,2,3,5;5;2,9;2;1;1
252857084571;252857084579;8;0,1,2,3,5;5;2,9;2;1;1
252857084579;252857084580;1;0,1,2,3,5;5;2,9;2;1;1
252857084580;252857084583;3;0,1,2,3,5;5;2,9;2;1;1
252857084583;252857084587;4;0,1,2,3,5;5;2,9;2;1;1
252857084587;252857084605;18;0,1,2,3,5;5;2,9;2;1;1
252857084605;252857084618;13;0,1,2,3,5;5;2,9;2;1;1
252857084618;252857084629;11;0,1,2,3,5;5;2,9;2;1;1
252857084629;252857084636;7;0,1,2,3,5;5;2,9;2;1;1
252857084636;252857084640;4;0,1,2,3,5;5;2,9;2;1;1
252857084640;252857084658;18;0,1,2,3,5;5;2,9;2;1;1
252857084658;252857084662;4;0,1,2,3,5;5;2,9;2;1;1
252857084662;252857084663;1;0,1,2,3,5;5;2,9;2;1;1
252857084663;252857084672;9;0,1,2,3,5;5;2,9;2;1;1
252857084672;252857084676;4;0,1,2,3,5;5;2,9;2;1;1
252857084676;252857084678;2;0,1,2,3,5;5;2,9;2;1;1
252857084678;252857084683;5;0,1,2,3,5;5;2,9;2;1;1
252857084683;252857084684;1;0,1,2,3,5;5;2,9;2;1;1
252857084684;252857084686;2;0,1,2,3,5;5;2,9;2;1;1
252857084686;252857084702;16;0,1,2,3,5;5;2,9;2;1;1
252857084702;252857084718;16;0,1,2,3,5;5;2,9;2;1;1
252857084718;252857084720;2;0,1,2,3,5;5;2,9;2;1;1
252857084720;252857084722;2;0,1,2,3,5;5;2,9;2;1;1
252857084722;252857084726;4;0,1,2,3,5;5;2,9;2;1;1
252857084726;252857084735;9;0,1,2,3,5;5;2,9;2;1;1
252857084735;252857084740;5;0,1,2,3,5;5;2,9;2;1;1
252857084740;252857084752;12;0,1,2,3,5;5;2,9;2;1;1
252857084752;252857084756;4;0,1,2,3,5;5;2,9;2;1;1
252857084756;252857084763;7;0,1,2,3,5;5;2,9;2;1;1
252857084763;252857084765;2;0,1,2,3,5;5;2,9;2;1;1
252857084765;252857084775;10;0,1,2,3,5;5;2,9;2;1;1
252857084775;252857084776;1;0,1,2,3,5;5;2,9;2;1;1
252857084776;252857084783;7;0,1,2,3,5;5;2,9;2;1;1
252857084783;252857084798;15;0,1,2,3,5;5;2,9;2;1;1
252857084798;252857084807;9;0,1,2,3,5;5;2,9;2;1;1
252857084807;252857084809;2;0,1,2,3,5;5;2,9;2;1;1
252857084809;252857084810;1;0,1,2,3,5;5;2,9;2;1;1
252857084810;252857084814;4;0,1,2,3,5;5;2,9;2;1;1
252857084814;252857084816;2;0,1,2,3,5;5;2,9;2;1;1
252857084816;252857084819;3;0,1,2,3,5;5;2,9;2;1;1
252857084819;252857084821;2;0,1,2,3,5;5;2,9;2;1;1
252857084821;252857084824;3;0,1,2,3,5;5;2,9;2;1;1
252857084824;252857084829;5;0,1,2,3,5;5;2,9;2;1;1
252857084829;252857084875;46;0,1,2,3,5;5;2,9;2;1;1
252857084875;252857084877;2;0,1,2,3,5;5;2,9;2;1;1
252857084877;252857084881;4;0,1,2,3,5;5;2,9;2;1;1
252857084881;252857084885;4;0,1,2,3,5;5;2,9;2;1;1
252857084885;252857084887;2;0,1,2,3,5;5;2,9;2;1;1
252857084887;252857084894;7;0,1,2,3,5;5;2,9;2;1;1
252857084894;252857084898;4;0,1,2,3,5;5;2,9;2;1;1
252857084898;252857084908;10;0,1,2,3,5;5;2,9;2;1;1
252857084908;252857084911;3;0,1,2,3,5;5;2,9;2;1;1
252857084911;252857084914;3;0,1,2,3,5;5;2,9;2;1;1
252857084914;252857084925;11;0,1,2,3,5;5;2,9;2;1;1
252857084925;252857084938;13;0,1,2,3,5;5;2,9;2;1;1
252857084938;252857084939;1;0,1,2,3,5;5;2,9;2;1;1
252857084939;252857084942;3;0,1,2,3,5;5;2,9;2;1;1
252857084942;252857084944;2;0,1,2,3,5;5;2,9;2;1;1
252857084944;252857084947;3;0,1,2,3,5;5;2,9;2;1;1
252857084947;252857084950;3;0,1,2,3,5;5;2,9;2;1;1
252857084950;252857084970;20;0,1,2,3,5;5;2,9;2;1;1
252857084970;252857084973;3;0,1,2,3,5;5;2,9;2;1;1
252857084973;252857084981;8;0,1,2,3,5;5;2,9;2;1;1
252857084981;252857084999;18;0,1,2,3,5;5;2,9;2;1;1
252857084999;252857085001;2;0,1,2,3,5;5;2,9;2;1;1
252857085001;252857085012;11;0,1,2,3,5;5;2,9;2;1;1
252857085012;252857085013;1;0,1,2,3,5;5;2,9;2;1;1
252857085013;252857085026;13;0,1,2,3,5;5;2,9;2;1;1
252857085026;252857085030;4;0,1,2,3,5;5;2,9;2;1;1
252857085030;252857085031;1;0,1,2,3,5;5;2,9;2;1;1
252857085031;252857085049;18;0,1,2,3,5;5;2,9;2;1;1
252857085049;252857085053;4;0,1,2,3,5;5;2,9;2;1;1
252857085053;252857085060;7;0,1,2,3,5;5;2,9;2;1;1
252857085060;252857085064;4;0,1,2,3,5;5;2,9;2;1;1
252857085064;252857085065;1;0,1,2,3,5;5;2,9;2;1;1
252857085065;252857085068;3;0,1,2,3,5;5;2,9;2;1;1
252857085068;252857085081;13;0,1,2,3,5;5;2,9;2;1;1
252857085081;252857085085;4;0,1,2,3,5;5;2,9;2;1;1
252857085085;252857085086;1;0,1,2,3,5;5;2,9;2;1;1
252857085086;252857085110;24;0,1,2,3,5;5;2,9;2;1;1
252857085110;252857085113;3;0,1,2,3,5;5;2,9;2;1;1
252857085113;252857085116;3;0,1,2,3,5;5;2,9;2;1;1
252857085116;252857085129;13;0,1,2,3,5;5;2,9;2;1;1
252857085129;252857085130;1;0,1,2,3,5;5;2,9;2;1;1
252857085130;252857085131;1;0,1,2,3,5;5;2,9;2;1;1
252857085131;252857085139;8;0,1,2,3,5;5;2,9;2;1;1
252857085139;252857085143;4;0,1,2,3,5;5;2,9;2;1;1
252857085143;252857085150;7;0,1,2,3,5;5;2,9;2;1;1
252857085150;252857085152;2;0,1,2,3,5;5;2,9;2;1;1
252857085152;252857085168;16;0,1,2,3,5;5;2,9;2;1;1
252857085168;252857085171;3;0,1,2,3,5;5;2,9;2;1;1
252857085171;252857085172;1;0,1,2,3,5;5;2,9;2;1;1
252857085172;252857085179;7;0,1,2,3,5;5;2,9;2;1;1
252857085179;252857085180;1;0,1,2,3,5;5;2,9;2;1;1
252857085180;252857085183;3;0,1,2,3,5;5;2,9;2;1;1
252857085183;252857085189;6;0,1,2,3,5;5;2,9;2;1;1
252857085189;252857085196;7;0,1,2,3,5;5;2,9;2;1;1
252857085196;252857085197;1;0,1,2,3,5;5;2,9;2;1;1
252857085197;252857085198;1;0,1,2,3,5;5;2,9;2;1;1
252857085198;252857085204;6;0,1,2,3,5;5;2,9;2;1;1
252857085204;252857085217;13;0,1,2,3,5;5;2,9;2;1;1
252857085217;252857085219;2;0,1,2,3,5;5;2,9;2;1;1
252857085219;252857085232;13;0,1,2,3,5;5;2,9;2;1;1
252857085232;252857085233;1;0,1,2,3,5;5;2,9;2;1;1
252857085233;252857085234;1;0,1,2,3,5;5;2,9;2;1;1
252857085234;252857085240;6;0,1,2,3,5;5;2,9;2;1;1
252857085240;252857085245;5;0,1,2,3,5;5;2,9;2;1;1
252857085245;252857085247;2;0,1,2,3,5;5;2,9;2;1;1
252857085247;252857085261;14;0,1,2,3,5;5;2,9;2;1;1
252857085261;252857085262;1;0,1,2,3,5;5;2,9;2;1;1
252857085262;252857085270;8;0,1,2,3,5;5;2,9;2;1;1
252857085270;252857085277;7;0,1,2,3,5;5;2,9;2;1;1
252857085277;252857085278;1;0,1,2,3,5;5;2,9;2;1;1
252857085278;252857085281;3;0,1,2,3,5;5;2,9;2;1;1
252857085281;252857085290;9;0,1,2,3,5;5;2,9;2;1;1
252857085290;252857085292;2;0,1,2,3,5;5;2,9;2;1;1
252857085292;252857085295;3;0,1,2,3,5;5;2,9;2;1;1
252857085295;252857085298;3;0,1,2,3,5;5;2,9;2;1;1
252857085298;252857085309;11;0,1,2,3,5;5;2,9;2;1;1
252857085309;252857085317;8;0,1,2,3,5;5;2,9;2;1;1
252857085317;252857085321;4;0,1,2,3,5;5;2,9;2;1;1
252857085321;252857085325;4;0,1,2,3,5;5;2,9;2;1;1
252857085325;252857085327;2;0,1,2,3,5;5;2,9;2;1;1
252857085327;252857085331;4;0,1,2,3,5;5;2,9;2;1;1
252857085331;252857085338;7;0,1,2,3,5;5;2,9;2;1;1
252857085338;252857085340;2;0,1,2,3,5;5;2,9;2;1;1
252857085340;252857085344;4;0,1,2,3,5;5;2,9;2;1;1
252857085344;252857085347;3;0,1,2,3,5;5;2,9;2;1;1
252857085347;252857085352;5;0,1,2,3,5;5;2,9;2;1;1
252857085352;252857085353;1;0,1,2,3,5;5;2,9;2;1;1
252857085353;252857085357;4;0,1,2,3,5;5;2,9;2;1;1
252857085357;252857085358;1;0,1,2,3,5;5;2,9;2;1;1
252857085358;252857085360;2;0,1,2,3,5;5;2,9;2;1;1
252857085360;252857085365;5;0,1,2,3,5;5;2,9;2;1;1
252857085365;252857085370;5;0,1,2,3,5;5;2,9;2;1;1
252857085370;252857085379;9;0,1,2,3,5;5;2,9;2;1;1
252857085379;252857085390;11;0,1,2,3,5;5;2,9;2;1;1
252857085390;252857085396;6;0,1,2,3,5;5;2,9;2;1;1
252857085396;252857085401;5;0,1,2,3,5;5;2,9;2;1;1
252857085401;252857085405;4;0,1,2,3,5;5;2,9;2;1;1
252857085405;252857085407;2;0,1,2,3,5;5;2,9;2;1;1
252857085407;252857085416;9;0,1,2,3,5;5;2,9;2;1;1
252857085416;252857085417;1;0,1,2,3,5;5;2,9;2;1;1
252857085417;252857085423;6;0,1,2,3,5;5;2,9;2;1;1
252857085423;252857085430;7;0,1,2,3,5;5;2,9;2;1;1
252857085430;252857085432;2;0,1,2,3,5;5;2,9;2;1;1
252857085432;252857085433;1;0,1,2,3,5;5;2,9;2;1;1
252857085433;252857085434;1;0,1,2,3,5;5;2,9;2;1;1
252857085434;252857085443;9;0,1,2,3,5;5;2,9;2;1;1
252857085443;252857085455;12;0,1,2,3,5;5;2,9;2;1;1
252857085455;252857085457;2;0,1,2,3,5;5;2,9;2;1;1
252857085457;252857085461;4;0,1,2,3,5;5;2,9;2;1;1
252857085461;252857085463;2;0,1,2,3,5;5;2,9;2;1;1
252857085463;252857085464;1;0,1,2,3,5;5;2,9;2;1;1
252857085464;252857085469;5;0,1,2,3,5;5;2,9;2;1;1
252857085469;252857085471;2;0,1,2,3,5;5;2,9;2;1;1
252857085471;252857085477;6;0,1,2,3,5;5;2,9;2;1;1
252857085477;252857085481;4;0,1,2,3,5;5;2,9;2;1;1
252857085481;252857085489;8;0,1,2,3,5;5;2,9;2;1;1
252857085489;252857085494;5;0,1,2,3,5;5;2,9;2;1;1
252857085494;252857085497;3;0,1,2,3,5;5;2,9;2;1;1
252857085497;252857085503;6;0,1,2,3,5;5;2,9;2;1;1
252857085503;252857085506;3;0,1,2,3,5;5;2,9;2;1;1
252857085506;252857085507;1;0,1,2,3,5;5;2,9;2;1;1
252857085507;252857085509;2;0,1,2,3,5;5;2,9;2;1;1
252857085509;252857085520;11;0,1,2,3,5;5;2,9;2;1;1
252857085520;252857085521;1;0,1,2,3,5;5;2,9;2;1;1
252857085521;252857085526;5;0,1,2,3,5;5;2,9;2;1;1
252857085526;252857085536;10;0,1,2,3,5;5;2,9;2;1;1
252857085536;252857085545;9;0,1,2,3,5;5;2,9;2;1;1
252857085545;252857085546;1;0,1,2,3,5;5;2,9;2;1;1
252857085546;252857085548;2;0,1,2,3,5;5;2,9;2;1;1
252857085548;252857085555;7;0,1,2,3,5;5;2,9;2;1;1
252857085555;252857085556;1;0,1,2,3,5;5;2,9;2;1;1
252857085556;252857085567;11;0,1,2,3,5;5;2,9;2;1;1
252857085567;252857085572;5;0,1,2,3,5;5;2,9;2;1;1
252857085572;252857085575;3;0,1,2,3,5;5;2,9;2;1;1
252857085575;252857085580;5;0,1,2,3,5;5;2,9;2;1;1
252857085580;252857085586;6;0,1,2,3,5;5;2,9;2;1;1
252857085586;252857085592;6;0,1,2,3,5;5;2,9;2;1;1
252857085592;252857085595;3;0,1,2,3,5;5;2,9;2;1;1
252857085595;252857085599;4;0,1,2,3,5;5;2,9;2;1;1
252857085599;252857085617;18;0,1,2,3,5;5;2,9;2;1;1
252857085617;252857085623;6;0,1,2,3,5;5;2,9;2;1;1
252857085623;252857085626;3;0,1,2,3,5;5;2,9;2;1;1
252857085626;252857085628;2;0,1,2,3,5;5;2,9;2;1;1
252857085628;252857085645;17;0,1,2,3,5;5;2,9;2;1;1
252857085645;252857085646;1;0,1,2,3,5;5;2,9;2;1;1
252857085646;252857085648;2;0,1,2,3,5;5;2,9;2;1;1
252857085648;252857085654;6;0,1,2,3,5;5;2,9;2;1;1
252857085654;252857085657;3;0,1,2,3,5;5;2,9;2;1;1
252857085657;252857085658;1;0,1,2,3,5;5;2,9;2;1;1
252857085658;252857085669;11;0,1,2,3,5;5;2,9;2;1;1
252857085669;252857085670;1;0,1,2,3,5;5;2,9;2;1;1
252857085670;252857085672;2;0,1,2,3,5;5;2,9;2;1;1
252857085672;252857085676;4;0,1,2,3,5;5;2,9;2;1;1
252857085676;252857085682;6;0,1,2,3,5;5;2,9;2;1;1
252857085682;252857085687;5;0,1,2,3,5;5;2,9;2;1;1
252857085687;252857085690;3;0,1,2,3,5;5;2,9;2;1;1
252857085690;252857085692;2;0,1,2,3,5;5;2,9;2;1;1
252857085692;252857085695;3;0,1,2,3,5;5;2,9;2;1;1
252857085695;252857085699;4;0,1,2,3,5;5;2,9;2;1;1
252857085699;252857085701;2;0,1,2,3,5;5;2,9;2;1;1
252857085701;252857085705;4;0,1,2,3,5;5;2,9;2;1;1
252857085705;252857085712;7;0,1,2,3,5;5;2,9;2;1;1
252857085712;252857085718;6;0,1,2,3,5;5;2,9;2;1;1
252857085718;252857085721;3;0,1,2,3,5;5;2,9;2;1;1
252857085721;252857085722;1;0,1,2,3,5;5;2,9;2;1;1
252857085722;252857085727;5;0,1,2,3,5;5;2,9;2;1;1
252857085727;252857085740;13;0,1,2,3,5;5;2,9;2;1;1
252857085740;252857085742;2;0,1,2,3,5;5;2,9;2;1;1
252857085742;252857085745;3;0,1,2,3,5;5;2,9;2;1;1
252857085745;252857085748;3;0,1,2,3,5;5;2,9;2;1;1
252857085748;252857085759;11;0,1,2,3,5;5;2,9;2;1;1
252857085759;252857085762;3;0,1,2,3,5;5;2,9;2;1;1
252857085762;252857085763;1;0,1,2,3,5;5;2,9;2;1;1
252857085763;252857085764;1;0,1,2,3,5;5;2,9;2;1;1
252857085764;252857085770;6;0,1,2,3,5;5;2,9;2;1;1
252857085770;252857085775;5;0,1,2,3,5;5;2,9;2;1;1
252857085775;252857085778;3;0,1,2,3,5;5;2,9;2;1;1
252857085778;252857085799;21;0,1,2,3,5;5;2,9;2;1;1
252857085799;252857085817;18;0,1,2,3,5;5;2,9;2;1;1
252857085817;252857085819;2;0,1,2,3,5;5;2,9;2;1;1
252857085819;252857085821;2;0,1,2,3,5;5;2,9;2;1;1
252857085821;252857085822;1;0,1,2,3,5;5;2,9;2;1;1
252857085822;252857085824;2;0,1,2,3,5;5;2,9;2;1;1
252857085824;252857085826;2;0,1,2,3,5;5;2,9;2;1;1
252857085826;252857085838;12;0,1,2,3,5;5;2,9;2;1;1
252857085838;252857085843;5;0,1,2,3,5;5;2,9;2;1;1
252857085843;252857085844;1;0,1,2,3,5;5;2,9;2;1;1
252857085844;252857085850;6;0,1,2,3,5;5;2,9;2;1;1
252857085850;252857085851;1;0,1,2,3,5;5;2,9;2;1;1
252857085851;252857085862;11;0,1,2,3,5;5;2,9;2;1;1
252857085862;252857085870;8;0,1,2,3,5;5;2,9;2;1;1
252857085870;252857085876;6;0,1,2,3,5;5;2,9;2;1;1
252857085876;252857085879;3;0,1,2,3,5;5;2,9;2;1;1
252857085879;252857085881;2;0,1,2,3,5;5;2,9;2;1;1
252857085881;252857085884;3;0,1,2,3,5;5;2,9;2;1;1
252857085884;252857085885;1;0,1,2,3,5;5;2,9;2;1;1
252857085885;252857085905;20;0,1,2,3,5;5;2,9;2;1;1
252857085905;252857085920;15;0,1,2,3,5;5;2,9;2;1;1
252857085920;252857085923;3;0,1,2,3,5;5;2,9;2;1;1
252857085923;252857085932;9;0,1,2,3,5;5;2,9;2;1;1
252857085932;252857085942;10;0,1,2,3,5;5;2,9;2;1;1
252857085942;252857085950;8;0,1,2,3,5;5;2,9;2;1;1
252857085950;252857085952;2;0,1,2,3,5;5;2,9;2;1;1
252857085952;252857085956;4;0,1,2,3,5;5;2,9;2;1;1
252857085956;252857085960;4;0,1,2,3,5;5;2,9;2;1;1
252857085960;252857085961;1;0,1,2,3,5;5;2,9;2;1;1
252857085961;252857085963;2;0,1,2,3,5;5;2,9;2;1;1
252857085963;252857085965;2;0,1,2,3,5;5;2,9;2;1;1
252857085965;252857085967;2;0,1,2,3,5;5;2,9;2;1;1
252857085967;252857085971;4;0,1,2,3,5;5;2,9;2;1;1
252857085971;252857085973;2;0,1,2,3,5;5;2,9;2;1;1
252857085973;252857085984;11;0,1,2,3,5;5;2,9;2;1;1
252857085984;252857085986;2;0,1,2,3,5;5;2,9;2;1;1
252857085986;252857085991;5;0,1,2,3,5;5;2,9;2;1;1
252857085991;252857085993;2;0,1,2,3,5;5;2,9;2;1;1
252857085993;252857086001;8;0,1,2,3,5;5;2,9;2;1;1
252857086001;252857086003;2;0,1,2,3,5;5;2,9;2;1;1
252857086003;252857086004;1;0,1,2,3,5;5;2,9;2;1;1
252857086004;252857086006;2;0,1,2,3,5;5;2,9;2;1;1
252857086006;252857086021;15;0,1,2,3,5;5;2,9;2;1;1
252857086021;252857086025;4;0,1,2,3,5;5;2,9;2;1;1
252857086025;252857086032;7;0,1,2,3,5;5;2,9;2;1;1
252857086032;252857086034;2;0,1,2,3,5;5;2,9;2;1;1
252857086034;252857086036;2;0,1,2,3,5;5;2,9;2;1;1
252857086036;252857086042;6;0,1,2,3,5;5;2,9;2;1;1
252857086042;252857086050;8;0,1,2,3,5;5;2,9;2;1;1
252857086050;252857086059;9;0,1,2,3,5;5;2,9;2;1;1
252857086059;252857086060;1;0,1,2,3,5;5;2,9;2;1;1
252857086060;252857086067;7;0,1,2,3,5;5;2,9;2;1;1
252857086067;252857086070;3;0,1,2,3,5;5;2,9;2;1;1
252857086070;252857086073;3;0,1,2,3,5;5;2,9;2;1;1
252857086073;252857086080;7;0,1,2,3,5;5;2,9;2;1;1
252857086080;252857086085;5;0,1,2,3,5;5;2,9;2;1;1
252857086085;252857086086;1;0,1,2,3,5;5;2,9;2;1;1
252857086086;252857086099;13;0,1,2,3,5;5;2,9;2;1;1
252857086099;252857086102;3;0,1,2,3,5;5;2,9;2;1;1
252857086102;252857086104;2;0,1,2,3,5;5;2,9;2;1;1
252857086104;252857086109;5;0,1,2,3,5;5;2,9;2;1;1
252857086109;252857086113;4;0,1,2,3,5;5;2,9;2;1;1
252857086113;252857086118;5;0,1,2,3,5;5;2,9;2;1;1
252857086118;252857086123;5;0,1,2,3,5;5;2,9;2;1;1
252857086123;252857086124;1;0,1,2,3,5;5;2,9;2;1;1
252857086124;252857086128;4;0,1,2,3,5;5;2,9;2;1;1
252857086128;252857086130;2;0,1,2,3,5;5;2,9;2;1;1
252857086130;252857086134;4;0,1,2,3,5;5;2,9;2;1;1
252857086134;252857086139;5;0,1,2,3,5;5;2,9;2;1;1
252857086139;252857086145;6;0,1,2,3,5;5;2,9;2;1;1
252857086145;252857086159;14;0,1,2,3,5;5;2,9;2;1;1
252857086159;252857086162;3;0,1,2,3,5;5;2,9;2;1;1
252857086162;252857086164;2;0,1,2,3,5;5;2,9;2;1;1
252857086164;252857086174;10;0,1,2,3,5;5;2,9;2;1;1
252857086174;252857086177;3;0,1,2,3,5;5;2,9;2;1;1
252857086177;252857086180;3;0,1,2,3,5;5;2,9;2;1;1
252857086180;252857086183;3;0,1,2,3,5;5;2,9;2;1;1
252857086183;252857086184;1;0,1,2,3,5;5;2,9;2;1;1
252857086184;252857086187;3;0,1,2,3,5;5;2,9;2;1;1
252857086187;252857086192;5;0,1,2,3,5;5;2,9;2;1;1
252857086192;252857086194;2;0,1,2,3,5;5;2,9;2;1;1
252857086194;252857086198;4;0,1,2,3,5;5;2,9;2;1;1
252857086198;252857086199;1;0,1,2,3,5;5;2,9;2;1;1
252857086199;252857086201;2;0,1,2,3,5;5;2,9;2;1;1
252857086201;252857086208;7;0,1,2,3,5;5;2,9;2;1;1
252857086208;252857086213;5;0,1,2,3,5;5;2,9;2;1;1
252857086213;252857086215;2;0,1,2,3,5;5;2,9;2;1;1
252857086215;252857086216;1;0,1,2,3,5;5;2,9;2;1;1
252857086216;252857086218;2;0,1,2,3,5;5;2,9;2;1;1
252857086218;252857086221;3;0,1,2,3,5;5;2,9;2;1;1
252857086221;252857086226;5;0,1,2,3,5;5;2,9;2;1;1
252857086226;252857086235;9;0,1,2,3,5;5;2,9;2;1;1
252857086235;252857086237;2;0,1,2,3,5;5;2,9;2;1;1
252857086237;252857086241;4;0,1,2,3,5;5;2,9;2;1;1
252857086241;252857086247;6;0,1,2,3,5;5;2,9;2;1;1
252857086247;252857086253;6;0,1,2,3,5;5;2,9;2;1;1
252857086253;252857086257;4;0,1,2,3,5;5;2,9;2;1;1
252857086257;252857086259;2;0,1,2,3,5;5;2,9;2;1;1
252857086259;252857086273;14;0,1,2,3,5;5;2,9;2;1;1
252857086273;252857086274;1;0,1,2,3,5;5;2,9;2;1;1
252857086274;252857086278;4;0,1,2,3,5;5;2,9;2;1;1
252857086278;252857086279;1;0,1,2,3,5;5;2,9;2;1;1
252857086279;252857086281;2;0,1,2,3,5;5;2,9;2;1;1
252857086281;252857086285;4;0,1,2,3,5;5;2,9;2;1;1
252857086285;252857086289;4;0,1,2,3,5;5;2,9;2;1;1
252857086289;252857086299;10;0,1,2,3,5;5;2,9;2;1;1
252857086299;252857086301;2;0,1,2,3,5;5;2,9;2;1;1
252857086301;252857086303;2;0,1,2,3,5;5;2,9;2;1;1
252857086303;252857086304;1;0,1,2,3,5;5;2,9;2;1;1
252857086304;252857086310;6;0,1,2,3,5;5;2,9;2;1;1
252857086310;252857086312;2;0,1,2,3,5;5;2,9;2;1;1
252857086312;252857086317;5;0,1,2,3,5;5;2,9;2;1;1
252857086317;252857086318;1;0,1,2,3,5;5;2,9;2;1;1
252857086318;252857086331;13;0,1,2,3,5;5;2,9;2;1;1
252857086331;252857086348;17;0,1,2,3,5;5;2,9;2;1;1
252857086348;252857086361;13;0,1,2,3,5;5;2,9;2;1;1
252857086361;252857086363;2;0,1,2,3,5;5;2,9;2;1;1
252857086363;252857086367;4;0,1,2,3,5;5;2,9;2;1;1
252857086367;252857086372;5;0,1,2,3,5;5;2,9;2;1;1
252857086372;252857086376;4;0,1,2,3,5;5;2,9;2;1;1
252857086376;252857086377;1;0,1,2,3,5;5;2,9;2;1;1
252857086377;252857086379;2;0,1,2,3,5;5;2,9;2;1;1
252857086379;252857086381;2;0,1,2,3,5;5;2,9;2;1;1
252857086381;252857086383;2;0,1,2,3,5;5;2,9;2;1;1
252857086383;252857086384;1;0,1,2,3,5;5;2,9;2;1;1
252857086384;252857086392;8;0,1,2,3,5;5;2,9;2;1;1
252857086392;252857086398;6;0,1,2,3,5;5;2,9;2;1;1
252857086398;252857086405;7;0,1,2,3,5;5;2,9;2;1;1
252857086405;252857086406;1;0,1,2,3,5;5;2,9;2;1;1
252857086406;252857086410;4;0,1,2,3,5;5;2,9;2;1;1
252857086410;252857086418;8;0,1,2,3,5;5;2,9;2;1;1
252857086418;252857086420;2;0,1,2,3,5;5;2,9;2;1;1
252857086420;252857086424;4;0,1,2,3,5;5;2,9;2;1;1
252857086424;252857086429;5;0,1,2,3,5;5;2,9;2;1;1
252857086429;252857086430;1;0,1,2,3,5;5;2,9;2;1;1
252857086430;252857086431;1;0,1,2,3,5;5;2,9;2;1;1
252857086431;252857086436;5;0,1,2,3,5;5;2,9;2;1;1
252857086436;252857086446;10;0,1,2,3,5;5;2,9;2;1;1
252857086446;252857086448;2;0,1,2,3,5;5;2,9;2;1;1
252857086448;252857086449;1;0,1,2,3,5;5;2,9;2;1;1
252857086449;252857086452;3;0,1,2,3,5;5;2,9;2;1;1
252857086452;252857086456;4;0,1,2,3,5;5;2,9;2;1;1
252857086456;252857086457;1;0,1,2,3,5;5;2,9;2;1;1
252857086457;252857086461;4;0,1,2,3,5;5;2,9;2;1;1
252857086461;252857086463;2;0,1,2,3,5;5;2,9;2;1;1
252857086463;252857086465;2;0,1,2,3,5;5;2,9;2;1;1
252857086465;252857086467;2;0,1,2,3,5;5;2,9;2;1;1
252857086467;252857086473;6;0,1,2,3,5;5;2,9;2;1;1
252857086473;252857086475;2;0,1,2,3,5;5;2,9;2;1;1
252857086475;252857086480;5;0,1,2,3,5;5;2,9;2;1;1
252857086480;252857086481;1;0,1,2,3,5;5;2,9;2;1;1
252857086481;252857086487;6;0,1,2,3,5;5;2,9;2;1;1
252857086487;252857086489;2;0,1,2,3,5;5;2,9;2;1;1
252857086489;252857086491;2;0,1,2,3,5;5;2,9;2;1;1
252857086491;252857086492;1;0,1,2,3,5;5;2,9;2;1;1
252857086492;252857086493;1;0,1,2,3,5;5;2,9;2;1;1
252857086493;252857086494;1;0,1,2,3,5;5;2,9;2;1;1
252857086494;252857086495;1;0,1,2,3,5;5;2,9;2;1;1
252857086495;252857086501;6;0,1,2,3,5;5;2,9;2;1;1
252857086501;252857086502;1;0,1,2,3,5;5;2,9;2;1;1
252857086502;252857086503;1;0,1,2,3,5;5;2,9;2;1;1
252857086503;252857086505;2;0,1,2,3,5;5;2,9;2;1;1
252857086505;252857086506;1;0,1,2,3,5;5;2,9;2;1;1
252857086506;252857086509;3;0,1,2,3,5;5;2,9;2;1;1
252857086509;252857086510;1;0,1,2,3,5;5;2,9;2;1;1
252857086510;252857086512;2;0,1,2,3,5;5;2,9;2;1;1
252857086512;252857086518;6;0,1,2,3,5;5;2,9;2;1;1
252857086518;252857086520;2;0,1,2,3,5;5;2,9;2;1;1
252857086520;252857086521;1;0,1,2,3,5;5;2,9;2;1;1
252857086521;252857086524;3;0,1,2,3,5;5;2,9;2;1;1
252857086524;252857086528;4;0,1,2,3,5;5;2,9;2;1;1
252857086528;252857086534;6;0,1,2,3,5;5;2,9;2;1;1
252857086534;252857086542;8;0,1,2,3,5;5;2,9;2;1;1
252857086542;252857086548;6;0,1,2,3,5;5;2,9;2;1;1
252857086548;252857086549;1;0,1,2,3,5;5;2,9;2;1;1
252857086549;252857086550;1;0,1,2,3,5;5;2,9;2;1;1
252857086550;252857086551;1;0,1,2,3,5;5;2,9;2;1;1
252857086551;252857086552;1;0,1,2,3,5;5;2,9;2;1;1
252857086552;252857086556;4;0,1,2,3,5;5;2,9;2;1;1
252857086556;252857086558;2;0,1,2,3,5;5;2,9;2;1;1
252857086558;252857086567;9;0,1,2,3,5;5;2,9;2;1;1
252857086567;252857086575;8;0,1,2,3,5;5;2,9;2;1;1
252857086575;252857086576;1;0,1,2,3,5;5;2,9;2;1;1
252857086576;252857086577;1;0,1,2,3,5;5;2,9;2;1;1
252857086577;252857086584;7;0,1,2,3,5;5;2,9;2;1;1
252857086584;252857086585;1;0,1,2,3,5;5;2,9;2;1;1
252857086585;252857086589;4;0,1,2,3,5;5;2,9;2;1;1
252857086589;252857086592;3;0,1,2,3,5;5;2,9;2;1;1
252857086592;252857086593;1;0,1,2,3,5;5;2,9;2;1;1
252857086593;252857086595;2;0,1,2,3,5;5;2,9;2;1;1
252857086595;252857086596;1;0,1,2,3,5;5;2,9;2;1;1
252857086596;252857086601;5;0,1,2,3,5;5;2,9;2;1;1
252857086601;252857086604;3;0,1,2,3,5;5;2,9;2;1;1
252857086604;252857086608;4;0,1,2,3,5;5;2,9;2;1;1
252857086608;252857086616;8;0,1,2,3,5;5;2,9;2;1;1
252857086616;252857086622;6;0,1,2,3,5;5;2,9;2;1;1
252857086622;252857086627;5;0,1,2,3,5;5;2,9;2;1;1
252857086627;252857086628;1;0,1,2,3,5;5;2,9;2;1;1
252857086628;252857086633;5;0,1,2,3,5;5;2,9;2;1;1
252857086633;252857086636;3;0,1,2,3,5;5;2,9;2;1;1
252857086636;252857086639;3;0,1,2,3,5;5;2,9;2;1;1
252857086639;252857086647;8;0,1,2,3,5;5;2,9;2;1;1
252857086647;252857086649;2;0,1,2,3,5;5;2,9;2;1;1
252857086649;252857086654;5;0,1,2,3,5;5;2,9;2;1;1
252857086654;252857086657;3;0,1,2,3,5;5;2,9;2;1;1
252857086657;252857086660;3;0,1,2,3,5;5;2,9;2;1;1
252857086660;252857086664;4;0,1,2,3,5;5;2,9;2;1;1
252857086664;252857086674;10;0,1,2,3,5;5;2,9;2;1;1
252857086674;252857086675;1;0,1,2,3,5;5;2,9;2;1;1
252857086675;252857086677;2;0,1,2,3,5;5;2,9;2;1;1
252857086677;252857086678;1;0,1,2,3,5;5;2,9;2;1;1
252857086678;252857086680;2;0,1,2,3,5;5;2,9;2;1;1
252857086680;252857086688;8;0,1,2,3,5;5;2,9;2;1;1
252857086688;252857086696;8;0,1,2,3,5;5;2,9;2;1;1
252857086696;252857086697;1;0,1,2,3,5;5;2,9;2;1;1
252857086697;252857086698;1;0,1,2,3,5;5;2,9;2;1;1
252857086698;252857086704;6;0,1,2,3,5;5;2,9;2;1;1
252857086704;252857086705;1;0,1,2,3,5;5;2,9;2;1;1
252857086705;252857086707;2;0,1,2,3,5;5;2,9;2;1;1
252857086707;252857086711;4;0,1,2,3,5;5;2,9;2;1;1
252857086711;252857086712;1;0,1,2,3,5;5;2,9;2;1;1
252857086712;252857086718;6;0,1,2,3,5;5;2,9;2;1;1
252857086718;252857086721;3;0,1,2,3,5;5;2,9;2;1;1
252857086721;252857086727;6;0,1,2,3,5;5;2,9;2;1;1
252857086727;252857086728;1;0,1,2,3,5;5;2,9;2;1;1
252857086728;252857086731;3;0,1,2,3,5;5;2,9;2;1;1
252857086731;252857086736;5;0,1,2,3,5;5;2,9;2;1;1
252857086736;252857086737;1;0,1,2,3,5;5;2,9;2;1;1
252857086737;252857086740;3;0,1,2,3,5;5;2,9;2;1;1
252857086740;252857086752;12;0,1,2,3,5;5;2,9;2;1;1
252857086752;252857086753;1;0,1,2,3,5;5;2,9;2;1;1
252857086753;252857086756;3;0,1,2,3,5;5;2,9;2;1;1
252857086756;252857086757;1;0,1,2,3,5;5;2,9;2;1;1
252857086757;252857086761;4;0,1,2,3,5;5;2,9;2;1;1
252857086761;252857086770;9;0,1,2,3,5;5;2,9;2;1;1
252857086770;252857086776;6;0,1,2,3,5;5;2,9;2;1;1
252857086776;252857086778;2;0,1,2,3,5;5;2,9;2;1;1
252857086778;252857086785;7;0,1,2,3,5;5;2,9;2;1;1
252857086785;252857086792;7;0,1,2,3,5;5;2,9;2;1;1
252857086792;252857086794;2;0,1,2,3,5;5;2,9;2;1;1
252857086794;252857086798;4;0,1,2,3,5;5;2,9;2;1;1
252857086798;252857086800;2;0,1,2,3,5;5;2,9;2;1;1
252857086800;252857086803;3;0,1,2,3,5;5;2,9;2;1;1
252857086803;252857086807;4;0,1,2,3,5;5;2,9;2;1;1
252857086807;252857086810;3;0,1,2,3,5;5;2,9;2;1;1
252857086810;252857086815;5;0,1,2,3,5;5;2,9;2;1;1
252857086815;252857086817;2;0,1,2,3,5;5;2,9;2;1;1
252857086817;252857086818;1;0,1,2,3,5;5;2,9;2;1;1
252857086818;252857086825;7;0,1,2,3,5;5;2,9;2;1;1
252857086825;252857086826;1;0,1,2,3,5;5;2,9;2;1;1
252857086826;252857086832;6;0,1,2,3,5;5;2,9;2;1;1
252857086832;252857086833;1;0,1,2,3,5;5;2,9;2;1;1
252857086833;252857086834;1;0,1,2,3,5;5;2,9;2;1;1
252857086834;252857086835;1;0,1,2,3,5;5;2,9;2;1;1
252857086835;252857086836;1;0,1,2,3,5;5;2,9;2;1;1
252857086836;252857086843;7;0,1,2,3,5;5;2,9;2;1;1
252857086843;252857086844;1;0,1,2,3,5;5;2,9;2;1;1
252857086844;252857086848;4;0,1,2,3,5;5;2,9;2;1;1
252857086848;252857086851;3;0,1,2,3,5;5;2,9;2;1;1
252857086851;252857086864;13;0,1,2,3,5;5;2,9;2;1;1
252857086864;252857086867;3;0,1,2,3,5;5;2,9;2;1;1
252857086867;252857086871;4;0,1,2,3,5;5;2,9;2;1;1
252857086871;252857086872;1;0,1,2,3,5;5;2,9;2;1;1
252857086872;252857086874;2;0,1,2,3,5;5;2,9;2;1;1
252857086874;252857086876;2;0,1,2,3,5;5;2,9;2;1;1
252857086876;252857086884;8;0,1,2,3,5;5;2,9;2;1;1
252857086884;252857086890;6;0,1,2,3,5;5;2,9;2;1;1
252857086890;252857086891;1;0,1,2,3,5;5;2,9;2;1;1
252857086891;252857086894;3;0,1,2,3,5;5;2,9;2;1;1
252857086894;252857086899;5;0,1,2,3,5;5;2,9;2;1;1
252857086899;252857086901;2;0,1,2,3,5;5;2,9;2;1;1
252857086901;252857086904;3;0,1,2,3,5;5;2,9;2;1;1
252857086904;252857086905;1;0,1,2,3,5;5;2,9;2;1;1
252857086905;252857086906;1;0,1,2,3,5;5;2,9;2;1;1
252857086906;252857086919;13;0,1,2,3,5;5;2,9;2;1;1
252857086919;252857086920;1;0,1,2,3,5;5;2,9;2;1;1
252857086920;252857086931;11;0,1,2,3,5;5;2,9;2;1;1
252857086931;252857086939;8;0,1,2,3,5;5;2,9;2;1;1
252857086939;252857086940;1;0,1,2,3,5;5;2,9;2;1;1
252857086940;252857086941;1;0,1,2,3,5;5;2,9;2;1;1
252857086941;252857086942;1;0,1,2,3,5;5;2,9;2;1;1
252857086942;252857086943;1;0,1,2,3,5;5;2,9;2;1;1
252857086943;252857086945;2;0,1,2,3,5;5;2,9;2;1;1
252857086945;252857086947;2;0,1,2,3,5;5;2,9;2;1;1
252857086947;252857086959;12;0,1,2,3,5;5;2,9;2;1;1
252857086959;252857086964;5;0,1,2,3,5;5;2,9;2;1;1
252857086964;252857086967;3;0,1,2,3,5;5;2,9;2;1;1
252857086967;252857086969;2;0,1,2,3,5;5;2,9;2;1;1
252857086969;252857086970;1;0,1,2,3,5;5;2,9;2;1;1
252857086970;252857086974;4;0,1,2,3,5;5;2,9;2;1;1
252857086974;252857086982;8;0,1,2,3,5;5;2,9;2;1;1
252857086982;252857086983;1;0,1,2,3,5;5;2,9;2;1;1
252857086983;252857086988;5;0,1,2,3,5;5;2,9;2;1;1
252857086988;252857086994;6;0,1,2,3,5;5;2,9;2;1;1
252857086994;252857086995;1;0,1,2,3,5;5;2,9;2;1;1
252857086995;252857086998;3;0,1,2,3,5;5;2,9;2;1;1
252857086998;252857087001;3;0,1,2,3,5;5;2,9;2;1;1
252857087001;252857087003;2;0,1,2,3,5;5;2,9;2;1;1
252857087003;252857087004;1;0,1,2,3,5;5;2,9;2;1;1
252857087004;252857087006;2;0,1,2,3,5;5;2,9;2;1;1
252857087006;252857087009;3;0,1,2,3,5;5;2,9;2;1;1
252857087009;252857087015;6;0,1,2,3,5;5;2,9;2;1;1
252857087015;252857087016;1;0,1,2,3,5;5;2,9;2;1;1
252857087016;252857087026;10;0,1,2,3,5;5;2,9;2;1;1
252857087026;252857087029;3;0,1,2,3,5;5;2,9;2;1;1
252857087029;252857087037;8;0,1,2,3,5;5;2,9;2;1;1
252857087037;252857087039;2;0,1,2,3,5;5;2,9;2;1;1
252857087039;252857087040;1;0,1,2,3,5;5;2,9;2;1;1
252857087040;252857087047;7;0,1,2,3,5;5;2,9;2;1;1
252857087047;252857087056;9;0,1,2,3,5;5;2,9;2;1;1
252857087056;252857087060;4;0,1,2,3,5;5;2,9;2;1;1
252857087060;252857087062;2;0,1,2,3,5;5;2,9;2;1;1
252857087062;252857087065;3;0,1,2,3,5;5;2,9;2;1;1
252857087065;252857087081;16;0,1,2,3,5;5;2,9;2;1;1
252857087081;252857087084;3;0,1,2,3,5;5;2,9;2;1;1
252857087084;252857087096;12;0,1,2,3,5;5;2,9;2;1;1
252857087096;252857087098;2;0,1,2,3,5;5;2,9;2;1;1
252857087098;252857087101;3;0,1,2,3,5;5;2,9;2;1;1
252857087101;252857087102;1;0,1,2,3,5;5;2,9;2;1;1
252857087102;252857087110;8;0,1,2,3,5;5;2,9;2;1;1
252857087110;252857087114;4;0,1,2,3,5;5;2,9;2;1;1
252857087114;252857087117;3;0,1,2,3,5;5;2,9;2;1;1
252857087117;252857087120;3;0,1,2,3,5;5;2,9;2;1;1
252857087120;252857087128;8;0,1,2,3,5;5;2,9;2;1;1
252857087128;252857087131;3;0,1,2,3,5;5;2,9;2;1;1
252857087131;252857087141;10;0,1,2,3,5;5;2,9;2;1;1
252857087141;252857087142;1;0,1,2,3,5;5;2,9;2;1;1
252857087142;252857087143;1;0,1,2,3,5;5;2,9;2;1;1
252857087143;252857087147;4;0,1,2,3,5;5;2,9;2;1;1
252857087147;252857087148;1;0,1,2,3,5;5;2,9;2;1;1
252857087148;252857087150;2;0,1,2,3,5;5;2,9;2;1;1
252857087150;252857087156;6;0,1,2,3,5;5;2,9;2;1;1
252857087156;252857087157;1;0,1,2,3,5;5;2,9;2;1;1
252857087157;252857087163;6;0,1,2,3,5;5;2,9;2;1;1
252857087163;252857087167;4;0,1,2,3,5;5;2,9;2;1;1
252857087167;252857087170;3;0,1,2,3,5;5;2,9;2;1;1
252857087170;252857087173;3;0,1,2,3,5;5;2,9;2;1;1
252857087173;252857087179;6;0,1,2,3,5;5;2,9;2;1;1
252857087179;252857087182;3;0,1,2,3,5;5;2,9;2;1;1
252857087182;252857087188;6;0,1,2,3,5;5;2,9;2;1;1
252857087188;252857087190;2;0,1,2,3,5;5;2,9;2;1;1
252857087190;252857087191;1;0,1,2,3,5;5;2,9;2;1;1
252857087191;252857087194;3;0,1,2,3,5;5;2,9;2;1;1
252857087194;252857087195;1;0,1,2,3,5;5;2,9;2;1;1
252857087195;252857087199;4;0,1,2,3,5;5;2,9;2;1;1
252857087199;252857087214;15;0,1,2,3,5;5;2,9;2;1;1
252857087214;252857087222;8;0,1,2,3,5;5;2,9;2;1;1
252857087222;252857087225;3;0,1,2,3,5;5;2,9;2;1;1
252857087225;252857087229;4;0,1,2,3,5;5;2,9;2;1;1
252857087229;252857087250;21;0,1,2,3,5;5;2,9;2;1;1
252857087250;252857087254;4;0,1,2,3,5;5;2,9;2;1;1
252857087254;252857087256;2;0,1,2,3,5;5;2,9;2;1;1
252857087256;252857087259;3;0,1,2,3,5;5;2,9;2;1;1
252857087259;252857087262;3;0,1,2,3,5;5;2,9;2;1;1
252857087262;252857087266;4;0,1,2,3,5;5;2,9;2;1;1
252857087266;252857087287;21;0,1,2,3,5;5;2,9;2;1;1
252857087287;252857087290;3;0,1,2,3,5;5;2,9;2;1;1
252857087290;252857087293;3;0,1,2,3,5;5;2,9;2;1;1
252857087293;252857087303;10;0,1,2,3,5;5;2,9;2;1;1
252857087303;252857087316;13;0,1,2,3,5;5;2,9;2;1;1
252857087316;252857087319;3;0,1,2,3,5;5;2,9;2;1;1
252857087319;252857087320;1;0,1,2,3,5;5;2,9;2;1;1
252857087320;252857087338;18;0,1,2,3,5;5;2,9;2;1;1
252857087338;252857087341;3;0,1,2,3,5;5;2,9;2;1;1
252857087341;252857087344;3;0,1,2,3,5;5;2,9;2;1;1
252857087344;252857087345;1;0,1,2,3,5;5;2,9;2;1;1
252857087345;252857087346;1;0,1,2,3,5;5;2,9;2;1;1
252857087346;252857087348;2;0,1,2,3,5;5;2,9;2;1;1
252857087348;252857087359;11;0,1,2,3,5;5;2,9;2;1;1
252857087359;252857087365;6;0,1,2,3,5;5;2,9;2;1;1
252857087365;252857087374;9;0,1,2,3,5;5;2,9;2;1;1
252857087374;252857087376;2;0,1,2,3,5;5;2,9;2;1;1
252857087376;252857087377;1;0,1,2,3,5;5;2,9;2;1;1
252857087377;252857087383;6;0,1,2,3,5;5;2,9;2;1;1
252857087383;252857087385;2;0,1,2,3,5;5;2,9;2;1;1
252857087385;252857087388;3;0,1,2,3,5;5;2,9;2;1;1
252857087388;252857087392;4;0,1,2,3,5;5;2,9;2;1;1
252857087392;252857087395;3;0,1,2,3,5;5;2,9;2;1;1
252857087395;252857087401;6;0,1,2,3,5;5;2,9;2;1;1
252857087401;252857087404;3;0,1,2,3,5;5;2,9;2;1;1
252857087404;252857087411;7;0,1,2,3,5;5;2,9;2;1;1
252857087411;252857087412;1;0,1,2,3,5;5;2,9;2;1;1
252857087412;252857087416;4;0,1,2,3,5;5;2,9;2;1;1
252857087416;252857087418;2;0,1,2,3,5;5;2,9;2;1;1
252857087418;252857087421;3;0,1,2,3,5;5;2,9;2;1;1
252857087421;252857087430;9;0,1,2,3,5;5;2,9;2;1;1
252857087430;252857087439;9;0,1,2,3,5;5;2,9;2;1;1
252857087439;252857087445;6;0,1,2,3,5;5;2,9;2;1;1
252857087445;252857087446;1;0,1,2,3,5;5;2,9;2;1;1
252857087446;252857087451;5;0,1,2,3,5;5;2,9;2;1;1
252857087451;252857087461;10;0,1,2,3,5;5;2,9;2;1;1
252857087461;252857087463;2;0,1,2,3,5;5;2,9;2;1;1
252857087463;252857087471;8;0,1,2,3,5;5;2,9;2;1;1
252857087471;252857087476;5;0,1,2,3,5;5;2,9;2;1;1
252857087476;252857087477;1;0,1,2,3,5;5;2,9;2;1;1
252857087477;252857087482;5;0,1,2,3,5;5;2,9;2;1;1
252857087482;252857087503;21;0,1,2,3,5;5;2,9;2;1;1
252857087503;252857087505;2;0,1,2,3,5;5;2,9;2;1;1
252857087505;252857087509;4;0,1,2,3,5;5;2,9;2;1;1
252857087509;252857087513;4;0,1,2,3,5;5;2,9;2;1;1
252857087513;252857087520;7;0,1,2,3,5;5;2,9;2;1;1
252857087520;252857087534;14;0,1,2,3,5;5;2,9;2;1;1
252857087534;252857087537;3;0,1,2,3,5;5;2,9;2;1;1
252857087537;252857087547;10;0,1,2,3,5;5;2,9;2;1;1
252857087547;252857087560;13;0,1,2,3,5;5;2,9;2;1;1
252857087560;252857087568;8;0,1,2,3,5;5;2,9;2;1;1
252857087568;252857087574;6;0,1,2,3,5;5;2,9;2;1;1
252857087574;252857087576;2;0,1,2,3,5;5;2,9;2;1;1
252857087576;252857087583;7;0,1,2,3,5;5;2,9;2;1;1
252857087583;252857087588;5;0,1,2,3,5;5;2,9;2;1;1
252857087588;252857087594;6;0,1,2,3,5;5;2,9;2;1;1
252857087594;252857087597;3;0,1,2,3,5;5;2,9;2;1;1
252857087597;252857087617;20;0,1,2,3,5;5;2,9;2;1;1
252857087617;252857087618;1;0,1,2,3,5;5;2,9;2;1;1
252857087618;252857087619;1;0,1,2,3,5;5;2,9;2;1;1
252857087619;252857087626;7;0,1,2,3,5;5;2,9;2;1;1
252857087626;252857087635;9;0,1,2,3,5;5;2,9;2;1;1
252857087635;252857087645;10;0,1,2,3,5;5;2,9;2;1;1
252857087645;252857087659;14;0,1,2,3,5;5;2,9;2;1;1
252857087659;252857087663;4;0,1,2,3,5;5;2,9;2;1;1
252857087663;252857087670;7;0,1,2,3,5;5;2,9;2;1;1
252857087670;252857087684;14;0,1,2,3,5;5;2,9;2;1;1
252857087684;252857087686;2;0,1,2,3,5;5;2,9;2;1;1
252857087686;252857087688;2;0,1,2,3,5;5;2,9;2;1;1
252857087688;252857087689;1;0,1,2,3,5;5;2,9;2;1;1
252857087689;252857087693;4;0,1,2,3,5;5;2,9;2;1;1
252857087693;252857087699;6;0,1,2,3,5;5;2,9;2;1;1
252857087699;252857087700;1;0,1,2,3,5;5;2,9;2;1;1
252857087700;252857087707;7;0,1,2,3,5;5;2,9;2;1;1
252857087707;252857087712;5;0,1,2,3,5;5;2,9;2;1;1
252857087712;252857087715;3;0,1,2,3,5;5;2,9;2;1;1
252857087715;252857087716;1;0,1,2,3,5;5;2,9;2;1;1
252857087716;252857087724;8;0,1,2,3,5;5;2,9;2;1;1
252857087724;252857087727;3;0,1,2,3,5;5;2,9;2;1;1
252857087727;252857087728;1;0,1,2,3,5;5;2,9;2;1;1
252857087728;252857087731;3;0,1,2,3,5;5;2,9;2;1;1
252857087731;252857087734;3;0,1,2,3,5;5;2,9;2;1;1
252857087734;252857087736;2;0,1,2,3,5;5;2,9;2;1;1
252857087736;252857087737;1;0,1,2,3,5;5;2,9;2;1;1
252857087737;252857087740;3;0,1,2,3,5;5;2,9;2;1;1
252857087740;252857087743;3;0,1,2,3,5;5;2,9;2;1;1
252857087743;252857087750;7;0,1,2,3,5;5;2,9;2;1;1
252857087750;252857087758;8;0,1,2,3,5;5;2,9;2;1;1
252857087758;252857087763;5;0,1,2,3,5;5;2,9;2;1;1
252857087763;252857087770;7;0,1,2,3,5;5;2,9;2;1;1
252857087770;252857087783;13;0,1,2,3,5;5;2,9;2;1;1
252857087783;252857087791;8;0,1,2,3,5;5;2,9;2;1;1
252857087791;252857087799;8;0,1,2,3,5;5;2,9;2;1;1
252857087799;252857087802;3;0,1,2,3,5;5;2,9;2;1;1
252857087802;252857087803;1;0,1,2,3,5;5;2,9;2;1;1
252857087803;252857087804;1;0,1,2,3,5;5;2,9;2;1;1
252857087804;252857087806;2;0,1,2,3,5;5;2,9;2;1;1
252857087806;252857087810;4;0,1,2,3,5;5;2,9;2;1;1
252857087810;252857087817;7;0,1,2,3,5;5;2,9;2;1;1
252857087817;252857087819;2;0,1,2,3,5;5;2,9;2;1;1
252857087819;252857087827;8;0,1,2,3,5;5;2,9;2;1;1
252857087827;252857087828;1;0,1,2,3,5;5;2,9;2;1;1
252857087828;252857087832;4;0,1,2,3,5;5;2,9;2;1;1
252857087832;252857087833;1;0,1,2,3,5;5;2,9;2;1;1
252857087833;252857087837;4;0,1,2,3,5;5;2,9;2;1;1
252857087837;252857087842;5;0,1,2,3,5;5;2,9;2;1;1
252857087842;252857087865;23;0,1,2,3,5;5;2,9;2;1;1
252857087865;252857087878;13;0,1,2,3,5;5;2,9;2;1;1
252857087878;252857087894;16;0,1,2,3,5;5;2,9;2;1;1
252857087894;252857087899;5;0,1,2,3,5;5;2,9;2;1;1
252857087899;252857087905;6;0,1,2,3,5;5;2,9;2;1;1
252857087905;252857087910;5;0,1,2,3,5;5;2,9;2;1;1
252857087910;252857087911;1;0,1,2,3,5;5;2,9;2;1;1
252857087911;252857087919;8;0,1,2,3,5;5;2,9;2;1;1
252857087919;252857087924;5;0,1,2,3,5;5;2,9;2;1;1
252857087924;252857087934;10;0,1,2,3,5;5;2,9;2;1;1
252857087934;252857087935;1;0,1,2,3,5;5;2,9;2;1;1
252857087935;252857087947;12;0,1,2,3,5;5;2,9;2;1;1
252857087947;252857087948;1;0,1,2,3,5;5;2,9;2;1;1
252857087948;252857087952;4;0,1,2,3,5;5;2,9;2;1;1
252857087952;252857087957;5;0,1,2,3,5;5;2,9;2;1;1
252857087957;252857087959;2;0,1,2,3,5;5;2,9;2;1;1
252857087959;252857087967;8;0,1,2,3,5;5;2,9;2;1;1
252857087967;252857087971;4;0,1,2,3,5;5;2,9;2;1;1
252857087971;252857087975;4;0,1,2,3,5;5;2,9;2;1;1
252857087975;252857087988;13;0,1,2,3,5;5;2,9;2;1;1
252857087988;252857087989;1;0,1,2,3,5;5;2,9;2;1;1
252857087989;252857088006;17;0,1,2,3,5;5;2,9;2;1;1
252857088006;252857088007;1;0,1,2,3,5;5;2,9;2;1;1
252857088007;252857088034;27;0,1,2,3,5;5;2,9;2;1;1
252857088034;252857088036;2;0,1,2,3,5;5;2,9;2;1;1
252857088036;252857088044;8;0,1,2,3,5;5;2,9;2;1;1
252857088044;252857088046;2;0,1,2,3,5;5;2,9;2;1;1
252857088046;252857088058;12;0,1,2,3,5;5;2,9;2;1;1
252857088058;252857088061;3;0,1,2,3,5;5;2,9;2;1;1
252857088061;252857088068;7;0,1,2,3,5;5;2,9;2;1;1
252857088068;252857088074;6;0,1,2,3,5;5;2,9;2;1;1
252857088074;252857088091;17;0,1,2,3,5;5;2,9;2;1;1
252857088091;252857088100;9;0,1,2,3,5;5;2,9;2;1;1
252857088100;252857088104;4;0,1,2,3,5;5;2,9;2;1;1
252857088104;252857088109;5;0,1,2,3,5;5;2,9;2;1;1
252857088109;252857088116;7;0,1,2,3,5;5;2,9;2;1;1
252857088116;252857088119;3;0,1,2,3,5;5;2,9;2;1;1
252857088119;252857088121;2;0,1,2,3,5;5;2,9;2;1;1
252857088121;252857088138;17;0,1,2,3,5;5;2,9;2;1;1
252857088138;252857088143;5;0,1,2,3,5;5;2,9;2;1;1
252857088143;252857088155;12;0,1,2,3,5;5;2,9;2;1;1
252857088155;252857088165;10;0,1,2,3,5;5;2,9;2;1;1
252857088165;252857088171;6;0,1,2,3,5;5;2,9;2;1;1
252857088171;252857088183;12;0,1,2,3,5;5;2,9;2;1;1
252857088183;252857088187;4;0,1,2,3,5;5;2,9;2;1;1
252857088187;252857088189;2;0,1,2,3,5;5;2,9;2;1;1
252857088189;252857088206;17;0,1,2,3,5;5;2,9;2;1;1
252857088206;252857088212;6;0,1,2,3,5;5;2,9;2;1;1
252857088212;252857088218;6;0,1,2,3,5;5;2,9;2;1;1
252857088218;252857088222;4;0,1,2,3,5;5;2,9;2;1;1
252857088222;252857088231;9;0,1,2,3,5;5;2,9;2;1;1
252857088231;252857088232;1;0,1,2,3,5;5;2,9;2;1;1
252857088232;252857088239;7;0,1,2,3,5;5;2,9;2;1;1
252857088239;252857088244;5;0,1,2,3,5;5;2,9;2;1;1
252857088244;252857088249;5;0,1,2,3,5;5;2,9;2;1;1
252857088249;252857088252;3;0,1,2,3,5;5;2,9;2;1;1
252857088252;252857088259;7;0,1,2,3,5;5;2,9;2;1;1
252857088259;252857088263;4;0,1,2,3,5;5;2,9;2;1;1
252857088263;252857088278;15;0,1,2,3,5;5;2,9;2;1;1
252857088278;252857088282;4;0,1,2,3,5;5;2,9;2;1;1
252857088282;252857088288;6;0,1,2,3,5;5;2,9;2;1;1
252857088288;252857088299;11;0,1,2,3,5;5;2,9;2;1;1
252857088299;252857088303;4;0,1,2,3,5;5;2,9;2;1;1
252857088303;252857088304;1;0,1,2,3,5;5;2,9;2;1;1
252857088304;252857088310;6;0,1,2,3,5;5;2,9;2;1;1
252857088310;252857088314;4;0,1,2,3,5;5;2,9;2;1;1
252857088314;252857088324;10;0,1,2,3,5;5;2,9;2;1;1
252857088324;252857088334;10;0,1,2,3,5;5;2,9;2;1;1
252857088334;252857088337;3;0,1,2,3,5;5;2,9;2;1;1
252857088337;252857088339;2;0,1,2,3,5;5;2,9;2;1;1
252857088339;252857088346;7;0,1,2,3,5;5;2,9;2;1;1
252857088346;252857088361;15;0,1,2,3,5;5;2,9;2;1;1
252857088361;252857088363;2;0,1,2,3,5;5;2,9;2;1;1
252857088363;252857088365;2;0,1,2,3,5;5;2,9;2;1;1
252857088365;252857088370;5;0,1,2,3,5;5;2,9;2;1;1
252857088370;252857088373;3;0,1,2,3,5;5;2,9;2;1;1
252857088373;252857088380;7;0,1,2,3,5;5;2,9;2;1;1
252857088380;252857088385;5;0,1,2,3,5;5;2,9;2;1;1
252857088385;252857088396;11;0,1,2,3,5;5;2,9;2;1;1
252857088396;252857088402;6;0,1,2,3,5;5;2,9;2;1;1
252857088402;252857088410;8;0,1,2,3,5;5;2,9;2;1;1
252857088410;252857088413;3;0,1,2,3,5;5;2,9;2;1;1
252857088413;252857088414;1;0,1,2,3,5;5;2,9;2;1;1
252857088414;252857088440;26;0,1,2,3,5;5;2,9;2;1;1
252857088440;252857088443;3;0,1,2,3,5;5;2,9;2;1;1
252857088443;252857088452;9;0,1,2,3,5;5;2,9;2;1;1
252857088452;252857088467;15;0,1,2,3,5;5;2,9;2;1;1
252857088467;252857088474;7;0,1,2,3,5;5;2,9;2;1;1
252857088474;252857088481;7;0,1,2,3,5;5;2,9;2;1;1
252857088481;252857088497;16;0,1,2,3,5;5;2,9;2;1;1
252857088497;252857088514;17;0,1,2,3,5;5;2,9;2;1;1
252857088514;252857088529;15;0,1,2,3,5;5;2,9;2;1;1
252857088529;252857088541;12;0,1,2,3,5;5;2,9;2;1;1
252857088541;252857088546;5;0,1,2,3,5;5;2,9;2;1;1
252857088546;252857088565;19;0,1,2,3,5;5;2,9;2;1;1
252857088565;252857088566;1;0,1,2,3,5;5;2,9;2;1;1
252857088566;252857088570;4;0,1,2,3,5;5;2,9;2;1;1
252857088570;252857088576;6;0,1,2,3,5;5;2,9;2;1;1
252857088576;252857088584;8;0,1,2,3,5;5;2,9;2;1;1
252857088584;252857088593;9;0,1,2,3,5;5;2,9;2;1;1
252857088593;252857088598;5;0,1,2,3,5;5;2,9;2;1;1
252857088598;252857088603;5;0,1,2,3,5;5;2,9;2;1;1
252857088603;252857088627;24;0,1,2,3,5;5;2,9;2;1;1
252857088627;252857088635;8;0,1,2,3,5;5;2,9;2;1;1
252857088635;252857088639;4;0,1,2,3,5;5;2,9;2;1;1
252857088639;252857088651;12;0,1,2,3,5;5;2,9;2;1;1
252857088651;252857088661;10;0,1,2,3,5;5;2,9;2;1;1
252857088661;252857088666;5;0,1,2,3,5;5;2,9;2;1;1
252857088666;252857088687;21;0,1,2,3,5;5;2,9;2;1;1
252857088687;252857088693;6;0,1,2,3,5;5;2,9;2;1;1
252857088693;252857088699;6;0,1,2,3,5;5;2,9;2;1;1
252857088699;252857088706;7;0,1,2,3,5;5;2,9;2;1;1
252857088706;252857088707;1;0,1,2,3,5;5;2,9;2;1;1
252857088707;252857088721;14;0,1,2,3,5;5;2,9;2;1;1
252857088721;252857088724;3;0,1,2,3,5;5;2,9;2;1;1
252857088724;252857088732;8;0,1,2,3,5;5;2,9;2;1;1
252857088732;252857088746;14;0,1,2,3,5;5;2,9;2;1;1
252857088746;252857088748;2;0,1,2,3,5;5;2,9;2;1;1
252857088748;252857088757;9;0,1,2,3,5;5;2,9;2;1;1
252857088757;252857088764;7;0,1,2,3,5;5;2,9;2;1;1
252857088764;252857088769;5;0,1,2,3,5;5;2,9;2;1;1
252857088769;252857088777;8;0,1,2,3,5;5;2,9;2;1;1
252857088777;252857088778;1;0,1,2,3,5;5;2,9;2;1;1
252857088778;252857088779;1;0,1,2,3,5;5;2,9;2;1;1
252857088779;252857088782;3;0,1,2,3,5;5;2,9;2;1;1
252857088782;252857088798;16;0,1,2,3,5;5;2,9;2;1;1
252857088798;252857088804;6;0,1,2,3,5;5;2,9;2;1;1
252857088804;252857088810;6;0,1,2,3,5;5;2,9;2;1;1
252857088810;252857088821;11;0,1,2,3,5;5;2,9;2;1;1
252857088821;252857088832;11;0,1,2,3,5;5;2,9;2;1;1
252857088832;252857088852;20;0,1,2,3,5;5;2,9;2;1;1
252857088852;252857088857;5;0,1,2,3,5;5;2,9;2;1;1
252857088857;252857088881;24;0,1,2,3,5;5;2,9;2;1;1
252857088881;252857088889;8;0,1,2,3,5;5;2,9;2;1;1
252857088889;252857088901;12;0,1,2,3,5;5;2,9;2;1;1
252857088901;252857088903;2;0,1,2,3,5;5;2,9;2;1;1
252857088903;252857088908;5;0,1,2,3,5;5;2,9;2;1;1
252857088908;252857088912;4;0,1,2,3,5;5;2,9;2;1;1
252857088912;252857088917;5;0,1,2,3,5;5;2,9;2;1;1
252857088917;252857088927;10;0,1,2,3,5;5;2,9;2;1;1
252857088927;252857088934;7;0,1,2,3,5;5;2,9;2;1;1
252857088934;252857088936;2;0,1,2,3,5;5;2,9;2;1;1
252857088936;252857088942;6;0,1,2,3,5;5;2,9;2;1;1
252857088942;252857088956;14;0,1,2,3,5;5;2,9;2;1;1
252857088956;252857088966;10;0,1,2,3,5;5;2,9;2;1;1
252857088966;252857088971;5;0,1,2,3,5;5;2,9;2;1;1
252857088971;252857088983;12;0,1,2,3,5;5;2,9;2;1;1
252857088983;252857088986;3;0,1,2,3,5;5;2,9;2;1;1
252857088986;252857088997;11;0,1,2,3,5;5;2,9;2;1;1
252857088997;252857089005;8;0,1,2,3,5;5;2,9;2;1;1
252857089005;252857089030;25;0,1,2,3,5;5;2,9;2;1;1
252857089030;252857089032;2;0,1,2,3,5;5;2,9;2;1;1
252857089032;252857089033;1;0,1,2,3,5;5;2,9;2;1;1
252857089033;252857089040;7;0,1,2,3,5;5;2,9;2;1;1
252857089040;252857089087;47;0,1,2,3,5;5;2,9;2;1;1
252857089087;252857089091;4;0,1,2,3,5;5;2,9;2;1;1
252857089091;252857089104;13;0,1,2,3,5;5;2,9;2;1;1
252857089104;252857089111;7;0,1,2,3,5;5;2,9;2;1;1
252857089111;252857089112;1;0,1,2,3,5;5;2,9;2;1;1
252857089112;252857089125;13;0,1,2,3,5;5;2,9;2;1;1
252857089125;252857089126;1;0,1,2,3,5;5;2,9;2;1;1
252857089126;252857089130;4;0,1,2,3,5;5;2,9;2;1;1
252857089130;252857089160;30;0,1,2,3,5;5;2,9;2;1;1
252857089160;252857089171;11;0,1,2,3,5;5;2,9;2;1;1
252857089171;252857089180;9;0,1,2,3,5;5;2,9;2;1;1
252857089180;252857089198;18;0,1,2,3,5;5;2,9;2;1;1
252857089198;252857089203;5;0,1,2,3,5;5;2,9;2;1;1
252857089203;252857089210;7;0,1,2,3,5;5;2,9;2;1;1
252857089210;252857089211;1;0,1,2,3,5;5;2,9;2;1;1
252857089211;252857089220;9;0,1,2,3,5;5;2,9;2;1;1
252857089220;252857089235;15;0,1,2,3,5;5;2,9;2;1;1
252857089235;252857089238;3;0,1,2,3,5;5;2,9;2;1;1
252857089238;252857089251;13;0,1,2,3,5;5;2,9;2;1;1
252857089251;252857089278;27;0,1,2,3,5;5;2,9;2;1;1
252857089278;252857089283;5;0,1,2,3,5;5;2,9;2;1;1
252857089283;252857089285;2;0,1,2,3,5;5;2,9;2;1;1
252857089285;252857089291;6;0,1,2,3,5;5;2,9;2;1;1
252857089291;252857089298;7;0,1,2,3,5;5;2,9;2;1;1
252857089298;252857089303;5;0,1,2,3,5;5;2,9;2;1;1
252857089303;252857089307;4;0,1,2,3,5;5;2,9;2;1;1
252857089307;252857089310;3;0,1,2,3,5;5;2,9;2;1;1
252857089310;252857089316;6;0,1,2,3,5;5;2,9;2;1;1
252857089316;252857089324;8;0,1,2,3,5;5;2,9;2;1;1
252857089324;252857089326;2;0,1,2,3,5;5;2,9;2;1;1
252857089326;252857089335;9;0,1,2,3,5;5;2,9;2;1;1
252857089335;252857089345;10;0,1,2,3,5;5;2,9;2;1;1
252857089345;252857089348;3;0,1,2,3,5;5;2,9;2;1;1
252857089348;252857089350;2;0,1,2,3,5;5;2,9;2;1;1
252857089350;252857089353;3;0,1,2,3,5;5;2,9;2;1;1
252857089353;252857089371;18;0,1,2,3,5;5;2,9;2;1;1
252857089371;252857089376;5;0,1,2,3,5;5;2,9;2;1;1
252857089376;252857089377;1;0,1,2,3,5;5;2,9;2;1;1
252857089377;252857089386;9;0,1,2,3,5;5;2,9;2;1;1
252857089386;252857089389;3;0,1,2,3,5;5;2,9;2;1;1
252857089389;252857089394;5;0,1,2,3,5;5;2,9;2;1;1
252857089394;252857089395;1;0,1,2,3,5;5;2,9;2;1;1
252857089395;252857089409;14;0,1,2,3,5;5;2,9;2;1;1
252857089409;252857089412;3;0,1,2,3,5;5;2,9;2;1;1
252857089412;252857089421;9;0,1,2,3,5;5;2,9;2;1;1
252857089421;252857089447;26;0,1,2,3,5;5;2,9;2;1;1
252857089447;252857089451;4;0,1,2,3,5;5;2,9;2;1;1
252857089451;252857089466;15;0,1,2,3,5;5;2,9;2;1;1
252857089466;252857089469;3;0,1,2,3,5;5;2,9;2;1;1
252857089469;252857089470;1;0,1,2,3,5;5;2,9;2;1;1
252857089470;252857089473;3;0,1,2,3,5;5;2,9;2;1;1
252857089473;252857089476;3;0,1,2,3,5;5;2,9;2;1;1
252857089476;252857089483;7;0,1,2,3,5;5;2,9;2;1;1
252857089483;252857089485;2;0,1,2,3,5;5;2,9;2;1;1
252857089485;252857089494;9;0,1,2,3,5;5;2,9;2;1;1
252857089494;252857089495;1;0,1,2,3,5;5;2,9;2;1;1
252857089495;252857089499;4;0,1,2,3,5;5;2,9;2;1;1
252857089499;252857089502;3;0,1,2,3,5;5;2,9;2;1;1
252857089502;252857089503;1;0,1,2,3,5;5;2,9;2;1;1
252857089503;252857089511;8;0,1,2,3,5;5;2,9;2;1;1
252857089511;252857089530;19;0,1,2,3,5;5;2,9;2;1;1
252857089530;252857089531;1;0,1,2,3,5;5;2,9;2;1;1
252857089531;252857089537;6;0,1,2,3,5;5;2,9;2;1;1
252857089537;252857089541;4;0,1,2,3,5;5;2,9;2;1;1
252857089541;252857089544;3;0,1,2,3,5;5;2,9;2;1;1
252857089544;252857089546;2;0,1,2,3,5;5;2,9;2;1;1
252857089546;252857089555;9;0,1,2,3,5;5;2,9;2;1;1
252857089555;252857089571;16;0,1,2,3,5;5;2,9;2;1;1
252857089571;252857089594;23;0,1,2,3,5;5;2,9;2;1;1
252857089594;252857089602;8;0,1,2,3,5;5;2,9;2;1;1
252857089602;252857089604;2;0,1,2,3,5;5;2,9;2;1;1
252857089604;252857089625;21;0,1,2,3,5;5;2,9;2;1;1
252857089625;252857089629;4;0,1,2,3,5;5;2,9;2;1;1
252857089629;252857089632;3;0,1,2,3,5;5;2,9;2;1;1
252857089632;252857089635;3;0,1,2,3,5;5;2,9;2;1;1
252857089635;252857089641;6;0,1,2,3,5;5;2,9;2;1;1
252857089641;252857089649;8;0,1,2,3,5;5;2,9;2;1;1
252857089649;252857089655;6;0,1,2,3,5;5;2,9;2;1;1
252857089655;252857089658;3;0,1,2,3,5;5;2,9;2;1;1
252857089658;252857089671;13;0,1,2,3,5;5;2,9;2;1;1
252857089671;252857089684;13;0,1,2,3,5;5;2,9;2;1;1
252857089684;252857089692;8;0,1,2,3,5;5;2,9;2;1;1
252857089692;252857089700;8;0,1,2,3,5;5;2,9;2;1;1
252857089700;252857089711;11;0,1,2,3,5;5;2,9;2;1;1
252857089711;252857089714;3;0,1,2,3,5;5;2,9;2;1;1
252857089714;252857089715;1;0,1,2,3,5;5;2,9;2;1;1
252857089715;252857089718;3;0,1,2,3,5;5;2,9;2;1;1
252857089718;252857089719;1;0,1,2,3,5;5;2,9;2;1;1
252857089719;252857089722;3;0,1,2,3,5;5;2,9;2;1;1
252857089722;252857089726;4;0,1,2,3,5;5;2,9;2;1;1
252857089726;252857089733;7;0,1,2,3,5;5;2,9;2;1;1
252857089733;252857089740;7;0,1,2,3,5;5;2,9;2;1;1
252857089740;252857089798;58;0,1,2,3,5;5;2,9;2;1;1
252857089798;252857089804;6;0,1,2,3,5;5;2,9;2;1;1
252857089804;252857089823;19;0,1,2,3,5;5;2,9;2;1;1
252857089823;252857089824;1;0,1,2,3,5;5;2,9;2;1;1
252857089824;252857089837;13;0,1,2,3,5;5;2,9;2;1;1
252857089837;252857089847;10;0,1,2,3,5;5;2,9;2;1;1
252857089847;252857089855;8;0,1,2,3,5;5;2,9;2;1;1
252857089855;252857089865;10;0,1,2,3,5;5;2,9;2;1;1
252857089865;252857089884;19;0,1,2,3,5;5;2,9;2;1;1
252857089884;252857089909;25;0,1,2,3,5;5;2,9;2;1;1
252857089909;252857089912;3;0,1,2,3,5;5;2,9;2;1;1
252857089912;252857089922;10;0,1,2,3,5;5;2,9;2;1;1
252857089922;252857089938;16;0,1,2,3,5;5;2,9;2;1;1
252857089938;252857089946;8;0,1,2,3,5;5;2,9;2;1;1
252857089946;252857089959;13;0,1,2,3,5;5;2,9;2;1;1
252857089959;252857089967;8;0,1,2,3,5;5;2,9;2;1;1
252857089967;252857089968;1;0,1,2,3,5;5;2,9;2;1;1
252857089968;252857089974;6;0,1,2,3,5;5;2,9;2;1;1
252857089974;252857089979;5;0,1,2,3,5;5;2,9;2;1;1
252857089979;252857089993;14;0,1,2,3,5;5;2,9;2;1;1
252857089993;252857090003;10;0,1,2,3,5;5;2,9;2;1;1
252857090003;252857090008;5;0,1,2,3,5;5;2,9;2;1;1
252857090008;252857090024;16;0,1,2,3,5;5;2,9;2;1;1
252857090024;252857090033;9;0,1,2,3,5;5;2,9;2;1;1
252857090033;252857090042;9;0,1,2,3,5;5;2,9;2;1;1
252857090042;252857090044;2;0,1,2,3,5;5;2,9;2;1;1
252857090044;252857090051;7;0,1,2,3,5;5;2,9;2;1;1
252857090051;252857090071;20;0,1,2,3,5;5;2,9;2;1;1
252857090071;252857090076;5;0,1,2,3,5;5;2,9;2;1;1
252857090076;252857090078;2;0,1,2,3,5;5;2,9;2;1;1
252857090078;252857090081;3;0,1,2,3,5;5;2,9;2;1;1
252857090081;252857090090;9;0,1,2,3,5;5;2,9;2;1;1
252857090090;252857090096;6;0,1,2,3,5;5;2,9;2;1;1
252857090096;252857090105;9;0,1,2,3,5;5;2,9;2;1;1
252857090105;252857090141;36;0,1,2,3,5;5;2,9;2;1;1
252857090141;252857090144;3;0,1,2,3,5;5;2,9;2;1;1
252857090144;252857090173;29;0,1,2,3,5;5;2,9;2;1;1
252857090173;252857090179;6;0,1,2,3,5;5;2,9;2;1;1
252857090179;252857090192;13;0,1,2,3,5;5;2,9;2;1;1
252857090192;252857090198;6;0,1,2,3,5;5;2,9;2;1;1
252857090198;252857090223;25;0,1,2,3,5;5;2,9;2;1;1
252857090223;252857090246;23;0,1,2,3,5;5;2,9;2;1;1
252857090246;252857090250;4;0,1,2,3,5;5;2,9;2;1;1
252857090250;252857090255;5;0,1,2,3,5;5;2,9;2;1;1
252857090255;252857090256;1;0,1,2,3,5;5;2,9;2;1;1
252857090256;252857090258;2;0,1,2,3,5;5;2,9;2;1;1
252857090258;252857090275;17;0,1,2,3,5;5;2,9;2;1;1
252857090275;252857090287;12;0,1,2,3,5;5;2,9;2;1;1
252857090287;252857090292;5;0,1,2,3,5;5;2,9;2;1;1
252857090292;252857090317;25;0,1,2,3,5;5;2,9;2;1;1
252857090317;252857090330;13;0,1,2,3,5;5;2,9;2;1;1
252857090330;252857090335;5;0,1,2,3,5;5;2,9;2;1;1
252857090335;252857090339;4;0,1,2,3,5;5;2,9;2;1;1
252857090339;252857090340;1;0,1,2,3,5;5;2,9;2;1;1
252857090340;252857090349;9;0,1,2,3,5;5;2,9;2;1;1
252857090349;252857090359;10;0,1,2,3,5;5;2,9;2;1;1
252857090359;252857090361;2;0,1,2,3,5;5;2,9;2;1;1
252857090361;252857090369;8;0,1,2,3,5;5;2,9;2;1;1
252857090369;252857090377;8;0,1,2,3,5;5;2,9;2;1;1
252857090377;252857090393;16;0,1,2,3,5;5;2,9;2;1;1
252857090393;252857090402;9;0,1,2,3,5;5;2,9;2;1;1
252857090402;252857090429;27;0,1,2,3,5;5;2,9;2;1;1
252857090429;252857090434;5;0,1,2,3,5;5;2,9;2;1;1
252857090434;252857090460;26;0,1,2,3,5;5;2,9;2;1;1
252857090460;252857090464;4;0,1,2,3,5;5;2,9;2;1;1
252857090464;252857090484;20;0,1,2,3,5;5;2,9;2;1;1
252857090484;252857090521;37;0,1,2,3,5;5;2,9;2;1;1
252857090521;252857090526;5;0,1,2,3,5;5;2,9;2;1;1
252857090526;252857090534;8;0,1,2,3,5;5;2,9;2;1;1
252857090534;252857090536;2;0,1,2,3,5;5;2,9;2;1;1
252857090536;252857090564;28;0,1,2,3,5;5;2,9;2;1;1
252857090564;252857090569;5;0,1,2,3,5;5;2,9;2;1;1
252857090569;252857090664;95;0,1,2,3,5;5;2,9;2;1;1
252857090664;252857090676;12;0,1,2,3,5;5;2,9;2;1;1
252857090676;252857090690;14;0,1,2,3,5;5;2,9;2;1;1
252857090690;252857090703;13;0,1,2,3,5;5;2,9;2;1;1
252857090703;252857090742;39;0,1,2,3,5;5;2,9;2;1;1
252857090742;252857090768;26;0,1,2,3,5;5;2,9;2;1;1
252857090768;252857090769;1;0,1,2,3,5;5;2,9;2;1;1
252857090769;252857090782;13;0,1,2,3,5;5;2,9;2;1;1
252857090782;252857090785;3;0,1,2,3,5;5;2,9;2;1;1
252857090785;252857090795;10;0,1,2,3,5;5;2,9;2;1;1
252857090795;252857090818;23;0,1,2,3,5;5;2,9;2;1;1
252857090818;252857090840;22;0,1,2,3,5;5;2,9;2;1;1
252857090840;252857090872;32;0,1,2,3,5;5;2,9;2;1;1
252857090872;252857090951;79;0,1,2,3,5;5;2,9;2;1;1
252857090951;252857090969;18;0,1,2,3,5;5;2,9;2;1;1
252857090969;252857090987;18;0,1,2,3,5;5;2,9;2;1;1
252857090987;252857091003;16;0,1,2,3,5;5;2,9;2;1;1
252857091003;252857091005;2;0,1,2,3,5;5;2,9;2;1;1
252857091005;252857091013;8;0,1,2,3,5;5;2,9;2;1;1
252857091013;252857091030;17;0,1,2,3,5;5;2,9;2;1;1
252857091030;252857091063;33;0,1,2,3,5;5;2,9;2;1;1
252857091063;252857091154;91;0,1,2,3,5;5;2,9;2;1;1
252857091154;252857091157;3;0,1,2,3,5;5;2,9;2;1;1
252857091157;252857091231;74;0,1,2,3,5;5;2,9;2;1;1
252857091231;252857091288;57;0,1,2,3,5;5;2,9;2;1;1
252857091288;252857091391;103;0,1,2,3,5;5;2,9;2;1;1
252857091391;252857091419;28;0,1,2,3,5;5;2,9;2;1;1
252857091419;252857091435;16;0,1,2,3,5;5;2,9;2;1;1
252857091435;252857091548;113;0,1,2,3,5;5;2,9;2;1;1
252857091548;252857091559;11;0,1,2,3,5;5;2,9;2;1;1
252857091559;252857091575;16;0,1,2,3,5;5;2,9;2;1;1
252857091575;252857091601;26;0,1,2,3,5;5;2,9;2;1;1
252857091601;252857091691;90;0,1,2,3,5;5;2,9;2;1;1
252857091691;252857091692;1;0,1,2,3,5;5;2,9;2;1;1
252857091692;252857091738;46;0,1,2,3,5;5;2,9;2;1;1
252857091738;252857091744;6;0,1,2,3,5;5;2,9;2;1;1
252857091744;252857091825;81;0,1,2,3,5;5;2,9;2;1;1
252857091825;252857091858;33;0,1,2,3,5;5;2,9;2;1;1
252857091858;252857091932;74;0,1,2,3,5;5;2,9;2;1;1
252857091932;252857091989;57;0,1,2,3,5;5;2,9;2;1;1
252857091989;252857092016;27;0,1,2,3,5;5;2,9;2;1;1
252857092016;252857092088;72;0,1,2,3,5;5;2,9;2;1;1
252857092088;252857092113;25;0,1,2,3,5;5;2,9;2;1;1
252857092113;252857092312;199;0,1,2,3,5;5;2,9;2;1;1
252857092312;252857092947;635;0,1,2,3,5;5;2,9;2;1;1
252857092947;252857093035;88;0,1,2,3,5;5;2,9;2;1;1
252857093035;252857093342;307;0,1,2,3,5;5;2,9;2;1;1
252857093342;252857093678;336;0,1,2,3,5;5;2,9;2;1;1
252857093678;252857093723;45;0,1,2,3,5;5;2,9;2;1;1
252857093723;252857093760;37;0,1,2,3,5;5;2,9;2;1;1
252857093760;252857093825;65;0,1,2,3,5;5;2,9;2;1;1
252857093825;252857093857;32;0,1,2,3,5;5;2,9;2;1;1
252857093857;252857093919;62;0,1,2,3,5;5;2,9;2;1;1
252857093919;252857094116;197;0,1,2,3,5;5;2,9;2;1;1
252857094116;252857101784;7668;0,1,2,3,5;5;2,9;2;1;1
252857101784;252857102591;807;0,1,2,3,5;5;2,9;2;1;1
252857102591;252857102732;141;0,1,2,3,5;5;2,9;2;1;1
252857102732;252857102947;215;0,1,2,3,5;5;2,9;2;1;1
252857102947;252857103037;90;0,1,2,3,5;5;2,9;2;1;1
252857103037;252857103101;64;0,1,2,3,5;5;2,9;2;1;1
252857103101;252857103319;218;0,1,2,3,5;5;2,9;2;1;1
252857103319;252857103396;77;0,1,2,3,5;5;2,9;2;1;1
252857103396;252857103714;318;0,1,2,3,5;5;2,9;2;1;1
252857103714;252857103994;280;0,1,2,3,5;5;2,9;2;1;1
252857103994;252857104079;85;0,1,2,3,5;5;2,9;2;1;1
252857104079;252857104341;262;0,1,2,3,5;5;2,9;2;1;1
252857104341;252857104479;138;0,1,2,3,5;5;2,9;2;1;1
252857104479;252857104530;51;0,1,2,3,5;5;2,9;2;1;1
252857104530;252857125968;21438;0,1,2,3,5;5;2,9;2;1;1
252857125968;252857127032;1064;0,1,2,3,5;5;2,9;2;1;1
252857127032;252857127041;9;0,1,2,3,5;5;2,9;2;1;1
252857127041;252857127083;42;0,1,2,3,5;5;2,9;2;1;1
252857127083;252857127339;256;0,1,2,3,5;5;2,9;2;1;1
252857127339;252857127444;105;0,1,2,3,5;5;2,9;2;1;1
252857127444;252857128893;1449;0,1,2,3,5;5;2,9;2;1;1
252857128893;252857129143;250;0,1,2,3,5;5;2,9;2;1;1
252857129143;252857129293;150;0,1,2,3,5;5;2,9;2;1;1
252857129293;252857129508;215;0,1,2,3,5;5;2,9;2;1;1
252857129508;252857129576;68;0,1,2,3,5;5;2,9;2;1;1
252857129576;252857129872;296;0,1,2,3,5;5;2,9;2;1;1
252857129872;252857129965;93;0,1,2,3,5;5;2,9;2;1;1
252857129965;252857130047;82;0,1,2,3,5;5;2,9;2;1;1
252857130047;252857130126;79;0,1,2,3,5;5;2,9;2;1;1
252857130126;252857130179;53;0,1,2,3,5;5;2,9;2;1;1
252857130179;252857130244;65;0,1,2,3,5;5;2,9;2;1;1
252857130244;252857130385;141;0,1,2,3,5;5;2,9;2;1;1
252857130385;252857130454;69;0,1,2,3,5;5;2,9;2;1;1
252857130454;252857130484;30;0,1,2,3,5;5;2,9;2;1;1
252857130484;252857130521;37;0,1,2,3,5;5;2,9;2;1;1
252857130521;252857130617;96;0,1,2,3,5;5;2,9;2;1;1
252857130617;252857130639;22;0,1,2,3,5;5;2,9;2;1;1
252857130639;252857130710;71;0,1,2,3,5;5;2,9;2;1;1
252857130710;252857130821;111;0,1,2,3,5;5;2,9;2;1;1
252857130821;252857130841;20;0,1,2,3,5;5;2,9;2;1;1
252857130841;252857130895;54;0,1,2,3,5;5;2,9;2;1;1
252857130895;252857131069;174;0,1,2,3,5;5;2,9;2;1;1
252857131069;252857131097;28;0,1,2,3,5;5;2,9;2;1;1
252857131097;252857131128;31;0,1,2,3,5;5;2,9;2;1;1
252857131128;252857131183;55;0,1,2,3,5;5;2,9;2;1;1
252857131183;252857131219;36;0,1,2,3,5;5;2,9;2;1;1
252857131219;252857131243;24;0,1,2,3,5;5;2,9;2;1;1
252857131243;252857131305;62;0,1,2,3,5;5;2,9;2;1;1
252857131305;252857131350;45;0,1,2,3,5;5;2,9;2;1;1
252857131350;252857131434;84;0,1,2,3,5;5;2,9;2;1;1
252857131434;252857131558;124;0,1,2,3,5;5;2,9;2;1;1
252857131558;252857131587;29;0,1,2,3,5;5;2,9;2;1;1
252857131587;252857131609;22;0,1,2,3,5;5;2,9;2;1;1
252857131609;252857131620;11;0,1,2,3,5;5;2,9;2;1;1
252857131620;252857131633;13;0,1,2,3,5;5;2,9;2;1;1
252857131633;252857131659;26;0,1,2,3,5;5;2,9;2;1;1
252857131659;252857131692;33;0,1,2,3,5;5;2,9;2;1;1
252857131692;252857131697;5;0,1,2,3,5;5;2,9;2;1;1
252857131697;252857131741;44;0,1,2,3,5;5;2,9;2;1;1
252857131741;252857131762;21;0,1,2,3,5;5;2,9;2;1;1
252857131762;252857131768;6;0,1,2,3,5;5;2,9;2;1;1
252857131768;252857131774;6;0,1,2,3,5;5;2,9;2;1;1
252857131774;252857131801;27;0,1,2,3,5;5;2,9;2;1;1
252857131801;252857131824;23;0,1,2,3,5;5;2,9;2;1;1
252857131824;252857131842;18;0,1,2,3,5;5;2,9;2;1;1
252857131842;252857131857;15;0,1,2,3,5;5;2,9;2;1;1
252857131857;252857132114;257;0,1,2,3,5;5;2,9;2;1;1
252857132114;252857132152;38;0,1,2,3,5;5;2,9;2;1;1
252857132152;252857132198;46;0,1,2,3,5;5;2,9;2;1;1
252857132198;252857132225;27;0,1,2,3,5;5;2,9;2;1;1
252857132225;252857132226;1;0,1,2,3,5;5;2,9;2;1;1
252857132226;252857132337;111;0,1,2,3,5;5;2,9;2;1;1
252857132337;252857132427;90;0,1,2,3,5;5;2,9;2;1;1
252857132427;252857132438;11;0,1,2,3,5;5;2,9;2;1;1
252857132438;252857132512;74;0,1,2,3,5;5;2,9;2;1;1
252857132512;252857132588;76;0,1,2,3,5;5;2,9;2;1;1
252857132588;252857132650;62;0,1,2,3,5;5;2,9;2;1;1
252857132650;252857132930;280;0,1,2,3,5;5;2,9;2;1;1
252857132930;252857132955;25;0,1,2,3,5;5;2,9;2;1;1
252857132955;252857132974;19;0,1,2,3,5;5;2,9;2;1;1
252857132974;252857133001;27;0,1,2,3,5;5;2,9;2;1;1
252857133001;252857133026;25;0,1,2,3,5;5;2,9;2;1;1
252857133026;252857133039;13;0,1,2,3,5;5;2,9;2;1;1
252857133039;252857133049;10;0,1,2,3,5;5;2,9;2;1;1
252857133049;252857133065;16;0,1,2,3,5;5;2,9;2;1;1
252857133065;252857133093;28;0,1,2,3,5;5;2,9;2;1;1
252857133093;252857133102;9;0,1,2,3,5;5;2,9;2;1;1
252857133102;252857133126;24;0,1,2,3,5;5;2,9;2;1;1
252857133126;252857133152;26;0,1,2,3,5;5;2,9;2;1;1
252857133152;252857133232;80;0,1,2,3,5;5;2,9;2;1;1
252857133232;252857133233;1;0,1,2,3,5;5;2,9;2;1;1
252857133233;252857133255;22;0,1,2,3,5;5;2,9;2;1;1
252857133255;252857133265;10;0,1,2,3,5;5;2,9;2;1;1
252857133265;252857133266;1;0,1,2,3,5;5;2,9;2;1;1
252857133266;252857133290;24;0,1,2,3,5;5;2,9;2;1;1
252857133290;252857133293;3;0,1,2,3,5;5;2,9;2;1;1
252857133293;252857133313;20;0,1,2,3,5;5;2,9;2;1;1
252857133313;252857133347;34;0,1,2,3,5;5;2,9;2;1;1
252857133347;252857133349;2;0,1,2,3,5;5;2,9;2;1;1
252857133349;252857133397;48;0,1,2,3,5;5;2,9;2;1;1
252857133397;252857133402;5;0,1,2,3,5;5;2,9;2;1;1
252857133402;252857133424;22;0,1,2,3,5;5;2,9;2;1;1
252857133424;252857133457;33;0,1,2,3,5;5;2,9;2;1;1
252857133457;252857133489;32;0,1,2,3,5;5;2,9;2;1;1
252857133489;252857133521;32;0,1,2,3,5;5;2,9;2;1;1
252857133521;252857133537;16;0,1,2,3,5;5;2,9;2;1;1
252857133537;252857133611;74;0,1,2,3,5;5;2,9;2;1;1
252857133611;252857133643;32;0,1,2,3,5;5;2,9;2;1;1
252857133643;252857133656;13;0,1,2,3,5;5;2,9;2;1;1
252857133656;252857133738;82;0,1,2,3,5;5;2,9;2;1;1
252857133738;252857133775;37;0,1,2,3,5;5;2,9;2;1;1
252857133775;252857133776;1;0,1,2,3,5;5;2,9;2;1;1
252857133776;252857133823;47;0,1,2,3,5;5;2,9;2;1;1
252857133823;252857133833;10;0,1,2,3,5;5;2,9;2;1;1
252857133833;252857133935;102;0,1,2,3,5;5;2,9;2;1;1
252857133935;252857133969;34;0,1,2,3,5;5;2,9;2;1;1
252857133969;252857134099;130;0,1,2,3,5;5;2,9;2;1;1
252857134099;252857134219;120;0,1,2,3,5;5;2,9;2;1;1
252857134219;252857134260;41;0,1,2,3,5;5;2,9;2;1;1
252857134260;252857134353;93;0,1,2,3,5;5;2,9;2;1;1
252857134353;252857134402;49;0,1,2,3,5;5;2,9;2;1;1
252857134402;252857134431;29;0,1,2,3,5;5;2,9;2;1;1
252857134431;252857134595;164;0,1,2,3,5;5;2,9;2;1;1
252857134595;252857134860;265;0,1,2,3,5;5;2,9;2;1;1
252857134860;252857134886;26;0,1,2,3,5;5;2,9;2;1;1
252857134886;252857134985;99;0,1,2,3,5;5;2,9;2;1;1
252857134985;252857135507;522;0,1,2,3,5;5;2,9;2;1;1
252857135507;252857135666;159;0,1,2,3,5;5;2,9;2;1;1
252857135666;252857135731;65;0,1,2,3,5;5;2,9;2;1;1
252857135731;252857135761;30;0,1,2,3,5;5;2,9;2;1;1
252857135761;252857135780;19;0,1,2,3,5;5;2,9;2;1;1
252857135780;252857135819;39;0,1,2,3,5;5;2,9;2;1;1
252857135819;252857135858;39;0,1,2,3,5;5;2,9;2;1;1
252857135858;252857135931;73;0,1,2,3,5;5;2,9;2;1;1
252857135931;252857135981;50;0,1,2,3,5;5;2,9;2;1;1
252857135981;252857136036;55;0,1,2,3,5;5;2,9;2;1;1
252857136036;252857136091;55;0,1,2,3,5;5;2,9;2;1;1
252857136091;252857136118;27;0,1,2,3,5;5;2,9;2;1;1
252857136118;252857136176;58;0,1,2,3,5;5;2,9;2;1;1
252857136176;252857136202;26;0,1,2,3,5;5;2,9;2;1;1
252857136202;252857136260;58;0,1,2,3,5;5;2,9;2;1;1
252857136260;252857136310;50;0,1,2,3,5;5;2,9;2;1;1
252857136310;252857137128;818;0,1,2,3,5;5;2,9;2;1;1
252857137128;252857137378;250;0,1,2,3,5;5;2,9;2;1;1
252857137378;252857137881;503;0,1,2,3,5;5;2,9;2;1;1
252857137881;252857138019;138;0,1,2,3,5;5;2,9;2;1;1
252857138019;252857138058;39;0,1,2,3,5;5;2,9;2;1;1
252857138058;252857138116;58;0,1,2,3,5;5;2,9;2;1;1
252857138116;252857138133;17;0,1,2,3,5;5;2,9;2;1;1
252857138133;252857138246;113;0,1,2,3,5;5;2,9;2;1;1
252857138246;252857138277;31;0,1,2,3,5;5;2,9;2;1;1
252857138277;252857138350;73;0,1,2,3,5;5;2,9;2;1;1
252857138350;252857138448;98;0,1,2,3,5;5;2,9;2;1;1
252857138448;252857138542;94;0,1,2,3,5;5;2,9;2;1;1
252857138542;252857138640;98;0,1,2,3,5;5;2,9;2;1;1
252857138640;252857139020;380;0,1,2,3,5;5;2,9;2;1;1
252857139020;252857140124;1104;0,1,2,3,5;5;2,9;2;1;1
252857140124;252857140183;59;0,1,2,3,5;5;2,9;2;1;1
252857140183;252857140258;75;0,1,2,3,5;5;2,9;2;1;1
252857140258;252857140389;131;0,1,2,3,5;5;2,9;2;1;1
252857140389;252857140420;31;0,1,2,3,5;5;2,9;2;1;1
252857140420;252857140454;34;0,1,2,3,5;5;2,9;2;1;1
252857140454;252857140515;61;0,1,2,3,5;5;2,9;2;1;1
252857140515;252857140548;33;0,1,2,3,5;5;2,9;2;1;1
252857140548;252857140568;20;0,1,2,3,5;5;2,9;2;1;1
252857140568;252857140673;105;0,1,2,3,5;5;2,9;2;1;1
252857140673;252857140851;178;0,1,2,3,5;5;2,9;2;1;1
252857140851;252857140889;38;0,1,2,3,5;5;2,9;2;1;1
252857140889;252857140925;36;0,1,2,3,5;5;2,9;2;1;1
252857140925;252857141038;113;0,1,2,3,5;5;2,9;2;1;1
252857141038;252857141142;104;0,1,2,3,5;5;2,9;2;1;1
252857141142;252857141418;276;0,1,2,3,5;5;2,9;2;1;1
252857141418;252857157325;15907;0,1,2,3,5;5;2,9;2;1;1
252857157325;252862407591;5250266;0,1,2,3,5;5;2,9;2;1;1
252862407591;252902483281;40075690;0,1,2,3,5;5;2,9;2;1;1
252902483281;252938154745;35671464;0,1,2,3,5;5;2,9;2;1;1
252938154745;252938271279;116534;0,1,2,3,5;5;2,9;2;1;1
252938271279;252938919684;648405;0,1,2,3,5;5;2,9;2;1;1
252938919684;252938981343;61659;0,1,2,3,5;5;2,9;2;1;1
252938981343;252938989639;8296;0,1,2,3,5;5;2,9;2;1;1
252938989639;252939019941;30302;0,1,2,3,5;5;2,9;2;1;1
252939019941;252939024095;4154;0,1,2,3,5;5;2,9;2;1;1
252939024095;252939059298;35203;0,1,2,3,5;5;2,9;2;1;1
252939059298;252939096532;37234;0,1,2,3,5;5;2,9;2;1;1
252939096532;252939103832;7300;0,1,2,3,5;5;2,9;2;1;1
252939103832;252939114832;11000;0,1,2,3,5;5;2,9;2;1;1
252939114832;252939127638;12806;0,1,2,3,5;5;2,9;2;1;1
252939127638;252939133341;5703;0,1,2,3,5;5;2,9;2;1;1
252939133341;252939165362;32021;0,1,2,3,5;5;2,9;2;1;1
252939165362;252939194225;28863;0,1,2,3,5;5;2,9;2;1;1
252939194225;252939210059;15834;0,1,2,3,5;5;2,9;2;1;1
252939210059;252939216225;6166;0,1,2,3,5;5;2,9;2;1;1
252939216225;252939243258;27033;0,1,2,3,5;5;2,9;2;1;1
252939243258;252939302545;59287;0,1,2,3,5;5;2,9;2;1;1
252939302545;252939365848;63303;0,1,2,3,5;5;2,9;2;1;1
252939365848;252939371110;5262;0,1,2,3,5;5;2,9;2;1;1
252939371110;252939435637;64527;0,1,2,3,5;5;2,9;2;1;1
252939435637;252939441760;6123;0,1,2,3,5;5;2,9;2;1;1
252939441760;252939486077;44317;0,1,2,3,5;5;2,9;2;1;1
252939486077;252939528949;42872;0,1,2,3,5;5;2,9;2;1;1
252939528949;252939893700;364751;0,1,2,3,5;5;2,9;2;1;1
252939893700;252940829002;935302;0,1,2,3,5;5;2,9;2;1;1
252940829002;252947020495;6191493;0,1,2,3,5;5;2,9;2;1;1
252947020495;252947606916;586421;0,1,2,3,5;5;2,9;2;1;1
252947606916;252947645349;38433;0,1,2,3,5;5;2,9;2;1;1
252947645349;252947694566;49217;0,1,2,3,5;5;2,9;2;1;1
252947694566;252947808894;114328;0,1,2,3,5;5;2,9;2;1;1
252947808894;252947895158;86264;0,1,2,3,5;5;2,9;2;1;1
252947895158;252947905440;10282;0,1,2,3,5;5;2,9;2;1;1
252947905440;252947926288;20848;0,1,2,3,5;5;2,9;2;1;1
252947926288;252947929234;2946;0,1,2,3,5;5;2,9;2;1;1
252947929234;252947967096;37862;0,1,2,3,5;5;2,9;2;1;1
252947967096;252948073778;106682;0,1,2,3,5;5;2,9;2;1;1
252948073778;252948447486;373708;0,1,2,3,5;5;2,9;2;1;1
252948447486;252952204726;3757240;0,1,2,3,5;5;2,9;2;1;1
252952204726;252956703569;4498843;0,1,2,3,5;5;2,9;2;1;1
252956703569;252956735059;31490;0,1,2,3,5;5;2,9;2;1;1
252956735059;252959744673;3009614;0,1,2,3,5;5;2,9;2;1;1
252959744673;252959847046;102373;0,1,2,3,5;5;2,9;2;1;1
252959847046;252959966792;119746;0,1,2,3,5;5;2,9;2;1;1
252959966792;252959971583;4791;0,1,2,3,5;5;2,9;2;1;1
252959971583;252960027993;56410;0,1,2,3,5;5;2,9;2;1;1
252960027993;252960031712;3719;0,1,2,3,5;5;2,9;2;1;1
252960031712;252960031792;80;0,1,2,3,5;5;2,9;2;1;1
252960031792;252960031844;52;0,1,2,3,5;5;2,9;2;1;1
252960031844;252960031954;110;0,1,2,3,5;5;2,9;2;1;1
252960031954;252960031960;6;0,1,2,3,5;5;2,9;2;1;1
252960031960;252960032058;98;0,1,2,3,5;5;2,9;2;1;1
252960032058;252960032167;109;0,1,2,3,5;5;2,9;2;1;1
252960032167;252960032258;91;0,1,2,3,5;5;2,9;2;1;1
252960032258;252960032300;42;0,1,2,3,5;5;2,9;2;1;1
252960032300;252960032348;48;0,1,2,3,5;5;2,9;2;1;1
252960032348;252960032398;50;0,1,2,3,5;5;2,9;2;1;1
252960032398;252960032402;4;0,1,2,3,5;5;2,9;2;1;1
252960032402;252960032446;44;0,1,2,3,5;5;2,9;2;1;1
252960032446;252960032531;85;0,1,2,3,5;5;2,9;2;1;1
252960032531;252960032545;14;0,1,2,3,5;5;2,9;2;1;1
252960032545;252960032570;25;0,1,2,3,5;5;2,9;2;1;1
252960032570;252960032600;30;0,1,2,3,5;5;2,9;2;1;1
252960032600;252960032656;56;0,1,2,3,5;5;2,9;2;1;1
252960032656;252960032670;14;0,1,2,3,5;5;2,9;2;1;1
252960032670;252960032701;31;0,1,2,3,5;5;2,9;2;1;1
252960032701;252960032704;3;0,1,2,3,5;5;2,9;2;1;1
252960032704;252960032720;16;0,1,2,3,5;5;2,9;2;1;1
252960032720;252960032759;39;0,1,2,3,5;5;2,9;2;1;1
252960032759;252960032775;16;0,1,2,3,5;5;2,9;2;1;1
252960032775;252960032777;2;0,1,2,3,5;5;2,9;2;1;1
252960032777;252960032793;16;0,1,2,3,5;5;2,9;2;1;1
252960032793;252960032814;21;0,1,2,3,5;5;2,9;2;1;1
252960032814;252960032852;38;0,1,2,3,5;5;2,9;2;1;1
252960032852;252960032881;29;0,1,2,3,5;5;2,9;2;1;1
252960032881;252960032902;21;0,1,2,3,5;5;2,9;2;1;1
252960032902;252960032909;7;0,1,2,3,5;5;2,9;2;1;1
252960032909;252960032941;32;0,1,2,3,5;5;2,9;2;1;1
252960032941;252960032961;20;0,1,2,3,5;5;2,9;2;1;1
252960032961;252960032973;12;0,1,2,3,5;5;2,9;2;1;1
252960032973;252960032983;10;0,1,2,3,5;5;2,9;2;1;1
252960032983;252960033027;44;0,1,2,3,5;5;2,9;2;1;1
252960033027;252960033070;43;0,1,2,3,5;5;2,9;2;1;1
252960033070;252960033082;12;0,1,2,3,5;5;2,9;2;1;1
252960033082;252960033121;39;0,1,2,3,5;5;2,9;2;1;1
252960033121;252960033128;7;0,1,2,3,5;5;2,9;2;1;1
252960033128;252960033131;3;0,1,2,3,5;5;2,9;2;1;1
252960033131;252960033141;10;0,1,2,3,5;5;2,9;2;1;1
252960033141;252960033160;19;0,1,2,3,5;5;2,9;2;1;1
252960033160;252960033170;10;0,1,2,3,5;5;2,9;2;1;1
252960033170;252960033177;7;0,1,2,3,5;5;2,9;2;1;1
252960033177;252960033189;12;0,1,2,3,5;5;2,9;2;1;1
252960033189;252960033216;27;0,1,2,3,5;5;2,9;2;1;1
252960033216;252960033219;3;0,1,2,3,5;5;2,9;2;1;1
252960033219;252960033226;7;0,1,2,3,5;5;2,9;2;1;1
252960033226;252960033233;7;0,1,2,3,5;5;2,9;2;1;1
252960033233;252960033250;17;0,1,2,3,5;5;2,9;2;1;1
252960033250;252960033273;23;0,1,2,3,5;5;2,9;2;1;1
252960033273;252960033298;25;0,1,2,3,5;5;2,9;2;1;1
252960033298;252960033300;2;0,1,2,3,5;5;2,9;2;1;1
252960033300;252960033304;4;0,1,2,3,5;5;2,9;2;1;1
252960033304;252960033314;10;0,1,2,3,5;5;2,9;2;1;1
252960033314;252960033315;1;0,1,2,3,5;5;2,9;2;1;1
252960033315;252960033318;3;0,1,2,3,5;5;2,9;2;1;1
252960033318;252960033321;3;0,1,2,3,5;5;2,9;2;1;1
252960033321;252960033325;4;0,1,2,3,5;5;2,9;2;1;1
252960033325;252960033352;27;0,1,2,3,5;5;2,9;2;1;1
252960033352;252960033359;7;0,1,2,3,5;5;2,9;2;1;1
252960033359;252960033381;22;0,1,2,3,5;5;2,9;2;1;1
252960033381;252960033390;9;0,1,2,3,5;5;2,9;2;1;1
252960033390;252960033400;10;0,1,2,3,5;5;2,9;2;1;1
252960033400;252960033405;5;0,1,2,3,5;5;2,9;2;1;1
252960033405;252960033451;46;0,1,2,3,5;5;2,9;2;1;1
252960033451;252960033475;24;0,1,2,3,5;5;2,9;2;1;1
252960033475;252960033495;20;0,1,2,3,5;5;2,9;2;1;1
252960033495;252960033514;19;0,1,2,3,5;5;2,9;2;1;1
252960033514;252960033534;20;0,1,2,3,5;5;2,9;2;1;1
252960033534;252960033560;26;0,1,2,3,5;5;2,9;2;1;1
252960033560;252960033562;2;0,1,2,3,5;5;2,9;2;1;1
252960033562;252960033591;29;0,1,2,3,5;5;2,9;2;1;1
252960033591;252960033612;21;0,1,2,3,5;5;2,9;2;1;1
252960033612;252960033691;79;0,1,2,3,5;5;2,9;2;1;1
252960033691;252960033693;2;0,1,2,3,5;5;2,9;2;1;1
252960033693;252960033740;47;0,1,2,3,5;5;2,9;2;1;1
252960033740;252960033769;29;0,1,2,3,5;5;2,9;2;1;1
252960033769;252960033770;1;0,1,2,3,5;5;2,9;2;1;1
252960033770;252960033783;13;0,1,2,3,5;5;2,9;2;1;1
252960033783;252960033798;15;0,1,2,3,5;5;2,9;2;1;1
252960033798;252960033811;13;0,1,2,3,5;5;2,9;2;1;1
252960033811;252960033830;19;0,1,2,3,5;5;2,9;2;1;1
252960033830;252960033840;10;0,1,2,3,5;5;2,9;2;1;1
252960033840;252960033858;18;0,1,2,3,5;5;2,9;2;1;1
252960033858;252960033872;14;0,1,2,3,5;5;2,9;2;1;1
252960033872;252960033878;6;0,1,2,3,5;5;2,9;2;1;1
252960033878;252960033879;1;0,1,2,3,5;5;2,9;2;1;1
252960033879;252960033884;5;0,1,2,3,5;5;2,9;2;1;1
252960033884;252960033896;12;0,1,2,3,5;5;2,9;2;1;1
252960033896;252960033900;4;0,1,2,3,5;5;2,9;2;1;1
252960033900;252960033903;3;0,1,2,3,5;5;2,9;2;1;1
252960033903;252960033906;3;0,1,2,3,5;5;2,9;2;1;1
252960033906;252960033907;1;0,1,2,3,5;5;2,9;2;1;1
252960033907;252960033910;3;0,1,2,3,5;5;2,9;2;1;1
252960033910;252960033914;4;0,1,2,3,5;5;2,9;2;1;1
252960033914;252960033923;9;0,1,2,3,5;5;2,9;2;1;1
252960033923;252960033926;3;0,1,2,3,5;5;2,9;2;1;1
252960033926;252960033942;16;0,1,2,3,5;5;2,9;2;1;1
252960033942;252960033945;3;0,1,2,3,5;5;2,9;2;1;1
252960033945;252960033956;11;0,1,2,3,5;5;2,9;2;1;1
252960033956;252960033972;16;0,1,2,3,5;5;2,9;2;1;1
252960033972;252960033973;1;0,1,2,3,5;5;2,9;2;1;1
252960033973;252960033974;1;0,1,2,3,5;5;2,9;2;1;1
252960033974;252960034011;37;0,1,2,3,5;5;2,9;2;1;1
252960034011;252960034013;2;0,1,2,3,5;5;2,9;2;1;1
252960034013;252960034016;3;0,1,2,3,5;5;2,9;2;1;1
252960034016;252960034035;19;0,1,2,3,5;5;2,9;2;1;1
252960034035;252960034052;17;0,1,2,3,5;5;2,9;2;1;1
252960034052;252960034063;11;0,1,2,3,5;5;2,9;2;1;1
252960034063;252960034068;5;0,1,2,3,5;5;2,9;2;1;1
252960034068;252960034077;9;0,1,2,3,5;5;2,9;2;1;1
252960034077;252960034082;5;0,1,2,3,5;5;2,9;2;1;1
252960034082;252960034083;1;0,1,2,3,5;5;2,9;2;1;1
252960034083;252960034084;1;0,1,2,3,5;5;2,9;2;1;1
252960034084;252960034093;9;0,1,2,3,5;5;2,9;2;1;1
252960034093;252960034133;40;0,1,2,3,5;5;2,9;2;1;1
252960034133;252960034140;7;0,1,2,3,5;5;2,9;2;1;1
252960034140;252960034147;7;0,1,2,3,5;5;2,9;2;1;1
252960034147;252960034156;9;0,1,2,3,5;5;2,9;2;1;1
252960034156;252960034163;7;0,1,2,3,5;5;2,9;2;1;1
252960034163;252960034164;1;0,1,2,3,5;5;2,9;2;1;1
252960034164;252960034171;7;0,1,2,3,5;5;2,9;2;1;1
252960034171;252960034175;4;0,1,2,3,5;5;2,9;2;1;1
252960034175;252960034176;1;0,1,2,3,5;5;2,9;2;1;1
252960034176;252960034178;2;0,1,2,3,5;5;2,9;2;1;1
252960034178;252960034194;16;0,1,2,3,5;5;2,9;2;1;1
252960034194;252960034199;5;0,1,2,3,5;5;2,9;2;1;1
252960034199;252960034200;1;0,1,2,3,5;5;2,9;2;1;1
252960034200;252960034205;5;0,1,2,3,5;5;2,9;2;1;1
252960034205;252960034215;10;0,1,2,3,5;5;2,9;2;1;1
252960034215;252960034226;11;0,1,2,3,5;5;2,9;2;1;1
252960034226;252960034231;5;0,1,2,3,5;5;2,9;2;1;1
252960034231;252960034239;8;0,1,2,3,5;5;2,9;2;1;1
252960034239;252960034241;2;0,1,2,3,5;5;2,9;2;1;1
252960034241;252960034263;22;0,1,2,3,5;5;2,9;2;1;1
252960034263;252960034268;5;0,1,2,3,5;5;2,9;2;1;1
252960034268;252960034277;9;0,1,2,3,5;5;2,9;2;1;1
252960034277;252960034285;8;0,1,2,3,5;5;2,9;2;1;1
252960034285;252960034290;5;0,1,2,3,5;5;2,9;2;1;1
252960034290;252960034308;18;0,1,2,3,5;5;2,9;2;1;1
252960034308;252960034312;4;0,1,2,3,5;5;2,9;2;1;1
252960034312;252960034314;2;0,1,2,3,5;5;2,9;2;1;1
252960034314;252960034327;13;0,1,2,3,5;5;2,9;2;1;1
252960034327;252960034351;24;0,1,2,3,5;5;2,9;2;1;1
252960034351;252960034363;12;0,1,2,3,5;5;2,9;2;1;1
252960034363;252960034372;9;0,1,2,3,5;5;2,9;2;1;1
252960034372;252960034401;29;0,1,2,3,5;5;2,9;2;1;1
252960034401;252960034413;12;0,1,2,3,5;5;2,9;2;1;1
252960034413;252960034424;11;0,1,2,3,5;5;2,9;2;1;1
252960034424;252960034431;7;0,1,2,3,5;5;2,9;2;1;1
252960034431;252960034484;53;0,1,2,3,5;5;2,9;2;1;1
252960034484;252960034491;7;0,1,2,3,5;5;2,9;2;1;1
252960034491;252960034509;18;0,1,2,3,5;5;2,9;2;1;1
252960034509;252960034542;33;0,1,2,3,5;5;2,9;2;1;1
252960034542;252960034547;5;0,1,2,3,5;5;2,9;2;1;1
252960034547;252960034556;9;0,1,2,3,5;5;2,9;2;1;1
252960034556;252960034581;25;0,1,2,3,5;5;2,9;2;1;1
252960034581;252960034584;3;0,1,2,3,5;5;2,9;2;1;1
252960034584;252960034592;8;0,1,2,3,5;5;2,9;2;1;1
252960034592;252960034624;32;0,1,2,3,5;5;2,9;2;1;1
252960034624;252960034625;1;0,1,2,3,5;5;2,9;2;1;1
252960034625;252960034628;3;0,1,2,3,5;5;2,9;2;1;1
252960034628;252960034631;3;0,1,2,3,5;5;2,9;2;1;1
252960034631;252960034671;40;0,1,2,3,5;5;2,9;2;1;1
252960034671;252960034695;24;0,1,2,3,5;5;2,9;2;1;1
252960034695;252960034697;2;0,1,2,3,5;5;2,9;2;1;1
252960034697;252960034698;1;0,1,2,3,5;5;2,9;2;1;1
252960034698;252960034724;26;0,1,2,3,5;5;2,9;2;1;1
252960034724;252960034742;18;0,1,2,3,5;5;2,9;2;1;1
252960034742;252960034754;12;0,1,2,3,5;5;2,9;2;1;1
252960034754;252960034761;7;0,1,2,3,5;5;2,9;2;1;1
252960034761;252960034767;6;0,1,2,3,5;5;2,9;2;1;1
252960034767;252960034771;4;0,1,2,3,5;5;2,9;2;1;1
252960034771;252960034781;10;0,1,2,3,5;5;2,9;2;1;1
252960034781;252960034782;1;0,1,2,3,5;5;2,9;2;1;1
252960034782;252960034796;14;0,1,2,3,5;5;2,9;2;1;1
252960034796;252960034805;9;0,1,2,3,5;5;2,9;2;1;1
252960034805;252960034808;3;0,1,2,3,5;5;2,9;2;1;1
252960034808;252960034824;16;0,1,2,3,5;5;2,9;2;1;1
252960034824;252960034835;11;0,1,2,3,5;5;2,9;2;1;1
252960034835;252960034860;25;0,1,2,3,5;5;2,9;2;1;1
252960034860;252960034904;44;0,1,2,3,5;5;2,9;2;1;1
252960034904;252960034905;1;0,1,2,3,5;5;2,9;2;1;1
252960034905;252960034937;32;0,1,2,3,5;5;2,9;2;1;1
252960034937;252960034962;25;0,1,2,3,5;5;2,9;2;1;1
252960034962;252960034986;24;0,1,2,3,5;5;2,9;2;1;1
252960034986;252960035004;18;0,1,2,3,5;5;2,9;2;1;1
252960035004;252960035038;34;0,1,2,3,5;5;2,9;2;1;1
252960035038;252960035071;33;0,1,2,3,5;5;2,9;2;1;1
252960035071;252960035084;13;0,1,2,3,5;5;2,9;2;1;1
252960035084;252960035087;3;0,1,2,3,5;5;2,9;2;1;1
252960035087;252960035092;5;0,1,2,3,5;5;2,9;2;1;1
252960035092;252960035114;22;0,1,2,3,5;5;2,9;2;1;1
252960035114;252960035116;2;0,1,2,3,5;5;2,9;2;1;1
252960035116;252960035135;19;0,1,2,3,5;5;2,9;2;1;1
252960035135;252960035145;10;0,1,2,3,5;5;2,9;2;1;1
252960035145;252960035176;31;0,1,2,3,5;5;2,9;2;1;1
252960035176;252960035178;2;0,1,2,3,5;5;2,9;2;1;1
252960035178;252960035184;6;0,1,2,3,5;5;2,9;2;1;1
252960035184;252960035196;12;0,1,2,3,5;5;2,9;2;1;1
252960035196;252960035223;27;0,1,2,3,5;5;2,9;2;1;1
252960035223;252960035230;7;0,1,2,3,5;5;2,9;2;1;1
252960035230;252960035233;3;0,1,2,3,5;5;2,9;2;1;1
252960035233;252960035239;6;0,1,2,3,5;5;2,9;2;1;1
252960035239;252960035248;9;0,1,2,3,5;5;2,9;2;1;1
252960035248;252960035265;17;0,1,2,3,5;5;2,9;2;1;1
252960035265;252960035266;1;0,1,2,3,5;5;2,9;2;1;1
252960035266;252960035269;3;0,1,2,3,5;5;2,9;2;1;1
252960035269;252960035279;10;0,1,2,3,5;5;2,9;2;1;1
252960035279;252960035285;6;0,1,2,3,5;5;2,9;2;1;1
252960035285;252960035291;6;0,1,2,3,5;5;2,9;2;1;1
252960035291;252960035297;6;0,1,2,3,5;5;2,9;2;1;1
252960035297;252960035308;11;0,1,2,3,5;5;2,9;2;1;1
252960035308;252960035310;2;0,1,2,3,5;5;2,9;2;1;1
252960035310;252960035313;3;0,1,2,3,5;5;2,9;2;1;1
252960035313;252960035332;19;0,1,2,3,5;5;2,9;2;1;1
252960035332;252960035339;7;0,1,2,3,5;5;2,9;2;1;1
252960035339;252960035345;6;0,1,2,3,5;5;2,9;2;1;1
252960035345;252960035350;5;0,1,2,3,5;5;2,9;2;1;1
252960035350;252960035351;1;0,1,2,3,5;5;2,9;2;1;1
252960035351;252960035368;17;0,1,2,3,5;5;2,9;2;1;1
252960035368;252960035372;4;0,1,2,3,5;5;2,9;2;1;1
252960035372;252960035374;2;0,1,2,3,5;5;2,9;2;1;1
252960035374;252960035399;25;0,1,2,3,5;5;2,9;2;1;1
252960035399;252960035408;9;0,1,2,3,5;5;2,9;2;1;1
252960035408;252960035425;17;0,1,2,3,5;5;2,9;2;1;1
252960035425;252960035426;1;0,1,2,3,5;5;2,9;2;1;1
252960035426;252960035432;6;0,1,2,3,5;5;2,9;2;1;1
252960035432;252960035463;31;0,1,2,3,5;5;2,9;2;1;1
252960035463;252960035465;2;0,1,2,3,5;5;2,9;2;1;1
252960035465;252960035468;3;0,1,2,3,5;5;2,9;2;1;1
252960035468;252960035472;4;0,1,2,3,5;5;2,9;2;1;1
252960035472;252960035486;14;0,1,2,3,5;5;2,9;2;1;1
252960035486;252960035487;1;0,1,2,3,5;5;2,9;2;1;1
252960035487;252960035512;25;0,1,2,3,5;5;2,9;2;1;1
252960035512;252960035558;46;0,1,2,3,5;5;2,9;2;1;1
252960035558;252960035577;19;0,1,2,3,5;5;2,9;2;1;1
252960035577;252960035587;10;0,1,2,3,5;5;2,9;2;1;1
252960035587;252960035620;33;0,1,2,3,5;5;2,9;2;1;1
252960035620;252960035624;4;0,1,2,3,5;5;2,9;2;1;1
252960035624;252960035636;12;0,1,2,3,5;5;2,9;2;1;1
252960035636;252960035650;14;0,1,2,3,5;5;2,9;2;1;1
252960035650;252960035667;17;0,1,2,3,5;5;2,9;2;1;1
252960035667;252960035673;6;0,1,2,3,5;5;2,9;2;1;1
252960035673;252960035675;2;0,1,2,3,5;5;2,9;2;1;1
252960035675;252960035686;11;0,1,2,3,5;5;2,9;2;1;1
252960035686;252960035688;2;0,1,2,3,5;5;2,9;2;1;1
252960035688;252960035691;3;0,1,2,3,5;5;2,9;2;1;1
252960035691;252960035692;1;0,1,2,3,5;5;2,9;2;1;1
252960035692;252960035698;6;0,1,2,3,5;5;2,9;2;1;1
252960035698;252960035702;4;0,1,2,3,5;5;2,9;2;1;1
252960035702;252960035711;9;0,1,2,3,5;5;2,9;2;1;1
252960035711;252960035714;3;0,1,2,3,5;5;2,9;2;1;1
252960035714;252960035716;2;0,1,2,3,5;5;2,9;2;1;1
252960035716;252960035741;25;0,1,2,3,5;5;2,9;2;1;1
252960035741;252960035743;2;0,1,2,3,5;5;2,9;2;1;1
252960035743;252960035745;2;0,1,2,3,5;5;2,9;2;1;1
252960035745;252960035766;21;0,1,2,3,5;5;2,9;2;1;1
252960035766;252960035772;6;0,1,2,3,5;5;2,9;2;1;1
252960035772;252960035775;3;0,1,2,3,5;5;2,9;2;1;1
252960035775;252960035793;18;0,1,2,3,5;5;2,9;2;1;1
252960035793;252960035831;38;0,1,2,3,5;5;2,9;2;1;1
252960035831;252960035848;17;0,1,2,3,5;5;2,9;2;1;1
252960035848;252960035860;12;0,1,2,3,5;5;2,9;2;1;1
252960035860;252960035864;4;0,1,2,3,5;5;2,9;2;1;1
252960035864;252960035877;13;0,1,2,3,5;5;2,9;2;1;1
252960035877;252960035883;6;0,1,2,3,5;5;2,9;2;1;1
252960035883;252960035889;6;0,1,2,3,5;5;2,9;2;1;1
252960035889;252960035896;7;0,1,2,3,5;5;2,9;2;1;1
252960035896;252960035897;1;0,1,2,3,5;5;2,9;2;1;1
252960035897;252960035902;5;0,1,2,3,5;5;2,9;2;1;1
252960035902;252960035904;2;0,1,2,3,5;5;2,9;2;1;1
252960035904;252960035914;10;0,1,2,3,5;5;2,9;2;1;1
252960035914;252960035916;2;0,1,2,3,5;5;2,9;2;1;1
252960035916;252960035923;7;0,1,2,3,5;5;2,9;2;1;1
252960035923;252960035925;2;0,1,2,3,5;5;2,9;2;1;1
252960035925;252960035927;2;0,1,2,3,5;5;2,9;2;1;1
252960035927;252960035934;7;0,1,2,3,5;5;2,9;2;1;1
252960035934;252960035952;18;0,1,2,3,5;5;2,9;2;1;1
252960035952;252960035967;15;0,1,2,3,5;5;2,9;2;1;1
252960035967;252960035975;8;0,1,2,3,5;5;2,9;2;1;1
252960035975;252960035982;7;0,1,2,3,5;5;2,9;2;1;1
252960035982;252960036016;34;0,1,2,3,5;5;2,9;2;1;1
252960036016;252960036021;5;0,1,2,3,5;5;2,9;2;1;1
252960036021;252960036025;4;0,1,2,3,5;5;2,9;2;1;1
252960036025;252960036026;1;0,1,2,3,5;5;2,9;2;1;1
252960036026;252960036032;6;0,1,2,3,5;5;2,9;2;1;1
252960036032;252960036052;20;0,1,2,3,5;5;2,9;2;1;1
252960036052;252960036054;2;0,1,2,3,5;5;2,9;2;1;1
252960036054;252960036062;8;0,1,2,3,5;5;2,9;2;1;1
252960036062;252960036075;13;0,1,2,3,5;5;2,9;2;1;1
252960036075;252960036082;7;0,1,2,3,5;5;2,9;2;1;1
252960036082;252960036084;2;0,1,2,3,5;5;2,9;2;1;1
252960036084;252960036092;8;0,1,2,3,5;5;2,9;2;1;1
252960036092;252960036103;11;0,1,2,3,5;5;2,9;2;1;1
252960036103;252960036106;3;0,1,2,3,5;5;2,9;2;1;1
252960036106;252960036112;6;0,1,2,3,5;5;2,9;2;1;1
252960036112;252960036121;9;0,1,2,3,5;5;2,9;2;1;1
252960036121;252960036129;8;0,1,2,3,5;5;2,9;2;1;1
252960036129;252960036131;2;0,1,2,3,5;5;2,9;2;1;1
252960036131;252960036132;1;0,1,2,3,5;5;2,9;2;1;1
252960036132;252960036138;6;0,1,2,3,5;5;2,9;2;1;1
252960036138;252960036148;10;0,1,2,3,5;5;2,9;2;1;1
252960036148;252960036171;23;0,1,2,3,5;5;2,9;2;1;1
252960036171;252960036174;3;0,1,2,3,5;5;2,9;2;1;1
252960036174;252960036190;16;0,1,2,3,5;5;2,9;2;1;1
252960036190;252960036195;5;0,1,2,3,5;5;2,9;2;1;1
252960036195;252960036200;5;0,1,2,3,5;5;2,9;2;1;1
252960036200;252960036217;17;0,1,2,3,5;5;2,9;2;1;1
252960036217;252960036234;17;0,1,2,3,5;5;2,9;2;1;1
252960036234;252960036235;1;0,1,2,3,5;5;2,9;2;1;1
252960036235;252960036242;7;0,1,2,3,5;5;2,9;2;1;1
252960036242;252960036243;1;0,1,2,3,5;5;2,9;2;1;1
252960036243;252960036244;1;0,1,2,3,5;5;2,9;2;1;1
252960036244;252960036246;2;0,1,2,3,5;5;2,9;2;1;1
252960036246;252960036248;2;0,1,2,3,5;5;2,9;2;1;1
252960036248;252960036250;2;0,1,2,3,5;5;2,9;2;1;1
252960036250;252960036291;41;0,1,2,3,5;5;2,9;2;1;1
252960036291;252960036304;13;0,1,2,3,5;5;2,9;2;1;1
252960036304;252960036305;1;0,1,2,3,5;5;2,9;2;1;1
252960036305;252960036316;11;0,1,2,3,5;5;2,9;2;1;1
252960036316;252960036352;36;0,1,2,3,5;5;2,9;2;1;1
252960036352;252960036356;4;0,1,2,3,5;5;2,9;2;1;1
252960036356;252960036367;11;0,1,2,3,5;5;2,9;2;1;1
252960036367;252960036396;29;0,1,2,3,5;5;2,9;2;1;1
252960036396;252960036418;22;0,1,2,3,5;5;2,9;2;1;1
252960036418;252960036441;23;0,1,2,3,5;5;2,9;2;1;1
252960036441;252960036500;59;0,1,2,3,5;5;2,9;2;1;1
252960036500;252960036507;7;0,1,2,3,5;5;2,9;2;1;1
252960036507;252960036521;14;0,1,2,3,5;5;2,9;2;1;1
252960036521;252960036523;2;0,1,2,3,5;5;2,9;2;1;1
252960036523;252960036534;11;0,1,2,3,5;5;2,9;2;1;1
252960036534;252960036567;33;0,1,2,3,5;5;2,9;2;1;1
252960036567;252960036611;44;0,1,2,3,5;5;2,9;2;1;1
252960036611;252960036649;38;0,1,2,3,5;5;2,9;2;1;1
252960036649;252960036675;26;0,1,2,3,5;5;2,9;2;1;1
252960036675;252960036690;15;0,1,2,3,5;5;2,9;2;1;1
252960036690;252960036722;32;0,1,2,3,5;5;2,9;2;1;1
252960036722;252960036737;15;0,1,2,3,5;5;2,9;2;1;1
252960036737;252960036771;34;0,1,2,3,5;5;2,9;2;1;1
252960036771;252960036808;37;0,1,2,3,5;5;2,9;2;1;1
252960036808;252960036826;18;0,1,2,3,5;5;2,9;2;1;1
252960036826;252960036835;9;0,1,2,3,5;5;2,9;2;1;1
252960036835;252960036863;28;0,1,2,3,5;5;2,9;2;1;1
252960036863;252960036885;22;0,1,2,3,5;5;2,9;2;1;1
252960036885;252960036927;42;0,1,2,3,5;5;2,9;2;1;1
252960036927;252960036943;16;0,1,2,3,5;5;2,9;2;1;1
252960036943;252960036986;43;0,1,2,3,5;5;2,9;2;1;1
252960036986;252960037012;26;0,1,2,3,5;5;2,9;2;1;1
252960037012;252960037021;9;0,1,2,3,5;5;2,9;2;1;1
252960037021;252960037031;10;0,1,2,3,5;5;2,9;2;1;1
252960037031;252960037066;35;0,1,2,3,5;5;2,9;2;1;1
252960037066;252960037081;15;0,1,2,3,5;5;2,9;2;1;1
252960037081;252960037086;5;0,1,2,3,5;5;2,9;2;1;1
252960037086;252960037089;3;0,1,2,3,5;5;2,9;2;1;1
252960037089;252960037123;34;0,1,2,3,5;5;2,9;2;1;1
252960037123;252960037140;17;0,1,2,3,5;5;2,9;2;1;1
252960037140;252960037144;4;0,1,2,3,5;5;2,9;2;1;1
252960037144;252960037149;5;0,1,2,3,5;5;2,9;2;1;1
252960037149;252960037153;4;0,1,2,3,5;5;2,9;2;1;1
252960037153;252960037192;39;0,1,2,3,5;5;2,9;2;1;1
252960037192;252960037193;1;0,1,2,3,5;5;2,9;2;1;1
252960037193;252960037213;20;0,1,2,3,5;5;2,9;2;1;1
252960037213;252960037232;19;0,1,2,3,5;5;2,9;2;1;1
252960037232;252960037234;2;0,1,2,3,5;5;2,9;2;1;1
252960037234;252960037237;3;0,1,2,3,5;5;2,9;2;1;1
252960037237;252960037249;12;0,1,2,3,5;5;2,9;2;1;1
252960037249;252960037280;31;0,1,2,3,5;5;2,9;2;1;1
252960037280;252960037295;15;0,1,2,3,5;5;2,9;2;1;1
252960037295;252960037296;1;0,1,2,3,5;5;2,9;2;1;1
252960037296;252960037304;8;0,1,2,3,5;5;2,9;2;1;1
252960037304;252960037330;26;0,1,2,3,5;5;2,9;2;1;1
252960037330;252960037334;4;0,1,2,3,5;5;2,9;2;1;1
252960037334;252960037336;2;0,1,2,3,5;5;2,9;2;1;1
252960037336;252960037337;1;0,1,2,3,5;5;2,9;2;1;1
252960037337;252960037344;7;0,1,2,3,5;5;2,9;2;1;1
252960037344;252960037345;1;0,1,2,3,5;5;2,9;2;1;1
252960037345;252960037374;29;0,1,2,3,5;5;2,9;2;1;1
252960037374;252960037384;10;0,1,2,3,5;5;2,9;2;1;1
252960037384;252960037396;12;0,1,2,3,5;5;2,9;2;1;1
252960037396;252960037406;10;0,1,2,3,5;5;2,9;2;1;1
252960037406;252960037413;7;0,1,2,3,5;5;2,9;2;1;1
252960037413;252960037486;73;0,1,2,3,5;5;2,9;2;1;1
252960037486;252960037517;31;0,1,2,3,5;5;2,9;2;1;1
252960037517;252960037535;18;0,1,2,3,5;5;2,9;2;1;1
252960037535;252960037565;30;0,1,2,3,5;5;2,9;2;1;1
252960037565;252960037626;61;0,1,2,3,5;5;2,9;2;1;1
252960037626;252960037670;44;0,1,2,3,5;5;2,9;2;1;1
252960037670;252960037696;26;0,1,2,3,5;5;2,9;2;1;1
252960037696;252960037716;20;0,1,2,3,5;5;2,9;2;1;1
252960037716;252960037750;34;0,1,2,3,5;5;2,9;2;1;1
252960037750;252960037800;50;0,1,2,3,5;5;2,9;2;1;1
252960037800;252960037818;18;0,1,2,3,5;5;2,9;2;1;1
252960037818;252960037860;42;0,1,2,3,5;5;2,9;2;1;1
252960037860;252960037957;97;0,1,2,3,5;5;2,9;2;1;1
252960037957;252960037977;20;0,1,2,3,5;5;2,9;2;1;1
252960037977;252960038068;91;0,1,2,3,5;5;2,9;2;1;1
252960038068;252960038092;24;0,1,2,3,5;5;2,9;2;1;1
252960038092;252960038157;65;0,1,2,3,5;5;2,9;2;1;1
252960038157;252960038174;17;0,1,2,3,5;5;2,9;2;1;1
252960038174;252960038207;33;0,1,2,3,5;5;2,9;2;1;1
252960038207;252960038209;2;0,1,2,3,5;5;2,9;2;1;1
252960038209;252960038213;4;0,1,2,3,5;5;2,9;2;1;1
252960038213;252960038217;4;0,1,2,3,5;5;2,9;2;1;1
252960038217;252960038244;27;0,1,2,3,5;5;2,9;2;1;1
252960038244;252960038247;3;0,1,2,3,5;5;2,9;2;1;1
252960038247;252960038278;31;0,1,2,3,5;5;2,9;2;1;1
252960038278;252960038285;7;0,1,2,3,5;5;2,9;2;1;1
252960038285;252960038311;26;0,1,2,3,5;5;2,9;2;1;1
252960038311;252960038320;9;0,1,2,3,5;5;2,9;2;1;1
252960038320;252960038330;10;0,1,2,3,5;5;2,9;2;1;1
252960038330;252960038358;28;0,1,2,3,5;5;2,9;2;1;1
252960038358;252960038379;21;0,1,2,3,5;5;2,9;2;1;1
252960038379;252960038417;38;0,1,2,3,5;5;2,9;2;1;1
252960038417;252960038450;33;0,1,2,3,5;5;2,9;2;1;1
252960038450;252960038492;42;0,1,2,3,5;5;2,9;2;1;1
252960038492;252960038499;7;0,1,2,3,5;5;2,9;2;1;1
252960038499;252960038555;56;0,1,2,3,5;5;2,9;2;1;1
252960038555;252960038566;11;0,1,2,3,5;5;2,9;2;1;1
252960038566;252960038587;21;0,1,2,3,5;5;2,9;2;1;1
252960038587;252960038625;38;0,1,2,3,5;5;2,9;2;1;1
252960038625;252960038637;12;0,1,2,3,5;5;2,9;2;1;1
252960038637;252960038717;80;0,1,2,3,5;5;2,9;2;1;1
252960038717;252960038721;4;0,1,2,3,5;5;2,9;2;1;1
252960038721;252960038764;43;0,1,2,3,5;5;2,9;2;1;1
252960038764;252960038781;17;0,1,2,3,5;5;2,9;2;1;1
252960038781;252960038815;34;0,1,2,3,5;5;2,9;2;1;1
252960038815;252960038845;30;0,1,2,3,5;5;2,9;2;1;1
252960038845;252960038866;21;0,1,2,3,5;5;2,9;2;1;1
252960038866;252960038878;12;0,1,2,3,5;5;2,9;2;1;1
252960038878;252960038883;5;0,1,2,3,5;5;2,9;2;1;1
252960038883;252960038889;6;0,1,2,3,5;5;2,9;2;1;1
252960038889;252960038905;16;0,1,2,3,5;5;2,9;2;1;1
252960038905;252960038913;8;0,1,2,3,5;5;2,9;2;1;1
252960038913;252960038915;2;0,1,2,3,5;5;2,9;2;1;1
252960038915;252960038926;11;0,1,2,3,5;5;2,9;2;1;1
252960038926;252960038930;4;0,1,2,3,5;5;2,9;2;1;1
252960038930;252960038948;18;0,1,2,3,5;5;2,9;2;1;1
252960038948;252960038960;12;0,1,2,3,5;5;2,9;2;1;1
252960038960;252960038981;21;0,1,2,3,5;5;2,9;2;1;1
252960038981;252960039026;45;0,1,2,3,5;5;2,9;2;1;1
252960039026;252960039035;9;0,1,2,3,5;5;2,9;2;1;1
252960039035;252960039069;34;0,1,2,3,5;5;2,9;2;1;1
252960039069;252960039092;23;0,1,2,3,5;5;2,9;2;1;1
252960039092;252960039097;5;0,1,2,3,5;5;2,9;2;1;1
252960039097;252960039114;17;0,1,2,3,5;5;2,9;2;1;1
252960039114;252960039139;25;0,1,2,3,5;5;2,9;2;1;1
252960039139;252960039195;56;0,1,2,3,5;5;2,9;2;1;1
252960039195;252960039214;19;0,1,2,3,5;5;2,9;2;1;1
252960039214;252960039224;10;0,1,2,3,5;5;2,9;2;1;1
252960039224;252960039249;25;0,1,2,3,5;5;2,9;2;1;1
252960039249;252960039260;11;0,1,2,3,5;5;2,9;2;1;1
252960039260;252960039269;9;0,1,2,3,5;5;2,9;2;1;1
252960039269;252960039296;27;0,1,2,3,5;5;2,9;2;1;1
252960039296;252960039323;27;0,1,2,3,5;5;2,9;2;1;1
252960039323;252960039347;24;0,1,2,3,5;5;2,9;2;1;1
252960039347;252960039423;76;0,1,2,3,5;5;2,9;2;1;1
252960039423;252960039461;38;0,1,2,3,5;5;2,9;2;1;1
252960039461;252960039488;27;0,1,2,3,5;5;2,9;2;1;1
252960039488;252960039551;63;0,1,2,3,5;5;2,9;2;1;1
252960039551;252960039553;2;0,1,2,3,5;5;2,9;2;1;1
252960039553;252960039723;170;0,1,2,3,5;5;2,9;2;1;1
252960039723;252960039793;70;0,1,2,3,5;5;2,9;2;1;1
252960039793;252960039926;133;0,1,2,3,5;5;2,9;2;1;1
252960039926;252960039957;31;0,1,2,3,5;5;2,9;2;1;1
252960039957;252960050754;10797;0,1,2,3,5;5;2,9;2;1;1
252960050754;252960050762;8;0,1,2,3,5;5;2,9;2;1;1
252960050762;252960050769;7;0,1,2,3,5;5;2,9;2;1;1
252960050769;252960050819;50;0,1,2,3,5;5;2,9;2;1;1
252960050819;252960050845;26;0,1,2,3,5;5;2,9;2;1;1
252960050845;252960050894;49;0,1,2,3,5;5;2,9;2;1;1
252960050894;252960050903;9;0,1,2,3,5;5;2,9;2;1;1
252960050903;252960050918;15;0,1,2,3,5;5;2,9;2;1;1
252960050918;252960050989;71;0,1,2,3,5;5;2,9;2;1;1
252960050989;252960051011;22;0,1,2,3,5;5;2,9;2;1;1
252960051011;252960051014;3;0,1,2,3,5;5;2,9;2;1;1
252960051014;252960051056;42;0,1,2,3,5;5;2,9;2;1;1
252960051056;252960051077;21;0,1,2,3,5;5;2,9;2;1;1
252960051077;252960051080;3;0,1,2,3,5;5;2,9;2;1;1
252960051080;252960051082;2;0,1,2,3,5;5;2,9;2;1;1
252960051082;252960051145;63;0,1,2,3,5;5;2,9;2;1;1
252960051145;252960051166;21;0,1,2,3,5;5;2,9;2;1;1
252960051166;252960051175;9;0,1,2,3,5;5;2,9;2;1;1
252960051175;252960051180;5;0,1,2,3,5;5;2,9;2;1;1
252960051180;252960051211;31;0,1,2,3,5;5;2,9;2;1;1
252960051211;252960051254;43;0,1,2,3,5;5;2,9;2;1;1
252960051254;252960051257;3;0,1,2,3,5;5;2,9;2;1;1
252960051257;252960051300;43;0,1,2,3,5;5;2,9;2;1;1
252960051300;252960051302;2;0,1,2,3,5;5;2,9;2;1;1
252960051302;252960051318;16;0,1,2,3,5;5;2,9;2;1;1
252960051318;252960051337;19;0,1,2,3,5;5;2,9;2;1;1
252960051337;252960051448;111;0,1,2,3,5;5;2,9;2;1;1
252960051448;252960051456;8;0,1,2,3,5;5;2,9;2;1;1
252960051456;252960051474;18;0,1,2,3,5;5;2,9;2;1;1
252960051474;252960051495;21;0,1,2,3,5;5;2,9;2;1;1
252960051495;252960051521;26;0,1,2,3,5;5;2,9;2;1;1
252960051521;252960051555;34;0,1,2,3,5;5;2,9;2;1;1
252960051555;252960051564;9;0,1,2,3,5;5;2,9;2;1;1
252960051564;252960051594;30;0,1,2,3,5;5;2,9;2;1;1
252960051594;252960051608;14;0,1,2,3,5;5;2,9;2;1;1
252960051608;252960051658;50;0,1,2,3,5;5;2,9;2;1;1
252960051658;252960051664;6;0,1,2,3,5;5;2,9;2;1;1
252960051664;252960051691;27;0,1,2,3,5;5;2,9;2;1;1
252960051691;252960051702;11;0,1,2,3,5;5;2,9;2;1;1
252960051702;252960051715;13;0,1,2,3,5;5;2,9;2;1;1
252960051715;252960051720;5;0,1,2,3,5;5;2,9;2;1;1
252960051720;252960051729;9;0,1,2,3,5;5;2,9;2;1;1
252960051729;252960051745;16;0,1,2,3,5;5;2,9;2;1;1
252960051745;252960051775;30;0,1,2,3,5;5;2,9;2;1;1
252960051775;252960051776;1;0,1,2,3,5;5;2,9;2;1;1
252960051776;252960051782;6;0,1,2,3,5;5;2,9;2;1;1
252960051782;252960051789;7;0,1,2,3,5;5;2,9;2;1;1
252960051789;252960051792;3;0,1,2,3,5;5;2,9;2;1;1
252960051792;252960051816;24;0,1,2,3,5;5;2,9;2;1;1
252960051816;252960051828;12;0,1,2,3,5;5;2,9;2;1;1
252960051828;252960051831;3;0,1,2,3,5;5;2,9;2;1;1
252960051831;252960051853;22;0,1,2,3,5;5;2,9;2;1;1
252960051853;252960051878;25;0,1,2,3,5;5;2,9;2;1;1
252960051878;252960051890;12;0,1,2,3,5;5;2,9;2;1;1
252960051890;252960051951;61;0,1,2,3,5;5;2,9;2;1;1
252960051951;252960051964;13;0,1,2,3,5;5;2,9;2;1;1
252960051964;252960051984;20;0,1,2,3,5;5;2,9;2;1;1
252960051984;252960052002;18;0,1,2,3,5;5;2,9;2;1;1
252960052002;252960052032;30;0,1,2,3,5;5;2,9;2;1;1
252960052032;252960052050;18;0,1,2,3,5;5;2,9;2;1;1
252960052050;252960052051;1;0,1,2,3,5;5;2,9;2;1;1
252960052051;252960052052;1;0,1,2,3,5;5;2,9;2;1;1
252960052052;252960052053;1;0,1,2,3,5;5;2,9;2;1;1
252960052053;252960052058;5;0,1,2,3,5;5;2,9;2;1;1
252960052058;252960052072;14;0,1,2,3,5;5;2,9;2;1;1
252960052072;252960052089;17;0,1,2,3,5;5;2,9;2;1;1
252960052089;252960052119;30;0,1,2,3,5;5;2,9;2;1;1
252960052119;252960052132;13;0,1,2,3,5;5;2,9;2;1;1
252960052132;252960052134;2;0,1,2,3,5;5;2,9;2;1;1
252960052134;252960052135;1;0,1,2,3,5;5;2,9;2;1;1
252960052135;252960052146;11;0,1,2,3,5;5;2,9;2;1;1
252960052146;252960052180;34;0,1,2,3,5;5;2,9;2;1;1
252960052180;252960052204;24;0,1,2,3,5;5;2,9;2;1;1
252960052204;252960052208;4;0,1,2,3,5;5;2,9;2;1;1
252960052208;252960052227;19;0,1,2,3,5;5;2,9;2;1;1
252960052227;252960052232;5;0,1,2,3,5;5;2,9;2;1;1
252960052232;252960052262;30;0,1,2,3,5;5;2,9;2;1;1
252960052262;252960052270;8;0,1,2,3,5;5;2,9;2;1;1
252960052270;252960052282;12;0,1,2,3,5;5;2,9;2;1;1
252960052282;252960052303;21;0,1,2,3,5;5;2,9;2;1;1
252960052303;252960052338;35;0,1,2,3,5;5;2,9;2;1;1
252960052338;252960052348;10;0,1,2,3,5;5;2,9;2;1;1
252960052348;252960052352;4;0,1,2,3,5;5;2,9;2;1;1
252960052352;252960052441;89;0,1,2,3,5;5;2,9;2;1;1
252960052441;252960052462;21;0,1,2,3,5;5;2,9;2;1;1
252960052462;252960052474;12;0,1,2,3,5;5;2,9;2;1;1
252960052474;252960052496;22;0,1,2,3,5;5;2,9;2;1;1
252960052496;252960052501;5;0,1,2,3,5;5;2,9;2;1;1
252960052501;252960052511;10;0,1,2,3,5;5;2,9;2;1;1
252960052511;252960052513;2;0,1,2,3,5;5;2,9;2;1;1
252960052513;252960052523;10;0,1,2,3,5;5;2,9;2;1;1
252960052523;252960052533;10;0,1,2,3,5;5;2,9;2;1;1
252960052533;252960052543;10;0,1,2,3,5;5;2,9;2;1;1
252960052543;252960052546;3;0,1,2,3,5;5;2,9;2;1;1
252960052546;252960052552;6;0,1,2,3,5;5;2,9;2;1;1
252960052552;252960052559;7;0,1,2,3,5;5;2,9;2;1;1
252960052559;252960052567;8;0,1,2,3,5;5;2,9;2;1;1
252960052567;252960052578;11;0,1,2,3,5;5;2,9;2;1;1
252960052578;252960052589;11;0,1,2,3,5;5;2,9;2;1;1
252960052589;252960052596;7;0,1,2,3,5;5;2,9;2;1;1
252960052596;252960052599;3;0,1,2,3,5;5;2,9;2;1;1
252960052599;252960052607;8;0,1,2,3,5;5;2,9;2;1;1
252960052607;252960052626;19;0,1,2,3,5;5;2,9;2;1;1
252960052626;252960052640;14;0,1,2,3,5;5;2,9;2;1;1
252960052640;252960052642;2;0,1,2,3,5;5;2,9;2;1;1
252960052642;252960052667;25;0,1,2,3,5;5;2,9;2;1;1
252960052667;252960052693;26;0,1,2,3,5;5;2,9;2;1;1
252960052693;252960052752;59;0,1,2,3,5;5;2,9;2;1;1
252960052752;252960052761;9;0,1,2,3,5;5;2,9;2;1;1
252960052761;252960052767;6;0,1,2,3,5;5;2,9;2;1;1
252960052767;252960052769;2;0,1,2,3,5;5;2,9;2;1;1
252960052769;252960052786;17;0,1,2,3,5;5;2,9;2;1;1
252960052786;252960052790;4;0,1,2,3,5;5;2,9;2;1;1
252960052790;252960052848;58;0,1,2,3,5;5;2,9;2;1;1
252960052848;252960052869;21;0,1,2,3,5;5;2,9;2;1;1
252960052869;252960052871;2;0,1,2,3,5;5;2,9;2;1;1
252960052871;252960052881;10;0,1,2,3,5;5;2,9;2;1;1
252960052881;252960052885;4;0,1,2,3,5;5;2,9;2;1;1
252960052885;252960052888;3;0,1,2,3,5;5;2,9;2;1;1
252960052888;252960052889;1;0,1,2,3,5;5;2,9;2;1;1
252960052889;252960052890;1;0,1,2,3,5;5;2,9;2;1;1
252960052890;252960052896;6;0,1,2,3,5;5;2,9;2;1;1
252960052896;252960052935;39;0,1,2,3,5;5;2,9;2;1;1
252960052935;252960052957;22;0,1,2,3,5;5;2,9;2;1;1
252960052957;252960052965;8;0,1,2,3,5;5;2,9;2;1;1
252960052965;252960052966;1;0,1,2,3,5;5;2,9;2;1;1
252960052966;252960052978;12;0,1,2,3,5;5;2,9;2;1;1
252960052978;252960053022;44;0,1,2,3,5;5;2,9;2;1;1
252960053022;252960053025;3;0,1,2,3,5;5;2,9;2;1;1
252960053025;252960053028;3;0,1,2,3,5;5;2,9;2;1;1
252960053028;252960053030;2;0,1,2,3,5;5;2,9;2;1;1
252960053030;252960053050;20;0,1,2,3,5;5;2,9;2;1;1
252960053050;252960053056;6;0,1,2,3,5;5;2,9;2;1;1
252960053056;252960053059;3;0,1,2,3,5;5;2,9;2;1;1
252960053059;252960053063;4;0,1,2,3,5;5;2,9;2;1;1
252960053063;252960053102;39;0,1,2,3,5;5;2,9;2;1;1
252960053102;252960053125;23;0,1,2,3,5;5;2,9;2;1;1
252960053125;252960053144;19;0,1,2,3,5;5;2,9;2;1;1
252960053144;252960053175;31;0,1,2,3,5;5;2,9;2;1;1
252960053175;252960053190;15;0,1,2,3,5;5;2,9;2;1;1
252960053190;252960053193;3;0,1,2,3,5;5;2,9;2;1;1
252960053193;252960053211;18;0,1,2,3,5;5;2,9;2;1;1
252960053211;252960053244;33;0,1,2,3,5;5;2,9;2;1;1
252960053244;252960053262;18;0,1,2,3,5;5;2,9;2;1;1
252960053262;252960053301;39;0,1,2,3,5;5;2,9;2;1;1
252960053301;252960053304;3;0,1,2,3,5;5;2,9;2;1;1
252960053304;252960053311;7;0,1,2,3,5;5;2,9;2;1;1
252960053311;252960053339;28;0,1,2,3,5;5;2,9;2;1;1
252960053339;252960053354;15;0,1,2,3,5;5;2,9;2;1;1
252960053354;252960053369;15;0,1,2,3,5;5;2,9;2;1;1
252960053369;252960053412;43;0,1,2,3,5;5;2,9;2;1;1
252960053412;252960053420;8;0,1,2,3,5;5;2,9;2;1;1
252960053420;252960053425;5;0,1,2,3,5;5;2,9;2;1;1
252960053425;252960053436;11;0,1,2,3,5;5;2,9;2;1;1
252960053436;252960053445;9;0,1,2,3,5;5;2,9;2;1;1
252960053445;252960053449;4;0,1,2,3,5;5;2,9;2;1;1
252960053449;252960053471;22;0,1,2,3,5;5;2,9;2;1;1
252960053471;252960053474;3;0,1,2,3,5;5;2,9;2;1;1
252960053474;252960053486;12;0,1,2,3,5;5;2,9;2;1;1
252960053486;252960053515;29;0,1,2,3,5;5;2,9;2;1;1
252960053515;252960053521;6;0,1,2,3,5;5;2,9;2;1;1
252960053521;252960053529;8;0,1,2,3,5;5;2,9;2;1;1
252960053529;252960053534;5;0,1,2,3,5;5;2,9;2;1;1
252960053534;252960053562;28;0,1,2,3,5;5;2,9;2;1;1
252960053562;252960053584;22;0,1,2,3,5;5;2,9;2;1;1
252960053584;252960053610;26;0,1,2,3,5;5;2,9;2;1;1
252960053610;252960053611;1;0,1,2,3,5;5;2,9;2;1;1
252960053611;252960053623;12;0,1,2,3,5;5;2,9;2;1;1
252960053623;252960053624;1;0,1,2,3,5;5;2,9;2;1;1
252960053624;252960053633;9;0,1,2,3,5;5;2,9;2;1;1
252960053633;252960053649;16;0,1,2,3,5;5;2,9;2;1;1
252960053649;252960053672;23;0,1,2,3,5;5;2,9;2;1;1
252960053672;252960053688;16;0,1,2,3,5;5;2,9;2;1;1
252960053688;252960053702;14;0,1,2,3,5;5;2,9;2;1;1
252960053702;252960053710;8;0,1,2,3,5;5;2,9;2;1;1
252960053710;252960053711;1;0,1,2,3,5;5;2,9;2;1;1
252960053711;252960053742;31;0,1,2,3,5;5;2,9;2;1;1
252960053742;252960053753;11;0,1,2,3,5;5;2,9;2;1;1
252960053753;252960053766;13;0,1,2,3,5;5;2,9;2;1;1
252960053766;252960053785;19;0,1,2,3,5;5;2,9;2;1;1
252960053785;252960053803;18;0,1,2,3,5;5;2,9;2;1;1
252960053803;252960053806;3;0,1,2,3,5;5;2,9;2;1;1
252960053806;252960053808;2;0,1,2,3,5;5;2,9;2;1;1
252960053808;252960053818;10;0,1,2,3,5;5;2,9;2;1;1
252960053818;252960053825;7;0,1,2,3,5;5;2,9;2;1;1
252960053825;252960053844;19;0,1,2,3,5;5;2,9;2;1;1
252960053844;252960053846;2;0,1,2,3,5;5;2,9;2;1;1
252960053846;252960053848;2;0,1,2,3,5;5;2,9;2;1;1
252960053848;252960053883;35;0,1,2,3,5;5;2,9;2;1;1
252960053883;252960053887;4;0,1,2,3,5;5;2,9;2;1;1
252960053887;252960053899;12;0,1,2,3,5;5;2,9;2;1;1
252960053899;252960053900;1;0,1,2,3,5;5;2,9;2;1;1
252960053900;252960053914;14;0,1,2,3,5;5;2,9;2;1;1
252960053914;252960053915;1;0,1,2,3,5;5;2,9;2;1;1
252960053915;252960053919;4;0,1,2,3,5;5;2,9;2;1;1
252960053919;252960053933;14;0,1,2,3,5;5;2,9;2;1;1
252960053933;252960053940;7;0,1,2,3,5;5;2,9;2;1;1
252960053940;252960053941;1;0,1,2,3,5;5;2,9;2;1;1
252960053941;252960053948;7;0,1,2,3,5;5;2,9;2;1;1
252960053948;252960053962;14;0,1,2,3,5;5;2,9;2;1;1
252960053962;252960053967;5;0,1,2,3,5;5;2,9;2;1;1
252960053967;252960053973;6;0,1,2,3,5;5;2,9;2;1;1
252960053973;252960053974;1;0,1,2,3,5;5;2,9;2;1;1
252960053974;252960053977;3;0,1,2,3,5;5;2,9;2;1;1
252960053977;252960053978;1;0,1,2,3,5;5;2,9;2;1;1
252960053978;252960053998;20;0,1,2,3,5;5;2,9;2;1;1
252960053998;252960054006;8;0,1,2,3,5;5;2,9;2;1;1
252960054006;252960054032;26;0,1,2,3,5;5;2,9;2;1;1
252960054032;252960054073;41;0,1,2,3,5;5;2,9;2;1;1
252960054073;252960054079;6;0,1,2,3,5;5;2,9;2;1;1
252960054079;252960054090;11;0,1,2,3,5;5;2,9;2;1;1
252960054090;252960054105;15;0,1,2,3,5;5;2,9;2;1;1
252960054105;252960054113;8;0,1,2,3,5;5;2,9;2;1;1
252960054113;252960054126;13;0,1,2,3,5;5;2,9;2;1;1
252960054126;252960054136;10;0,1,2,3,5;5;2,9;2;1;1
252960054136;252960054160;24;0,1,2,3,5;5;2,9;2;1;1
252960054160;252960054181;21;0,1,2,3,5;5;2,9;2;1;1
252960054181;252960054183;2;0,1,2,3,5;5;2,9;2;1;1
252960054183;252960054201;18;0,1,2,3,5;5;2,9;2;1;1
252960054201;252960054221;20;0,1,2,3,5;5;2,9;2;1;1
252960054221;252960054271;50;0,1,2,3,5;5;2,9;2;1;1
252960054271;252960054276;5;0,1,2,3,5;5;2,9;2;1;1
252960054276;252960054282;6;0,1,2,3,5;5;2,9;2;1;1
252960054282;252960054293;11;0,1,2,3,5;5;2,9;2;1;1
252960054293;252960054319;26;0,1,2,3,5;5;2,9;2;1;1
252960054319;252960054322;3;0,1,2,3,5;5;2,9;2;1;1
252960054322;252960054324;2;0,1,2,3,5;5;2,9;2;1;1
252960054324;252960054330;6;0,1,2,3,5;5;2,9;2;1;1
252960054330;252960054341;11;0,1,2,3,5;5;2,9;2;1;1
252960054341;252960054342;1;0,1,2,3,5;5;2,9;2;1;1
252960054342;252960054350;8;0,1,2,3,5;5;2,9;2;1;1
252960054350;252960054356;6;0,1,2,3,5;5;2,9;2;1;1
252960054356;252960054367;11;0,1,2,3,5;5;2,9;2;1;1
252960054367;252960054373;6;0,1,2,3,5;5;2,9;2;1;1
252960054373;252960054383;10;0,1,2,3,5;5;2,9;2;1;1
252960054383;252960054400;17;0,1,2,3,5;5;2,9;2;1;1
252960054400;252960054412;12;0,1,2,3,5;5;2,9;2;1;1
252960054412;252960054420;8;0,1,2,3,5;5;2,9;2;1;1
252960054420;252960054427;7;0,1,2,3,5;5;2,9;2;1;1
252960054427;252960054428;1;0,1,2,3,5;5;2,9;2;1;1
252960054428;252960054442;14;0,1,2,3,5;5;2,9;2;1;1
252960054442;252960054450;8;0,1,2,3,5;5;2,9;2;1;1
252960054450;252960054488;38;0,1,2,3,5;5;2,9;2;1;1
252960054488;252960054497;9;0,1,2,3,5;5;2,9;2;1;1
252960054497;252960054507;10;0,1,2,3,5;5;2,9;2;1;1
252960054507;252960054515;8;0,1,2,3,5;5;2,9;2;1;1
252960054515;252960054520;5;0,1,2,3,5;5;2,9;2;1;1
252960054520;252960054526;6;0,1,2,3,5;5;2,9;2;1;1
252960054526;252960054530;4;0,1,2,3,5;5;2,9;2;1;1
252960054530;252960054541;11;0,1,2,3,5;5;2,9;2;1;1
252960054541;252960054550;9;0,1,2,3,5;5;2,9;2;1;1
252960054550;252960054556;6;0,1,2,3,5;5;2,9;2;1;1
252960054556;252960054582;26;0,1,2,3,5;5;2,9;2;1;1
252960054582;252960054620;38;0,1,2,3,5;5;2,9;2;1;1
252960054620;252960054624;4;0,1,2,3,5;5;2,9;2;1;1
252960054624;252960054626;2;0,1,2,3,5;5;2,9;2;1;1
252960054626;252960054636;10;0,1,2,3,5;5;2,9;2;1;1
252960054636;252960054639;3;0,1,2,3,5;5;2,9;2;1;1
252960054639;252960054653;14;0,1,2,3,5;5;2,9;2;1;1
252960054653;252960054661;8;0,1,2,3,5;5;2,9;2;1;1
252960054661;252960054667;6;0,1,2,3,5;5;2,9;2;1;1
252960054667;252960054668;1;0,1,2,3,5;5;2,9;2;1;1
252960054668;252960054672;4;0,1,2,3,5;5;2,9;2;1;1
252960054672;252960054682;10;0,1,2,3,5;5;2,9;2;1;1
252960054682;252960054683;1;0,1,2,3,5;5;2,9;2;1;1
252960054683;252960054704;21;0,1,2,3,5;5;2,9;2;1;1
252960054704;252960054709;5;0,1,2,3,5;5;2,9;2;1;1
252960054709;252960054716;7;0,1,2,3,5;5;2,9;2;1;1
252960054716;252960054724;8;0,1,2,3,5;5;2,9;2;1;1
252960054724;252960054747;23;0,1,2,3,5;5;2,9;2;1;1
252960054747;252960054754;7;0,1,2,3,5;5;2,9;2;1;1
252960054754;252960054755;1;0,1,2,3,5;5;2,9;2;1;1
252960054755;252960054766;11;0,1,2,3,5;5;2,9;2;1;1
252960054766;252960054778;12;0,1,2,3,5;5;2,9;2;1;1
252960054778;252960054796;18;0,1,2,3,5;5;2,9;2;1;1
252960054796;252960054802;6;0,1,2,3,5;5;2,9;2;1;1
252960054802;252960054813;11;0,1,2,3,5;5;2,9;2;1;1
252960054813;252960054821;8;0,1,2,3,5;5;2,9;2;1;1
252960054821;252960054822;1;0,1,2,3,5;5;2,9;2;1;1
252960054822;252960054866;44;0,1,2,3,5;5;2,9;2;1;1
252960054866;252960054897;31;0,1,2,3,5;5;2,9;2;1;1
252960054897;252960054923;26;0,1,2,3,5;5;2,9;2;1;1
252960054923;252960054926;3;0,1,2,3,5;5;2,9;2;1;1
252960054926;252960054929;3;0,1,2,3,5;5;2,9;2;1;1
252960054929;252960054941;12;0,1,2,3,5;5;2,9;2;1;1
252960054941;252960054946;5;0,1,2,3,5;5;2,9;2;1;1
252960054946;252960054949;3;0,1,2,3,5;5;2,9;2;1;1
252960054949;252960054955;6;0,1,2,3,5;5;2,9;2;1;1
252960054955;252960054956;1;0,1,2,3,5;5;2,9;2;1;1
252960054956;252960054985;29;0,1,2,3,5;5;2,9;2;1;1
252960054985;252960054997;12;0,1,2,3,5;5;2,9;2;1;1
252960054997;252960054998;1;0,1,2,3,5;5;2,9;2;1;1
252960054998;252960055023;25;0,1,2,3,5;5;2,9;2;1;1
252960055023;252960055034;11;0,1,2,3,5;5;2,9;2;1;1
252960055034;252960055040;6;0,1,2,3,5;5;2,9;2;1;1
252960055040;252960055042;2;0,1,2,3,5;5;2,9;2;1;1
252960055042;252960055051;9;0,1,2,3,5;5;2,9;2;1;1
252960055051;252960055072;21;0,1,2,3,5;5;2,9;2;1;1
252960055072;252960055103;31;0,1,2,3,5;5;2,9;2;1;1
252960055103;252960055105;2;0,1,2,3,5;5;2,9;2;1;1
252960055105;252960055107;2;0,1,2,3,5;5;2,9;2;1;1
252960055107;252960055119;12;0,1,2,3,5;5;2,9;2;1;1
252960055119;252960055128;9;0,1,2,3,5;5;2,9;2;1;1
252960055128;252960055132;4;0,1,2,3,5;5;2,9;2;1;1
252960055132;252960055135;3;0,1,2,3,5;5;2,9;2;1;1
252960055135;252960055159;24;0,1,2,3,5;5;2,9;2;1;1
252960055159;252960055187;28;0,1,2,3,5;5;2,9;2;1;1
252960055187;252960055200;13;0,1,2,3,5;5;2,9;2;1;1
252960055200;252960055221;21;0,1,2,3,5;5;2,9;2;1;1
252960055221;252960055244;23;0,1,2,3,5;5;2,9;2;1;1
252960055244;252960055253;9;0,1,2,3,5;5;2,9;2;1;1
252960055253;252960055257;4;0,1,2,3,5;5;2,9;2;1;1
252960055257;252960055268;11;0,1,2,3,5;5;2,9;2;1;1
252960055268;252960055271;3;0,1,2,3,5;5;2,9;2;1;1
252960055271;252960055277;6;0,1,2,3,5;5;2,9;2;1;1
252960055277;252960055280;3;0,1,2,3,5;5;2,9;2;1;1
252960055280;252960055324;44;0,1,2,3,5;5;2,9;2;1;1
252960055324;252960055331;7;0,1,2,3,5;5;2,9;2;1;1
252960055331;252960055333;2;0,1,2,3,5;5;2,9;2;1;1
252960055333;252960055345;12;0,1,2,3,5;5;2,9;2;1;1
252960055345;252960055363;18;0,1,2,3,5;5;2,9;2;1;1
252960055363;252960055392;29;0,1,2,3,5;5;2,9;2;1;1
252960055392;252960055400;8;0,1,2,3,5;5;2,9;2;1;1
252960055400;252960055412;12;0,1,2,3,5;5;2,9;2;1;1
252960055412;252960055417;5;0,1,2,3,5;5;2,9;2;1;1
252960055417;252960055420;3;0,1,2,3,5;5;2,9;2;1;1
252960055420;252960055438;18;0,1,2,3,5;5;2,9;2;1;1
252960055438;252960055452;14;0,1,2,3,5;5;2,9;2;1;1
252960055452;252960055469;17;0,1,2,3,5;5;2,9;2;1;1
252960055469;252960055479;10;0,1,2,3,5;5;2,9;2;1;1
252960055479;252960055485;6;0,1,2,3,5;5;2,9;2;1;1
252960055485;252960055510;25;0,1,2,3,5;5;2,9;2;1;1
252960055510;252960055516;6;0,1,2,3,5;5;2,9;2;1;1
252960055516;252960055544;28;0,1,2,3,5;5;2,9;2;1;1
252960055544;252960055557;13;0,1,2,3,5;5;2,9;2;1;1
252960055557;252960055578;21;0,1,2,3,5;5;2,9;2;1;1
252960055578;252960055642;64;0,1,2,3,5;5;2,9;2;1;1
252960055642;252960055653;11;0,1,2,3,5;5;2,9;2;1;1
252960055653;252960055661;8;0,1,2,3,5;5;2,9;2;1;1
252960055661;252960055665;4;0,1,2,3,5;5;2,9;2;1;1
252960055665;252960055680;15;0,1,2,3,5;5;2,9;2;1;1
252960055680;252960055681;1;0,1,2,3,5;5;2,9;2;1;1
252960055681;252960055684;3;0,1,2,3,5;5;2,9;2;1;1
252960055684;252960055700;16;0,1,2,3,5;5;2,9;2;1;1
252960055700;252960055705;5;0,1,2,3,5;5;2,9;2;1;1
252960055705;252960055772;67;0,1,2,3,5;5;2,9;2;1;1
252960055772;252960055784;12;0,1,2,3,5;5;2,9;2;1;1
252960055784;252960055790;6;0,1,2,3,5;5;2,9;2;1;1
252960055790;252960055806;16;0,1,2,3,5;5;2,9;2;1;1
252960055806;252960055812;6;0,1,2,3,5;5;2,9;2;1;1
252960055812;252960055828;16;0,1,2,3,5;5;2,9;2;1;1
252960055828;252960055837;9;0,1,2,3,5;5;2,9;2;1;1
252960055837;252960055860;23;0,1,2,3,5;5;2,9;2;1;1
252960055860;252960055875;15;0,1,2,3,5;5;2,9;2;1;1
252960055875;252960055883;8;0,1,2,3,5;5;2,9;2;1;1
252960055883;252960055907;24;0,1,2,3,5;5;2,9;2;1;1
252960055907;252960055911;4;0,1,2,3,5;5;2,9;2;1;1
252960055911;252960055919;8;0,1,2,3,5;5;2,9;2;1;1
252960055919;252960055921;2;0,1,2,3,5;5;2,9;2;1;1
252960055921;252960055932;11;0,1,2,3,5;5;2,9;2;1;1
252960055932;252960055936;4;0,1,2,3,5;5;2,9;2;1;1
252960055936;252960055960;24;0,1,2,3,5;5;2,9;2;1;1
252960055960;252960055967;7;0,1,2,3,5;5;2,9;2;1;1
252960055967;252960055976;9;0,1,2,3,5;5;2,9;2;1;1
252960055976;252960055996;20;0,1,2,3,5;5;2,9;2;1;1
252960055996;252960056015;19;0,1,2,3,5;5;2,9;2;1;1
252960056015;252960056031;16;0,1,2,3,5;5;2,9;2;1;1
252960056031;252960056034;3;0,1,2,3,5;5;2,9;2;1;1
252960056034;252960056049;15;0,1,2,3,5;5;2,9;2;1;1
252960056049;252960056079;30;0,1,2,3,5;5;2,9;2;1;1
252960056079;252960056097;18;0,1,2,3,5;5;2,9;2;1;1
252960056097;252960056104;7;0,1,2,3,5;5;2,9;2;1;1
252960056104;252960056125;21;0,1,2,3,5;5;2,9;2;1;1
252960056125;252960056135;10;0,1,2,3,5;5;2,9;2;1;1
252960056135;252960056146;11;0,1,2,3,5;5;2,9;2;1;1
252960056146;252960056167;21;0,1,2,3,5;5;2,9;2;1;1
252960056167;252960056171;4;0,1,2,3,5;5;2,9;2;1;1
252960056171;252960056175;4;0,1,2,3,5;5;2,9;2;1;1
252960056175;252960056188;13;0,1,2,3,5;5;2,9;2;1;1
252960056188;252960056232;44;0,1,2,3,5;5;2,9;2;1;1
252960056232;252960056249;17;0,1,2,3,5;5;2,9;2;1;1
252960056249;252960056266;17;0,1,2,3,5;5;2,9;2;1;1
252960056266;252960056285;19;0,1,2,3,5;5;2,9;2;1;1
252960056285;252960056299;14;0,1,2,3,5;5;2,9;2;1;1
252960056299;252960056300;1;0,1,2,3,5;5;2,9;2;1;1
252960056300;252960056313;13;0,1,2,3,5;5;2,9;2;1;1
252960056313;252960056315;2;0,1,2,3,5;5;2,9;2;1;1
252960056315;252960056316;1;0,1,2,3,5;5;2,9;2;1;1
252960056316;252960056346;30;0,1,2,3,5;5;2,9;2;1;1
252960056346;252960056347;1;0,1,2,3,5;5;2,9;2;1;1
252960056347;252960056359;12;0,1,2,3,5;5;2,9;2;1;1
252960056359;252960056401;42;0,1,2,3,5;5;2,9;2;1;1
252960056401;252960056413;12;0,1,2,3,5;5;2,9;2;1;1
252960056413;252960056420;7;0,1,2,3,5;5;2,9;2;1;1
252960056420;252960056442;22;0,1,2,3,5;5;2,9;2;1;1
252960056442;252960056443;1;0,1,2,3,5;5;2,9;2;1;1
252960056443;252960056444;1;0,1,2,3,5;5;2,9;2;1;1
252960056444;252960056462;18;0,1,2,3,5;5;2,9;2;1;1
252960056462;252960056480;18;0,1,2,3,5;5;2,9;2;1;1
252960056480;252960056481;1;0,1,2,3,5;5;2,9;2;1;1
252960056481;252960056490;9;0,1,2,3,5;5;2,9;2;1;1
252960056490;252960056493;3;0,1,2,3,5;5;2,9;2;1;1
252960056493;252960056499;6;0,1,2,3,5;5;2,9;2;1;1
252960056499;252960056502;3;0,1,2,3,5;5;2,9;2;1;1
252960056502;252960056505;3;0,1,2,3,5;5;2,9;2;1;1
252960056505;252960056520;15;0,1,2,3,5;5;2,9;2;1;1
252960056520;252960056526;6;0,1,2,3,5;5;2,9;2;1;1
252960056526;252960056528;2;0,1,2,3,5;5;2,9;2;1;1
252960056528;252960056535;7;0,1,2,3,5;5;2,9;2;1;1
252960056535;252960056544;9;0,1,2,3,5;5;2,9;2;1;1
252960056544;252960056559;15;0,1,2,3,5;5;2,9;2;1;1
252960056559;252960056579;20;0,1,2,3,5;5;2,9;2;1;1
252960056579;252960056639;60;0,1,2,3,5;5;2,9;2;1;1
252960056639;252960056687;48;0,1,2,3,5;5;2,9;2;1;1
252960056687;252960056714;27;0,1,2,3,5;5;2,9;2;1;1
252960056714;252960056723;9;0,1,2,3,5;5;2,9;2;1;1
252960056723;252960056727;4;0,1,2,3,5;5;2,9;2;1;1
252960056727;252960056728;1;0,1,2,3,5;5;2,9;2;1;1
252960056728;252960056746;18;0,1,2,3,5;5;2,9;2;1;1
252960056746;252960056752;6;0,1,2,3,5;5;2,9;2;1;1
252960056752;252960056781;29;0,1,2,3,5;5;2,9;2;1;1
252960056781;252960056784;3;0,1,2,3,5;5;2,9;2;1;1
252960056784;252960056796;12;0,1,2,3,5;5;2,9;2;1;1
252960056796;252960056806;10;0,1,2,3,5;5;2,9;2;1;1
252960056806;252960056844;38;0,1,2,3,5;5;2,9;2;1;1
252960056844;252960056872;28;0,1,2,3,5;5;2,9;2;1;1
252960056872;252960056888;16;0,1,2,3,5;5;2,9;2;1;1
252960056888;252960056955;67;0,1,2,3,5;5;2,9;2;1;1
252960056955;252960056973;18;0,1,2,3,5;5;2,9;2;1;1
252960056973;252960056977;4;0,1,2,3,5;5;2,9;2;1;1
252960056977;252960057037;60;0,1,2,3,5;5;2,9;2;1;1
252960057037;252960057063;26;0,1,2,3,5;5;2,9;2;1;1
252960057063;252960057080;17;0,1,2,3,5;5;2,9;2;1;1
252960057080;252960057111;31;0,1,2,3,5;5;2,9;2;1;1
252960057111;252960057145;34;0,1,2,3,5;5;2,9;2;1;1
252960057145;252960057155;10;0,1,2,3,5;5;2,9;2;1;1
252960057155;252960057159;4;0,1,2,3,5;5;2,9;2;1;1
252960057159;252960057167;8;0,1,2,3,5;5;2,9;2;1;1
252960057167;252960057185;18;0,1,2,3,5;5;2,9;2;1;1
252960057185;252960057275;90;0,1,2,3,5;5;2,9;2;1;1
252960057275;252960057280;5;0,1,2,3,5;5;2,9;2;1;1
252960057280;252960057287;7;0,1,2,3,5;5;2,9;2;1;1
252960057287;252960057330;43;0,1,2,3,5;5;2,9;2;1;1
252960057330;252960057354;24;0,1,2,3,5;5;2,9;2;1;1
252960057354;252960057368;14;0,1,2,3,5;5;2,9;2;1;1
252960057368;252960057381;13;0,1,2,3,5;5;2,9;2;1;1
252960057381;252960057386;5;0,1,2,3,5;5;2,9;2;1;1
252960057386;252960057411;25;0,1,2,3,5;5;2,9;2;1;1
252960057411;252960057415;4;0,1,2,3,5;5;2,9;2;1;1
252960057415;252960057434;19;0,1,2,3,5;5;2,9;2;1;1
252960057434;252960057470;36;0,1,2,3,5;5;2,9;2;1;1
252960057470;252960057530;60;0,1,2,3,5;5;2,9;2;1;1
252960057530;252960057540;10;0,1,2,3,5;5;2,9;2;1;1
252960057540;252960057567;27;0,1,2,3,5;5;2,9;2;1;1
252960057567;252960057570;3;0,1,2,3,5;5;2,9;2;1;1
252960057570;252960057612;42;0,1,2,3,5;5;2,9;2;1;1
252960057612;252960057621;9;0,1,2,3,5;5;2,9;2;1;1
252960057621;252960057635;14;0,1,2,3,5;5;2,9;2;1;1
252960057635;252960057660;25;0,1,2,3,5;5;2,9;2;1;1
252960057660;252960057687;27;0,1,2,3,5;5;2,9;2;1;1
252960057687;252960057711;24;0,1,2,3,5;5;2,9;2;1;1
252960057711;252960057762;51;0,1,2,3,5;5;2,9;2;1;1
252960057762;252960058092;330;0,1,2,3,5;5;2,9;2;1;1
252960058092;252960062965;4873;0,1,2,3,5;5;2,9;2;1;1
252960062965;252960222081;159116;0,1,2,3,5;5;2,9;2;1;1
252960222081;252960384198;162117;0,1,2,3,5;5;2,9;2;1;1
252960384198;252980327295;19943097;0,1,2,3,5;5;2,9;2;1;1
252980327295;253017338335;37011040;0,1,2,3,5;5;2,9;2;1;1
253017338335;253017393882;55547;0,1,2,3,5;5;2,9;2;1;1
253017393882;253017438574;44692;0,1,2,3,5;5;2,9;2;1;1
253017438574;253017457496;18922;0,1,2,3,5;5;2,9;2;1;1
253017457496;253017458733;1237;0,1,2,3,5;5;2,9;2;1;1
253017458733;253017634607;175874;0,1,2,3,5;5;2,9;2;1;1
253017634607;253017872458;237851;0,1,2,3,5;5;2,9;2;1;1
253017872458;253023863380;5990922;0,1,2,3,5;5;2,9;2;1;1
253023863380;253024069400;206020;0,1,2,3,5;5;2,9;2;1;1
253024069400;253033493014;9423614;0,1,2,3,5;5;2,9;2;1;1
253033493014;253034010513;517499;0,1,2,3,5;5;2,9;2;1;1
253034010513;253034025705;15192;0,1,2,3,5;5;2,9;2;1;1
253034025705;253034046583;20878;0,1,2,3,5;5;2,9;2;1;1
253034046583;253034394515;347932;0,1,2,3,5;5;2,9;2;1;1
253034394515;253034892786;498271;0,1,2,3,5;5;2,9;2;1;1
253034892786;253035095686;202900;0,1,2,3,5;5;2,9;2;1;1
253035095686;253035437203;341517;0,1,2,3,5;5;2,9;2;1;1
253035437203;253035438237;1034;0,1,2,3,5;5;2,9;2;1;1
253035438237;253035613877;175640;0,1,2,3,5;5;2,9;2;1;1
253035613877;253035630900;17023;0,1,2,3,5;5;2,9;2;1;1
253035630900;253035644233;13333;0,1,2,3,5;5;2,9;2;1;1
253035644233;253301189106;265544873;0,1,2,3,5;5;2,9;2;1;1
253301189106;253301303149;114043;0,1,2,3,5;5;2,9;2;1;1
253301303149;253309317599;8014450;0,1,2,3,5;5;2,9;2;1;1
253309317599;253458777886;149460287;0,1,2,3,5;5;2,9;2;1;1
253458777886;253458778958;1072;0,1,2,3,4,5;6;2,9,11;3;1;1
253458778958;253458781231;2273;0,1,2,3,5;5;2,9;2;1;1
253458781231;253458784506;3275;0,1,2,3,5;5;2,9,11;3;1;1
253458784506;253459039523;255017;0,1,2,3,5;5;2,9;2;1;1
253459039523;253486943114;27903591;0,1,2,3,5,8;6;2,9,11;3;1;1
253486943114;253540205449;53262335;0,1,2,3,5;5;2,9;2;1;1
253540205449;253540221409;15960;0,1,2,3,5;5;2,9;2;1;1
253540221409;253540277174;55765;0,1,2,3,5;5;2,9;2;1;1
253540277174;253540283350;6176;0,1,2,3,5;5;2,9;2;1;1
253540283350;253540287628;4278;0,1,2,3,5;5;2,9;2;1;1
253540287628;253540288155;527;0,1,2,3,4,5;6;2,9;2;1;1
253540288155;253540307003;18848;0,1,2,3,5;5;2,9;2;1;1
253540307003;253540332864;25861;0,1,2,3,5;5;2,9;2;1;1
253540332864;253540400593;67729;0,1,2,3,5;5;2,9;2;1;1
253540400593;253540414132;13539;0,1,2,3,5;5;2,9;2;1;1
253540414132;253540419028;4896;0,1,2,3,5;5;2,9;2;1;1
253540419028;253720333989;179914961;0,1,2,3,5;5;2,9;2;1;1
253720333989;253720431151;97162;0,1,2,3,5;5;2,9;2;1;1
253720431151;253720666955;235804;0,1,2,3,5;5;2,9;2;1;1
253720666955;253720687861;20906;0,1,2,3,5;5;2,9;2;1;1
253720687861;253720696586;8725;0,1,2,3,5;5;2,9;2;1;1
253720696586;253720922459;225873;0,1,2,3,5;5;2,9;2;1;1
253720922459;253721596764;674305;0,1,2,3,5;5;2,9;2;1;1
253721596764;253731733271;10136507;0,1,2,3,5;5;2,9;2;1;1
253731733271;253742906970;11173699;0,1,2,3,5;5;2,9;2;1;1
253742906970;253750254907;7347937;0,1,2,3,5;5;2,9;2;1;1
253750254907;253750272692;17785;0,1,2,3,5;5;2,9;2;1;1
253750272692;253750289184;16492;0,1,2,3,5;5;2,9;2;1;1
253750289184;253898486038;148196854;0,1,2,3,5;5;2,9;2;1;1
253898486038;253898661116;175078;0,1,2,3,5;5;2,9;2;1;1
253898661116;253936336371;37675255;0,1,2,3,5;5;2,9;2;1;1
253936336371;253936422262;85891;0,1,2,3,5;5;2,9;2;1;1
253936422262;253959409359;22987097;0,1,2,3,5;5;2,9;2;1;1
253959409359;253962129631;2720272;0,1,2,3,5;5;2,9;2;1;1
253962129631;253971429367;9299736;0,1,2,3,5;5;2,9;2;1;1
253971429367;253973711321;2281954;0,1,2,3,5;5;2,9;2;1;1
253973711321;253995509538;21798217;0,1,2,3,5;5;2,9;2;1;1
253995509538;253996366667;857129;0,1,2,3,5;5;2,9;2;1;1
253996366667;254021509752;25143085;0,1,2,3,5;5;2,9;2;1;1
254021509752;254024180831;2671079;0,1,2,3,5;5;2,9;2;1;1
254024180831;254047748794;23567963;0,1,2,3,5;5;2,9;2;1;1
254047748794;254056404861;8656067;0,1,2,3,5;5;2,9;2;1;1
254056404861;254056407517;2656;0,1,2,3,5;5;2,9;2;1;1
254056407517;254056542952;135435;0,1,2,3,5;5;2,9;2;1;1
254056542952;254060000943;3457991;0,1,2,3,5;5;2,9;2;1;1
254060000943;254065980962;5980019;0,1,2,3,5;5;2,9;2;1;1
254065980962;254066964447;983485;0,1,2,3,5;5;2,9;2;1;1
254066964447;254069399006;2434559;0,1,2,3,5;5;2,9;2;1;1
254069399006;254069630946;231940;0,1,2,3,5;5;2,9;2;1;1
254069630946;254131044434;61413488;0,1,2,3,5;5;2,9;2;1;1
254131044434;254393577906;262533472;1,2,3,5;4;2,9;2;1;1
254393577906;254865064879;471486973;1,2,3,5;4;2,9;2;1;1
254865064879;254865206528;141649;1,2,3,5;4;2,9;2;1;1
254865206528;255246876184;381669656;1,2,3,5;4;2,9;2;1;1
255246876184;255281311487;34435303;0,1,2,3,5;5;2,9,10;3;1;1
255281311487;255310278673;28967186;1,2,3,5;4;2,9;2;1;1
255310278673;255336123992;25845319;0,1,2,3,5;5;2,6,9;3;1;1
255336123992;255834324318;498200326;1,2,3,5;4;2,9;2;1;1
255834324318;255881567232;47242914;0,1,2,3,5;5;2,3,9;3;1;1
255881567232;256525177991;643610759;1,2,3,5;4;2,9;2;1;1
256525177991;256575802083;50624092;1,2,3,5;4;2,3,9;3;1;1
256575802083;256801229786;225427703;1,2,3,5;4;2,9;2;1;1
256801229786;256849075340;47845554;0,1,2,3,5;5;2,5,9;3;1;1
256849075340;256894325533;45250193;1,2,3,5;4;2,9;2;1;1
256894325533;256895124984;799451;1,2,3,5;4;2,9;2;1;1
256895124984;256903472680;8347696;1,2,3,5;4;2,9;2;1;1
256903472680;256904581879;1109199;1,2,3,5;4;2,9;2;1;1
256904581879;256912872429;8290550;1,2,3,5;4;2,9;2;1;1
256912872429;256913788923;916494;1,2,3,5;4;2,9;2;1;1
256913788923;256920135849;6346926;1,2,3,5;4;2,9;2;1;1
256920135849;256921118592;982743;1,2,3,5;4;2,9;2;1;1
256921118592;256927721340;6602748;1,2,3,5;4;2,9;2;1;1
256927721340;256928741345;1020005;1,2,3,5;4;2,9;2;1;1
256928741345;256937064838;8323493;1,2,3,5;4;2,9;2;1;1
256937064838;256938035878;971040;1,2,3,5;4;2,9;2;1;1
256938035878;256944045589;6009711;1,2,3,5;4;2,9;2;1;1
256944045589;256944851800;806211;1,2,3,5;4;2,9;2;1;1
256944851800;256950505080;5653280;1,2,3,5;4;2,9;2;1;1
256950505080;256951145572;640492;1,2,3,5;4;2,9;2;1;1
256951145572;256955931045;4785473;1,2,3,5;4;2,9;2;1;1
256955931045;256956055018;123973;1,2,3,5;4;2,9;2;1;1
256956055018;257273192588;317137570;1,2,3,5;4;2,9;2;1;1
257273192588;257273193642;1054;1,2,3,4,5;5;2,9,11;3;1;1
257273193642;257273195661;2019;1,2,3,5;4;2,9;2;1;1
257273195661;257273198932;3271;1,2,3,5;4;2,9,11;3;1;1
257273198932;257274149718;950786;1,2,3,5;4;2,9;2;1;1
257274149718;257303427819;29278101;1,2,3,5,8;5;2,9,11;3;1;1
257303427819;257316881903;13454084;1,2,3,5;4;2,9;2;1;1
257316881903;257359857699;42975796;1,2,3,5;4;2,6,9;3;1;1
257359857699;257499111210;139253511;1,2,3,5;4;2,9;2;1;1
257499111210;257505519908;6408698;1,2,3,5;4;2,5,9;3;1;1
257505519908;257505976844;456936;1,2,3,5;4;2,5,9;3;1;1
257505976844;257538720725;32743881;1,2,3,5;4;2,5,9;3;1;1
257538720725;257538726317;5592;1,2,3,5;4;2,5,9;3;1;1
257538726317;257538735245;8928;1,2,3,5;4;2,5,9;3;1;1
257538735245;257538744501;9256;1,2,3,5;4;2,5,9;3;1;1
257538744501;257538753578;9077;1,2,3,5;4;2,5,9;3;1;1
257538753578;257538757595;4017;1,2,3,5;4;2,5,9;3;1;1
257538757595;257549858984;11101389;1,2,3,5;4;2,5,9;3;1;1
257549858984;257748469118;198610134;1,2,3,5;4;2,9;2;1;1
257748469118;257748640767;171649;1,2,3,5;4;2,9;2;1;1
257748640767;257763390768;14750001;1,2,3,5;4;2,9;2;1;1
257763390768;257810856778;47466010;0,1,2,3,5;5;0,2,9;3;1;1
257810856778;257849532766;38675988;1,2,3,5;4;2,9;2;1;1
257849532766;257849574972;42206;1,2,3,5;4;2,9;2;1;1
257849574972;257852087347;2512375;1,2,3,5;4;2,9;2;1;1
257852087347;257852101940;14593;1,2,3,5;4;2,9;2;1;1
257852101940;257852122857;20917;1,2,3,5;4;2,9;2;1;1
257852122857;257852227630;104773;1,2,3,5;4;2,9;2;1;1
257852227630;257852505630;278000;1,2,3,5;4;2,9;2;1;1
257852505630;258076315092;223809462;1,2,3,5;4;2,9;2;1;1
258076315092;258076471280;156188;1,3,5;3;2,9;2;1;1
258076471280;258076477640;6360;1,3,5;3;2,9;2;1;1
258076477640;258076478560;920;1,3,5;3;2,9;2;1;1
258076478560;258076488487;9927;1,3,5;3;2,9;2;1;1
258076488487;258076489141;654;1,3,5;3;2,9;2;1;1
258076489141;258076491009;1868;1,3,5;3;2,9;2;1;1
258076491009;258076496214;5205;1,3,5;3;2,9;2;1;1
258076496214;258076512102;15888;1,3,5;3;2,9;2;1;1
258076512102;258076521833;9731;1,3,5;3;2,9;2;1;1
258076521833;258076521922;89;1,3,5;3;2,9;2;1;1
258076521922;258076538172;16250;1,3,5;3;2,9;2;1;1
258076538172;258076543139;4967;1,3,5;3;2,9;2;1;1
258076543139;258076552291;9152;1,3,5;3;2,9;2;1;1
258076552291;258076571287;18996;1,3,5;3;2,9;2;1;1
258076571287;258076623060;51773;1,3,5;3;2,9;2;1;1
258076623060;258076624678;1618;1,3,5;3;2,9;2;1;1
258076624678;258076629470;4792;1,3,5;3;2,9;2;1;1
258076629470;258076635743;6273;1,3,5;3;2,9;2;1;1
258076635743;258076637221;1478;1,3,5;3;2,9;2;1;1
258076637221;258076650662;13441;1,3,5;3;2,9;2;1;1
258076650662;258076652008;1346;1,3,5;3;2,9;2;1;1
258076652008;258076660761;8753;1,3,5;3;2,9;2;1;1
258076660761;258076663472;2711;1,3,5;3;2,9;2;1;1
258076663472;258076664036;564;1,3,5;3;2,9;2;1;1
258076664036;258076669006;4970;1,3,5;3;2,9;2;1;1
258076669006;258076669080;74;1,3,5;3;2,9;2;1;1
258076669080;258076670329;1249;1,3,5;3;2,9;2;1;1
258076670329;258076670733;404;1,3,5;3;2,9;2;1;1
258076670733;258076671520;787;1,3,5;3;2,9;2;1;1
258076671520;258076713430;41910;1,3,5;3;2,9;2;1;1
258076713430;258076720107;6677;1,3,5;3;2,9;2;1;1
258076720107;258076720674;567;1,3,5;3;2,9;2;1;1
258076720674;258076734323;13649;1,3,5;3;2,9;2;1;1
258076734323;258076734975;652;1,3,5;3;2,9;2;1;1
258076734975;258076749051;14076;1,3,5;3;2,9;2;1;1
258076749051;258076767303;18252;1,3,5;3;2,9;2;1;1
258076767303;258076775950;8647;1,3,5;3;2,9;2;1;1
258076775950;258076786230;10280;1,3,5;3;2,9;2;1;1
258076786230;258076801643;15413;1,3,5;3;2,9;2;1;1
258076801643;258076821542;19899;1,3,5;3;2,9;2;1;1
258076821542;258076822028;486;1,3,5;3;2,9;2;1;1
258076822028;258076823620;1592;1,3,5;3;2,9;2;1;1
258076823620;258076829556;5936;1,3,5;3;2,9;2;1;1
258076829556;258076830042;486;1,3,5;3;2,9;2;1;1
258076830042;258076852354;22312;1,3,5;3;2,9;2;1;1
258076852354;258076855072;2718;1,3,5;3;2,9;2;1;1
258076855072;258076855561;489;1,3,5;3;2,9;2;1;1
258076855561;258076889594;34033;1,3,5;3;2,9;2;1;1
258076889594;258076901113;11519;1,3,5;3;2,9;2;1;1
258076901113;258076908297;7184;1,3,5;3;2,9;2;1;1
258076908297;258076908981;684;1,3,5;3;2,9;2;1;1
258076908981;258076967056;58075;1,3,5;3;2,9;2;1;1
258076967056;258076997379;30323;1,3,5;3;2,9;2;1;1
258076997379;258077008032;10653;1,3,5;3;2,9;2;1;1
258077008032;258077021264;13232;1,3,5;3;2,9;2;1;1
258077021264;258077053838;32574;1,3,5;3;2,9;2;1;1
258077053838;258077056427;2589;1,3,5;3;2,9;2;1;1
258077056427;258077056925;498;1,3,5;3;2,9;2;1;1
258077056925;258077074302;17377;1,3,5;3;2,9;2;1;1
258077074302;258077074782;480;1,3,5;3;2,9;2;1;1
258077074782;258077074913;131;1,3,5;3;2,9;2;1;1
258077074913;258077086167;11254;1,3,5;3;2,9;2;1;1
258077086167;258077098836;12669;1,3,5;3;2,9;2;1;1
258077098836;258077112303;13467;1,3,5;3;2,9;2;1;1
258077112303;258077113011;708;1,3,5;3;2,9;2;1;1
258077113011;258077127690;14679;1,3,5;3;2,9;2;1;1
258077127690;258077128171;481;1,3,5;3;2,9;2;1;1
258077128171;258077133431;5260;1,3,5;3;2,9;2;1;1
258077133431;258077138502;5071;1,3,5;3;2,9;2;1;1
258077138502;258077180794;42292;1,3,5;3;2,9;2;1;1
258077180794;258077197642;16848;1,3,5;3;2,9;2;1;1
258077197642;258077198271;629;1,3,5;3;2,9;2;1;1
258077198271;258077205863;7592;1,3,5;3;2,9;2;1;1
258077205863;258077225806;19943;1,3,5;3;2,9;2;1;1
258077225806;258077246518;20712;1,3,5;3;2,9;2;1;1
258077246518;258077250828;4310;1,3,5;3;2,9;2;1;1
258077250828;258077260863;10035;1,3,5;3;2,9;2;1;1
258077260863;258077261344;481;1,3,5;3;2,9;2;1;1
258077261344;258077273023;11679;1,3,5;3;2,9;2;1;1
258077273023;258077302833;29810;1,3,5;3;2,9;2;1;1
258077302833;258077303457;624;1,3,5;3;2,9;2;1;1
258077303457;258077305933;2476;1,3,5;3;2,9;2;1;1
258077305933;258077309913;3980;1,3,5;3;2,9;2;1;1
258077309913;258077310403;490;1,3,5;3;2,9;2;1;1
258077310403;258077311409;1006;1,3,5;3;2,9;2;1;1
258077311409;258077321510;10101;1,3,5;3;2,9;2;1;1
258077321510;258077346217;24707;1,3,5;3;2,9;2;1;1
258077346217;258077359236;13019;1,3,5;3;2,9;2;1;1
258077359236;258077388708;29472;1,3,5;3;2,9;2;1;1
258077388708;258077405121;16413;1,3,5;3;2,9;2;1;1
258077405121;258077405922;801;1,3,5;3;2,9;2;1;1
258077405922;258077409207;3285;1,3,5;3;2,9;2;1;1
258077409207;258077413165;3958;1,3,5;3;2,9;2;1;1
258077413165;258077413556;391;1,3,5;3;2,9;2;1;1
258077413556;258077413673;117;1,3,5;3;2,9;2;1;1
258077413673;258077414034;361;1,3,5;3;2,9;2;1;1
258077414034;258077430940;16906;1,3,5;3;2,9;2;1;1
258077430940;258077442555;11615;1,3,5;3;2,9;2;1;1
258077442555;258077463460;20905;1,3,5;3;2,9;2;1;1
258077463460;258077463946;486;1,3,5;3;2,9;2;1;1
258077463946;258077472772;8826;1,3,5;3;2,9;2;1;1
258077472772;258077485621;12849;1,3,5;3;2,9;2;1;1
258077485621;258077496314;10693;1,3,5;3;2,9;2;1;1
258077496314;258077496830;516;1,3,5;3;2,9;2;1;1
258077496830;258077497711;881;1,3,5;3;2,9;2;1;1
258077497711;258077498205;494;1,3,5;3;2,9;2;1;1
258077498205;258077505524;7319;1,3,5;3;2,9;2;1;1
258077505524;258077527043;21519;1,3,5;3;2,9;2;1;1
258077527043;258077556947;29904;1,3,5;3;2,9;2;1;1
258077556947;258077579941;22994;1,3,5;3;2,9;2;1;1
258077579941;258077582605;2664;1,3,5;3;2,9;2;1;1
258077582605;258077583093;488;1,3,5;3;2,9;2;1;1
258077583093;258077614904;31811;1,3,5;3;2,9;2;1;1
258077614904;258077636317;21413;1,3,5;3;2,9;2;1;1
258077636317;258077638710;2393;1,3,5;3;2,9;2;1;1
258077638710;258077639191;481;1,3,5;3;2,9;2;1;1
258077639191;258077661834;22643;1,3,5;3;2,9;2;1;1
258077661834;258077689139;27305;1,3,5;3;2,9;2;1;1
258077689139;258077696472;7333;1,3,5;3;2,9;2;1;1
258077696472;258077710303;13831;1,3,5;3;2,9;2;1;1
258077710303;258077711151;848;1,3,5;3;2,9;2;1;1
258077711151;258077715881;4730;1,3,5;3;2,9;2;1;1
258077715881;258077744077;28196;1,3,5;3;2,9;2;1;1
258077744077;258077758516;14439;1,3,5;3;2,9;2;1;1
258077758516;258077759169;653;1,3,5;3;2,9;2;1;1
258077759169;258077770138;10969;1,3,5;3;2,9;2;1;1
258077770138;258077770622;484;1,3,5;3;2,9;2;1;1
258077770622;258077771917;1295;1,3,5;3;2,9;2;1;1
258077771917;258077791778;19861;1,3,5;3;2,9;2;1;1
258077791778;258077815418;23640;1,3,5;3;2,9;2;1;1
258077815418;258077835982;20564;1,3,5;3;2,9;2;1;1
258077835982;258077836738;756;1,3,5;3;2,9;2;1;1
258077836738;258077837389;651;1,3,5;3;2,9;2;1;1
258077837389;258077846952;9563;1,3,5;3;2,9;2;1;1
258077846952;258077872917;25965;1,3,5;3;2,9;2;1;1
258077872917;258077873400;483;1,3,5;3;2,9;2;1;1
258077873400;258077887071;13671;1,3,5;3;2,9;2;1;1
258077887071;258077899465;12394;1,3,5;3;2,9;2;1;1
258077899465;258077904520;5055;1,3,5;3;2,9;2;1;1
258077904520;258077905171;651;1,3,5;3;2,9;2;1;1
258077905171;258077910705;5534;1,3,5;3;2,9;2;1;1
258077910705;258077911188;483;1,3,5;3;2,9;2;1;1
258077911188;258077928585;17397;1,3,5;3;2,9;2;1;1
258077928585;258077949767;21182;1,3,5;3;2,9;2;1;1
258077949767;258077966487;16720;1,3,5;3;2,9;2;1;1
258077966487;258077977423;10936;1,3,5;3;2,9;2;1;1
258077977423;258078004745;27322;1,3,5;3;2,9;2;1;1
258078004745;258078005224;479;1,3,5;3;2,9;2;1;1
258078005224;258078008214;2990;1,3,5;3;2,9;2;1;1
258078008214;258078038572;30358;1,3,5;3;2,9;2;1;1
258078038572;258078039142;570;1,3,5;3;2,9;2;1;1
258078039142;258078039632;490;1,3,5;3;2,9;2;1;1
258078039632;258078044648;5016;1,3,5;3;2,9;2;1;1
258078044648;258078065112;20464;1,3,5;3;2,9;2;1;1
258078065112;258078085431;20319;1,3,5;3;2,9;2;1;1
258078085431;258078091748;6317;1,3,5;3;2,9;2;1;1
258078091748;258078094164;2416;1,3,5;3;2,9;2;1;1
258078094164;258078094642;478;1,3,5;3;2,9;2;1;1
258078094642;258078122446;27804;1,3,5;3;2,9;2;1;1
258078122446;258078122934;488;1,3,5;3;2,9;2;1;1
258078122934;258078126751;3817;1,3,5;3;2,9;2;1;1
258078126751;258078140278;13527;1,3,5;3;2,9;2;1;1
258078140278;258078160567;20289;1,3,5;3;2,9;2;1;1
258078160567;258078161219;652;1,3,5;3;2,9;2;1;1
258078161219;258078166393;5174;1,3,5;3;2,9;2;1;1
258078166393;258078183081;16688;1,3,5;3;2,9;2;1;1
258078183081;258078198298;15217;1,3,5;3;2,9;2;1;1
258078198298;258078198948;650;1,3,5;3;2,9;2;1;1
258078198948;258078199202;254;1,3,5;3;2,9;2;1;1
258078199202;258078199851;649;1,3,5;3;2,9;2;1;1
258078199851;258078212444;12593;1,3,5;3;2,9;2;1;1
258078212444;258078217563;5119;1,3,5;3;2,9;2;1;1
258078217563;258078252608;35045;1,3,5;3;2,9;2;1;1
258078252608;258078273068;20460;1,3,5;3;2,9;2;1;1
258078273068;258078276136;3068;1,3,5;3;2,9;2;1;1
258078276136;258078276789;653;1,3,5;3;2,9;2;1;1
258078276789;258078285168;8379;1,3,5;3;2,9;2;1;1
258078285168;258078296246;11078;1,3,5;3;2,9;2;1;1
258078296246;258078326312;30066;1,3,5;3;2,9;2;1;1
258078326312;258078326802;490;1,3,5;3;2,9;2;1;1
258078326802;258078335179;8377;1,3,5;3;2,9;2;1;1
258078335179;258078352869;17690;1,3,5;3;2,9;2;1;1
258078352869;258078353366;497;1,3,5;3;2,9;2;1;1
258078353366;258078359837;6471;1,3,5;3;2,9;2;1;1
258078359837;258078384232;24395;1,3,5;3;2,9;2;1;1
258078384232;258078396091;11859;1,3,5;3;2,9;2;1;1
258078396091;258078406218;10127;1,3,5;3;2,9;2;1;1
258078406218;258078406698;480;1,3,5;3;2,9;2;1;1
258078406698;258078417049;10351;1,3,5;3;2,9;2;1;1
258078417049;258078417534;485;1,3,5;3;2,9;2;1;1
258078417534;258078425221;7687;1,3,5;3;2,9;2;1;1
258078425221;258078446406;21185;1,3,5;3;2,9;2;1;1
258078446406;258078467678;21272;1,3,5;3;2,9;2;1;1
258078467678;258078498371;30693;1,3,5;3;2,9;2;1;1
258078498371;258078508806;10435;1,3,5;3;2,9;2;1;1
258078508806;258078514209;5403;1,3,5;3;2,9;2;1;1
258078514209;258078514857;648;1,3,5;3;2,9;2;1;1
258078514857;258078530364;15507;1,3,5;3;2,9;2;1;1
258078530364;258078553120;22756;1,3,5;3;2,9;2;1;1
258078553120;258078566049;12929;1,3,5;3;2,9;2;1;1
258078566049;258078566702;653;1,3,5;3;2,9;2;1;1
258078566702;258078571739;5037;1,3,5;3;2,9;2;1;1
258078571739;258078582382;10643;1,3,5;3;2,9;2;1;1
258078582382;258078582876;494;1,3,5;3;2,9;2;1;1
258078582876;258078585201;2325;1,3,5;3;2,9;2;1;1
258078585201;258078585687;486;1,3,5;3;2,9;2;1;1
258078585687;258078591619;5932;1,3,5;3;2,9;2;1;1
258078591619;258078616903;25284;1,3,5;3;2,9;2;1;1
258078616903;258078628972;12069;1,3,5;3;2,9;2;1;1
258078628972;258078629478;506;1,3,5;3;2,9;2;1;1
258078629478;258078630128;650;1,3,5;3;2,9;2;1;1
258078630128;258078639906;9778;1,3,5;3;2,9;2;1;1
258078639906;258078670017;30111;1,3,5;3;2,9;2;1;1
258078670017;258078684301;14284;1,3,5;3;2,9;2;1;1
258078684301;258078693354;9053;1,3,5;3;2,9;2;1;1
258078693354;258078693844;490;1,3,5;3;2,9;2;1;1
258078693844;258078710385;16541;1,3,5;3;2,9;2;1;1
258078710385;258078735540;25155;1,3,5;3;2,9;2;1;1
258078735540;258078741559;6019;1,3,5;3;2,9;2;1;1
258078741559;258078742047;488;1,3,5;3;2,9;2;1;1
258078742047;258078764098;22051;1,3,5;3;2,9;2;1;1
258078764098;258078787486;23388;1,3,5;3;2,9;2;1;1
258078787486;258078790428;2942;1,3,5;3;2,9;2;1;1
258078790428;258078790913;485;1,3,5;3;2,9;2;1;1
258078790913;258078800770;9857;1,3,5;3;2,9;2;1;1
258078800770;258078801505;735;1,3,5;3;2,9;2;1;1
258078801505;258078805867;4362;1,3,5;3;2,9;2;1;1
258078805867;258078818332;12465;1,3,5;3;2,9;2;1;1
258078818332;258078832273;13941;1,3,5;3;2,9;2;1;1
258078832273;258078832938;665;1,3,5;3;2,9;2;1;1
258078832938;258078907752;74814;1,3,5;3;2,9;2;1;1
258078907752;258078934954;27202;1,3,5;3;2,9;2;1;1
258078934954;258078945517;10563;1,3,5;3;2,9;2;1;1
258078945517;258078945997;480;1,3,5;3;2,9;2;1;1
258078945997;258078947081;1084;1,3,5;3;2,9;2;1;1
258078947081;258078973245;26164;1,3,5;3;2,9;2;1;1
258078973245;258078989161;15916;1,3,5;3;2,9;2;1;1
258078989161;258079027815;38654;1,3,5;3;2,9;2;1;1
258079027815;258079028305;490;1,3,5;3;2,9;2;1;1
258079028305;258079033523;5218;1,3,5;3;2,9;2;1;1
258079033523;258079038792;5269;1,3,5;3;2,9;2;1;1
258079038792;258079074487;35695;1,3,5;3;2,9;2;1;1
258079074487;258079085072;10585;1,3,5;3;2,9;2;1;1
258079085072;258079085558;486;1,3,5;3;2,9;2;1;1
258079085558;258079089639;4081;1,3,5;3;2,9;2;1;1
258079089639;258079090120;481;1,3,5;3;2,9;2;1;1
258079090120;258079102041;11921;1,3,5;3;2,9;2;1;1
258079102041;258079139532;37491;1,3,5;3;2,9;2;1;1
258079139532;258079152170;12638;1,3,5;3;2,9;2;1;1
258079152170;258079153855;1685;1,3,5;3;2,9;2;1;1
258079153855;258079154504;649;1,3,5;3;2,9;2;1;1
258079154504;258079168035;13531;1,3,5;3;2,9;2;1;1
258079168035;258079178128;10093;1,3,5;3;2,9;2;1;1
258079178128;258079178735;607;1,3,5;3;2,9;2;1;1
258079178735;258079218058;39323;1,3,5;3;2,9;2;1;1
258079218058;258079240629;22571;1,3,5;3;2,9;2;1;1
258079240629;258079250779;10150;1,3,5;3;2,9;2;1;1
258079250779;258079251258;479;1,3,5;3;2,9;2;1;1
258079251258;258079271110;19852;1,3,5;3;2,9;2;1;1
258079271110;258079296361;25251;1,3,5;3;2,9;2;1;1
258079296361;258079306885;10524;1,3,5;3;2,9;2;1;1
258079306885;258079308034;1149;1,3,5;3;2,9;2;1;1
258079308034;258079312796;4762;1,3,5;3;2,9;2;1;1
258079312796;258079333673;20877;1,3,5;3;2,9;2;1;1
258079333673;258079359377;25704;1,3,5;3;2,9;2;1;1
258079359377;258079369581;10204;1,3,5;3;2,9;2;1;1
258079369581;258079392179;22598;1,3,5;3;2,9;2;1;1
258079392179;258079392831;652;1,3,5;3;2,9;2;1;1
258079392831;258079421294;28463;1,3,5;3;2,9;2;1;1
258079421294;258079445877;24583;1,3,5;3;2,9;2;1;1
258079445877;258079458563;12686;1,3,5;3;2,9;2;1;1
258079458563;258079459328;765;1,3,5;3;2,9;2;1;1
258079459328;258079473555;14227;1,3,5;3;2,9;2;1;1
258079473555;258079491118;17563;1,3,5;3;2,9;2;1;1
258079491118;258079513958;22840;1,3,5;3;2,9;2;1;1
258079513958;258079539480;25522;1,3,5;3;2,9;2;1;1
258079539480;258079545181;5701;1,3,5;3;2,9;2;1;1
258079545181;258079545664;483;1,3,5;3;2,9;2;1;1
258079545664;258079550226;4562;1,3,5;3;2,9;2;1;1
258079550226;258079550709;483;1,3,5;3;2,9;2;1;1
258079550709;258079559120;8411;1,3,5;3;2,9;2;1;1
258079559120;258079583025;23905;1,3,5;3;2,9;2;1;1
258079583025;258079593761;10736;1,3,5;3;2,9;2;1;1
258079593761;258079594236;475;1,3,5;3;2,9;2;1;1
258079594236;258079603408;9172;1,3,5;3;2,9;2;1;1
258079603408;258079628273;24865;1,3,5;3;2,9;2;1;1
258079628273;258079638430;10157;1,3,5;3;2,9;2;1;1
258079638430;258079638909;479;1,3,5;3;2,9;2;1;1
258079638909;258079645844;6935;1,3,5;3;2,9;2;1;1
258079645844;258079687174;41330;1,3,5;3;2,9;2;1;1
258079687174;258079714316;27142;1,3,5;3;2,9;2;1;1
258079714316;258079725987;11671;1,3,5;3;2,9;2;1;1
258079725987;258079726467;480;1,3,5;3;2,9;2;1;1
258079726467;258079729702;3235;1,3,5;3;2,9;2;1;1
258079729702;258079771094;41392;1,3,5;3;2,9;2;1;1
258079771094;258079773942;2848;1,3,5;3;2,9;2;1;1
258079773942;258079781065;7123;1,3,5;3;2,9;2;1;1
258079781065;258079784418;3353;1,3,5;3;2,9;2;1;1
258079784418;258079784900;482;1,3,5;3;2,9;2;1;1
258079784900;258079792558;7658;1,3,5;3;2,9;2;1;1
258079792558;258079793179;621;1,3,5;3;2,9;2;1;1
258079793179;258079794171;992;1,3,5;3;2,9;2;1;1
258079794171;258079806783;12612;1,3,5;3;2,9;2;1;1
258079806783;258079807462;679;1,3,5;3;2,9;2;1;1
258079807462;258079828780;21318;1,3,5;3;2,9;2;1;1
258079828780;258079844361;15581;1,3,5;3;2,9;2;1;1
258079844361;258079903176;58815;1,3,5;3;2,9;2;1;1
258079903176;258079903945;769;1,3,5;3;2,9;2;1;1
258079903945;258079906829;2884;1,3,5;3;2,9;2;1;1
258079906829;258079911548;4719;1,3,5;3;2,9;2;1;1
258079911548;258079937434;25886;1,3,5;3;2,9;2;1;1
258079937434;258079973448;36014;1,3,5;3;2,9;2;1;1
258079973448;258079973935;487;1,3,5;3;2,9;2;1;1
258079973935;258079976577;2642;1,3,5;3;2,9;2;1;1
258079976577;258079980674;4097;1,3,5;3;2,9;2;1;1
258079980674;258079989437;8763;1,3,5;3;2,9;2;1;1
258079989437;258079990087;650;1,3,5;3;2,9;2;1;1
258079990087;258080000218;10131;1,3,5;3;2,9;2;1;1
258080000218;258080011012;10794;1,3,5;3;2,9;2;1;1
258080011012;258080011490;478;1,3,5;3;2,9;2;1;1
258080011490;258080021788;10298;1,3,5;3;2,9;2;1;1
258080021788;258080030841;9053;1,3,5;3;2,9;2;1;1
258080030841;258080063439;32598;1,3,5;3;2,9;2;1;1
258080063439;258080067520;4081;1,3,5;3;2,9;2;1;1
258080067520;258080110459;42939;1,3,5;3;2,9;2;1;1
258080110459;258080143440;32981;1,3,5;3;2,9;2;1;1
258080143440;258080153756;10316;1,3,5;3;2,9;2;1;1
258080153756;258080157170;3414;1,3,5;3;2,9;2;1;1
258080157170;258080157821;651;1,3,5;3;2,9;2;1;1
258080157821;258080168847;11026;1,3,5;3;2,9;2;1;1
258080168847;258080179938;11091;1,3,5;3;2,9;2;1;1
258080179938;258080180417;479;1,3,5;3;2,9;2;1;1
258080180417;258080203704;23287;1,3,5;3;2,9;2;1;1
258080203704;258080219298;15594;1,3,5;3;2,9;2;1;1
258080219298;258080230785;11487;1,3,5;3;2,9;2;1;1
258080230785;258080231275;490;1,3,5;3;2,9;2;1;1
258080231275;258080261301;30026;1,3,5;3;2,9;2;1;1
258080261301;258080322073;60772;1,3,5;3;2,9;2;1;1
258080322073;258080363704;41631;1,3,5;3;2,9;2;1;1
258080363704;258080372151;8447;1,3,5;3;2,9;2;1;1
258080372151;258080373944;1793;1,3,5;3;2,9;2;1;1
258080373944;258080374434;490;1,3,5;3;2,9;2;1;1
258080374434;258080378311;3877;1,3,5;3;2,9;2;1;1
258080378311;258080391445;13134;1,3,5;3;2,9;2;1;1
258080391445;258080392097;652;1,3,5;3;2,9;2;1;1
258080392097;258080393710;1613;1,3,5;3;2,9;2;1;1
258080393710;258080407153;13443;1,3,5;3;2,9;2;1;1
258080407153;258080407805;652;1,3,5;3;2,9;2;1;1
258080407805;258080420106;12301;1,3,5;3;2,9;2;1;1
258080420106;258080444655;24549;1,3,5;3;2,9;2;1;1
258080444655;258080455558;10903;1,3,5;3;2,9;2;1;1
258080455558;258080456038;480;1,3,5;3;2,9;2;1;1
258080456038;258080462474;6436;1,3,5;3;2,9;2;1;1
258080462474;258080481485;19011;1,3,5;3;2,9;2;1;1
258080481485;258080512596;31111;1,3,5;3;2,9;2;1;1
258080512596;258080533030;20434;1,3,5;3;2,9;2;1;1
258080533030;258080544176;11146;1,3,5;3;2,9;2;1;1
258080544176;258080544661;485;1,3,5;3;2,9;2;1;1
258080544661;258080554166;9505;1,3,5;3;2,9;2;1;1
258080554166;258080556501;2335;1,3,5;3;2,9;2;1;1
258080556501;258080585714;29213;1,3,5;3;2,9;2;1;1
258080585714;258080594813;9099;1,3,5;3;2,9;2;1;1
258080594813;258080622418;27605;1,3,5;3;2,9;2;1;1
258080622418;258080630822;8404;1,3,5;3;2,9;2;1;1
258080630822;258080654961;24139;1,3,5;3;2,9;2;1;1
258080654961;258080700605;45644;1,3,5;3;2,9;2;1;1
258080700605;258080721444;20839;1,3,5;3;2,9;2;1;1
258080721444;258080725467;4023;1,3,5;3;2,9;2;1;1
258080725467;258080736056;10589;1,3,5;3;2,9;2;1;1
258080736056;258080736738;682;1,3,5;3;2,9;2;1;1
258080736738;258080738264;1526;1,3,5;3;2,9;2;1;1
258080738264;258080738752;488;1,3,5;3;2,9;2;1;1
258080738752;258080746897;8145;1,3,5;3;2,9;2;1;1
258080746897;258080755996;9099;1,3,5;3;2,9;2;1;1
258080755996;258080787299;31303;1,3,5;3;2,9;2;1;1
258080787299;258080811507;24208;1,3,5;3;2,9;2;1;1
258080811507;258080823122;11615;1,3,5;3;2,9;2;1;1
258080823122;258080823603;481;1,3,5;3;2,9;2;1;1
258080823603;258080831434;7831;1,3,5;3;2,9;2;1;1
258080831434;258080858735;27301;1,3,5;3;2,9;2;1;1
258080858735;258080870287;11552;1,3,5;3;2,9;2;1;1
258080870287;258080870778;491;1,3,5;3;2,9;2;1;1
258080870778;258080912214;41436;1,3,5;3;2,9;2;1;1
258080912214;258080924311;12097;1,3,5;3;2,9;2;1;1
258080924311;258080935163;10852;1,3,5;3;2,9;2;1;1
258080935163;258080935809;646;1,3,5;3;2,9;2;1;1
258080935809;258080954229;18420;1,3,5;3;2,9;2;1;1
258080954229;258080974353;20124;1,3,5;3;2,9;2;1;1
258080974353;258080987691;13338;1,3,5;3;2,9;2;1;1
258080987691;258080988341;650;1,3,5;3;2,9;2;1;1
258080988341;258081034258;45917;1,3,5;3;2,9;2;1;1
258081034258;258081036655;2397;1,3,5;3;2,9;2;1;1
258081036655;258081077573;40918;1,3,5;3;2,9;2;1;1
258081077573;258081098795;21222;1,3,5;3;2,9;2;1;1
258081098795;258081109788;10993;1,3,5;3;2,9;2;1;1
258081109788;258081110275;487;1,3,5;3;2,9;2;1;1
258081110275;258081113611;3336;1,3,5;3;2,9;2;1;1
258081113611;258081121863;8252;1,3,5;3;2,9;2;1;1
258081121863;258081155278;33415;1,3,5;3;2,9;2;1;1
258081155278;258081168717;13439;1,3,5;3;2,9;2;1;1
258081168717;258081180097;11380;1,3,5;3;2,9;2;1;1
258081180097;258081180631;534;1,3,5;3;2,9;2;1;1
258081180631;258081197506;16875;1,3,5;3;2,9;2;1;1
258081197506;258081199607;2101;1,3,5;3;2,9;2;1;1
258081199607;258081245296;45689;1,3,5;3;2,9;2;1;1
258081245296;258081266567;21271;1,3,5;3;2,9;2;1;1
258081266567;258081279492;12925;1,3,5;3;2,9;2;1;1
258081279492;258081279978;486;1,3,5;3;2,9;2;1;1
258081279978;258081304089;24111;1,3,5;3;2,9;2;1;1
258081304089;258081313326;9237;1,3,5;3;2,9;2;1;1
258081313326;258081347848;34522;1,3,5;3;2,9;2;1;1
258081347848;258081368163;20315;1,3,5;3;2,9;2;1;1
258081368163;258081378968;10805;1,3,5;3;2,9;2;1;1
258081378968;258081379446;478;1,3,5;3;2,9;2;1;1
258081379446;258081391708;12262;1,3,5;3;2,9;2;1;1
258081391708;258081426023;34315;1,3,5;3;2,9;2;1;1
258081426023;258081434814;8791;1,3,5;3;2,9;2;1;1
258081434814;258081436632;1818;1,3,5;3;2,9;2;1;1
258081436632;258081437112;480;1,3,5;3;2,9;2;1;1
258081437112;258081465746;28634;1,3,5;3;2,9;2;1;1
258081465746;258081476215;10469;1,3,5;3;2,9;2;1;1
258081476215;258081476703;488;1,3,5;3;2,9;2;1;1
258081476703;258081486684;9981;1,3,5;3;2,9;2;1;1
258081486684;258081495667;8983;1,3,5;3;2,9;2;1;1
258081495667;258081520241;24574;1,3,5;3;2,9;2;1;1
258081520241;258081541533;21292;1,3,5;3;2,9;2;1;1
258081541533;258081552859;11326;1,3,5;3;2,9;2;1;1
258081552859;258081553348;489;1,3,5;3;2,9;2;1;1
258081553348;258081567768;14420;1,3,5;3;2,9;2;1;1
258081567768;258081577002;9234;1,3,5;3;2,9;2;1;1
258081577002;258081608362;31360;1,3,5;3;2,9;2;1;1
258081608362;258081640990;32628;1,3,5;3;2,9;2;1;1
258081640990;258081659537;18547;1,3,5;3;2,9;2;1;1
258081659537;258081661882;2345;1,3,5;3;2,9;2;1;1
258081661882;258081697480;35598;1,3,5;3;2,9;2;1;1
258081697480;258081731154;33674;1,3,5;3;2,9;2;1;1
258081731154;258081733977;2823;1,3,5;3;2,9;2;1;1
258081733977;258081745429;11452;1,3,5;3;2,9;2;1;1
258081745429;258081746079;650;1,3,5;3;2,9;2;1;1
258081746079;258081754629;8550;1,3,5;3;2,9;2;1;1
258081754629;258081765298;10669;1,3,5;3;2,9;2;1;1
258081765298;258081765784;486;1,3,5;3;2,9;2;1;1
258081765784;258081786674;20890;1,3,5;3;2,9;2;1;1
258081786674;258081811448;24774;1,3,5;3;2,9;2;1;1
258081811448;258081835611;24163;1,3,5;3;2,9;2;1;1
258081835611;258081858184;22573;1,3,5;3;2,9;2;1;1
258081858184;258081870075;11891;1,3,5;3;2,9;2;1;1
258081870075;258081870560;485;1,3,5;3;2,9;2;1;1
258081870560;258081878708;8148;1,3,5;3;2,9;2;1;1
258081878708;258081892656;13948;1,3,5;3;2,9;2;1;1
258081892656;258081903926;11270;1,3,5;3;2,9;2;1;1
258081903926;258081904414;488;1,3,5;3;2,9;2;1;1
258081904414;258081909947;5533;1,3,5;3;2,9;2;1;1
258081909947;258081918734;8787;1,3,5;3;2,9;2;1;1
258081918734;258081953509;34775;1,3,5;3;2,9;2;1;1
258081953509;258081977329;23820;1,3,5;3;2,9;2;1;1
258081977329;258081988131;10802;1,3,5;3;2,9;2;1;1
258081988131;258081988621;490;1,3,5;3;2,9;2;1;1
258081988621;258081991529;2908;1,3,5;3;2,9;2;1;1
258081991529;258082002297;10768;1,3,5;3;2,9;2;1;1
258082002297;258082028421;26124;1,3,5;3;2,9;2;1;1
258082028421;258082036923;8502;1,3,5;3;2,9;2;1;1
258082036923;258082070335;33412;1,3,5;3;2,9;2;1;1
258082070335;258082096475;26140;1,3,5;3;2,9;2;1;1
258082096475;258082141530;45055;1,3,5;3;2,9;2;1;1
258082141530;258082161962;20432;1,3,5;3;2,9;2;1;1
258082161962;258082180314;18352;1,3,5;3;2,9;2;1;1
258082180314;258082213367;33053;1,3,5;3;2,9;2;1;1
258082213367;258082216589;3222;1,3,5;3;2,9;2;1;1
258082216589;258082235935;19346;1,3,5;3;2,9;2;1;1
258082235935;258082246434;10499;1,3,5;3;2,9;2;1;1
258082246434;258082246955;521;1,3,5;3;2,9;2;1;1
258082246955;258082263178;16223;1,3,5;3;2,9;2;1;1
258082263178;258082290611;27433;1,3,5;3;2,9;2;1;1
258082290611;258082301127;10516;1,3,5;3;2,9;2;1;1
258082301127;258082309125;7998;1,3,5;3;2,9;2;1;1
258082309125;258082342980;33855;1,3,5;3;2,9;2;1;1
258082342980;258082361939;18959;1,3,5;3;2,9;2;1;1
258082361939;258082366504;4565;1,3,5;3;2,9;2;1;1
258082366504;258082369094;2590;1,3,5;3;2,9;2;1;1
258082369094;258082415812;46718;1,3,5;3;2,9;2;1;1
258082415812;258082423563;7751;1,3,5;3;2,9;2;1;1
258082423563;258082457358;33795;1,3,5;3;2,9;2;1;1
258082457358;258082470515;13157;1,3,5;3;2,9;2;1;1
258082470515;258082499619;29104;1,3,5;3;2,9;2;1;1
258082499619;258082520162;20543;1,3,5;3;2,9;2;1;1
258082520162;258082531496;11334;1,3,5;3;2,9;2;1;1
258082531496;258082531986;490;1,3,5;3;2,9;2;1;1
258082531986;258082541600;9614;1,3,5;3;2,9;2;1;1
258082541600;258082571758;30158;1,3,5;3;2,9;2;1;1
258082571758;258082585069;13311;1,3,5;3;2,9;2;1;1
258082585069;258082593187;8118;1,3,5;3;2,9;2;1;1
258082593187;258082619498;26311;1,3,5;3;2,9;2;1;1
258082619498;258082627677;8179;1,3,5;3;2,9;2;1;1
258082627677;258082674852;47175;1,3,5;3;2,9;2;1;1
258082674852;258082676992;2140;1,3,5;3;2,9;2;1;1
258082676992;258082714913;37921;1,3,5;3;2,9;2;1;1
258082714913;258082722869;7956;1,3,5;3;2,9;2;1;1
258082722869;258082756371;33502;1,3,5;3;2,9;2;1;1
258082756371;258082778692;22321;1,3,5;3;2,9;2;1;1
258082778692;258082830337;51645;1,3,5;3;2,9;2;1;1
258082830337;258082834543;4206;1,3,5;3;2,9;2;1;1
258082834543;258082863155;28612;1,3,5;3;2,9;2;1;1
258082863155;258082865223;2068;1,3,5;3;2,9;2;1;1
258082865223;258082899477;34254;1,3,5;3;2,9;2;1;1
258082899477;258082920306;20829;1,3,5;3;2,9;2;1;1
258082920306;258082932687;12381;1,3,5;3;2,9;2;1;1
258082932687;258082951700;19013;1,3,5;3;2,9;2;1;1
258082951700;258082973868;22168;1,3,5;3;2,9;2;1;1
258082973868;258082998655;24787;1,3,5;3;2,9;2;1;1
258082998655;258083007126;8471;1,3,5;3;2,9;2;1;1
258083007126;258083007555;429;1,3,5;3;2,9;2;1;1
258083007555;258083038737;31182;1,3,5;3;2,9;2;1;1
258083038737;258083040816;2079;1,3,5;3;2,9;2;1;1
258083040816;258083070842;30026;1,3,5;3;2,9;2;1;1
258083070842;258083078938;8096;1,3,5;3;2,9;2;1;1
258083078938;258083102805;23867;1,3,5;3;2,9;2;1;1
258083102805;258083110755;7950;1,3,5;3;2,9;2;1;1
258083110755;258083148373;37618;1,3,5;3;2,9;2;1;1
258083148373;258083160920;12547;1,3,5;3;2,9;2;1;1
258083160920;258083172446;11526;1,3,5;3;2,9;2;1;1
258083172446;258083175080;2634;1,3,5;3;2,9;2;1;1
258083175080;258083197518;22438;1,3,5;3;2,9;2;1;1
258083197518;258083205695;8177;1,3,5;3;2,9;2;1;1
258083205695;258083214274;8579;1,3,5;3;2,9;2;1;1
258083214274;258083216338;2064;1,3,5;3;2,9;2;1;1
258083216338;258083255358;39020;1,3,5;3;2,9;2;1;1
258083255358;258083263292;7934;1,3,5;3;2,9;2;1;1
258083263292;258083297919;34627;1,3,5;3;2,9;2;1;1
258083297919;258083305598;7679;1,3,5;3;2,9;2;1;1
258083305598;258083331881;26283;1,3,5;3;2,9;2;1;1
258083331881;258083353136;21255;1,3,5;3;2,9;2;1;1
258083353136;258083371459;18323;1,3,5;3;2,9;2;1;1
258083371459;258083380809;9350;1,3,5;3;2,9;2;1;1
258083380809;258083430746;49937;1,3,5;3;2,9;2;1;1
258083430746;258083433420;2674;1,3,5;3;2,9;2;1;1
258083433420;258083434346;926;1,3,5;3;2,9;2;1;1
258083434346;258083441471;7125;1,3,5;3;2,9;2;1;1
258083441471;258083445438;3967;1,3,5;3;2,9;2;1;1
258083445438;258083445729;291;1,3,5;3;2,9;2;1;1
258083445729;258083449810;4081;1,3,5;3;2,9;2;1;1
258083449810;258083451682;1872;1,3,5;3;2,9;2;1;1
258083451682;258083463363;11681;1,3,5;3;2,9;2;1;1
258083463363;258083464018;655;1,3,5;3;2,9;2;1;1
258083464018;258083492581;28563;1,3,5;3;2,9;2;1;1
258083492581;258083496768;4187;1,3,5;3;2,9;2;1;1
258083496768;258083614374;117606;1,3,5;3;2,9;2;1;1
258083614374;258083658761;44387;1,3,5;3;2,9;2;1;1
258083658761;258083670619;11858;1,3,5;3;2,9;2;1;1
258083670619;258083682961;12342;1,3,5;3;2,9;2;1;1
258083682961;258083690009;7048;1,3,5;3;2,9;2;1;1
258083690009;258083690660;651;1,3,5;3;2,9;2;1;1
258083690660;258083701571;10911;1,3,5;3;2,9;2;1;1
258083701571;258083739932;38361;1,3,5;3;2,9;2;1;1
258083739932;258083751643;11711;1,3,5;3;2,9;2;1;1
258083751643;258083768641;16998;1,3,5;3;2,9;2;1;1
258083768641;258083769126;485;1,3,5;3;2,9;2;1;1
258083769126;258083788695;19569;1,3,5;3;2,9;2;1;1
258083788695;258083801255;12560;1,3,5;3;2,9;2;1;1
258083801255;258083820303;19048;1,3,5;3;2,9;2;1;1
258083820303;258083820953;650;1,3,5;3;2,9;2;1;1
258083820953;258083829564;8611;1,3,5;3;2,9;2;1;1
258083829564;258083845269;15705;1,3,5;3;2,9;2;1;1
258083845269;258083845749;480;1,3,5;3;2,9;2;1;1
258083845749;258083846802;1053;1,3,5;3;2,9;2;1;1
258083846802;258083870526;23724;1,3,5;3;2,9;2;1;1
258083870526;258083890687;20161;1,3,5;3;2,9;2;1;1
258083890687;258083891336;649;1,3,5;3;2,9;2;1;1
258083891336;258083891488;152;1,3,5;3;2,9;2;1;1
258083891488;258083908765;17277;1,3,5;3;2,9;2;1;1
258083908765;258083924749;15984;1,3,5;3;2,9;2;1;1
258083924749;258083925228;479;1,3,5;3;2,9;2;1;1
258083925228;258083932530;7302;1,3,5;3;2,9;2;1;1
258083932530;258083942335;9805;1,3,5;3;2,9;2;1;1
258083942335;258083960088;17753;1,3,5;3;2,9;2;1;1
258083960088;258083960584;496;1,3,5;3;2,9;2;1;1
258083960584;258083979208;18624;1,3,5;3;2,9;2;1;1
258083979208;258083988774;9566;1,3,5;3;2,9;2;1;1
258083988774;258084004756;15982;1,3,5;3;2,9;2;1;1
258084004756;258084005238;482;1,3,5;3;2,9;2;1;1
258084005238;258084033373;28135;1,3,5;3;2,9;2;1;1
258084033373;258084037178;3805;1,3,5;3;2,9;2;1;1
258084037178;258084055020;17842;1,3,5;3;2,9;2;1;1
258084055020;258084055503;483;1,3,5;3;2,9;2;1;1
258084055503;258084078262;22759;1,3,5;3;2,9;2;1;1
258084078262;258084083391;5129;1,3,5;3;2,9;2;1;1
258084083391;258084101286;17895;1,3,5;3;2,9;2;1;1
258084101286;258084101911;625;1,3,5;3;2,9;2;1;1
258084101911;258084120967;19056;1,3,5;3;2,9;2;1;1
258084120967;258084125120;4153;1,3,5;3;2,9;2;1;1
258084125120;258084144611;19491;1,3,5;3;2,9;2;1;1
258084144611;258084145088;477;1,3,5;3;2,9;2;1;1
258084145088;258084162844;17756;1,3,5;3;2,9;2;1;1
258084162844;258084172935;10091;1,3,5;3;2,9;2;1;1
258084172935;258084193193;20258;1,3,5;3;2,9;2;1;1
258084193193;258084193840;647;1,3,5;3;2,9;2;1;1
258084193840;258084213178;19338;1,3,5;3;2,9;2;1;1
258084213178;258084222953;9775;1,3,5;3;2,9;2;1;1
258084222953;258084238952;15999;1,3,5;3;2,9;2;1;1
258084238952;258084239431;479;1,3,5;3;2,9;2;1;1
258084239431;258084260023;20592;1,3,5;3;2,9;2;1;1
258084260023;258084280673;20650;1,3,5;3;2,9;2;1;1
258084280673;258084287551;6878;1,3,5;3;2,9;2;1;1
258084287551;258084298147;10596;1,3,5;3;2,9;2;1;1
258084298147;258084298625;478;1,3,5;3;2,9;2;1;1
258084298625;258084326411;27786;1,3,5;3;2,9;2;1;1
258084326411;258084345612;19201;1,3,5;3;2,9;2;1;1
258084345612;258084346774;1162;1,3,5;3;2,9;2;1;1
258084346774;258084347423;649;1,3,5;3;2,9;2;1;1
258084347423;258084376447;29024;1,3,5;3;2,9;2;1;1
258084376447;258084394644;18197;1,3,5;3;2,9;2;1;1
258084394644;258084395295;651;1,3,5;3;2,9;2;1;1
258084395295;258084423395;28100;1,3,5;3;2,9;2;1;1
258084423395;258084428139;4744;1,3,5;3;2,9;2;1;1
258084428139;258084444582;16443;1,3,5;3;2,9;2;1;1
258084444582;258084445062;480;1,3,5;3;2,9;2;1;1
258084445062;258084482360;37298;1,3,5;3;2,9;2;1;1
258084482360;258084486184;3824;1,3,5;3;2,9;2;1;1
258084486184;258084502836;16652;1,3,5;3;2,9;2;1;1
258084502836;258084503319;483;1,3,5;3;2,9;2;1;1
258084503319;258084531471;28152;1,3,5;3;2,9;2;1;1
258084531471;258084536347;4876;1,3,5;3;2,9;2;1;1
258084536347;258084552104;15757;1,3,5;3;2,9;2;1;1
258084552104;258084552602;498;1,3,5;3;2,9;2;1;1
258084552602;258084581609;29007;1,3,5;3;2,9;2;1;1
258084581609;258084591502;9893;1,3,5;3;2,9;2;1;1
258084591502;258084607689;16187;1,3,5;3;2,9;2;1;1
258084607689;258084608239;550;1,3,5;3;2,9;2;1;1
258084608239;258084623695;15456;1,3,5;3;2,9;2;1;1
258084623695;258084634044;10349;1,3,5;3;2,9;2;1;1
258084634044;258084652478;18434;1,3,5;3;2,9;2;1;1
258084652478;258084653055;577;1,3,5;3;2,9;2;1;1
258084653055;258084665513;12458;1,3,5;3;2,9;2;1;1
258084665513;258084676223;10710;1,3,5;3;2,9;2;1;1
258084676223;258084693406;17183;1,3,5;3;2,9;2;1;1
258084693406;258084694147;741;1,3,5;3;2,9;2;1;1
258084694147;258084706356;12209;1,3,5;3;2,9;2;1;1
258084706356;258084725723;19367;1,3,5;3;2,9;2;1;1
258084725723;258084743737;18014;1,3,5;3;2,9;2;1;1
258084743737;258084744342;605;1,3,5;3;2,9;2;1;1
258084744342;258084744991;649;1,3,5;3;2,9;2;1;1
258084744991;258084771844;26853;1,3,5;3;2,9;2;1;1
258084771844;258084785024;13180;1,3,5;3;2,9;2;1;1
258084785024;258084788695;3671;1,3,5;3;2,9;2;1;1
258084788695;258084788929;234;1,3,5;3;2,9;2;1;1
258084788929;258084789180;251;1,3,5;3;2,9;2;1;1
258084789180;258084808977;19797;1,3,5;3;2,9;2;1;1
258084808977;258084809942;965;1,3,5;3;2,9;2;1;1
258084809942;258084826784;16842;1,3,5;3;2,9;2;1;1
258084826784;258084831711;4927;1,3,5;3;2,9;2;1;1
258084831711;258084847966;16255;1,3,5;3;2,9;2;1;1
258084847966;258084848553;587;1,3,5;3;2,9;2;1;1
258084848553;258084870147;21594;1,3,5;3;2,9;2;1;1
258084870147;258084880582;10435;1,3,5;3;2,9;2;1;1
258084880582;258084896313;15731;1,3,5;3;2,9;2;1;1
258084896313;258084896791;478;1,3,5;3;2,9;2;1;1
258084896791;258084917120;20329;1,3,5;3;2,9;2;1;1
258084917120;258084922110;4990;1,3,5;3;2,9;2;1;1
258084922110;258084937901;15791;1,3,5;3;2,9;2;1;1
258084937901;258084938450;549;1,3,5;3;2,9;2;1;1
258084938450;258084958634;20184;1,3,5;3;2,9;2;1;1
258084958634;258084969007;10373;1,3,5;3;2,9;2;1;1
258084969007;258084985308;16301;1,3,5;3;2,9;2;1;1
258084985308;258084985794;486;1,3,5;3;2,9;2;1;1
258084985794;258084989059;3265;1,3,5;3;2,9;2;1;1
258084989059;258084999452;10393;1,3,5;3;2,9;2;1;1
258084999452;258085021367;21915;1,3,5;3;2,9;2;1;1
258085021367;258085022588;1221;1,3,5;3;2,9;2;1;1
258085022588;258085024772;2184;1,3,5;3;2,9;2;1;1
258085024772;258085035604;10832;1,3,5;3;2,9;2;1;1
258085035604;258085058063;22459;1,3,5;3;2,9;2;1;1
258085058063;258085058715;652;1,3,5;3;2,9;2;1;1
258085058715;258085061752;3037;1,3,5;3;2,9;2;1;1
258085061752;258085071788;10036;1,3,5;3;2,9;2;1;1
258085071788;258085091197;19409;1,3,5;3;2,9;2;1;1
258085091197;258085091843;646;1,3,5;3;2,9;2;1;1
258085091843;258085102676;10833;1,3,5;3;2,9;2;1;1
258085102676;258085107824;5148;1,3,5;3;2,9;2;1;1
258085107824;258085126630;18806;1,3,5;3;2,9;2;1;1
258085126630;258085127282;652;1,3,5;3;2,9;2;1;1
258085127282;258085155371;28089;1,3,5;3;2,9;2;1;1
258085155371;258085165991;10620;1,3,5;3;2,9;2;1;1
258085165991;258085182342;16351;1,3,5;3;2,9;2;1;1
258085182342;258085182834;492;1,3,5;3;2,9;2;1;1
258085182834;258085205445;22611;1,3,5;3;2,9;2;1;1
258085205445;258085210304;4859;1,3,5;3;2,9;2;1;1
258085210304;258085225683;15379;1,3,5;3;2,9;2;1;1
258085225683;258085226252;569;1,3,5;3;2,9;2;1;1
258085226252;258085255492;29240;1,3,5;3;2,9;2;1;1
258085255492;258085295068;39576;1,3,5;3;2,9;2;1;1
258085295068;258085314172;19104;1,3,5;3;2,9;2;1;1
258085314172;258085314802;630;1,3,5;3;2,9;2;1;1
258085314802;258085315455;653;1,3,5;3;2,9;2;1;1
258085315455;258085322943;7488;1,3,5;3;2,9;2;1;1
258085322943;258085358105;35162;1,3,5;3;2,9;2;1;1
258085358105;258085386575;28470;1,3,5;3;2,9;2;1;1
258085386575;258085403246;16671;1,3,5;3;2,9;2;1;1
258085403246;258085403727;481;1,3,5;3;2,9;2;1;1
258085403727;258085404941;1214;1,3,5;3;2,9;2;1;1
258085404941;258085429489;24548;1,3,5;3;2,9;2;1;1
258085429489;258085437178;7689;1,3,5;3;2,9;2;1;1
258085437178;258085448297;11119;1,3,5;3;2,9;2;1;1
258085448297;258085448948;651;1,3,5;3;2,9;2;1;1
258085448948;258085478845;29897;1,3,5;3;2,9;2;1;1
258085478845;258085485422;6577;1,3,5;3;2,9;2;1;1
258085485422;258085495490;10068;1,3,5;3;2,9;2;1;1
258085495490;258085495979;489;1,3,5;3;2,9;2;1;1
258085495979;258085496146;167;1,3,5;3;2,9;2;1;1
258085496146;258085515345;19199;1,3,5;3;2,9;2;1;1
258085515345;258085515996;651;1,3,5;3;2,9;2;1;1
258085515996;258085531128;15132;1,3,5;3;2,9;2;1;1
258085531128;258085534754;3626;1,3,5;3;2,9;2;1;1
258085534754;258085572385;37631;1,3,5;3;2,9;2;1;1
258085572385;258085577549;5164;1,3,5;3;2,9;2;1;1
258085577549;258085595045;17496;1,3,5;3;2,9;2;1;1
258085595045;258085595695;650;1,3,5;3;2,9;2;1;1
258085595695;258085623483;27788;1,3,5;3;2,9;2;1;1
258085623483;258085632229;8746;1,3,5;3;2,9;2;1;1
258085632229;258085665402;33173;1,3,5;3;2,9;2;1;1
258085665402;258085675526;10124;1,3,5;3;2,9;2;1;1
258085675526;258085695018;19492;1,3,5;3;2,9;2;1;1
258085695018;258085695669;651;1,3,5;3;2,9;2;1;1
258085695669;258085712608;16939;1,3,5;3;2,9;2;1;1
258085712608;258085722779;10171;1,3,5;3;2,9;2;1;1
258085722779;258085742295;19516;1,3,5;3;2,9;2;1;1
258085742295;258085742954;659;1,3,5;3;2,9;2;1;1
258085742954;258085752952;9998;1,3,5;3;2,9;2;1;1
258085752952;258085792753;39801;1,3,5;3;2,9;2;1;1
258085792753;258085804252;11499;1,3,5;3;2,9;2;1;1
258085804252;258085804806;554;1,3,5;3;2,9;2;1;1
258085804806;258085823916;19110;1,3,5;3;2,9;2;1;1
258085823916;258085824566;650;1,3,5;3;2,9;2;1;1
258085824566;258085830789;6223;1,3,5;3;2,9;2;1;1
258085830789;258085831312;523;1,3,5;3;2,9;2;1;1
258085831312;258085855792;24480;1,3,5;3;2,9;2;1;1
258085855792;258085859771;3979;1,3,5;3;2,9;2;1;1
258085859771;258085875161;15390;1,3,5;3;2,9;2;1;1
258085875161;258085875648;487;1,3,5;3;2,9;2;1;1
258085875648;258085896307;20659;1,3,5;3;2,9;2;1;1
258085896307;258085898893;2586;1,3,5;3;2,9;2;1;1
258085898893;258085939200;40307;1,3,5;3;2,9;2;1;1
258085939200;258085948215;9015;1,3,5;3;2,9;2;1;1
258085948215;258085969958;21743;1,3,5;3;2,9;2;1;1
258085969958;258085980376;10418;1,3,5;3;2,9;2;1;1
258085980376;258085996108;15732;1,3,5;3;2,9;2;1;1
258085996108;258085996647;539;1,3,5;3;2,9;2;1;1
258085996647;258086027477;30830;1,3,5;3;2,9;2;1;1
258086027477;258086052868;25391;1,3,5;3;2,9;2;1;1
258086052868;258086070388;17520;1,3,5;3;2,9;2;1;1
258086070388;258086070877;489;1,3,5;3;2,9;2;1;1
258086070877;258086101446;30569;1,3,5;3;2,9;2;1;1
258086101446;258086107061;5615;1,3,5;3;2,9;2;1;1
258086107061;258086123287;16226;1,3,5;3;2,9;2;1;1
258086123287;258086128120;4833;1,3,5;3;2,9;2;1;1
258086128120;258086128959;839;1,3,5;3;2,9;2;1;1
258086128959;258086129330;371;1,3,5;3;2,9;2;1;1
258086129330;258086150091;20761;1,3,5;3;2,9;2;1;1
258086150091;258086150328;237;1,3,5;3;2,9;2;1;1
258086150328;258086150978;650;1,3,5;3;2,9;2;1;1
258086150978;258086160087;9109;1,3,5;3;2,9;2;1;1
258086160087;258086177686;17599;1,3,5;3;2,9;2;1;1
258086177686;258086178347;661;1,3,5;3;2,9;2;1;1
258086178347;258086188482;10135;1,3,5;3;2,9;2;1;1
258086188482;258086191078;2596;1,3,5;3;2,9;2;1;1
258086191078;258086220614;29536;1,3,5;3;2,9;2;1;1
258086220614;258086235771;15157;1,3,5;3;2,9;2;1;1
258086235771;258086261700;25929;1,3,5;3;2,9;2;1;1
258086261700;258086271045;9345;1,3,5;3;2,9;2;1;1
258086271045;258086303701;32656;1,3,5;3;2,9;2;1;1
258086303701;258086313728;10027;1,3,5;3;2,9;2;1;1
258086313728;258086333109;19381;1,3,5;3;2,9;2;1;1
258086333109;258086333761;652;1,3,5;3;2,9;2;1;1
258086333761;258086354139;20378;1,3,5;3;2,9;2;1;1
258086354139;258086379436;25297;1,3,5;3;2,9;2;1;1
258086379436;258086400092;20656;1,3,5;3;2,9;2;1;1
258086400092;258086400856;764;1,3,5;3;2,9;2;1;1
258086400856;258086407960;7104;1,3,5;3;2,9;2;1;1
258086407960;258086419214;11254;1,3,5;3;2,9;2;1;1
258086419214;258086449815;30601;1,3,5;3;2,9;2;1;1
258086449815;258086453879;4064;1,3,5;3;2,9;2;1;1
258086453879;258086474240;20361;1,3,5;3;2,9;2;1;1
258086474240;258086474896;656;1,3,5;3;2,9;2;1;1
258086474896;258086481063;6167;1,3,5;3;2,9;2;1;1
258086481063;258086489727;8664;1,3,5;3;2,9;2;1;1
258086489727;258086554609;64882;1,3,5;3;2,9;2;1;1
258086554609;258086564137;9528;1,3,5;3;2,9;2;1;1
258086564137;258086596519;32382;1,3,5;3;2,9;2;1;1
258086596519;258086598928;2409;1,3,5;3;2,9;2;1;1
258086598928;258086645939;47011;1,3,5;3;2,9;2;1;1
258086645939;258086658069;12130;1,3,5;3;2,9;2;1;1
258086658069;258086689806;31737;1,3,5;3;2,9;2;1;1
258086689806;258086698782;8976;1,3,5;3;2,9;2;1;1
258086698782;258086731820;33038;1,3,5;3;2,9;2;1;1
258086731820;258086751899;20079;1,3,5;3;2,9;2;1;1
258086751899;258086767724;15825;1,3,5;3;2,9;2;1;1
258086767724;258086770035;2311;1,3,5;3;2,9;2;1;1
258086770035;258086808015;37980;1,3,5;3;2,9;2;1;1
258086808015;258086816280;8265;1,3,5;3;2,9;2;1;1
258086816280;258086855825;39545;1,3,5;3;2,9;2;1;1
258086855825;258086864028;8203;1,3,5;3;2,9;2;1;1
258086864028;258086899708;35680;1,3,5;3;2,9;2;1;1
258086899708;258086902082;2374;1,3,5;3;2,9;2;1;1
258086902082;258086939493;37411;1,3,5;3;2,9;2;1;1
258086939493;258086942119;2626;1,3,5;3;2,9;2;1;1
258086942119;258086994782;52663;1,3,5;3;2,9;2;1;1
258086994782;258087034146;39364;1,3,5;3;2,9;2;1;1
258087034146;258087040626;6480;1,3,5;3;2,9;2;1;1
258087040626;258087042957;2331;1,3,5;3;2,9;2;1;1
258087042957;258087057426;14469;1,3,5;3;2,9;2;1;1
258087057426;258087057919;493;1,3,5;3;2,9;2;1;1
258087057919;258087084627;26708;1,3,5;3;2,9;2;1;1
258087084627;258087094147;9520;1,3,5;3;2,9;2;1;1
258087094147;258087125190;31043;1,3,5;3;2,9;2;1;1
258087125190;258087134484;9294;1,3,5;3;2,9;2;1;1
258087134484;258087165448;30964;1,3,5;3;2,9;2;1;1
258087165448;258087191472;26024;1,3,5;3;2,9;2;1;1
258087191472;258087205764;14292;1,3,5;3;2,9;2;1;1
258087205764;258087207979;2215;1,3,5;3;2,9;2;1;1
258087207979;258087210798;2819;1,3,5;3;2,9;2;1;1
258087210798;258087211448;650;1,3,5;3;2,9;2;1;1
258087211448;258087266803;55355;1,3,5;3;2,9;2;1;1
258087266803;258087291108;24305;1,3,5;3;2,9;2;1;1
258087291108;258087320075;28967;1,3,5;3;2,9;2;1;1
258087320075;258087322541;2466;1,3,5;3;2,9;2;1;1
258087322541;258087352442;29901;1,3,5;3;2,9;2;1;1
258087352442;258087393056;40614;1,3,5;3;2,9;2;1;1
258087393056;258087394657;1601;1,3,5;3;2,9;2;1;1
258087394657;258087402642;7985;1,3,5;3;2,9;2;1;1
258087402642;258087411290;8648;1,3,5;3;2,9;2;1;1
258087411290;258087411940;650;1,3,5;3;2,9;2;1;1
258087411940;258087451087;39147;1,3,5;3;2,9;2;1;1
258087451087;258087475567;24480;1,3,5;3;2,9;2;1;1
258087475567;258087484391;8824;1,3,5;3;2,9;2;1;1
258087484391;258087485557;1166;1,3,5;3;2,9;2;1;1
258087485557;258087512917;27360;1,3,5;3;2,9;2;1;1
258087512917;258087537475;24558;1,3,5;3;2,9;2;1;1
258087537475;258087555593;18118;1,3,5;3;2,9;2;1;1
258087555593;258087556074;481;1,3,5;3;2,9;2;1;1
258087556074;258087556209;135;1,3,5;3;2,9;2;1;1
258087556209;258087565136;8927;1,3,5;3;2,9;2;1;1
258087565136;258087611545;46409;1,3,5;3;2,9;2;1;1
258087611545;258087620143;8598;1,3,5;3;2,9;2;1;1
258087620143;258087653982;33839;1,3,5;3;2,9;2;1;1
258087653982;258087662128;8146;1,3,5;3;2,9;2;1;1
258087662128;258087716109;53981;1,3,5;3;2,9;2;1;1
258087716109;258087718770;2661;1,3,5;3;2,9;2;1;1
258087718770;258087748754;29984;1,3,5;3;2,9;2;1;1
258087748754;258087750971;2217;1,3,5;3;2,9;2;1;1
258087750971;258087789099;38128;1,3,5;3;2,9;2;1;1
258087789099;258087800489;11390;1,3,5;3;2,9;2;1;1
258087800489;258087819757;19268;1,3,5;3;2,9;2;1;1
258087819757;258087820573;816;1,3,5;3;2,9;2;1;1
258087820573;258087841920;21347;1,3,5;3;2,9;2;1;1
258087841920;258087850520;8600;1,3,5;3;2,9;2;1;1
258087850520;258087883697;33177;1,3,5;3;2,9;2;1;1
258087883697;258087892329;8632;1,3,5;3;2,9;2;1;1
258087892329;258087924874;32545;1,3,5;3;2,9;2;1;1
258087924874;258087934102;9228;1,3,5;3;2,9;2;1;1
258087934102;258087965836;31734;1,3,5;3;2,9;2;1;1
258087965836;258087974226;8390;1,3,5;3;2,9;2;1;1
258087974226;258087997593;23367;1,3,5;3;2,9;2;1;1
258087997593;258088005748;8155;1,3,5;3;2,9;2;1;1
258088005748;258088040776;35028;1,3,5;3;2,9;2;1;1
258088040776;258088062860;22084;1,3,5;3;2,9;2;1;1
258088062860;258088079494;16634;1,3,5;3;2,9;2;1;1
258088079494;258088079982;488;1,3,5;3;2,9;2;1;1
258088079982;258088081396;1414;1,3,5;3;2,9;2;1;1
258088081396;258088089488;8092;1,3,5;3;2,9;2;1;1
258088089488;258088104675;15187;1,3,5;3;2,9;2;1;1
258088104675;258088105156;481;1,3,5;3;2,9;2;1;1
258088105156;258088122986;17830;1,3,5;3;2,9;2;1;1
258088122986;258088131337;8351;1,3,5;3;2,9;2;1;1
258088131337;258088251742;120405;1,3,5;3;2,9;2;1;1
258088251742;258088254127;2385;1,3,5;3;2,9;2;1;1
258088254127;258088295743;41616;1,3,5;3;2,9;2;1;1
258088295743;258088298205;2462;1,3,5;3;2,9;2;1;1
258088298205;258088341785;43580;1,3,5;3;2,9;2;1;1
258088341785;258088344285;2500;1,3,5;3;2,9;2;1;1
258088344285;258088372617;28332;1,3,5;3;2,9;2;1;1
258088372617;258088377925;5308;1,3,5;3;2,9;2;1;1
258088377925;258088392981;15056;1,3,5;3;2,9;2;1;1
258088392981;258088393471;490;1,3,5;3;2,9;2;1;1
258088393471;258088418252;24781;1,3,5;3;2,9;2;1;1
258088418252;258088448164;29912;1,3,5;3;2,9;2;1;1
258088448164;258088458502;10338;1,3,5;3;2,9;2;1;1
258088458502;258088466589;8087;1,3,5;3;2,9;2;1;1
258088466589;258088466921;332;1,3,5;3;2,9;2;1;1
258088466921;258088467571;650;1,3,5;3;2,9;2;1;1
258088467571;258088497674;30103;1,3,5;3;2,9;2;1;1
258088497674;258088505958;8284;1,3,5;3;2,9;2;1;1
258088505958;258088546710;40752;1,3,5;3;2,9;2;1;1
258088546710;258088549913;3203;1,3,5;3;2,9;2;1;1
258088549913;258088589556;39643;1,3,5;3;2,9;2;1;1
258088589556;258088597913;8357;1,3,5;3;2,9;2;1;1
258088597913;258088629588;31675;1,3,5;3;2,9;2;1;1
258088629588;258088638526;8938;1,3,5;3;2,9;2;1;1
258088638526;258088670817;32291;1,3,5;3;2,9;2;1;1
258088670817;258088674334;3517;1,3,5;3;2,9;2;1;1
258088674334;258088690176;15842;1,3,5;3;2,9;2;1;1
258088690176;258088690655;479;1,3,5;3;2,9;2;1;1
258088690655;258088728321;37666;1,3,5;3;2,9;2;1;1
258088728321;258088737331;9010;1,3,5;3;2,9;2;1;1
258088737331;258088756527;19196;1,3,5;3;2,9;2;1;1
258088756527;258088757286;759;1,3,5;3;2,9;2;1;1
258088757286;258088766327;9041;1,3,5;3;2,9;2;1;1
258088766327;258088791210;24883;1,3,5;3;2,9;2;1;1
258088791210;258088806151;14941;1,3,5;3;2,9;2;1;1
258088806151;258088814387;8236;1,3,5;3;2,9;2;1;1
258088814387;258088849376;34989;1,3,5;3;2,9;2;1;1
258088849376;258088851571;2195;1,3,5;3;2,9;2;1;1
258088851571;258088880633;29062;1,3,5;3;2,9;2;1;1
258088880633;258088891474;10841;1,3,5;3;2,9;2;1;1
258088891474;258088908609;17135;1,3,5;3;2,9;2;1;1
258088908609;258088909094;485;1,3,5;3;2,9;2;1;1
258088909094;258088927846;18752;1,3,5;3;2,9;2;1;1
258088927846;258088940072;12226;1,3,5;3;2,9;2;1;1
258088940072;258088958321;18249;1,3,5;3;2,9;2;1;1
258088958321;258088958972;651;1,3,5;3;2,9;2;1;1
258088958972;258088961846;2874;1,3,5;3;2,9;2;1;1
258088961846;258088971665;9819;1,3,5;3;2,9;2;1;1
258088971665;258088991149;19484;1,3,5;3;2,9;2;1;1
258088991149;258088991914;765;1,3,5;3;2,9;2;1;1
258088991914;258088996198;4284;1,3,5;3;2,9;2;1;1
258088996198;258089018713;22515;1,3,5;3;2,9;2;1;1
258089018713;258089033838;15125;1,3,5;3;2,9;2;1;1
258089033838;258089034317;479;1,3,5;3;2,9;2;1;1
258089034317;258089035378;1061;1,3,5;3;2,9;2;1;1
258089035378;258089059040;23662;1,3,5;3;2,9;2;1;1
258089059040;258089070671;11631;1,3,5;3;2,9;2;1;1
258089070671;258089079570;8899;1,3,5;3;2,9;2;1;1
258089079570;258089108762;29192;1,3,5;3;2,9;2;1;1
258089108762;258089111401;2639;1,3,5;3;2,9;2;1;1
258089111401;258089147442;36041;1,3,5;3;2,9;2;1;1
258089147442;258089149888;2446;1,3,5;3;2,9;2;1;1
258089149888;258089197165;47277;1,3,5;3;2,9;2;1;1
258089197165;258089210961;13796;1,3,5;3;2,9;2;1;1
258089210961;258089226703;15742;1,3,5;3;2,9;2;1;1
258089226703;258089227183;480;1,3,5;3;2,9;2;1;1
258089227183;258089245285;18102;1,3,5;3;2,9;2;1;1
258089245285;258089256614;11329;1,3,5;3;2,9;2;1;1
258089256614;258089271979;15365;1,3,5;3;2,9;2;1;1
258089271979;258089272462;483;1,3,5;3;2,9;2;1;1
258089272462;258089283633;11171;1,3,5;3;2,9;2;1;1
258089283633;258089311053;27420;1,3,5;3;2,9;2;1;1
258089311053;258089329379;18326;1,3,5;3;2,9;2;1;1
258089329379;258089330380;1001;1,3,5;3;2,9;2;1;1
258089330380;258089331027;647;1,3,5;3;2,9;2;1;1
258089331027;258089341164;10137;1,3,5;3;2,9;2;1;1
258089341164;258089356729;15565;1,3,5;3;2,9;2;1;1
258089356729;258089357205;476;1,3,5;3;2,9;2;1;1
258089357205;258089370895;13690;1,3,5;3;2,9;2;1;1
258089370895;258089392082;21187;1,3,5;3;2,9;2;1;1
258089392082;258089406667;14585;1,3,5;3;2,9;2;1;1
258089406667;258089407149;482;1,3,5;3;2,9;2;1;1
258089407149;258089431442;24293;1,3,5;3;2,9;2;1;1
258089431442;258089437713;6271;1,3,5;3;2,9;2;1;1
258089437713;258089455706;17993;1,3,5;3;2,9;2;1;1
258089455706;258089456357;651;1,3,5;3;2,9;2;1;1
258089456357;258089485081;28724;1,3,5;3;2,9;2;1;1
258089485081;258089494702;9621;1,3,5;3;2,9;2;1;1
258089494702;258089519114;24412;1,3,5;3;2,9;2;1;1
258089519114;258089544594;25480;1,3,5;3;2,9;2;1;1
258089544594;258089563293;18699;1,3,5;3;2,9;2;1;1
258089563293;258089563895;602;1,3,5;3;2,9;2;1;1
258089563895;258089563940;45;1,3,5;3;2,9;2;1;1
258089563940;258089589591;25651;1,3,5;3;2,9;2;1;1
258089589591;258089607688;18097;1,3,5;3;2,9;2;1;1
258089607688;258089608173;485;1,3,5;3;2,9;2;1;1
258089608173;258089615393;7220;1,3,5;3;2,9;2;1;1
258089615393;258089646962;31569;1,3,5;3;2,9;2;1;1
258089646962;258089648499;1537;1,3,5;3;2,9;2;1;1
258089648499;258089660676;12177;1,3,5;3;2,9;2;1;1
258089660676;258089664695;4019;1,3,5;3;2,9;2;1;1
258089664695;258089665345;650;1,3,5;3;2,9;2;1;1
258089665345;258089679903;14558;1,3,5;3;2,9;2;1;1
258089679903;258089680553;650;1,3,5;3;2,9;2;1;1
258089680553;258089689632;9079;1,3,5;3;2,9;2;1;1
258089689632;258089692165;2533;1,3,5;3;2,9;2;1;1
258089692165;258090039834;347669;1,3,5;3;2,9;2;1;1
258090039834;258090042061;2227;1,3,5;3;2,9;2;1;1
258090042061;258090087165;45104;1,3,5;3;2,9;2;1;1
258090087165;258090095667;8502;1,3,5;3;2,9;2;1;1
258090095667;258090142044;46377;1,3,5;3;2,9;2;1;1
258090142044;258090147579;5535;1,3,5;3;2,9;2;1;1
258090147579;258090163211;15632;1,3,5;3;2,9;2;1;1
258090163211;258090163704;493;1,3,5;3;2,9;2;1;1
258090163704;258090178472;14768;1,3,5;3;2,9;2;1;1
258090178472;258090199276;20804;1,3,5;3;2,9;2;1;1
258090199276;258090215388;16112;1,3,5;3;2,9;2;1;1
258090215388;258090215893;505;1,3,5;3;2,9;2;1;1
258090215893;258090217134;1241;1,3,5;3;2,9;2;1;1
258090217134;258090219740;2606;1,3,5;3;2,9;2;1;1
258090219740;258090284358;64618;1,3,5;3;2,9;2;1;1
258090284358;258090296303;11945;1,3,5;3;2,9;2;1;1
258090296303;258090314760;18457;1,3,5;3;2,9;2;1;1
258090314760;258090315574;814;1,3,5;3;2,9;2;1;1
258090315574;258090320525;4951;1,3,5;3;2,9;2;1;1
258090320525;258090357673;37148;1,3,5;3;2,9;2;1;1
258090357673;258090379934;22261;1,3,5;3;2,9;2;1;1
258090379934;258090382067;2133;1,3,5;3;2,9;2;1;1
258090382067;258090394578;12511;1,3,5;3;2,9;2;1;1
258090394578;258090395058;480;1,3,5;3;2,9;2;1;1
258090395058;258090397715;2657;1,3,5;3;2,9;2;1;1
258090397715;258090398201;486;1,3,5;3;2,9;2;1;1
258090398201;258090407999;9798;1,3,5;3;2,9;2;1;1
258090407999;258090410731;2732;1,3,5;3;2,9;2;1;1
258090410731;258090439323;28592;1,3,5;3;2,9;2;1;1
258090439323;258090448112;8789;1,3,5;3;2,9;2;1;1
258090448112;258090477105;28993;1,3,5;3;2,9;2;1;1
258090477105;258090479309;2204;1,3,5;3;2,9;2;1;1
258090479309;258090509803;30494;1,3,5;3;2,9;2;1;1
258090509803;258090514096;4293;1,3,5;3;2,9;2;1;1
258090514096;258090533447;19351;1,3,5;3;2,9;2;1;1
258090533447;258090534098;651;1,3,5;3;2,9;2;1;1
258090534098;258090551076;16978;1,3,5;3;2,9;2;1;1
258090551076;258090577086;26010;1,3,5;3;2,9;2;1;1
258090577086;258090592379;15293;1,3,5;3;2,9;2;1;1
258090592379;258090593055;676;1,3,5;3;2,9;2;1;1
258090593055;258090597944;4889;1,3,5;3;2,9;2;1;1
258090597944;258090600814;2870;1,3,5;3;2,9;2;1;1
258090600814;258090639810;38996;1,3,5;3;2,9;2;1;1
258090639810;258090642476;2666;1,3,5;3;2,9;2;1;1
258090642476;258090672145;29669;1,3,5;3;2,9;2;1;1
258090672145;258090699999;27854;1,3,5;3;2,9;2;1;1
258090699999;258090718742;18743;1,3,5;3;2,9;2;1;1
258090718742;258090719001;259;1,3,5;3;2,9;2;1;1
258090719001;258090719650;649;1,3,5;3;2,9;2;1;1
258090719650;258090754830;35180;1,3,5;3;2,9;2;1;1
258090754830;258090757194;2364;1,3,5;3;2,9;2;1;1
258090757194;258090775202;18008;1,3,5;3;2,9;2;1;1
258090775202;258090775689;487;1,3,5;3;2,9;2;1;1
258090775689;258090784051;8362;1,3,5;3;2,9;2;1;1
258090784051;258090791717;7666;1,3,5;3;2,9;2;1;1
258090791717;258090806693;14976;1,3,5;3;2,9;2;1;1
258090806693;258090807172;479;1,3,5;3;2,9;2;1;1
258090807172;258090814390;7218;1,3,5;3;2,9;2;1;1
258090814390;258090824790;10400;1,3,5;3;2,9;2;1;1
258090824790;258090830328;5538;1,3,5;3;2,9;2;1;1
258090830328;258090830816;488;1,3,5;3;2,9;2;1;1
258090830816;258090867496;36680;1,3,5;3;2,9;2;1;1
258090867496;258090879661;12165;1,3,5;3;2,9;2;1;1
258090879661;258090882196;2535;1,3,5;3;2,9;2;1;1
258090882196;258090882676;480;1,3,5;3;2,9;2;1;1
258090882676;258090907830;25154;1,3,5;3;2,9;2;1;1
258090907830;258090919166;11336;1,3,5;3;2,9;2;1;1
258090919166;258090924950;5784;1,3,5;3;2,9;2;1;1
258090924950;258090925427;477;1,3,5;3;2,9;2;1;1
258090925427;258090958824;33397;1,3,5;3;2,9;2;1;1
258090958824;258090960865;2041;1,3,5;3;2,9;2;1;1
258090960865;258090961344;479;1,3,5;3;2,9;2;1;1
258090961344;258090975762;14418;1,3,5;3;2,9;2;1;1
258090975762;258090976247;485;1,3,5;3;2,9;2;1;1
258090976247;258090999018;22771;1,3,5;3;2,9;2;1;1
258090999018;258091045088;46070;1,3,5;3;2,9;2;1;1
258091045088;258091046463;1375;1,3,5;3;2,9;2;1;1
258091046463;258091064880;18417;1,3,5;3;2,9;2;1;1
258091064880;258091065532;652;1,3,5;3;2,9;2;1;1
258091065532;258091079011;13479;1,3,5;3;2,9;2;1;1
258091079011;258091094340;15329;1,3,5;3;2,9;2;1;1
258091094340;258091094825;485;1,3,5;3;2,9;2;1;1
258091094825;258091096621;1796;1,3,5;3;2,9;2;1;1
258091096621;258091119358;22737;1,3,5;3;2,9;2;1;1
258091119358;258091135118;15760;1,3,5;3;2,9;2;1;1
258091135118;258091135603;485;1,3,5;3;2,9;2;1;1
258091135603;258091140193;4590;1,3,5;3;2,9;2;1;1
258091140193;258091165599;25406;1,3,5;3;2,9;2;1;1
258091165599;258091186708;21109;1,3,5;3;2,9;2;1;1
258091186708;258091247094;60386;1,3,5;3;2,9;2;1;1
258091247094;258091253664;6570;1,3,5;3;2,9;2;1;1
258091253664;258091271943;18279;1,3,5;3;2,9;2;1;1
258091271943;258091272753;810;1,3,5;3;2,9;2;1;1
258091272753;258091287442;14689;1,3,5;3;2,9;2;1;1
258091287442;258091301392;13950;1,3,5;3;2,9;2;1;1
258091301392;258091319968;18576;1,3,5;3;2,9;2;1;1
258091319968;258091320618;650;1,3,5;3;2,9;2;1;1
258091320618;258091329900;9282;1,3,5;3;2,9;2;1;1
258091329900;258091330299;399;1,3,5;3;2,9;2;1;1
258091330299;258091345574;15275;1,3,5;3;2,9;2;1;1
258091345574;258091346057;483;1,3,5;3;2,9;2;1;1
258091346057;258091374403;28346;1,3,5;3;2,9;2;1;1
258091374403;258091386412;12009;1,3,5;3;2,9;2;1;1
258091386412;258091401887;15475;1,3,5;3;2,9;2;1;1
258091401887;258091405229;3342;1,3,5;3;2,9;2;1;1
258091405229;258091405879;650;1,3,5;3;2,9;2;1;1
258091405879;258091414971;9092;1,3,5;3;2,9;2;1;1
258091414971;258091416783;1812;1,3,5;3;2,9;2;1;1
258091416783;258091417270;487;1,3,5;3;2,9;2;1;1
258091417270;258091425562;8292;1,3,5;3;2,9;2;1;1
258091425562;258091448060;22498;1,3,5;3;2,9;2;1;1
258091448060;258091456873;8813;1,3,5;3;2,9;2;1;1
258091456873;258091488333;31460;1,3,5;3;2,9;2;1;1
258091488333;258091537369;49036;1,3,5;3;2,9;2;1;1
258091537369;258091540162;2793;1,3,5;3;2,9;2;1;1
258091540162;258091547796;7634;1,3,5;3;2,9;2;1;1
258091547796;258091563994;16198;1,3,5;3;2,9;2;1;1
258091563994;258091564477;483;1,3,5;3;2,9;2;1;1
258091564477;258091578049;13572;1,3,5;3;2,9;2;1;1
258091578049;258091604665;26616;1,3,5;3;2,9;2;1;1
258091604665;258091623737;19072;1,3,5;3;2,9;2;1;1
258091623737;258091624559;822;1,3,5;3;2,9;2;1;1
258091624559;258091632829;8270;1,3,5;3;2,9;2;1;1
258091632829;258091641289;8460;1,3,5;3;2,9;2;1;1
258091641289;258091674553;33264;1,3,5;3;2,9;2;1;1
258091674553;258091677472;2919;1,3,5;3;2,9;2;1;1
258091677472;258091715547;38075;1,3,5;3;2,9;2;1;1
258091715547;258091725209;9662;1,3,5;3;2,9;2;1;1
258091725209;258091759439;34230;1,3,5;3;2,9;2;1;1
258091759439;258091768025;8586;1,3,5;3;2,9;2;1;1
258091768025;258091821248;53223;1,3,5;3;2,9;2;1;1
258091821248;258091845637;24389;1,3,5;3;2,9;2;1;1
258091845637;258091861055;15418;1,3,5;3;2,9;2;1;1
258091861055;258091861647;592;1,3,5;3;2,9;2;1;1
258091861647;258091863309;1662;1,3,5;3;2,9;2;1;1
258091863309;258091872095;8786;1,3,5;3;2,9;2;1;1
258091872095;258091903906;31811;1,3,5;3;2,9;2;1;1
258091903906;258091913775;9869;1,3,5;3;2,9;2;1;1
258091913775;258091945156;31381;1,3,5;3;2,9;2;1;1
258091945156;258091962840;17684;1,3,5;3;2,9;2;1;1
258091962840;258091986373;23533;1,3,5;3;2,9;2;1;1
258091986373;258091995186;8813;1,3,5;3;2,9;2;1;1
258091995186;258092027298;32112;1,3,5;3;2,9;2;1;1
258092027298;258092030374;3076;1,3,5;3;2,9;2;1;1
258092030374;258092072128;41754;1,3,5;3;2,9;2;1;1
258092072128;258092080732;8604;1,3,5;3;2,9;2;1;1
258092080732;258092121367;40635;1,3,5;3;2,9;2;1;1
258092121367;258092154594;33227;1,3,5;3;2,9;2;1;1
258092154594;258092170005;15411;1,3,5;3;2,9;2;1;1
258092170005;258092170690;685;1,3,5;3;2,9;2;1;1
258092170690;258092171302;612;1,3,5;3;2,9;2;1;1
258092171302;258092180510;9208;1,3,5;3;2,9;2;1;1
258092180510;258092229358;48848;1,3,5;3;2,9;2;1;1
258092229358;258092231912;2554;1,3,5;3;2,9;2;1;1
258092231912;258092266854;34942;1,3,5;3;2,9;2;1;1
258092266854;258092286537;19683;1,3,5;3;2,9;2;1;1
258092286537;258092309852;23315;1,3,5;3;2,9;2;1;1
258092309852;258092319274;9422;1,3,5;3;2,9;2;1;1
258092319274;258092344250;24976;1,3,5;3;2,9;2;1;1
258092344250;258092352770;8520;1,3,5;3;2,9;2;1;1
258092352770;258092405914;53144;1,3,5;3;2,9;2;1;1
258092405914;258092424142;18228;1,3,5;3;2,9;2;1;1
258092424142;258092447516;23374;1,3,5;3;2,9;2;1;1
258092447516;258092483308;35792;1,3,5;3;2,9;2;1;1
258092483308;258092489885;6577;1,3,5;3;2,9;2;1;1
258092489885;258092498338;8453;1,3,5;3;2,9;2;1;1
258092498338;258092498819;481;1,3,5;3;2,9;2;1;1
258092498819;258092499123;304;1,3,5;3;2,9;2;1;1
258092499123;258092576048;76925;1,3,5;3;2,9;2;1;1
258092576048;258092584208;8160;1,3,5;3;2,9;2;1;1
258092584208;258092683784;99576;1,3,5;3;2,9;2;1;1
258092683784;258092686611;2827;1,3,5;3;2,9;2;1;1
258092686611;258092724776;38165;1,3,5;3;2,9;2;1;1
258092724776;258092733056;8280;1,3,5;3;2,9;2;1;1
258092733056;258092773409;40353;1,3,5;3;2,9;2;1;1
258092773409;258092776985;3576;1,3,5;3;2,9;2;1;1
258092776985;258092792973;15988;1,3,5;3;2,9;2;1;1
258092792973;258092793460;487;1,3,5;3;2,9;2;1;1
258092793460;258092814232;20772;1,3,5;3;2,9;2;1;1
258092814232;258092823615;9383;1,3,5;3;2,9;2;1;1
258092823615;258092846858;23243;1,3,5;3;2,9;2;1;1
258092846858;258092855346;8488;1,3,5;3;2,9;2;1;1
258092855346;258092891265;35919;1,3,5;3;2,9;2;1;1
258092891265;258092900036;8771;1,3,5;3;2,9;2;1;1
258092900036;258092936027;35991;1,3,5;3;2,9;2;1;1
258092936027;258092944770;8743;1,3,5;3;2,9;2;1;1
258092944770;258092974129;29359;1,3,5;3;2,9;2;1;1
258092974129;258092983453;9324;1,3,5;3;2,9;2;1;1
258092983453;258093014085;30632;1,3,5;3;2,9;2;1;1
258093014085;258093017996;3911;1,3,5;3;2,9;2;1;1
258093017996;258093036079;18083;1,3,5;3;2,9;2;1;1
258093036079;258093036569;490;1,3,5;3;2,9;2;1;1
258093036569;258093047047;10478;1,3,5;3;2,9;2;1;1
258093047047;258093049788;2741;1,3,5;3;2,9;2;1;1
258093049788;258093087160;37372;1,3,5;3;2,9;2;1;1
258093087160;258093095870;8710;1,3,5;3;2,9;2;1;1
258093095870;258093128425;32555;1,3,5;3;2,9;2;1;1
258093128425;258093137802;9377;1,3,5;3;2,9;2;1;1
258093137802;258093172638;34836;1,3,5;3;2,9;2;1;1
258093172638;258093172674;36;1,3,5;3;2,9;2;1;1
258093172674;258093183577;10903;1,3,5;3;2,9;2;1;1
258093183577;258093183756;179;1,3,5;3;2,9;2;1;1
258093183756;258093183783;27;1,3,5;3;2,9;2;1;1
258093183783;258093184344;561;1,3,5;3;2,9;2;1;1
258093184344;258093184405;61;1,3,5;3;2,9;2;1;1
258093184405;258093184697;292;1,3,5;3;2,9;2;1;1
258093184697;258093185540;843;1,3,5;3;2,9;2;1;1
258093185540;258093185976;436;1,3,5;3;2,9;2;1;1
258093185976;258093187138;1162;1,3,5;3;2,9;2;1;1
258093187138;258093192227;5089;1,3,5;3;2,9;2;1;1
258093192227;258093193624;1397;1,3,5;3;2,9;2;1;1
258093193624;258093198703;5079;1,3,5;3;2,9;2;1;1
258093198703;258093201068;2365;1,3,5;3;2,9;2;1;1
258093201068;258093201533;465;1,3,5;3;2,9;2;1;1
258093201533;258093253858;52325;1,3,5;3;2,9;2;1;1
258093253858;258093262661;8803;1,3,5;3;2,9;2;1;1
258093262661;258093286787;24126;1,3,5;3;2,9;2;1;1
258093286787;258093295339;8552;1,3,5;3;2,9;2;1;1
258093295339;258093326143;30804;1,3,5;3;2,9;2;1;1
258093326143;258093328652;2509;1,3,5;3;2,9;2;1;1
258093328652;258093344888;16236;1,3,5;3;2,9;2;1;1
258093344888;258093384304;39416;1,3,5;3;2,9;2;1;1
258093384304;258093423282;38978;1,3,5;3;2,9;2;1;1
258093423282;258093469510;46228;1,3,5;3;2,9;2;1;1
258093469510;258093518417;48907;1,3,5;3;2,9;2;1;1
258093518417;258093561730;43313;1,3,5;3;2,9;2;1;1
258093561730;258093602502;40772;1,3,5;3;2,9;2;1;1
258093602502;258093633536;31034;1,3,5;3;2,9;2;1;1
258093633536;258093666929;33393;1,3,5;3;2,9;2;1;1
258093666929;258093707520;40591;1,3,5;3;2,9;2;1;1
258093707520;258093752066;44546;1,3,5;3;2,9;2;1;1
258093752066;258093795546;43480;1,3,5;3;2,9;2;1;1
258093795546;258093836371;40825;1,3,5;3;2,9;2;1;1
258093836371;258093873819;37448;1,3,5;3;2,9;2;1;1
258093873819;258093914976;41157;1,3,5;3;2,9;2;1;1
258093914976;258093939197;24221;1,3,5;3;2,9;2;1;1
258093939197;258093980434;41237;1,3,5;3;2,9;2;1;1
258093980434;258094023119;42685;1,3,5;3;2,9;2;1;1
258094023119;258094058572;35453;1,3,5;3;2,9;2;1;1
258094058572;258094107228;48656;1,3,5;3;2,9;2;1;1
258094107228;258094148398;41170;1,3,5;3;2,9;2;1;1
258094148398;258094202711;54313;1,3,5;3;2,9;2;1;1
258094202711;258094249246;46535;1,3,5;3;2,9;2;1;1
258094249246;258094296623;47377;1,3,5;3;2,9;2;1;1
258094296623;258094343208;46585;1,3,5;3;2,9;2;1;1
258094343208;258094375501;32293;1,3,5;3;2,9;2;1;1
258094375501;258094438432;62931;1,3,5;3;2,9;2;1;1
258094438432;258094494185;55753;1,3,5;3;2,9;2;1;1
258094494185;258094532697;38512;1,3,5;3;2,9;2;1;1
258094532697;258094590669;57972;1,3,5;3;2,9;2;1;1
258094590669;258094638913;48244;1,3,5;3;2,9;2;1;1
258094638913;258094679442;40529;1,3,5;3;2,9;2;1;1
258094679442;258094728252;48810;1,3,5;3;2,9;2;1;1
258094728252;258094760853;32601;1,3,5;3;2,9;2;1;1
258094760853;258094846510;85657;1,3,5;3;2,9;2;1;1
258094846510;258094887233;40723;1,3,5;3;2,9;2;1;1
258094887233;258094932210;44977;1,3,5;3;2,9;2;1;1
258094932210;258094975576;43366;1,3,5;3;2,9;2;1;1
258094975576;258095012916;37340;1,3,5;3;2,9;2;1;1
258095012916;258095044207;31291;1,3,5;3;2,9;2;1;1
258095044207;258095085155;40948;1,3,5;3;2,9;2;1;1
258095085155;258095126567;41412;1,3,5;3;2,9;2;1;1
258095126567;258095161913;35346;1,3,5;3;2,9;2;1;1
258095161913;258095208858;46945;1,3,5;3;2,9;2;1;1
258095208858;258095442959;234101;1,3,5;3;2,9;2;1;1
258095442959;258095489366;46407;1,3,5;3;2,9;2;1;1
258095489366;258095536551;47185;1,3,5;3;2,9;2;1;1
258095536551;258095569995;33444;1,3,5;3;2,9;2;1;1
258095569995;258095612267;42272;1,3,5;3;2,9;2;1;1
258095612267;258095648141;35874;1,3,5;3;2,9;2;1;1
258095648141;258095690398;42257;1,3,5;3;2,9;2;1;1
258095690398;258095729742;39344;1,3,5;3;2,9;2;1;1
258095729742;258095753912;24170;1,3,5;3;2,9;2;1;1
258095753912;258095794023;40111;1,3,5;3;2,9;2;1;1
258095794023;258095809130;15107;1,3,5;3;2,9;2;1;1
258095809130;258095809209;79;0,1,3,5;4;2,9;2;1;1
258095809209;258095809275;66;0,1,3,5;4;2,9;2;1;1
258095809275;258095809328;53;0,1,3,5;4;2,9;2;1;1
258095809328;258095809458;130;0,1,3,5;4;2,9;2;1;1
258095809458;258095809549;91;0,1,3,5;4;2,9;2;1;1
258095809549;258095809695;146;0,1,3,5;4;2,9;2;1;1
258095809695;258095809730;35;0,1,3,5;4;2,9;2;1;1
258095809730;258095809779;49;0,1,3,5;4;2,9;2;1;1
258095809779;258095809784;5;0,1,3,5;4;2,9;2;1;1
258095809784;258095809792;8;0,1,3,5;4;2,9;2;1;1
258095809792;258095809809;17;0,1,3,5;4;2,9;2;1;1
258095809809;258095809847;38;0,1,3,5;4;2,9;2;1;1
258095809847;258095809851;4;0,1,3,5;4;2,9;2;1;1
258095809851;258095809867;16;0,1,3,5;4;2,9;2;1;1
258095809867;258095809887;20;0,1,3,5;4;2,9;2;1;1
258095809887;258095809892;5;0,1,3,5;4;2,9;2;1;1
258095809892;258095809966;74;0,1,3,5;4;2,9;2;1;1
258095809966;258095809985;19;0,1,3,5;4;2,9;2;1;1
258095809985;258095810011;26;0,1,3,5;4;2,9;2;1;1
258095810011;258095810110;99;0,1,3,5;4;2,9;2;1;1
258095810110;258095810136;26;0,1,3,5;4;2,9;2;1;1
258095810136;258095810180;44;0,1,3,5;4;2,9;2;1;1
258095810180;258095810230;50;0,1,3,5;4;2,9;2;1;1
258095810230;258095810267;37;0,1,3,5;4;2,9;2;1;1
258095810267;258095810304;37;0,1,3,5;4;2,9;2;1;1
258095810304;258095810314;10;0,1,3,5;4;2,9;2;1;1
258095810314;258095810337;23;0,1,3,5;4;2,9;2;1;1
258095810337;258095810340;3;0,1,3,5;4;2,9;2;1;1
258095810340;258095810377;37;0,1,3,5;4;2,9;2;1;1
258095810377;258095810414;37;0,1,3,5;4;2,9;2;1;1
258095810414;258095810415;1;0,1,3,5;4;2,9;2;1;1
258095810415;258095810450;35;0,1,3,5;4;2,9;2;1;1
258095810450;258095810451;1;0,1,3,5;4;2,9;2;1;1
258095810451;258095810487;36;0,1,3,5;4;2,9;2;1;1
258095810487;258095810519;32;0,1,3,5;4;2,9;2;1;1
258095810519;258095810547;28;0,1,3,5;4;2,9;2;1;1
258095810547;258095810565;18;0,1,3,5;4;2,9;2;1;1
258095810565;258095810589;24;0,1,3,5;4;2,9;2;1;1
258095810589;258095810658;69;0,1,3,5;4;2,9;2;1;1
258095810658;258095810692;34;0,1,3,5;4;2,9;2;1;1
258095810692;258095810762;70;0,1,3,5;4;2,9;2;1;1
258095810762;258095810773;11;0,1,3,5;4;2,9;2;1;1
258095810773;258095810776;3;0,1,3,5;4;2,9;2;1;1
258095810776;258095810777;1;0,1,3,5;4;2,9;2;1;1
258095810777;258095810785;8;0,1,3,5;4;2,9;2;1;1
258095810785;258095810821;36;0,1,3,5;4;2,9;2;1;1
258095810821;258095810840;19;0,1,3,5;4;2,9;2;1;1
258095810840;258095810877;37;0,1,3,5;4;2,9;2;1;1
258095810877;258095810891;14;0,1,3,5;4;2,9;2;1;1
258095810891;258095810892;1;0,1,3,5;4;2,9;2;1;1
258095810892;258095810944;52;0,1,3,5;4;2,9;2;1;1
258095810944;258095810945;1;0,1,3,5;4;2,9;2;1;1
258095810945;258095810975;30;0,1,3,5;4;2,9;2;1;1
258095810975;258095810997;22;0,1,3,5;4;2,9;2;1;1
258095810997;258095810998;1;0,1,3,5;4;2,9;2;1;1
258095810998;258095811011;13;0,1,3,5;4;2,9;2;1;1
258095811011;258095811034;23;0,1,3,5;4;2,9;2;1;1
258095811034;258095811039;5;0,1,3,5;4;2,9;2;1;1
258095811039;258095811048;9;0,1,3,5;4;2,9;2;1;1
258095811048;258095811049;1;0,1,3,5;4;2,9;2;1;1
258095811049;258095811058;9;0,1,3,5;4;2,9;2;1;1
258095811058;258095811061;3;0,1,3,5;4;2,9;2;1;1
258095811061;258095811068;7;0,1,3,5;4;2,9;2;1;1
258095811068;258095811079;11;0,1,3,5;4;2,9;2;1;1
258095811079;258095811085;6;0,1,3,5;4;2,9;2;1;1
258095811085;258095811092;7;0,1,3,5;4;2,9;2;1;1
258095811092;258095811099;7;0,1,3,5;4;2,9;2;1;1
258095811099;258095811109;10;0,1,3,5;4;2,9;2;1;1
258095811109;258095811110;1;0,1,3,5;4;2,9;2;1;1
258095811110;258095811111;1;0,1,3,5;4;2,9;2;1;1
258095811111;258095811120;9;0,1,3,5;4;2,9;2;1;1
258095811120;258095811122;2;0,1,3,5;4;2,9;2;1;1
258095811122;258095811127;5;0,1,3,5;4;2,9;2;1;1
258095811127;258095811128;1;0,1,3,5;4;2,9;2;1;1
258095811128;258095811133;5;0,1,3,5;4;2,9;2;1;1
258095811133;258095811155;22;0,1,3,5;4;2,9;2;1;1
258095811155;258095811157;2;0,1,3,5;4;2,9;2;1;1
258095811157;258095811169;12;0,1,3,5;4;2,9;2;1;1
258095811169;258095811172;3;0,1,3,5;4;2,9;2;1;1
258095811172;258095811178;6;0,1,3,5;4;2,9;2;1;1
258095811178;258095811180;2;0,1,3,5;4;2,9;2;1;1
258095811180;258095811205;25;0,1,3,5;4;2,9;2;1;1
258095811205;258095811206;1;0,1,3,5;4;2,9;2;1;1
258095811206;258095811211;5;0,1,3,5;4;2,9;2;1;1
258095811211;258095811215;4;0,1,3,5;4;2,9;2;1;1
258095811215;258095811231;16;0,1,3,5;4;2,9;2;1;1
258095811231;258095811238;7;0,1,3,5;4;2,9;2;1;1
258095811238;258095811243;5;0,1,3,5;4;2,9;2;1;1
258095811243;258095811254;11;0,1,3,5;4;2,9;2;1;1
258095811254;258095811256;2;0,1,3,5;4;2,9;2;1;1
258095811256;258095811280;24;0,1,3,5;4;2,9;2;1;1
258095811280;258095811284;4;0,1,3,5;4;2,9;2;1;1
258095811284;258095811296;12;0,1,3,5;4;2,9;2;1;1
258095811296;258095811299;3;0,1,3,5;4;2,9;2;1;1
258095811299;258095811304;5;0,1,3,5;4;2,9;2;1;1
258095811304;258095811306;2;0,1,3,5;4;2,9;2;1;1
258095811306;258095811317;11;0,1,3,5;4;2,9;2;1;1
258095811317;258095811322;5;0,1,3,5;4;2,9;2;1;1
258095811322;258095811332;10;0,1,3,5;4;2,9;2;1;1
258095811332;258095811334;2;0,1,3,5;4;2,9;2;1;1
258095811334;258095811351;17;0,1,3,5;4;2,9;2;1;1
258095811351;258095811356;5;0,1,3,5;4;2,9;2;1;1
258095811356;258095811359;3;0,1,3,5;4;2,9;2;1;1
258095811359;258095811360;1;0,1,3,5;4;2,9;2;1;1
258095811360;258095811365;5;0,1,3,5;4;2,9;2;1;1
258095811365;258095811373;8;0,1,3,5;4;2,9;2;1;1
258095811373;258095811384;11;0,1,3,5;4;2,9;2;1;1
258095811384;258095811387;3;0,1,3,5;4;2,9;2;1;1
258095811387;258095811388;1;0,1,3,5;4;2,9;2;1;1
258095811388;258095811390;2;0,1,3,5;4;2,9;2;1;1
258095811390;258095811400;10;0,1,3,5;4;2,9;2;1;1
258095811400;258095811401;1;0,1,3,5;4;2,9;2;1;1
258095811401;258095811418;17;0,1,3,5;4;2,9;2;1;1
258095811418;258095811419;1;0,1,3,5;4;2,9;2;1;1
258095811419;258095811421;2;0,1,3,5;4;2,9;2;1;1
258095811421;258095811427;6;0,1,3,5;4;2,9;2;1;1
258095811427;258095811445;18;0,1,3,5;4;2,9;2;1;1
258095811445;258095811458;13;0,1,3,5;4;2,9;2;1;1
258095811458;258095811461;3;0,1,3,5;4;2,9;2;1;1
258095811461;258095811470;9;0,1,3,5;4;2,9;2;1;1
258095811470;258095811474;4;0,1,3,5;4;2,9;2;1;1
258095811474;258095811480;6;0,1,3,5;4;2,9;2;1;1
258095811480;258095811491;11;0,1,3,5;4;2,9;2;1;1
258095811491;258095811494;3;0,1,3,5;4;2,9;2;1;1
258095811494;258095811507;13;0,1,3,5;4;2,9;2;1;1
258095811507;258095811510;3;0,1,3,5;4;2,9;2;1;1
258095811510;258095811523;13;0,1,3,5;4;2,9;2;1;1
258095811523;258095811529;6;0,1,3,5;4;2,9;2;1;1
258095811529;258095811534;5;0,1,3,5;4;2,9;2;1;1
258095811534;258095811541;7;0,1,3,5;4;2,9;2;1;1
258095811541;258095811555;14;0,1,3,5;4;2,9;2;1;1
258095811555;258095811563;8;0,1,3,5;4;2,9;2;1;1
258095811563;258095811575;12;0,1,3,5;4;2,9;2;1;1
258095811575;258095811583;8;0,1,3,5;4;2,9;2;1;1
258095811583;258095811594;11;0,1,3,5;4;2,9;2;1;1
258095811594;258095811605;11;0,1,3,5;4;2,9;2;1;1
258095811605;258095811609;4;0,1,3,5;4;2,9;2;1;1
258095811609;258095811614;5;0,1,3,5;4;2,9;2;1;1
258095811614;258095811625;11;0,1,3,5;4;2,9;2;1;1
258095811625;258095811633;8;0,1,3,5;4;2,9;2;1;1
258095811633;258095811635;2;0,1,3,5;4;2,9;2;1;1
258095811635;258095811638;3;0,1,3,5;4;2,9;2;1;1
258095811638;258095811665;27;0,1,3,5;4;2,9;2;1;1
258095811665;258095811667;2;0,1,3,5;4;2,9;2;1;1
258095811667;258095811686;19;0,1,3,5;4;2,9;2;1;1
258095811686;258095811710;24;0,1,3,5;4;2,9;2;1;1
258095811710;258095811711;1;0,1,3,5;4;2,9;2;1;1
258095811711;258095811716;5;0,1,3,5;4;2,9;2;1;1
258095811716;258095811758;42;0,1,3,5;4;2,9;2;1;1
258095811758;258095811759;1;0,1,3,5;4;2,9;2;1;1
258095811759;258095811765;6;0,1,3,5;4;2,9;2;1;1
258095811765;258095811793;28;0,1,3,5;4;2,9;2;1;1
258095811793;258095811812;19;0,1,3,5;4;2,9;2;1;1
258095811812;258095811813;1;0,1,3,5;4;2,9;2;1;1
258095811813;258095811850;37;0,1,3,5;4;2,9;2;1;1
258095811850;258095811880;30;0,1,3,5;4;2,9;2;1;1
258095811880;258095811886;6;0,1,3,5;4;2,9;2;1;1
258095811886;258095811903;17;0,1,3,5;4;2,9;2;1;1
258095811903;258095811919;16;0,1,3,5;4;2,9;2;1;1
258095811919;258095811921;2;0,1,3,5;4;2,9;2;1;1
258095811921;258095811933;12;0,1,3,5;4;2,9;2;1;1
258095811933;258095811935;2;0,1,3,5;4;2,9;2;1;1
258095811935;258095811949;14;0,1,3,5;4;2,9;2;1;1
258095811949;258095811978;29;0,1,3,5;4;2,9;2;1;1
258095811978;258095811983;5;0,1,3,5;4;2,9;2;1;1
258095811983;258095811992;9;0,1,3,5;4;2,9;2;1;1
258095811992;258095812016;24;0,1,3,5;4;2,9;2;1;1
258095812016;258095812043;27;0,1,3,5;4;2,9;2;1;1
258095812043;258095812054;11;0,1,3,5;4;2,9;2;1;1
258095812054;258095812063;9;0,1,3,5;4;2,9;2;1;1
258095812063;258095812071;8;0,1,3,5;4;2,9;2;1;1
258095812071;258095812072;1;0,1,3,5;4;2,9;2;1;1
258095812072;258095812107;35;0,1,3,5;4;2,9;2;1;1
258095812107;258095812110;3;0,1,3,5;4;2,9;2;1;1
258095812110;258095812141;31;0,1,3,5;4;2,9;2;1;1
258095812141;258095812142;1;0,1,3,5;4;2,9;2;1;1
258095812142;258095812181;39;0,1,3,5;4;2,9;2;1;1
258095812181;258095812203;22;0,1,3,5;4;2,9;2;1;1
258095812203;258095812225;22;0,1,3,5;4;2,9;2;1;1
258095812225;258095812240;15;0,1,3,5;4;2,9;2;1;1
258095812240;258095812242;2;0,1,3,5;4;2,9;2;1;1
258095812242;258095812245;3;0,1,3,5;4;2,9;2;1;1
258095812245;258095812264;19;0,1,3,5;4;2,9;2;1;1
258095812264;258095812275;11;0,1,3,5;4;2,9;2;1;1
258095812275;258095812317;42;0,1,3,5;4;2,9;2;1;1
258095812317;258095812335;18;0,1,3,5;4;2,9;2;1;1
258095812335;258095812348;13;0,1,3,5;4;2,9;2;1;1
258095812348;258095812377;29;0,1,3,5;4;2,9;2;1;1
258095812377;258095812381;4;0,1,3,5;4;2,9;2;1;1
258095812381;258095812382;1;0,1,3,5;4;2,9;2;1;1
258095812382;258095812394;12;0,1,3,5;4;2,9;2;1;1
258095812394;258095812410;16;0,1,3,5;4;2,9;2;1;1
258095812410;258095812423;13;0,1,3,5;4;2,9;2;1;1
258095812423;258095812439;16;0,1,3,5;4;2,9;2;1;1
258095812439;258095812443;4;0,1,3,5;4;2,9;2;1;1
258095812443;258095812446;3;0,1,3,5;4;2,9;2;1;1
258095812446;258095812453;7;0,1,3,5;4;2,9;2;1;1
258095812453;258095812455;2;0,1,3,5;4;2,9;2;1;1
258095812455;258095812480;25;0,1,3,5;4;2,9;2;1;1
258095812480;258095812543;63;0,1,3,5;4;2,9;2;1;1
258095812543;258095812580;37;0,1,3,5;4;2,9;2;1;1
258095812580;258095812595;15;0,1,3,5;4;2,9;2;1;1
258095812595;258095812598;3;0,1,3,5;4;2,9;2;1;1
258095812598;258095812599;1;0,1,3,5;4;2,9;2;1;1
258095812599;258095812642;43;0,1,3,5;4;2,9;2;1;1
258095812642;258095812659;17;0,1,3,5;4;2,9;2;1;1
258095812659;258095812687;28;0,1,3,5;4;2,9;2;1;1
258095812687;258095812718;31;0,1,3,5;4;2,9;2;1;1
258095812718;258095812722;4;0,1,3,5;4;2,9;2;1;1
258095812722;258095812758;36;0,1,3,5;4;2,9;2;1;1
258095812758;258095812783;25;0,1,3,5;4;2,9;2;1;1
258095812783;258095812814;31;0,1,3,5;4;2,9;2;1;1
258095812814;258095812827;13;0,1,3,5;4;2,9;2;1;1
258095812827;258095812854;27;0,1,3,5;4;2,9;2;1;1
258095812854;258095812867;13;0,1,3,5;4;2,9;2;1;1
258095812867;258095812869;2;0,1,3,5;4;2,9;2;1;1
258095812869;258095812904;35;0,1,3,5;4;2,9;2;1;1
258095812904;258095812909;5;0,1,3,5;4;2,9;2;1;1
258095812909;258095812946;37;0,1,3,5;4;2,9;2;1;1
258095812946;258095812948;2;0,1,3,5;4;2,9;2;1;1
258095812948;258095812984;36;0,1,3,5;4;2,9;2;1;1
258095812984;258095812987;3;0,1,3,5;4;2,9;2;1;1
258095812987;258095813007;20;0,1,3,5;4;2,9;2;1;1
258095813007;258095813022;15;0,1,3,5;4;2,9;2;1;1
258095813022;258095813025;3;0,1,3,5;4;2,9;2;1;1
258095813025;258095813042;17;0,1,3,5;4;2,9;2;1;1
258095813042;258095813056;14;0,1,3,5;4;2,9;2;1;1
258095813056;258095813061;5;0,1,3,5;4;2,9;2;1;1
258095813061;258095813062;1;0,1,3,5;4;2,9;2;1;1
258095813062;258095813074;12;0,1,3,5;4;2,9;2;1;1
258095813074;258095813083;9;0,1,3,5;4;2,9;2;1;1
258095813083;258095813092;9;0,1,3,5;4;2,9;2;1;1
258095813092;258095813103;11;0,1,3,5;4;2,9;2;1;1
258095813103;258095813117;14;0,1,3,5;4;2,9;2;1;1
258095813117;258095813121;4;0,1,3,5;4;2,9;2;1;1
258095813121;258095813138;17;0,1,3,5;4;2,9;2;1;1
258095813138;258095813152;14;0,1,3,5;4;2,9;2;1;1
258095813152;258095813182;30;0,1,3,5;4;2,9;2;1;1
258095813182;258095813187;5;0,1,3,5;4;2,9;2;1;1
258095813187;258095813189;2;0,1,3,5;4;2,9;2;1;1
258095813189;258095813205;16;0,1,3,5;4;2,9;2;1;1
258095813205;258095813224;19;0,1,3,5;4;2,9;2;1;1
258095813224;258095813229;5;0,1,3,5;4;2,9;2;1;1
258095813229;258095813268;39;0,1,3,5;4;2,9;2;1;1
258095813268;258095813279;11;0,1,3,5;4;2,9;2;1;1
258095813279;258095813302;23;0,1,3,5;4;2,9;2;1;1
258095813302;258095813332;30;0,1,3,5;4;2,9;2;1;1
258095813332;258095813337;5;0,1,3,5;4;2,9;2;1;1
258095813337;258095813338;1;0,1,3,5;4;2,9;2;1;1
258095813338;258095813363;25;0,1,3,5;4;2,9;2;1;1
258095813363;258095813373;10;0,1,3,5;4;2,9;2;1;1
258095813373;258095813374;1;0,1,3,5;4;2,9;2;1;1
258095813374;258095813408;34;0,1,3,5;4;2,9;2;1;1
258095813408;258095813429;21;0,1,3,5;4;2,9;2;1;1
258095813429;258095813458;29;0,1,3,5;4;2,9;2;1;1
258095813458;258095813475;17;0,1,3,5;4;2,9;2;1;1
258095813475;258095813507;32;0,1,3,5;4;2,9;2;1;1
258095813507;258095813541;34;0,1,3,5;4;2,9;2;1;1
258095813541;258095813582;41;0,1,3,5;4;2,9;2;1;1
258095813582;258095813587;5;0,1,3,5;4;2,9;2;1;1
258095813587;258095813633;46;0,1,3,5;4;2,9;2;1;1
258095813633;258095813676;43;0,1,3,5;4;2,9;2;1;1
258095813676;258095813703;27;0,1,3,5;4;2,9;2;1;1
258095813703;258095813720;17;0,1,3,5;4;2,9;2;1;1
258095813720;258095813764;44;0,1,3,5;4;2,9;2;1;1
258095813764;258095813808;44;0,1,3,5;4;2,9;2;1;1
258095813808;258095813826;18;0,1,3,5;4;2,9;2;1;1
258095813826;258095813853;27;0,1,3,5;4;2,9;2;1;1
258095813853;258095813864;11;1,3,5;3;2,9;2;1;1
258095813864;258095813902;38;0,1,3,5;4;2,9;2;1;1
258095813902;258095813939;37;0,1,3,5;4;2,9;2;1;1
258095813939;258095814070;131;0,1,3,5;4;2,9;2;1;1
258095814070;258095814193;123;0,1,3,5;4;2,9;2;1;1
258095814193;258095814313;120;0,1,3,5;4;2,9;2;1;1
258095814313;258095830897;16584;1,3,5;3;2,9;2;1;1
258095830897;258095852415;21518;0,1,3,5;4;2,9;2;1;1
258095852415;258095856097;3682;0,1,3,5;4;2,9;2;1;1
258095856097;258095856973;876;0,1,3,5;4;2,9;2;1;1
258095856973;258095857597;624;0,1,3,5;4;2,9;2;1;1
258095857597;258095859703;2106;0,1,3,5;4;2,9;2;1;1
258095859703;258095872652;12949;0,1,3,5;4;2,9;2;1;1
258095872652;258095873009;357;0,1,3,5;4;2,9;2;1;1
258095873009;258095873603;594;0,1,3,5;4;2,9;2;1;1
258095873603;258095873822;219;0,1,3,5;4;2,9;2;1;1
258095873822;258095878997;5175;0,1,3,5;4;2,9;2;1;1
258095878997;258095880726;1729;0,1,3,5;4;2,9;2;1;1
258095880726;258095880760;34;0,1,3,5;4;2,9;2;1;1
258095880760;258095883177;2417;0,1,3,5;4;2,9;2;1;1
258095883177;258095883465;288;0,1,3,5;4;2,9;2;1;1
258095883465;258095893408;9943;0,1,3,5;4;2,9;2;1;1
258095893408;258095893547;139;0,1,3,5;4;2,9;2;1;1
258095893547;258095893669;122;0,1,3,5;4;2,9;2;1;1
258095893669;258095896656;2987;0,1,3,5;4;2,9;2;1;1
258095896656;258095904262;7606;0,1,3,5;4;2,9;2;1;1
258095904262;258095904792;530;0,1,3,5;4;2,9;2;1;1
258095904792;258095904814;22;0,1,3,5;4;2,9;2;1;1
258095904814;258095905409;595;0,1,3,5;4;2,9;2;1;1
258095905409;258095907902;2493;0,1,3,5;4;2,9;2;1;1
258095907902;258095908030;128;0,1,3,5;4;2,9;2;1;1
258095908030;258095911099;3069;0,1,3,5;4;2,9;2;1;1
258095911099;258095911790;691;0,1,3,5;4;2,9;2;1;1
258095911790;258095913795;2005;0,1,3,5;4;2,9;2;1;1
258095913795;258095914763;968;0,1,3,5;4;2,9;2;1;1
258095914763;258095923573;8810;0,1,3,5;4;2,9;2;1;1
258095923573;258095934236;10663;0,1,3,5;4;2,9;2;1;1
258095934236;258095934753;517;0,1,3,5;4;2,9;2;1;1
258095934753;258095935594;841;0,1,3,5;4;2,9;2;1;1
258095935594;258095936038;444;0,1,3,5;4;2,9;2;1;1
258095936038;258095936515;477;0,1,3,5;4;2,9;2;1;1
258095936515;258095936945;430;0,1,3,5;4;2,9;2;1;1
258095936945;258095938465;1520;0,1,3,5;4;2,9;2;1;1
258095938465;258095940295;1830;0,1,3,5;4;2,9;2;1;1
258095940295;258095941204;909;0,1,3,5;4;2,9;2;1;1
258095941204;258095944925;3721;0,1,3,5;4;2,9;2;1;1
258095944925;258095948919;3994;0,1,3,5;4;2,9;2;1;1
258095948919;258095949727;808;0,1,3,5;4;2,9;2;1;1
258095949727;258095950004;277;0,1,3,5;4;2,9;2;1;1
258095950004;258095951838;1834;0,1,3,5;4;2,9;2;1;1
258095951838;258095952128;290;0,1,3,5;4;2,9;2;1;1
258095952128;258095952882;754;0,1,3,5;4;2,9;2;1;1
258095952882;258095955728;2846;0,1,3,5;4;2,9;2;1;1
258095955728;258095956513;785;0,1,3,5;4;2,9;2;1;1
258095956513;258095956592;79;0,1,3,5;4;2,9;2;1;1
258095956592;258095957288;696;0,1,3,5;4;2,9;2;1;1
258095957288;258095963840;6552;0,1,3,5;4;2,9;2;1;1
258095963840;258095966079;2239;0,1,3,5;4;2,9;2;1;1
258095966079;258095967073;994;0,1,3,5;4;2,9;2;1;1
258095967073;258095967077;4;0,1,3,5;4;2,9;2;1;1
258095967077;258095967105;28;0,1,3,5;4;2,9;2;1;1
258095967105;258095967470;365;0,1,3,5;4;2,9;2;1;1
258095967470;258095968018;548;0,1,3,5;4;2,9;2;1;1
258095968018;258095968111;93;0,1,3,5;4;2,9;2;1;1
258095968111;258095968147;36;0,1,3,5;4;2,9;2;1;1
258095968147;258095968253;106;0,1,3,5;4;2,9;2;1;1
258095968253;258095968447;194;0,1,3,5;4;2,9;2;1;1
258095968447;258095969210;763;0,1,3,5;4;2,9;2;1;1
258095969210;258095969323;113;0,1,3,5;4;2,9;2;1;1
258095969323;258095969481;158;0,1,3,5;4;2,9;2;1;1
258095969481;258095970062;581;0,1,3,5;4;2,9;2;1;1
258095970062;258095970317;255;0,1,3,5;4;2,9;2;1;1
258095970317;258095973230;2913;0,1,3,5;4;2,9;2;1;1
258095973230;258095973507;277;0,1,3,5;4;2,9;2;1;1
258095973507;258095973523;16;0,1,3,5;4;2,9;2;1;1
258095973523;258095973545;22;0,1,3,5;4;2,9;2;1;1
258095973545;258095973730;185;0,1,3,5;4;2,9;2;1;1
258095973730;258095973894;164;0,1,3,5;4;2,9;2;1;1
258095973894;258095974007;113;0,1,3,5;4;2,9;2;1;1
258095974007;258095974089;82;0,1,3,5;4;2,9;2;1;1
258095974089;258095974119;30;0,1,3,5;4;2,9;2;1;1
258095974119;258095974146;27;0,1,3,5;4;2,9;2;1;1
258095974146;258095974172;26;0,1,3,5;4;2,9;2;1;1
258095974172;258095974199;27;0,1,3,5;4;2,9;2;1;1
258095974199;258095974671;472;0,1,3,5;4;2,9;2;1;1
258095974671;258095974902;231;0,1,3,5;4;2,9;2;1;1
258095974902;258095974985;83;0,1,3,5;4;2,9;2;1;1
258095974985;258095975126;141;0,1,3,5;4;2,9;2;1;1
258095975126;258095977577;2451;0,1,3,5;4;2,9;2;1;1
258095977577;258095978244;667;0,1,3,5;4;2,9;2;1;1
258095978244;258095978669;425;0,1,3,5;4;2,9;2;1;1
258095978669;258095985289;6620;0,1,3,5;4;2,9;2;1;1
258095985289;258095985393;104;0,1,3,5;4;2,9;2;1;1
258095985393;258095986355;962;0,1,3,5;4;2,9;2;1;1
258095986355;258095986579;224;0,1,3,5;4;2,9;2;1;1
258095986579;258095988676;2097;0,1,3,5;4;2,9;2;1;1
258095988676;258095989065;389;0,1,3,5;4;2,9;2;1;1
258095989065;258095989920;855;0,1,3,5;4;2,9;2;1;1
258095989920;258095992719;2799;0,1,3,5;4;2,9;2;1;1
258095992719;258095992725;6;0,1,3,5;4;2,9;2;1;1
258095992725;258095992760;35;0,1,3,5;4;2,9;2;1;1
258095992760;258095992953;193;0,1,3,5;4;2,9;2;1;1
258095992953;258095993101;148;0,1,3,5;4;2,9;2;1;1
258095993101;258095993285;184;0,1,3,5;4;2,9;2;1;1
258095993285;258095993747;462;0,1,3,5;4;2,9;2;1;1
258095993747;258095994711;964;0,1,3,5;4;2,9;2;1;1
258095994711;258095997277;2566;0,1,3,5;4;2,9;2;1;1
258095997277;258095997453;176;0,1,3,5;4;2,9;2;1;1
258095997453;258095998223;770;0,1,3,5;4;2,9;2;1;1
258095998223;258095998368;145;0,1,3,5;4;2,9;2;1;1
258095998368;258095998516;148;0,1,3,5;4;2,9;2;1;1
258095998516;258095998691;175;0,1,3,5;4;2,9;2;1;1
258095998691;258095998752;61;0,1,3,5;4;2,9;2;1;1
258095998752;258095998837;85;0,1,3,5;4;2,9;2;1;1
258095998837;258095999832;995;0,1,3,5;4;2,9;2;1;1
258095999832;258096010143;10311;0,1,3,5;4;2,9;2;1;1
258096010143;258096012669;2526;0,1,3,5;4;2,9;2;1;1
258096012669;258096014527;1858;0,1,3,5;4;2,9;2;1;1
258096014527;258096016909;2382;0,1,3,5;4;2,9;2;1;1
258096016909;258096017043;134;0,1,3,5;4;2,9;2;1;1
258096017043;258096017187;144;0,1,3,5;4;2,9;2;1;1
258096017187;258096017354;167;0,1,3,5;4;2,9;2;1;1
258096017354;258096017555;201;0,1,3,5;4;2,9;2;1;1
258096017555;258096019184;1629;0,1,3,5;4;2,9;2;1;1
258096019184;258096019654;470;0,1,3,5;4;2,9;2;1;1
258096019654;258096021833;2179;0,1,3,5;4;2,9;2;1;1
258096021833;258096021968;135;0,1,3,5;4;2,9;2;1;1
258096021968;258096022215;247;0,1,3,5;4;2,9;2;1;1
258096022215;258096022259;44;0,1,3,5;4;2,9;2;1;1
258096022259;258096022266;7;0,1,3,5;4;2,9;2;1;1
258096022266;258096022395;129;0,1,3,5;4;2,9;2;1;1
258096022395;258096022481;86;0,1,3,5;4;2,9;2;1;1
258096022481;258096022529;48;0,1,3,5;4;2,9;2;1;1
258096022529;258096022578;49;0,1,3,5;4;2,9;2;1;1
258096022578;258096022688;110;0,1,3,5;4;2,9;2;1;1
258096022688;258096022720;32;0,1,3,5;4;2,9;2;1;1
258096022720;258096024009;1289;0,1,3,5;4;2,9;2;1;1
258096024009;258096024325;316;0,1,3,5;4;2,9;2;1;1
258096024325;258096026100;1775;0,1,3,5;4;2,9;2;1;1
258096026100;258096027379;1279;0,1,3,5;4;2,9;2;1;1
258096027379;258096027866;487;0,1,3,5;4;2,9;2;1;1
258096027866;258096027894;28;0,1,3,5;4;2,9;2;1;1
258096027894;258096028159;265;0,1,3,5;4;2,9;2;1;1
258096028159;258096028294;135;0,1,3,5;4;2,9;2;1;1
258096028294;258096028964;670;0,1,3,5;4;2,9;2;1;1
258096028964;258096032755;3791;0,1,3,5;4;2,9;2;1;1
258096032755;258096033412;657;0,1,3,5;4;2,9;2;1;1
258096033412;258096034019;607;0,1,3,5;4;2,9;2;1;1
258096034019;258096034289;270;0,1,3,5;4;2,9;2;1;1
258096034289;258096034750;461;0,1,3,5;4;2,9;2;1;1
258096034750;258096035497;747;0,1,3,5;4;2,9;2;1;1
258096035497;258096035500;3;0,1,3,5;4;2,9;2;1;1
258096035500;258096035545;45;0,1,3,5;4;2,9;2;1;1
258096035545;258096035595;50;0,1,3,5;4;2,9;2;1;1
258096035595;258096035729;134;0,1,3,5;4;2,9;2;1;1
258096035729;258096035824;95;0,1,3,5;4;2,9;2;1;1
258096035824;258096037639;1815;0,1,3,5;4;2,9;2;1;1
258096037639;258096037670;31;0,1,3,5;4;2,9;2;1;1
258096037670;258096038713;1043;0,1,3,5;4;2,9;2;1;1
258096038713;258096039893;1180;0,1,3,5;4;2,9;2;1;1
258096039893;258096039960;67;0,1,3,5;4;2,9;2;1;1
258096039960;258096040703;743;0,1,3,5;4;2,9;2;1;1
258096040703;258096040987;284;0,1,3,5;4;2,9;2;1;1
258096040987;258096041596;609;0,1,3,5;4;2,9;2;1;1
258096041596;258096041683;87;0,1,3,5;4;2,9;2;1;1
258096041683;258096041697;14;0,1,3,5;4;2,9;2;1;1
258096041697;258096041767;70;0,1,3,5;4;2,9;2;1;1
258096041767;258096041983;216;0,1,3,5;4;2,9;2;1;1
258096041983;258096042406;423;0,1,3,5;4;2,9;2;1;1
258096042406;258096042782;376;0,1,3,5;4;2,9;2;1;1
258096042782;258096043016;234;0,1,3,5;4;2,9;2;1;1
258096043016;258096043417;401;0,1,3,5;4;2,9;2;1;1
258096043417;258096046804;3387;0,1,3,5;4;2,9;2;1;1
258096046804;258096046869;65;0,1,3,5;4;2,9;2;1;1
258096046869;258096047068;199;0,1,3,5;4;2,9;2;1;1
258096047068;258096047132;64;0,1,3,5;4;2,9;2;1;1
258096047132;258096047162;30;0,1,3,5;4;2,9;2;1;1
258096047162;258096047314;152;0,1,3,5;4;2,9;2;1;1
258096047314;258096047497;183;0,1,3,5;4;2,9;2;1;1
258096047497;258096047536;39;0,1,3,5;4;2,9;2;1;1
258096047536;258096047575;39;0,1,3,5;4;2,9;2;1;1
258096047575;258096047753;178;0,1,3,5;4;2,9;2;1;1
258096047753;258096047811;58;0,1,3,5;4;2,9;2;1;1
258096047811;258096047873;62;0,1,3,5;4;2,9;2;1;1
258096047873;258096047907;34;0,1,3,5;4;2,9;2;1;1
258096047907;258096049088;1181;0,1,3,5;4;2,9;2;1;1
258096049088;258096051072;1984;0,1,3,5;4;2,9;2;1;1
258096051072;258096051492;420;0,1,3,5;4;2,9;2;1;1
258096051492;258096051539;47;0,1,3,5;4;2,9;2;1;1
258096051539;258096051577;38;0,1,3,5;4;2,9;2;1;1
258096051577;258096051760;183;0,1,3,5;4;2,9;2;1;1
258096051760;258096051901;141;0,1,3,5;4;2,9;2;1;1
258096051901;258096052091;190;0,1,3,5;4;2,9;2;1;1
258096052091;258096052132;41;0,1,3,5;4;2,9;2;1;1
258096052132;258096052198;66;0,1,3,5;4;2,9;2;1;1
258096052198;258096052830;632;0,1,3,5;4;2,9;2;1;1
258096052830;258096053054;224;0,1,3,5;4;2,9;2;1;1
258096053054;258096053120;66;0,1,3,5;4;2,9;2;1;1
258096053120;258096053192;72;0,1,3,5;4;2,9;2;1;1
258096053192;258096053463;271;0,1,3,5;4;2,9;2;1;1
258096053463;258096053524;61;0,1,3,5;4;2,9;2;1;1
258096053524;258096053717;193;0,1,3,5;4;2,9;2;1;1
258096053717;258096054387;670;0,1,3,5;4;2,9;2;1;1
258096054387;258096055035;648;0,1,3,5;4;2,9;2;1;1
258096055035;258096055058;23;0,1,3,5;4;2,9;2;1;1
258096055058;258096055158;100;0,1,3,5;4;2,9;2;1;1
258096055158;258096055426;268;0,1,3,5;4;2,9;2;1;1
258096055426;258096056477;1051;0,1,3,5;4;2,9;2;1;1
258096056477;258096057045;568;0,1,3,5;4;2,9;2;1;1
258096057045;258096057203;158;0,1,3,5;4;2,9;2;1;1
258096057203;258096057670;467;0,1,3,5;4;2,9;2;1;1
258096057670;258096057803;133;0,1,3,5;4;2,9;2;1;1
258096057803;258096057854;51;0,1,3,5;4;2,9;2;1;1
258096057854;258096057865;11;0,1,3,5;4;2,9;2;1;1
258096057865;258096058174;309;0,1,3,5;4;2,9;2;1;1
258096058174;258096058215;41;0,1,3,5;4;2,9;2;1;1
258096058215;258096058277;62;0,1,3,5;4;2,9;2;1;1
258096058277;258096058467;190;0,1,3,5;4;2,9;2;1;1
258096058467;258096058554;87;0,1,3,5;4;2,9;2;1;1
258096058554;258096058866;312;0,1,3,5;4;2,9;2;1;1
258096058866;258096059398;532;0,1,3,5;4;2,9;2;1;1
258096059398;258096059641;243;0,1,3,5;4;2,9;2;1;1
258096059641;258096060174;533;0,1,3,5;4;2,9;2;1;1
258096060174;258096060671;497;0,1,3,5;4;2,9;2;1;1
258096060671;258096060756;85;0,1,3,5;4;2,9;2;1;1
258096060756;258096061315;559;0,1,3,5;4;2,9;2;1;1
258096061315;258096061619;304;0,1,3,5;4;2,9;2;1;1
258096061619;258096061822;203;0,1,3,5;4;2,9;2;1;1
258096061822;258096061947;125;0,1,3,5;4;2,9;2;1;1
258096061947;258096062518;571;0,1,3,5;4;2,9;2;1;1
258096062518;258096062658;140;0,1,3,5;4;2,9;2;1;1
258096062658;258096062745;87;0,1,3,5;4;2,9;2;1;1
258096062745;258096062830;85;0,1,3,5;4;2,9;2;1;1
258096062830;258096062847;17;0,1,3,5;4;2,9;2;1;1
258096062847;258096063016;169;0,1,3,5;4;2,9;2;1;1
258096063016;258096063144;128;0,1,3,5;4;2,9;2;1;1
258096063144;258096063188;44;0,1,3,5;4;2,9;2;1;1
258096063188;258096063397;209;0,1,3,5;4;2,9;2;1;1
258096063397;258096063468;71;0,1,3,5;4;2,9;2;1;1
258096063468;258096063480;12;0,1,3,5;4;2,9;2;1;1
258096063480;258096063642;162;0,1,3,5;4;2,9;2;1;1
258096063642;258096063697;55;0,1,3,5;4;2,9;2;1;1
258096063697;258096063726;29;0,1,3,5;4;2,9;2;1;1
258096063726;258096063853;127;0,1,3,5;4;2,9;2;1;1
258096063853;258096064169;316;0,1,3,5;4;2,9;2;1;1
258096064169;258096064257;88;0,1,3,5;4;2,9;2;1;1
258096064257;258096064267;10;0,1,3,5;4;2,9;2;1;1
258096064267;258096064368;101;0,1,3,5;4;2,9;2;1;1
258096064368;258096064380;12;0,1,3,5;4;2,9;2;1;1
258096064380;258096064399;19;0,1,3,5;4;2,9;2;1;1
258096064399;258096064406;7;0,1,3,5;4;2,9;2;1;1
258096064406;258096064511;105;0,1,3,5;4;2,9;2;1;1
258096064511;258096064786;275;0,1,3,5;4;2,9;2;1;1
258096064786;258096065027;241;0,1,3,5;4;2,9;2;1;1
258096065027;258096065196;169;0,1,3,5;4;2,9;2;1;1
258096065196;258096065237;41;0,1,3,5;4;2,9;2;1;1
258096065237;258096065257;20;0,1,3,5;4;2,9;2;1;1
258096065257;258096066375;1118;0,1,3,5;4;2,9;2;1;1
258096066375;258096066612;237;0,1,3,5;4;2,9;2;1;1
258096066612;258096066733;121;0,1,3,5;4;2,9;2;1;1
258096066733;258096067179;446;0,1,3,5;4;2,9;2;1;1
258096067179;258096067279;100;0,1,3,5;4;2,9;2;1;1
258096067279;258096067657;378;0,1,3,5;4;2,9;2;1;1
258096067657;258096067991;334;0,1,3,5;4;2,9;2;1;1
258096067991;258096068855;864;0,1,3,5;4;2,9;2;1;1
258096068855;258096068926;71;0,1,3,5;4;2,9;2;1;1
258096068926;258096069009;83;0,1,3,5;4;2,9;2;1;1
258096069009;258096069047;38;0,1,3,5;4;2,9;2;1;1
258096069047;258096069060;13;0,1,3,5;4;2,9;2;1;1
258096069060;258096069071;11;0,1,3,5;4;2,9;2;1;1
258096069071;258096069097;26;0,1,3,5;4;2,9;2;1;1
258096069097;258096069115;18;0,1,3,5;4;2,9;2;1;1
258096069115;258096069147;32;0,1,3,5;4;2,9;2;1;1
258096069147;258096069198;51;0,1,3,5;4;2,9;2;1;1
258096069198;258096069203;5;0,1,3,5;4;2,9;2;1;1
258096069203;258096069310;107;0,1,3,5;4;2,9;2;1;1
258096069310;258096069414;104;0,1,3,5;4;2,9;2;1;1
258096069414;258096069426;12;0,1,3,5;4;2,9;2;1;1
258096069426;258096069627;201;0,1,3,5;4;2,9;2;1;1
258096069627;258096070072;445;0,1,3,5;4;2,9;2;1;1
258096070072;258096070132;60;0,1,3,5;4;2,9;2;1;1
258096070132;258096070391;259;0,1,3,5;4;2,9;2;1;1
258096070391;258096070604;213;0,1,3,5;4;2,9;2;1;1
258096070604;258096072371;1767;0,1,3,5;4;2,9;2;1;1
258096072371;258096072652;281;0,1,3,5;4;2,9;2;1;1
258096072652;258096072702;50;0,1,3,5;4;2,9;2;1;1
258096072702;258096072802;100;0,1,3,5;4;2,9;2;1;1
258096072802;258096073076;274;0,1,3,5;4;2,9;2;1;1
258096073076;258096073270;194;0,1,3,5;4;2,9;2;1;1
258096073270;258096073927;657;0,1,3,5;4;2,9;2;1;1
258096073927;258096074929;1002;0,1,3,5;4;2,9;2;1;1
258096074929;258096075750;821;0,1,3,5;4;2,9;2;1;1
258096075750;258096076560;810;0,1,3,5;4;2,9;2;1;1
258096076560;258096076639;79;0,1,3,5;4;2,9;2;1;1
258096076639;258096076863;224;0,1,3,5;4;2,9;2;1;1
258096076863;258096076956;93;0,1,3,5;4;2,9;2;1;1
258096076956;258096077031;75;0,1,3,5;4;2,9;2;1;1
258096077031;258096077401;370;0,1,3,5;4;2,9;2;1;1
258096077401;258096078308;907;0,1,3,5;4;2,9;2;1;1
258096078308;258096078549;241;0,1,3,5;4;2,9;2;1;1
258096078549;258096078655;106;0,1,3,5;4;2,9;2;1;1
258096078655;258096078683;28;0,1,3,5;4;2,9;2;1;1
258096078683;258096078724;41;0,1,3,5;4;2,9;2;1;1
258096078724;258096078927;203;0,1,3,5;4;2,9;2;1;1
258096078927;258096079059;132;0,1,3,5;4;2,9;2;1;1
258096079059;258096079244;185;0,1,3,5;4;2,9;2;1;1
258096079244;258096079308;64;0,1,3,5;4;2,9;2;1;1
258096079308;258096079549;241;0,1,3,5;4;2,9;2;1;1
258096079549;258096079676;127;0,1,3,5;4;2,9;2;1;1
258096079676;258096079753;77;0,1,3,5;4;2,9;2;1;1
258096079753;258096079823;70;0,1,3,5;4;2,9;2;1;1
258096079823;258096080483;660;0,1,3,5;4;2,9;2;1;1
258096080483;258096080534;51;0,1,3,5;4;2,9;2;1;1
258096080534;258096080634;100;0,1,3,5;4;2,9;2;1;1
258096080634;258096080920;286;0,1,3,5;4;2,9;2;1;1
258096080920;258096081100;180;0,1,3,5;4;2,9;2;1;1
258096081100;258096081258;158;0,1,3,5;4;2,9;2;1;1
258096081258;258096081357;99;0,1,3,5;4;2,9;2;1;1
258096081357;258096082358;1001;0,1,3,5;4;2,9;2;1;1
258096082358;258096082461;103;0,1,3,5;4;2,9;2;1;1
258096082461;258096083123;662;0,1,3,5;4;2,9;2;1;1
258096083123;258096083264;141;0,1,3,5;4;2,9;2;1;1
258096083264;258096083529;265;0,1,3,5;4;2,9;2;1;1
258096083529;258096083573;44;0,1,3,5;4;2,9;2;1;1
258096083573;258096083674;101;0,1,3,5;4;2,9;2;1;1
258096083674;258096083827;153;0,1,3,5;4;2,9;2;1;1
258096083827;258096084031;204;0,1,3,5;4;2,9;2;1;1
258096084031;258096084182;151;0,1,3,5;4;2,9;2;1;1
258096084182;258096084209;27;0,1,3,5;4;2,9;2;1;1
258096084209;258096084232;23;0,1,3,5;4;2,9;2;1;1
258096084232;258096084356;124;0,1,3,5;4;2,9;2;1;1
258096084356;258096084407;51;0,1,3,5;4;2,9;2;1;1
258096084407;258096084704;297;0,1,3,5;4;2,9;2;1;1
258096084704;258096084768;64;0,1,3,5;4;2,9;2;1;1
258096084768;258096084957;189;0,1,3,5;4;2,9;2;1;1
258096084957;258096085127;170;0,1,3,5;4;2,9;2;1;1
258096085127;258096085201;74;0,1,3,5;4;2,9;2;1;1
258096085201;258096085245;44;0,1,3,5;4;2,9;2;1;1
258096085245;258096085270;25;0,1,3,5;4;2,9;2;1;1
258096085270;258096085318;48;0,1,3,5;4;2,9;2;1;1
258096085318;258096085343;25;0,1,3,5;4;2,9;2;1;1
258096085343;258096085466;123;0,1,3,5;4;2,9;2;1;1
258096085466;258096085483;17;0,1,3,5;4;2,9;2;1;1
258096085483;258096085811;328;0,1,3,5;4;2,9;2;1;1
258096085811;258096085955;144;0,1,3,5;4;2,9;2;1;1
258096085955;258096086018;63;0,1,3,5;4;2,9;2;1;1
258096086018;258096086164;146;0,1,3,5;4;2,9;2;1;1
258096086164;258096086175;11;0,1,3,5;4;2,9;2;1;1
258096086175;258096086404;229;0,1,3,5;4;2,9;2;1;1
258096086404;258096086483;79;0,1,3,5;4;2,9;2;1;1
258096086483;258096086779;296;0,1,3,5;4;2,9;2;1;1
258096086779;258096086991;212;0,1,3,5;4;2,9;2;1;1
258096086991;258096087039;48;0,1,3,5;4;2,9;2;1;1
258096087039;258096087645;606;0,1,3,5;4;2,9;2;1;1
258096087645;258096087748;103;0,1,3,5;4;2,9;2;1;1
258096087748;258096089495;1747;0,1,3,5;4;2,9;2;1;1
258096089495;258096089828;333;0,1,3,5;4;2,9;2;1;1
258096089828;258096090121;293;0,1,3,5;4;2,9;2;1;1
258096090121;258096090230;109;0,1,3,5;4;2,9;2;1;1
258096090230;258096090385;155;0,1,3,5;4;2,9;2;1;1
258096090385;258096090409;24;0,1,3,5;4;2,9;2;1;1
258096090409;258096090531;122;0,1,3,5;4;2,9;2;1;1
258096090531;258096090629;98;0,1,3,5;4;2,9;2;1;1
258096090629;258096090834;205;0,1,3,5;4;2,9;2;1;1
258096090834;258096090871;37;0,1,3,5;4;2,9;2;1;1
258096090871;258096090938;67;0,1,3,5;4;2,9;2;1;1
258096090938;258096091065;127;0,1,3,5;4;2,9;2;1;1
258096091065;258096091069;4;0,1,3,5;4;2,9;2;1;1
258096091069;258096091112;43;0,1,3,5;4;2,9;2;1;1
258096091112;258096091225;113;0,1,3,5;4;2,9;2;1;1
258096091225;258096091315;90;0,1,3,5;4;2,9;2;1;1
258096091315;258096091399;84;0,1,3,5;4;2,9;2;1;1
258096091399;258096091430;31;0,1,3,5;4;2,9;2;1;1
258096091430;258096091523;93;0,1,3,5;4;2,9;2;1;1
258096091523;258096091571;48;0,1,3,5;4;2,9;2;1;1
258096091571;258096091585;14;0,1,3,5;4;2,9;2;1;1
258096091585;258096091673;88;0,1,3,5;4;2,9;2;1;1
258096091673;258096091906;233;0,1,3,5;4;2,9;2;1;1
258096091906;258096092029;123;0,1,3,5;4;2,9;2;1;1
258096092029;258096092063;34;0,1,3,5;4;2,9;2;1;1
258096092063;258096092087;24;0,1,3,5;4;2,9;2;1;1
258096092087;258096092144;57;0,1,3,5;4;2,9;2;1;1
258096092144;258096092635;491;0,1,3,5;4;2,9;2;1;1
258096092635;258096092704;69;0,1,3,5;4;2,9;2;1;1
258096092704;258096092732;28;0,1,3,5;4;2,9;2;1;1
258096092732;258096092904;172;0,1,3,5;4;2,9;2;1;1
258096092904;258096094016;1112;0,1,3,5;4;2,9;2;1;1
258096094016;258096094307;291;0,1,3,5;4;2,9;2;1;1
258096094307;258096094683;376;0,1,3,5;4;2,9;2;1;1
258096094683;258096095000;317;0,1,3,5;4;2,9;2;1;1
258096095000;258096095490;490;0,1,3,5;4;2,9;2;1;1
258096095490;258096095940;450;0,1,3,5;4;2,9;2;1;1
258096095940;258096096058;118;0,1,3,5;4;2,9;2;1;1
258096096058;258096096398;340;0,1,3,5;4;2,9;2;1;1
258096096398;258096096400;2;0,1,3,5;4;2,9;2;1;1
258096096400;258096096663;263;0,1,3,5;4;2,9;2;1;1
258096096663;258096097106;443;0,1,3,5;4;2,9;2;1;1
258096097106;258096097172;66;0,1,3,5;4;2,9;2;1;1
258096097172;258096097877;705;0,1,3,5;4;2,9;2;1;1
258096097877;258096097960;83;0,1,3,5;4;2,9;2;1;1
258096097960;258096098388;428;0,1,3,5;4;2,9;2;1;1
258096098388;258096098944;556;0,1,3,5;4;2,9;2;1;1
258096098944;258096099382;438;0,1,3,5;4;2,9;2;1;1
258096099382;258096099417;35;0,1,3,5;4;2,9;2;1;1
258096099417;258096099477;60;0,1,3,5;4;2,9;2;1;1
258096099477;258096099525;48;0,1,3,5;4;2,9;2;1;1
258096099525;258096099529;4;0,1,3,5;4;2,9;2;1;1
258096099529;258096099542;13;0,1,3,5;4;2,9;2;1;1
258096099542;258096099566;24;0,1,3,5;4;2,9;2;1;1
258096099566;258096099595;29;0,1,3,5;4;2,9;2;1;1
258096099595;258096099646;51;0,1,3,5;4;2,9;2;1;1
258096099646;258096099880;234;0,1,3,5;4;2,9;2;1;1
258096099880;258096099899;19;0,1,3,5;4;2,9;2;1;1
258096099899;258096100040;141;0,1,3,5;4;2,9;2;1;1
258096100040;258096100202;162;0,1,3,5;4;2,9;2;1;1
258096100202;258096100234;32;0,1,3,5;4;2,9;2;1;1
258096100234;258096100401;167;0,1,3,5;4;2,9;2;1;1
258096100401;258096100463;62;0,1,3,5;4;2,9;2;1;1
258096100463;258096100490;27;0,1,3,5;4;2,9;2;1;1
258096100490;258096100584;94;0,1,3,5;4;2,9;2;1;1
258096100584;258096101183;599;0,1,3,5;4;2,9;2;1;1
258096101183;258096103014;1831;0,1,3,5;4;2,9;2;1;1
258096103014;258096103387;373;0,1,3,5;4;2,9;2;1;1
258096103387;258096103955;568;0,1,3,5;4;2,9;2;1;1
258096103955;258096104283;328;0,1,3,5;4;2,9;2;1;1
258096104283;258096104416;133;0,1,3,5;4;2,9;2;1;1
258096104416;258096105990;1574;0,1,3,5;4;2,9;2;1;1
258096105990;258096106094;104;0,1,3,5;4;2,9;2;1;1
258096106094;258096106664;570;0,1,3,5;4;2,9;2;1;1
258096106664;258096107009;345;0,1,3,5;4;2,9;2;1;1
258096107009;258096107619;610;0,1,3,5;4;2,9;2;1;1
258096107619;258096108012;393;0,1,3,5;4;2,9;2;1;1
258096108012;258096108172;160;0,1,3,5;4;2,9;2;1;1
258096108172;258096108648;476;0,1,3,5;4;2,9;2;1;1
258096108648;258096109058;410;0,1,3,5;4;2,9;2;1;1
258096109058;258096109207;149;0,1,3,5;4;2,9;2;1;1
258096109207;258096109481;274;0,1,3,5;4;2,9;2;1;1
258096109481;258096110214;733;0,1,3,5;4;2,9;2;1;1
258096110214;258096110515;301;0,1,3,5;4;2,9;2;1;1
258096110515;258096110864;349;0,1,3,5;4;2,9;2;1;1
258096110864;258096110868;4;0,1,3,5;4;2,9;2;1;1
258096110868;258096111404;536;0,1,3,5;4;2,9;2;1;1
258096111404;258096112282;878;0,1,3,5;4;2,9;2;1;1
258096112282;258096112305;23;0,1,3,5;4;2,9;2;1;1
258096112305;258096113180;875;0,1,3,5;4;2,9;2;1;1
258096113180;258096114107;927;0,1,3,5;4;2,9;2;1;1
258096114107;258096114314;207;0,1,3,5;4;2,9;2;1;1
258096114314;258096114523;209;0,1,3,5;4;2,9;2;1;1
258096114523;258096114758;235;0,1,3,5;4;2,9;2;1;1
258096114758;258096115382;624;0,1,3,5;4;2,9;2;1;1
258096115382;258096116029;647;0,1,3,5;4;2,9;2;1;1
258096116029;258096120377;4348;0,1,3,5;4;2,9;2;1;1
258096120377;258096120726;349;0,1,3,5;4;2,9;2;1;1
258096120726;258096121867;1141;0,1,3,5;4;2,9;2;1;1
258096121867;258096121893;26;0,1,3,5;4;2,9;2;1;1
258096121893;258096122138;245;0,1,3,5;4;2,9;2;1;1
258096122138;258096122490;352;0,1,3,5;4;2,9;2;1;1
258096122490;258096122528;38;0,1,3,5;4;2,9;2;1;1
258096122528;258096122630;102;0,1,3,5;4;2,9;2;1;1
258096122630;258096123064;434;0,1,3,5;4;2,9;2;1;1
258096123064;258096123356;292;0,1,3,5;4;2,9;2;1;1
258096123356;258096123737;381;0,1,3,5;4;2,9;2;1;1
258096123737;258096124050;313;0,1,3,5;4;2,9;2;1;1
258096124050;258096124309;259;0,1,3,5;4;2,9;2;1;1
258096124309;258096124646;337;0,1,3,5;4;2,9;2;1;1
258096124646;258096124861;215;0,1,3,5;4;2,9;2;1;1
258096124861;258096127115;2254;0,1,3,5;4;2,9;2;1;1
258096127115;258096127348;233;0,1,3,5;4;2,9;2;1;1
258096127348;258096127659;311;0,1,3,5;4;2,9;2;1;1
258096127659;258096127663;4;0,1,3,5;4;2,9;2;1;1
258096127663;258096128025;362;0,1,3,5;4;2,9;2;1;1
258096128025;258096128461;436;0,1,3,5;4;2,9;2;1;1
258096128461;258096128806;345;0,1,3,5;4;2,9;2;1;1
258096128806;258096129214;408;0,1,3,5;4;2,9;2;1;1
258096129214;258096129642;428;0,1,3,5;4;2,9;2;1;1
258096129642;258096130317;675;0,1,3,5;4;2,9;2;1;1
258096130317;258096131875;1558;0,1,3,5;4;2,9;2;1;1
258096131875;258096132008;133;0,1,3,5;4;2,9;2;1;1
258096132008;258096133999;1991;0,1,3,5;4;2,9;2;1;1
258096133999;258096134375;376;0,1,3,5;4;2,9;2;1;1
258096134375;258096135015;640;0,1,3,5;4;2,9;2;1;1
258096135015;258096135199;184;0,1,3,5;4;2,9;2;1;1
258096135199;258096135575;376;0,1,3,5;4;2,9;2;1;1
258096135575;258096135943;368;0,1,3,5;4;2,9;2;1;1
258096135943;258096136109;166;0,1,3,5;4;2,9;2;1;1
258096136109;258096136171;62;0,1,3,5;4;2,9;2;1;1
258096136171;258096136383;212;0,1,3,5;4;2,9;2;1;1
258096136383;258096136494;111;0,1,3,5;4;2,9;2;1;1
258096136494;258096136996;502;0,1,3,5;4;2,9;2;1;1
258096136996;258096137404;408;0,1,3,5;4;2,9;2;1;1
258096137404;258096137503;99;0,1,3,5;4;2,9;2;1;1
258096137503;258096140138;2635;0,1,3,5;4;2,9;2;1;1
258096140138;258096140275;137;0,1,3,5;4;2,9;2;1;1
258096140275;258096140596;321;0,1,3,5;4;2,9;2;1;1
258096140596;258096140618;22;0,1,3,5;4;2,9;2;1;1
258096140618;258096140685;67;0,1,3,5;4;2,9;2;1;1
258096140685;258096141982;1297;0,1,3,5;4;2,9;2;1;1
258096141982;258096142553;571;0,1,3,5;4;2,9;2;1;1
258096142553;258096149639;7086;0,1,3,5;4;2,9;2;1;1
258096149639;258096151010;1371;0,1,3,5;4;2,9;2;1;1
258096151010;258096154426;3416;0,1,3,5;4;2,9;2;1;1
258096154426;258096157742;3316;0,1,3,5;4;2,9;2;1;1
258096157742;258096159908;2166;0,1,3,5;4;2,9;2;1;1
258096159908;258096162434;2526;0,1,3,5;4;2,9;2;1;1
258096162434;258096164224;1790;0,1,3,5;4;2,9;2;1;1
258096164224;258096166849;2625;0,1,3,5;4;2,9;2;1;1
258096166849;258096168989;2140;0,1,3,5;4;2,9;2;1;1
258096168989;258096169432;443;0,1,3,5;4;2,9;2;1;1
258096169432;258096169918;486;0,1,3,5;4;2,9;2;1;1
258096169918;258096171278;1360;0,1,3,5;4;2,9;2;1;1
258096171278;258096172834;1556;0,1,3,5;4;2,9;2;1;1
258096172834;258096172877;43;0,1,3,5;4;2,9;2;1;1
258096172877;258096172930;53;0,1,3,5;4;2,9;2;1;1
258096172930;258096173162;232;0,1,3,5;4;2,9;2;1;1
258096173162;258096173211;49;0,1,3,5;4;2,9;2;1;1
258096173211;258096173356;145;0,1,3,5;4;2,9;2;1;1
258096173356;258096175672;2316;0,1,3,5;4;2,9;2;1;1
258096175672;258096176810;1138;0,1,3,5;4;2,9;2;1;1
258096176810;258096178947;2137;0,1,3,5;4;2,9;2;1;1
258096178947;258096184737;5790;0,1,3,5;4;2,9;2;1;1
258096184737;258096186634;1897;0,1,3,5;4;2,9;2;1;1
258096186634;258096188262;1628;0,1,3,5;4;2,9;2;1;1
258096188262;258096188347;85;0,1,3,5;4;2,9;2;1;1
258096188347;258096188708;361;0,1,3,5;4;2,9;2;1;1
258096188708;258096189054;346;0,1,3,5;4;2,9;2;1;1
258096189054;258096192692;3638;0,1,3,5;4;2,9;2;1;1
258096192692;258096192705;13;0,1,3,5;4;2,9;2;1;1
258096192705;258096192716;11;0,1,3,5;4;2,9;2;1;1
258096192716;258096193069;353;0,1,3,5;4;2,9;2;1;1
258096193069;258096193098;29;0,1,3,5;4;2,9;2;1;1
258096193098;258096193967;869;0,1,3,5;4;2,9;2;1;1
258096193967;258096194104;137;0,1,3,5;4;2,9;2;1;1
258096194104;258096198642;4538;0,1,3,5;4;2,9;2;1;1
258096198642;258096200253;1611;0,1,3,5;4;2,9;2;1;1
258096200253;258096208545;8292;0,1,3,5;4;2,9;2;1;1
258096208545;258096211420;2875;0,1,3,5;4;2,9;2;1;1
258096211420;258096211817;397;0,1,3,5;4;2,9;2;1;1
258096211817;258096211855;38;0,1,3,5;4;2,9;2;1;1
258096211855;258096211994;139;0,1,3,5;4;2,9;2;1;1
258096211994;258096212107;113;0,1,3,5;4;2,9;2;1;1
258096212107;258096212394;287;0,1,3,5;4;2,9;2;1;1
258096212394;258096212625;231;0,1,3,5;4;2,9;2;1;1
258096212625;258096213727;1102;0,1,3,5;4;2,9;2;1;1
258096213727;258096215370;1643;0,1,3,5;4;2,9;2;1;1
258096215370;258096215435;65;0,1,3,5;4;2,9;2;1;1
258096215435;258096218309;2874;0,1,3,5;4;2,9;2;1;1
258096218309;258096219847;1538;0,1,3,5;4;2,9;2;1;1
258096219847;258096220915;1068;0,1,3,5;4;2,9;2;1;1
258096220915;258096227064;6149;0,1,3,5;4;2,9;2;1;1
258096227064;258096227121;57;0,1,3,5;4;2,9;2;1;1
258096227121;258096227270;149;0,1,3,5;4;2,9;2;1;1
258096227270;258096227298;28;0,1,3,5;4;2,9;2;1;1
258096227298;258096227317;19;0,1,3,5;4;2,9;2;1;1
258096227317;258096229718;2401;0,1,3,5;4;2,9;2;1;1
258096229718;258096233153;3435;0,1,3,5;4;2,9;2;1;1
258096233153;258096238280;5127;0,1,3,5;4;2,9;2;1;1
258096238280;258096238333;53;0,1,3,5;4;2,9;2;1;1
258096238333;258096240201;1868;0,1,3,5;4;2,9;2;1;1
258096240201;258096243297;3096;0,1,3,5;4;2,9;2;1;1
258096243297;258096246056;2759;0,1,3,5;4;2,9;2;1;1
258096246056;258096246405;349;0,1,3,5;4;2,9;2;1;1
258096246405;258096246557;152;0,1,3,5;4;2,9;2;1;1
258096246557;258096246715;158;0,1,3,5;4;2,9;2;1;1
258096246715;258096246883;168;0,1,3,5;4;2,9;2;1;1
258096246883;258096252172;5289;0,1,3,5;4;2,9;2;1;1
258096252172;258096252632;460;0,1,3,5;4;2,9;2;1;1
258096252632;258096257702;5070;0,1,3,5;4;2,9;2;1;1
258096257702;258096257891;189;0,1,3,5;4;2,9;2;1;1
258096257891;258096266625;8734;0,1,3,5;4;2,9;2;1;1
258096266625;258096266798;173;0,1,3,5;4;2,9;2;1;1
258096266798;258096267258;460;0,1,3,5;4;2,9;2;1;1
258096267258;258096298604;31346;0,1,3,5;4;2,9;2;1;1
258096298604;258096303120;4516;0,1,3,5;4;2,9;2;1;1
258096303120;258096321406;18286;0,1,3,5;4;2,9;2;1;1
258096321406;258096324346;2940;0,1,3,5;4;2,9;2;1;1
258096324346;258096324720;374;0,1,3,5;4;2,9;2;1;1
258096324720;258096328350;3630;0,1,3,5;4;2,9;2;1;1
258096328350;258096328565;215;0,1,3,5;4;2,9;2;1;1
258096328565;258096328803;238;0,1,3,5;4;2,9;2;1;1
258096328803;258096328807;4;0,1,3,5;4;2,9;2;1;1
258096328807;258096328859;52;0,1,3,5;4;2,9;2;1;1
258096328859;258096328978;119;0,1,3,5;4;2,9;2;1;1
258096328978;258096329179;201;0,1,3,5;4;2,9;2;1;1
258096329179;258096329859;680;0,1,3,5;4;2,9;2;1;1
258096329859;258096329909;50;0,1,3,5;4;2,9;2;1;1
258096329909;258096330003;94;0,1,3,5;4;2,9;2;1;1
258096330003;258096333506;3503;0,1,3,5;4;2,9;2;1;1
258096333506;258096333635;129;0,1,3,5;4;2,9;2;1;1
258096333635;258096333971;336;0,1,3,5;4;2,9;2;1;1
258096333971;258096339365;5394;0,1,3,5;4;2,9;2;1;1
258096339365;258096339837;472;0,1,3,5;4;2,9;2;1;1
258096339837;258096340083;246;0,1,3,5;4;2,9;2;1;1
258096340083;258096342928;2845;0,1,3,5;4;2,9;2;1;1
258096342928;258096343560;632;0,1,3,5;4;2,9;2;1;1
258096343560;258096343624;64;0,1,3,5;4;2,9;2;1;1
258096343624;258096343919;295;0,1,3,5;4;2,9;2;1;1
258096343919;258096344001;82;0,1,3,5;4;2,9;2;1;1
258096344001;258096344185;184;0,1,3,5;4;2,9;2;1;1
258096344185;258096344316;131;0,1,3,5;4;2,9;2;1;1
258096344316;258096344372;56;0,1,3,5;4;2,9;2;1;1
258096344372;258096431739;87367;0,1,3,5;4;2,9;2;1;1
258096431739;258096462638;30899;0,1,3,5;4;2,9;2;1;1
258096462638;258096473577;10939;0,1,3,5;4;2,9;2;1;1
258096473577;258096482500;8923;0,1,3,5;4;2,9;2;1;1
258096482500;258096482758;258;0,1,3,5;4;2,9;2;1;1
258096482758;258096519370;36612;0,1,3,5;4;2,9;2;1;1
258096519370;258096530184;10814;0,1,3,5;4;2,9;2;1;1
258096530184;258096530235;51;0,1,3,5;4;2,9;2;1;1
258096530235;258096530261;26;0,1,3,5;4;2,9;2;1;1
258096530261;258096530317;56;0,1,3,5;4;2,9;2;1;1
258096530317;258096530331;14;0,1,3,5;4;2,9;2;1;1
258096530331;258096530352;21;0,1,3,5;4;2,9;2;1;1
258096530352;258096531165;813;0,1,3,5;4;2,9;2;1;1
258096531165;258096561944;30779;0,1,3,5;4;2,9;2;1;1
258096561944;258096565328;3384;0,1,3,5;4;2,9;2;1;1
258096565328;258096565762;434;0,1,3,5;4;2,9;2;1;1
258096565762;258096565998;236;0,1,3,5;4;2,9;2;1;1
258096565998;258096566076;78;0,1,3,5;4;2,9;2;1;1
258096566076;258096566521;445;0,1,3,5;4;2,9;2;1;1
258096566521;258096597440;30919;0,1,3,5;4;2,9;2;1;1
258096597440;258096636865;39425;0,1,3,5;4;2,9;2;1;1
258096636865;258096637921;1056;0,1,3,4,5;5;2,9;2;1;1
258096637921;258096689834;51913;0,1,3,5;4;2,9;2;1;1
258096689834;258096698978;9144;0,1,3,5;4;2,9;2;1;1
258096698978;258096699232;254;0,1,3,5;4;2,9;2;1;1
258096699232;258096731147;31915;0,1,3,5;4;2,9;2;1;1
258096731147;258096734854;3707;0,1,3,5;4;2,9;2;1;1
258096734854;258096734962;108;0,1,3,5;4;2,9;2;1;1
258096734962;258096735276;314;0,1,3,5;4;2,9;2;1;1
258096735276;258096735464;188;0,1,3,5;4;2,9;2;1;1
258096735464;258096762048;26584;0,1,3,5;4;2,9;2;1;1
258096762048;258096762089;41;0,1,3,5;4;2,9;2;1;1
258096762089;258096762140;51;0,1,3,5;4;2,9;2;1;1
258096762140;258096762356;216;0,1,3,5;4;2,9;2;1;1
258096762356;258096762506;150;0,1,3,5;4;2,9;2;1;1
258096762506;258096762652;146;0,1,3,5;4;2,9;2;1;1
258096762652;258096762707;55;0,1,3,5;4;2,9;2;1;1
258096762707;258096762799;92;0,1,3,5;4;2,9;2;1;1
258096762799;258096762926;127;0,1,3,5;4;2,9;2;1;1
258096762926;258096763082;156;0,1,3,5;4;2,9;2;1;1
258096763082;258096763237;155;0,1,3,5;4;2,9;2;1;1
258096763237;258096766491;3254;0,1,3,5;4;2,9;2;1;1
258096766491;258096774140;7649;0,1,3,5;4;2,9;2;1;1
258096774140;258096775434;1294;0,1,3,5;4;2,9;2;1;1
258096775434;258096779182;3748;0,1,3,5;4;2,9;2;1;1
258096779182;258096781575;2393;0,1,3,5;4;2,9;2;1;1
258096781575;258096784147;2572;0,1,3,5;4;2,9;2;1;1
258096784147;258096784559;412;0,1,3,5;4;2,9;2;1;1
258096784559;258096797006;12447;0,1,3,5;4;2,9;2;1;1
258096797006;258096802819;5813;0,1,3,5;4;2,9;2;1;1
258096802819;258096803081;262;0,1,3,5;4;2,9;2;1;1
258096803081;258096803135;54;0,1,3,5;4;2,9;2;1;1
258096803135;258096803147;12;0,1,3,5;4;2,9;2;1;1
258096803147;258096803168;21;0,1,3,5;4;2,9;2;1;1
258096803168;258096803362;194;0,1,3,5;4;2,9;2;1;1
258096803362;258096803400;38;0,1,3,5;4;2,9;2;1;1
258096803400;258096803493;93;0,1,3,5;4;2,9;2;1;1
258096803493;258096814645;11152;0,1,3,5;4;2,9;2;1;1
258096814645;258096818701;4056;0,1,3,5;4;2,9;2;1;1
258096818701;258096820482;1781;0,1,3,5;4;2,9;2;1;1
258096820482;258096832932;12450;0,1,3,5;4;2,9;2;1;1
258096832932;258096836338;3406;0,1,3,5;4;2,9;2;1;1
258096836338;258096836870;532;0,1,3,5;4;2,9;2;1;1
258096836870;258096847909;11039;0,1,3,5;4;2,9;2;1;1
258096847909;258096871220;23311;0,1,3,5;4;2,9;2;1;1
258096871220;258096882526;11306;0,1,3,5;4;2,9;2;1;1
258096882526;258096882577;51;0,1,3,5;4;2,9;2;1;1
258096882577;258096891105;8528;0,1,3,5;4;2,9;2;1;1
258096891105;258096891356;251;0,1,3,5;4;2,9;2;1;1
258096891356;258096891565;209;0,1,3,5;4;2,9;2;1;1
258096891565;258096891664;99;0,1,3,5;4;2,9;2;1;1
258096891664;258096891744;80;0,1,3,5;4;2,9;2;1;1
258096891744;258096902759;11015;0,1,3,5;4;2,9;2;1;1
258096902759;258096905413;2654;0,1,3,5;4;2,9;2;1;1
258096905413;258096906245;832;0,1,3,5;4;2,9;2;1;1
258096906245;258096906768;523;0,1,3,5;4;2,9;2;1;1
258096906768;258096906813;45;0,1,3,5;4;2,9;2;1;1
258096906813;258096916174;9361;0,1,3,5;4;2,9;2;1;1
258096916174;258096917260;1086;0,1,3,5;4;2,9;2;1;1
258096917260;258096945258;27998;0,1,3,5;4;2,9;2;1;1
258096945258;258096945784;526;0,1,3,5;4;2,9;2;1;1
258096945784;258096945854;70;0,1,3,5;4;2,9;2;1;1
258096945854;258096948738;2884;0,1,3,5;4;2,9;2;1;1
258096948738;258096948810;72;0,1,3,5,6;5;2,9;2;1;1
258096948810;258096948852;42;0,1,3,5,6;5;2,9;2;1;1
258096948852;258096948876;24;0,1,3,5,6;5;2,9;2;1;1
258096948876;258096948885;9;0,1,3,5,6;5;2,9;2;1;1
258096948885;258096948926;41;0,1,3,5,6;5;2,9;2;1;1
258096948926;258096949047;121;0,1,3,5,6;5;2,9;2;1;1
258096949047;258096949114;67;0,1,3,5,6;5;2,9;2;1;1
258096949114;258096949130;16;0,1,3,5;4;2,9;2;1;1
258096949130;258096949153;23;0,1,3,5;4;2,9;2;1;1
258096949153;258096956710;7557;0,1,3,5;4;2,9;2;1;1
258096956710;258096961297;4587;0,1,3,5;4;2,9;2;1;1
258096961297;258096966421;5124;0,1,3,5;4;2,9;2;1;1
258096966421;258096966457;36;0,1,3,5;4;2,9;2;1;1
258096966457;258097000191;33734;0,1,3,5;4;2,9;2;1;1
258097000191;258097000459;268;0,1,3,5;4;2,9;2;1;1
258097000459;258097000508;49;0,1,3,5;4;2,9;2;1;1
258097000508;258097000598;90;0,1,3,5,6;5;2,9;2;1;1
258097000598;258097000675;77;0,1,3,5,6;5;2,9;2;1;1
258097000675;258097000684;9;0,1,3,5,6;5;2,9;2;1;1
258097000684;258097000892;208;0,1,3,5;4;2,9;2;1;1
258097000892;258097001200;308;0,1,3,5;4;2,9;2;1;1
258097001200;258097001349;149;0,1,3,5;4;2,9;2;1;1
258097001349;258097001371;22;0,1,3,5;4;2,9;2;1;1
258097001371;258097007502;6131;0,1,3,5;4;2,9;2;1;1
258097007502;258097007520;18;0,1,3,5;4;2,9;2;1;1
258097007520;258097007546;26;0,1,3,5;4;2,9;2;1;1
258097007546;258097007636;90;0,1,3,5;4;2,9;2;1;1
258097007636;258097007697;61;0,1,3,5;4;2,9;2;1;1
258097007697;258097007753;56;0,1,3,5;4;2,9;2;1;1
258097007753;258097007777;24;0,1,3,5,6;5;2,9;2;1;1
258097007777;258097007883;106;0,1,3,5,6;5;2,9;2;1;1
258097007883;258097007964;81;0,1,3,5,6;5;2,9;2;1;1
258097007964;258097008027;63;0,1,3,5;4;2,9;2;1;1
258097008027;258097012037;4010;0,1,3,5;4;2,9;2;1;1
258097012037;258097012707;670;0,1,3,5;4;2,9;2;1;1
258097012707;258097019306;6599;0,1,3,5;4;2,9;2;1;1
258097019306;258097046508;27202;0,1,3,5;4;2,9;2;1;1
258097046508;258097056673;10165;0,1,3,5;4;2,9;2;1;1
258097056673;258097056825;152;0,1,3,5;4;2,9;2;1;1
258097056825;258097056987;162;0,1,3,5;4;2,9;2;1;1
258097056987;258097057013;26;0,1,3,5;4;2,9;2;1;1
258097057013;258097057249;236;0,1,3,5;4;2,9;2;1;1
258097057249;258097059365;2116;0,1,3,5;4;2,9;2;1;1
258097059365;258097060670;1305;0,1,3,5;4;2,9;2;1;1
258097060670;258097061021;351;0,1,3,5;4;2,9;2;1;1
258097061021;258097061391;370;0,1,3,5;4;2,9;2;1;1
258097061391;258097061426;35;0,1,3,5;4;2,9;2;1;1
258097061426;258097061537;111;0,1,3,5,6;5;2,9;2;1;1
258097061537;258097061623;86;0,1,3,5,6;5;2,9;2;1;1
258097061623;258097061663;40;0,1,3,5,6;5;2,9;2;1;1
258097061663;258097061746;83;0,1,3,5,6;5;2,9;2;1;1
258097061746;258097061816;70;0,1,3,5;4;2,9;2;1;1
258097061816;258097061986;170;0,1,3,5;4;2,9;2;1;1
258097061986;258097062151;165;0,1,3,5;4;2,9;2;1;1
258097062151;258097071890;9739;0,1,3,5;4;2,9;2;1;1
258097071890;258097081798;9908;0,1,3,5;4;2,9;2;1;1
258097081798;258097081829;31;0,1,3,5;4;2,9;2;1;1
258097081829;258097081870;41;0,1,3,5;4;2,9;2;1;1
258097081870;258097081919;49;0,1,3,5;4;2,9;2;1;1
258097081919;258097082105;186;0,1,3,5;4;2,9;2;1;1
258097082105;258097082132;27;0,1,3,5;4;2,9;2;1;1
258097082132;258097082242;110;0,1,3,5;4;2,9;2;1;1
258097082242;258097082391;149;0,1,3,5;4;2,9;2;1;1
258097082391;258097082401;10;0,1,3,5;4;2,9;2;1;1
258097082401;258097082468;67;0,1,3,5;4;2,9;2;1;1
258097082468;258097082526;58;0,1,3,5;4;2,9;2;1;1
258097082526;258097082645;119;0,1,3,5;4;2,9;2;1;1
258097082645;258097083600;955;0,1,3,5;4;2,9;2;1;1
258097083600;258097083779;179;0,1,3,5;4;2,9;2;1;1
258097083779;258097084118;339;0,1,3,5;4;2,9;2;1;1
258097084118;258097084204;86;0,1,3,5;4;2,9;2;1;1
258097084204;258097084272;68;0,1,3,5;4;2,9;2;1;1
258097084272;258097086272;2000;0,1,3,5;4;2,9;2;1;1
258097086272;258097087023;751;0,1,3,5;4;2,9;2;1;1
258097087023;258097094215;7192;0,1,3,5;4;2,9;2;1;1
258097094215;258097094436;221;0,1,3,5;4;2,9;2;1;1
258097094436;258097095003;567;0,1,3,5;4;2,9;2;1;1
258097095003;258097095746;743;0,1,3,5;4;2,9;2;1;1
258097095746;258097096758;1012;0,1,3,5;4;2,9;2;1;1
258097096758;258097102038;5280;0,1,3,5;4;2,9;2;1;1
258097102038;258097109189;7151;0,1,3,5;4;2,9;2;1;1
258097109189;258097111166;1977;0,1,3,5;4;2,9;2;1;1
258097111166;258097111498;332;0,1,3,5;4;2,9;2;1;1
258097111498;258097111913;415;0,1,3,5;4;2,9;2;1;1
258097111913;258097139495;27582;0,1,3,5;4;2,9;2;1;1
258097139495;258097149872;10377;0,1,3,5;4;2,9;2;1;1
258097149872;258097150000;128;0,1,3,5;4;2,9;2;1;1
258097150000;258097150035;35;0,1,3,5;4;2,9;2;1;1
258097150035;258097150071;36;0,1,3,5;4;2,9;2;1;1
258097150071;258097150612;541;0,1,3,5;4;2,9;2;1;1
258097150612;258097180424;29812;0,1,3,5;4;2,9;2;1;1
258097180424;258097189622;9198;0,1,3,5;4;2,9;2;1;1
258097189622;258097189858;236;0,1,3,5;4;2,9;2;1;1
258097189858;258097189882;24;0,1,3,5;4;2,9;2;1;1
258097189882;258097189954;72;0,1,3,5;4;2,9;2;1;1
258097189954;258097189981;27;0,1,3,5;4;2,9;2;1;1
258097189981;258097190000;19;0,1,3,5;4;2,9;2;1;1
258097190000;258097190649;649;0,1,3,5;4;2,9;2;1;1
258097190649;258097259035;68386;0,1,3,5;4;2,9;2;1;1
258097259035;258097259145;110;0,1,3,5;4;2,9;2;1;1
258097259145;258097259294;149;0,1,3,5;4;2,9;2;1;1
258097259294;258097270133;10839;0,1,3,5;4;2,9;2;1;1
258097270133;258097274015;3882;0,1,3,5;4;2,9;2;1;1
258097274015;258097274188;173;0,1,3,5;4;2,9;2;1;1
258097274188;258097274221;33;0,1,3,5;4;2,9;2;1;1
258097274221;258097274244;23;0,1,3,5;4;2,9;2;1;1
258097274244;258097348744;74500;0,1,3,5;4;2,9;2;1;1
258097348744;258097349787;1043;0,1,3,5;4;2,9;2;1;1
258097349787;258097349842;55;0,1,3,5;4;2,9;2;1;1
258097349842;258097349864;22;0,1,3,5;4;2,9;2;1;1
258097349864;258097350324;460;0,1,3,5;4;2,9;2;1;1
258097350324;258097350550;226;0,1,3,5;4;2,9;2;1;1
258097350550;258097350618;68;0,1,3,5;4;2,9;2;1;1
258097350618;258097350657;39;0,1,3,5;4;2,9;2;1;1
258097350657;258097354536;3879;0,1,3,5;4;2,9;2;1;1
258097354536;258097354540;4;0,1,3,5;4;2,9;2;1;1
258097354540;258097354568;28;0,1,3,5;4;2,9;2;1;1
258097354568;258097389236;34668;0,1,3,5;4;2,9;2;1;1
258097389236;258097393778;4542;0,1,3,5;4;2,9;2;1;1
258097393778;258097394142;364;0,1,3,5;4;2,9;2;1;1
258097394142;258097398578;4436;0,1,3,5;4;2,9;2;1;1
258097398578;258097398634;56;0,1,3,5;4;2,9;2;1;1
258097398634;258097398752;118;0,1,3,5;4;2,9;2;1;1
258097398752;258097402440;3688;0,1,3,5;4;2,9;2;1;1
258097402440;258097402588;148;0,1,3,5,6;5;2,9;2;1;1
258097402588;258097402638;50;0,1,3,5,6;5;2,9;2;1;1
258097402638;258097402748;110;0,1,3,5;4;2,9;2;1;1
258097402748;258097402817;69;0,1,3,5;4;2,9;2;1;1
258097402817;258097402863;46;0,1,3,5;4;2,9;2;1;1
258097402863;258097402909;46;0,1,3,5;4;2,9;2;1;1
258097402909;258097402965;56;0,1,3,5;4;2,9;2;1;1
258097402965;258097403314;349;0,1,3,5;4;2,9;2;1;1
258097403314;258097403757;443;0,1,3,5;4;2,9;2;1;1
258097403757;258097403829;72;0,1,3,5;4;2,9;2;1;1
258097403829;258097403872;43;0,1,3,5;4;2,9;2;1;1
258097403872;258097404102;230;0,1,3,5;4;2,9;2;1;1
258097404102;258097404247;145;0,1,3,5;4;2,9;2;1;1
258097404247;258097404289;42;0,1,3,5;4;2,9;2;1;1
258097404289;258097415996;11707;0,1,3,5;4;2,9;2;1;1
258097415996;258097416081;85;0,1,3,5;4;2,9;2;1;1
258097416081;258097416200;119;0,1,3,5;4;2,9;2;1;1
258097416200;258097416282;82;0,1,3,5;4;2,9;2;1;1
258097416282;258097416386;104;0,1,3,5;4;2,9;2;1;1
258097416386;258097416402;16;0,1,3,5;4;2,9;2;1;1
258097416402;258097416422;20;0,1,3,5;4;2,9;2;1;1
258097416422;258097416520;98;0,1,3,5;4;2,9;2;1;1
258097416520;258097416672;152;0,1,3,5;4;2,9;2;1;1
258097416672;258097416695;23;0,1,3,5;4;2,9;2;1;1
258097416695;258097416793;98;0,1,3,5;4;2,9;2;1;1
258097416793;258097420220;3427;0,1,3,5;4;2,9;2;1;1
258097420220;258097422643;2423;0,1,3,5;4;2,9;2;1;1
258097422643;258097440272;17629;0,1,3,5;4;2,9;2;1;1
258097440272;258097440471;199;0,1,3,5,6;5;2,9;2;1;1
258097440471;258097440759;288;0,1,3,5;4;2,9;2;1;1
258097440759;258097440954;195;0,1,3,5;4;2,9;2;1;1
258097440954;258097441157;203;0,1,3,5;4;2,9;2;1;1
258097441157;258097441310;153;0,1,3,5;4;2,9;2;1;1
258097441310;258097441351;41;0,1,3,5;4;2,9;2;1;1
258097441351;258097441559;208;0,1,3,5;4;2,9;2;1;1
258097441559;258097441597;38;0,1,3,5;4;2,9;2;1;1
258097441597;258097441835;238;0,1,3,5;4;2,9;2;1;1
258097441835;258097442466;631;0,1,3,5;4;2,9;2;1;1
258097442466;258097450830;8364;0,1,3,5;4;2,9;2;1;1
258097450830;258097461779;10949;0,1,3,5;4;2,9;2;1;1
258097461779;258097465488;3709;0,1,3,5;4;2,9;2;1;1
258097465488;258097465549;61;0,1,3,5;4;2,9;2;1;1
258097465549;258097465735;186;0,1,3,5;4;2,9;2;1;1
258097465735;258097466014;279;0,1,3,5;4;2,9;2;1;1
258097466014;258097466299;285;0,1,3,5;4;2,9;2;1;1
258097466299;258097483648;17349;0,1,3,5;4;2,9;2;1;1
258097483648;258097483817;169;0,1,3,5;4;2,9;2;1;1
258097483817;258097484043;226;0,1,3,5;4;2,9;2;1;1
258097484043;258097484067;24;0,1,3,5;4;2,9;2;1;1
258097484067;258097484082;15;0,1,3,5;4;2,9;2;1;1
258097484082;258097484128;46;0,1,3,5;4;2,9;2;1;1
258097484128;258097484155;27;0,1,3,5;4;2,9;2;1;1
258097484155;258097484851;696;0,1,3,5;4;2,9;2;1;1
258097484851;258097485915;1064;0,1,3,5;4;2,9;2;1;1
258097485915;258097489351;3436;0,1,3,5;4;2,9;2;1;1
258097489351;258097489368;17;0,1,3,5;4;2,9;2;1;1
258097489368;258097500773;11405;0,1,3,5;4;2,9;2;1;1
258097500773;258097500920;147;0,1,3,5;4;2,9;2;1;1
258097500920;258097501311;391;0,1,3,5;4;2,9;2;1;1
258097501311;258097501389;78;0,1,3,5;4;2,9;2;1;1
258097501389;258097501637;248;0,1,3,5,6;5;2,9;2;1;1
258097501637;258097501716;79;0,1,3,5,6;5;2,9;2;1;1
258097501716;258097501750;34;0,1,3,5,6;5;2,9;2;1;1
258097501750;258097501791;41;0,1,3,5,6;5;2,9;2;1;1
258097501791;258097501825;34;0,1,3,5,6;5;2,9;2;1;1
258097501825;258097501860;35;0,1,3,5,6;5;2,9;2;1;1
258097501860;258097501893;33;0,1,3,5;4;2,9;2;1;1
258097501893;258097512006;10113;0,1,3,5;4;2,9;2;1;1
258097512006;258097512118;112;0,1,3,5;4;2,9;2;1;1
258097512118;258097533529;21411;0,1,3,5;4;2,9;2;1;1
258097533529;258097540383;6854;0,1,3,5;4;2,9;2;1;1
258097540383;258097540407;24;0,1,3,5;4;2,9;2;1;1
258097540407;258097540465;58;0,1,3,5;4;2,9;2;1;1
258097540465;258097540520;55;0,1,3,5;4;2,9;2;1;1
258097540520;258097540570;50;0,1,3,5;4;2,9;2;1;1
258097540570;258097540624;54;0,1,3,5;4;2,9;2;1;1
258097540624;258097541113;489;0,1,3,5;4;2,9;2;1;1
258097541113;258097542016;903;0,1,3,5;4;2,9;2;1;1
258097542016;258097542164;148;0,1,3,5;4;2,9;2;1;1
258097542164;258097542388;224;0,1,3,5;4;2,9;2;1;1
258097542388;258097542461;73;0,1,3,5;4;2,9;2;1;1
258097542461;258097542695;234;0,1,3,5;4;2,9;2;1;1
258097542695;258097542932;237;0,1,3,5;4;2,9;2;1;1
258097542932;258097545967;3035;0,1,3,5;4;2,9;2;1;1
258097545967;258097548146;2179;0,1,3,5;4;2,9;2;1;1
258097548146;258097548376;230;0,1,3,5;4;2,9;2;1;1
258097548376;258097548461;85;0,1,3,5;4;2,9;2;1;1
258097548461;258097548746;285;0,1,3,5;4;2,9;2;1;1
258097548746;258097548998;252;0,1,3,5;4;2,9;2;1;1
258097548998;258097564160;15162;0,1,3,5;4;2,9;2;1;1
258097564160;258097564737;577;0,1,3,5;4;2,9;2;1;1
258097564737;258097564873;136;0,1,3,5;4;2,9;2;1;1
258097564873;258097564960;87;0,1,3,5;4;2,9;2;1;1
258097564960;258097565121;161;0,1,3,5;4;2,9;2;1;1
258097565121;258097565336;215;0,1,3,5;4;2,9;2;1;1
258097565336;258097565743;407;0,1,3,5;4;2,9;2;1;1
258097565743;258097565795;52;0,1,3,5;4;2,9;2;1;1
258097565795;258097569328;3533;0,1,3,5;4;2,9;2;1;1
258097569328;258097569524;196;0,1,3,5,6;5;2,9;2;1;1
258097569524;258097569868;344;0,1,3,5;4;2,9;2;1;1
258097569868;258097570056;188;0,1,3,5;4;2,9;2;1;1
258097570056;258097570103;47;0,1,3,5;4;2,9;2;1;1
258097570103;258097570213;110;0,1,3,5;4;2,9;2;1;1
258097570213;258097570281;68;0,1,3,5;4;2,9;2;1;1
258097570281;258097570368;87;0,1,3,5;4;2,9;2;1;1
258097570368;258097570513;145;0,1,3,5;4;2,9;2;1;1
258097570513;258097570659;146;0,1,3,5;4;2,9;2;1;1
258097570659;258097575443;4784;0,1,3,5;4;2,9;2;1;1
258097575443;258097579540;4097;0,1,3,5;4;2,9;2;1;1
258097579540;258097585052;5512;0,1,3,5;4;2,9;2;1;1
258097585052;258097585061;9;0,1,3,5;4;2,9;2;1;1
258097585061;258097585111;50;0,1,3,5;4;2,9;2;1;1
258097585111;258097585122;11;0,1,3,5;4;2,9;2;1;1
258097585122;258097585146;24;0,1,3,5;4;2,9;2;1;1
258097585146;258097585174;28;0,1,3,5;4;2,9;2;1;1
258097585174;258097585798;624;0,1,3,5;4;2,9;2;1;1
258097585798;258097623166;37368;0,1,3,5;4;2,9;2;1;1
258097623166;258097634667;11501;0,1,3,5;4;2,9;2;1;1
258097634667;258097635086;419;0,1,3,5;4;2,9;2;1;1
258097635086;258097638499;3413;0,1,3,5;4;2,9;2;1;1
258097638499;258097638665;166;0,1,3,5,6;5;2,9;2;1;1
258097638665;258097638932;267;0,1,3,5;4;2,9;2;1;1
258097638932;258097639150;218;0,1,3,5;4;2,9;2;1;1
258097639150;258097639381;231;0,1,3,5;4;2,9;2;1;1
258097639381;258097639526;145;0,1,3,5;4;2,9;2;1;1
258097639526;258097639672;146;0,1,3,5;4;2,9;2;1;1
258097639672;258097639816;144;0,1,3,5;4;2,9;2;1;1
258097639816;258097639962;146;0,1,3,5;4;2,9;2;1;1
258097639962;258097640105;143;0,1,3,5;4;2,9;2;1;1
258097640105;258097644888;4783;0,1,3,5;4;2,9;2;1;1
258097644888;258097645105;217;0,1,3,5;4;2,9;2;1;1
258097645105;258097645140;35;0,1,3,5;4;2,9;2;1;1
258097645140;258097645274;134;0,1,3,5,6;5;2,9;2;1;1
258097645274;258097645628;354;0,1,3,5;4;2,9;2;1;1
258097645628;258097645955;327;0,1,3,5;4;2,9;2;1;1
258097645955;258097646044;89;0,1,3,5;4;2,9;2;1;1
258097646044;258097646149;105;0,1,3,5;4;2,9;2;1;1
258097646149;258097646373;224;0,1,3,5;4;2,9;2;1;1
258097646373;258097646687;314;0,1,3,5;4;2,9;2;1;1
258097646687;258097650306;3619;0,1,3,5;4;2,9;2;1;1
258097650306;258097657099;6793;0,1,3,5;4;2,9;2;1;1
258097657099;258097658261;1162;0,1,3,5;4;2,9;2;1;1
258097658261;258097660779;2518;0,1,3,5;4;2,9;2;1;1
258097660779;258097660991;212;0,1,3,5,6;5;2,9;2;1;1
258097660991;258097661027;36;0,1,3,5;4;2,9;2;1;1
258097661027;258097661111;84;0,1,3,5;4;2,9;2;1;1
258097661111;258097661230;119;0,1,3,5;4;2,9;2;1;1
258097661230;258097661288;58;0,1,3,5;4;2,9;2;1;1
258097661288;258097661457;169;0,1,3,5;4;2,9;2;1;1
258097661457;258097661632;175;0,1,3,5;4;2,9;2;1;1
258097661632;258097661671;39;0,1,3,5;4;2,9;2;1;1
258097661671;258097661793;122;0,1,3,5;4;2,9;2;1;1
258097661793;258097669481;7688;0,1,3,5;4;2,9;2;1;1
258097669481;258097671420;1939;0,1,3,5;4;2,9;2;1;1
258097671420;258097672319;899;0,1,3,5;4;2,9;2;1;1
258097672319;258097685325;13006;0,1,3,5;4;2,9;2;1;1
258097685325;258097685375;50;0,1,3,5;4;2,9;2;1;1
258097685375;258097685737;362;0,1,3,5;4;2,9;2;1;1
258097685737;258097698029;12292;0,1,3,5;4;2,9;2;1;1
258097698029;258097701613;3584;0,1,3,5;4;2,9;2;1;1
258097701613;258097701689;76;0,1,3,5;4;2,9;2;1;1
258097701689;258097701983;294;0,1,3,5;4;2,9;2;1;1
258097701983;258097702084;101;0,1,3,5;4;2,9;2;1;1
258097702084;258097702179;95;0,1,3,5;4;2,9;2;1;1
258097702179;258097726856;24677;0,1,3,5;4;2,9;2;1;1
258097726856;258097741194;14338;0,1,3,5;4;2,9;2;1;1
258097741194;258097745840;4646;0,1,3,5;4;2,9;2;1;1
258097745840;258097745861;21;0,1,3,5;4;2,9;2;1;1
258097745861;258097745876;15;0,1,3,5;4;2,9;2;1;1
258097745876;258097745917;41;0,1,3,5;4;2,9;2;1;1
258097745917;258097745968;51;0,1,3,5;4;2,9;2;1;1
258097745968;258097746021;53;0,1,3,5;4;2,9;2;1;1
258097746021;258097746045;24;0,1,3,5;4;2,9;2;1;1
258097746045;258097774596;28551;0,1,3,5;4;2,9;2;1;1
258097774596;258097784410;9814;0,1,3,5;4;2,9;2;1;1
258097784410;258097816693;32283;0,1,3,5;4;2,9;2;1;1
258097816693;258097826002;9309;0,1,3,5;4;2,9;2;1;1
258097826002;258097826256;254;0,1,3,5;4;2,9;2;1;1
258097826256;258097845406;19150;0,1,3,5;4;2,9;2;1;1
258097845406;258097845516;110;0,1,3,5;4;2,9;2;1;1
258097845516;258097845550;34;0,1,3,5;4;2,9;2;1;1
258097845550;258097858092;12542;0,1,3,5;4;2,9;2;1;1
258097858092;258097868453;10361;0,1,3,5;4;2,9;2;1;1
258097868453;258097868498;45;0,1,3,5;4;2,9;2;1;1
258097868498;258097868506;8;0,1,3,5;4;2,9;2;1;1
258097868506;258097868520;14;0,1,3,5;4;2,9;2;1;1
258097868520;258097868540;20;0,1,3,5;4;2,9;2;1;1
258097868540;258097878440;9900;0,1,3,5;4;2,9;2;1;1
258097878440;258097878462;22;0,1,3,5;4;2,9;2;1;1
258097878462;258097878674;212;0,1,3,5;4;2,9;2;1;1
258097878674;258097899707;21033;0,1,3,5;4;2,9;2;1;1
258097899707;258097953139;53432;0,1,3,5;4;2,9;2;1;1
258097953139;258097963538;10399;0,1,3,5;4;2,9;2;1;1
258097963538;258097963573;35;0,1,3,5;4;2,9;2;1;1
258097963573;258097986466;22893;0,1,3,5;4;2,9;2;1;1
258097986466;258098038347;51881;0,1,3,5;4;2,9;2;1;1
258098038347;258098038589;242;0,1,3,5;4;2,9;2;1;1
258098038589;258098038996;407;0,1,3,5;4;2,9;2;1;1
258098038996;258098039310;314;0,1,3,5;4;2,9;2;1;1
258098039310;258098040430;1120;0,1,3,5;4;2,9;2;1;1
258098040430;258098040455;25;0,1,3,5;4;2,9;2;1;1
258098040455;258098040518;63;0,1,3,5;4;2,9;2;1;1
258098040518;258098041914;1396;0,1,3,5;4;2,9;2;1;1
258098041914;258098041988;74;0,1,3,5;4;2,9;2;1;1
258098041988;258098050385;8397;0,1,3,5;4;2,9;2;1;1
258098050385;258098053259;2874;0,1,3,5;4;2,9;2;1;1
258098053259;258098163001;109742;0,1,3,5;4;2,9;2;1;1
258098163001;258098213589;50588;0,1,3,5;4;2,9;2;1;1
258098213589;258098222442;8853;0,1,3,5;4;2,9;2;1;1
258098222442;258098254654;32212;0,1,3,5;4;2,9;2;1;1
258098254654;258098257815;3161;0,1,3,5;4;2,9;2;1;1
258098257815;258098257872;57;0,1,3,5;4;2,9;2;1;1
258098257872;258098269104;11232;0,1,3,5;4;2,9;2;1;1
258098269104;258098269140;36;0,1,3,5;4;2,9;2;1;1
258098269140;258098269171;31;0,1,3,5;4;2,9;2;1;1
258098269171;258098300512;31341;0,1,3,5;4;2,9;2;1;1
258098300512;258098341330;40818;0,1,3,5;4;2,9;2;1;1
258098341330;258098341971;641;0,1,3,5;4;2,9;2;1;1
258098341971;258098350693;8722;0,1,3,5;4;2,9;2;1;1
258098350693;258098350842;149;0,1,3,5;4;2,9;2;1;1
258098350842;258098350869;27;0,1,3,5;4;2,9;2;1;1
258098350869;258098350956;87;0,1,3,5;4;2,9;2;1;1
258098350956;258098352888;1932;0,1,3,5;4;2,9;2;1;1
258098352888;258098353317;429;0,1,3,5;4;2,9;2;1;1
258098353317;258098353371;54;0,1,3,5;4;2,9;2;1;1
258098353371;258098353379;8;0,1,3,5;4;2,9;2;1;1
258098353379;258098353429;50;0,1,3,5;4;2,9;2;1;1
258098353429;258098372549;19120;0,1,3,5;4;2,9;2;1;1
258098372549;258098373006;457;0,1,3,5;4;2,9;2;1;1
258098373006;258098373054;48;0,1,3,5;4;2,9;2;1;1
258098373054;258098373073;19;0,1,3,5;4;2,9;2;1;1
258098373073;258098373107;34;0,1,3,5;4;2,9;2;1;1
258098373107;258098373645;538;0,1,3,5;4;2,9;2;1;1
258098373645;258098376493;2848;0,1,3,5;4;2,9;2;1;1
258098376493;258098376903;410;0,1,3,5;4;2,9;2;1;1
258098376903;258098389310;12407;0,1,3,5;4;2,9;2;1;1
258098389310;258098389384;74;0,1,3,5;4;2,9;2;1;1
258098389384;258098389510;126;0,1,3,5,6;5;2,9;2;1;1
258098389510;258098389604;94;0,1,3,5,6;5;2,9;2;1;1
258098389604;258098389628;24;0,1,3,5,6;5;2,9;2;1;1
258098389628;258098389937;309;0,1,3,5;4;2,9;2;1;1
258098389937;258098389972;35;0,1,3,5;4;2,9;2;1;1
258098389972;258098390092;120;0,1,3,5;4;2,9;2;1;1
258098390092;258098390211;119;0,1,3,5;4;2,9;2;1;1
258098390211;258098390306;95;0,1,3,5;4;2,9;2;1;1
258098390306;258098398624;8318;0,1,3,5;4;2,9;2;1;1
258098398624;258098399089;465;0,1,3,5;4;2,9;2;1;1
258098399089;258098399279;190;0,1,3,5;4;2,9;2;1;1
258098399279;258098399381;102;0,1,3,5;4;2,9;2;1;1
258098399381;258098399435;54;0,1,3,5;4;2,9;2;1;1
258098399435;258098399616;181;0,1,3,5;4;2,9;2;1;1
258098399616;258098399690;74;0,1,3,5;4;2,9;2;1;1
258098399690;258098399954;264;0,1,3,5,6;5;2,9;2;1;1
258098399954;258098400081;127;0,1,3,5,6;5;2,9;2;1;1
258098400081;258098400117;36;0,1,3,5,6;5;2,9;2;1;1
258098400117;258098400139;22;0,1,3,5,6;5;2,9;2;1;1
258098400139;258098400173;34;0,1,3,5,6;5;2,9;2;1;1
258098400173;258098400285;112;0,1,3,5,6;5;2,9;2;1;1
258098400285;258098400290;5;0,1,3,5,6;5;2,9;2;1;1
258098400290;258098400346;56;0,1,3,5,6;5;2,9;2;1;1
258098400346;258098400409;63;0,1,3,5,6;5;2,9;2;1;1
258098400409;258098400518;109;0,1,3,5,6;5;2,9;2;1;1
258098400518;258098400631;113;0,1,3,5,6;5;2,9;2;1;1
258098400631;258098400750;119;0,1,3,5,6;5;2,9;2;1;1
258098400750;258098400860;110;0,1,3,5;4;2,9;2;1;1
258098400860;258098401334;474;0,1,3,5;4;2,9;2;1;1
258098401334;258098401396;62;0,1,3,5;4;2,9;2;1;1
258098401396;258098407904;6508;0,1,3,5;4;2,9;2;1;1
258098407904;258098407992;88;0,1,3,5;4;2,9;2;1;1
258098407992;258098408644;652;0,1,3,5;4;2,9;2;1;1
258098408644;258098409569;925;0,1,3,5;4;2,9;2;1;1
258098409569;258098409617;48;0,1,3,5;4;2,9;2;1;1
258098409617;258098409991;374;0,1,3,5;4;2,9;2;1;1
258098409991;258098410597;606;0,1,3,5;4;2,9;2;1;1
258098410597;258098410672;75;0,1,3,5;4;2,9;2;1;1
258098410672;258098410698;26;0,1,3,5;4;2,9;2;1;1
258098410698;258098411184;486;0,1,3,5;4;2,9;2;1;1
258098411184;258098411496;312;0,1,3,5;4;2,9;2;1;1
258098411496;258098411682;186;0,1,3,5;4;2,9;2;1;1
258098411682;258098411859;177;0,1,3,5;4;2,9;2;1;1
258098411859;258098411883;24;0,1,3,5;4;2,9;2;1;1
258098411883;258098411896;13;0,1,3,5;4;2,9;2;1;1
258098411896;258098412608;712;0,1,3,5;4;2,9;2;1;1
258098412608;258098413350;742;0,1,3,5;4;2,9;2;1;1
258098413350;258098415267;1917;0,1,3,5;4;2,9;2;1;1
258098415267;258098415965;698;0,1,3,5;4;2,9;2;1;1
258098415965;258098416003;38;0,1,3,5;4;2,9;2;1;1
258098416003;258098416082;79;0,1,3,5,6;5;2,9;2;1;1
258098416082;258098416142;60;0,1,3,5,6;5;2,9;2;1;1
258098416142;258098416153;11;0,1,3,5,6;5;2,9;2;1;1
258098416153;258098416210;57;0,1,3,5,6;5;2,9;2;1;1
258098416210;258098416357;147;0,1,3,5,6;5;2,9;2;1;1
258098416357;258098416418;61;0,1,3,5,6;5;2,9;2;1;1
258098416418;258098416530;112;0,1,3,5;4;2,9;2;1;1
258098416530;258098416778;248;0,1,3,5;4;2,9;2;1;1
258098416778;258098420606;3828;0,1,3,5;4;2,9;2;1;1
258098420606;258098427192;6586;0,1,3,5;4;2,9;2;1;1
258098427192;258098428303;1111;0,1,3,5;4;2,9;2;1;1
258098428303;258098428403;100;0,1,3,5;4;2,9;2;1;1
258098428403;258098428672;269;0,1,3,5,6;5;2,9;2;1;1
258098428672;258098428707;35;0,1,3,5,6;5;2,9;2;1;1
258098428707;258098428795;88;0,1,3,5;4;2,9;2;1;1
258098428795;258098428912;117;0,1,3,5;4;2,9;2;1;1
258098428912;258098429028;116;0,1,3,5;4;2,9;2;1;1
258098429028;258098429361;333;0,1,3,5;4;2,9;2;1;1
258098429361;258098429763;402;0,1,3,5;4;2,9;2;1;1
258098429763;258098430662;899;0,1,3,5;4;2,9;2;1;1
258098430662;258098430805;143;0,1,3,5;4;2,9;2;1;1
258098430805;258098431057;252;0,1,3,5;4;2,9;2;1;1
258098431057;258098432935;1878;0,1,3,5;4;2,9;2;1;1
258098432935;258098439996;7061;0,1,3,5;4;2,9;2;1;1
258098439996;258098440201;205;0,1,3,5;4;2,9;2;1;1
258098440201;258098440283;82;0,1,3,5,6;5;2,9;2;1;1
258098440283;258098440391;108;0,1,3,5,6;5;2,9;2;1;1
258098440391;258098440417;26;0,1,3,5,6;5;2,9;2;1;1
258098440417;258098440640;223;0,1,3,5,6;5;2,9;2;1;1
258098440640;258098440648;8;0,1,3,5,6;5;2,9;2;1;1
258098440648;258098440688;40;0,1,3,5,6;5;2,9;2;1;1
258098440688;258098440760;72;0,1,3,5,6;5;2,9;2;1;1
258098440760;258098441141;381;0,1,3,5;4;2,9;2;1;1
258098441141;258098442416;1275;0,1,3,5;4;2,9;2;1;1
258098442416;258098444240;1824;0,1,3,5;4;2,9;2;1;1
258098444240;258098448660;4420;0,1,3,5;4;2,9;2;1;1
258098448660;258098451894;3234;0,1,3,5;4;2,9;2;1;1
258098451894;258098458793;6899;0,1,3,5;4;2,9;2;1;1
258098458793;258098459121;328;0,1,3,5;4;2,9;2;1;1
258098459121;258098462347;3226;0,1,3,5;4;2,9;2;1;1
258098462347;258098462463;116;0,1,3,5;4;2,9;2;1;1
258098462463;258098462516;53;0,1,3,5;4;2,9;2;1;1
258098462516;258098462720;204;0,1,3,5;4;2,9;2;1;1
258098462720;258098462885;165;0,1,3,5,6;5;2,9;2;1;1
258098462885;258098463068;183;0,1,3,5;4;2,9;2;1;1
258098463068;258098463254;186;0,1,3,5;4;2,9;2;1;1
258098463254;258098463289;35;0,1,3,5;4;2,9;2;1;1
258098463289;258098463425;136;0,1,3,5;4;2,9;2;1;1
258098463425;258098463514;89;0,1,3,5;4;2,9;2;1;1
258098463514;258098463675;161;0,1,3,5;4;2,9;2;1;1
258098463675;258098463824;149;0,1,3,5;4;2,9;2;1;1
258098463824;258098463970;146;0,1,3,5;4;2,9;2;1;1
258098463970;258098465930;1960;0,1,3,5;4;2,9;2;1;1
258098465930;258098466065;135;0,1,3,5,6;5;2,9;2;1;1
258098466065;258098466147;82;0,1,3,5,6;5;2,9;2;1;1
258098466147;258098466292;145;0,1,3,5;4;2,9;2;1;1
258098466292;258098466297;5;0,1,3,5;4;2,9;2;1;1
258098466297;258098466352;55;0,1,3,5;4;2,9;2;1;1
258098466352;258098466357;5;0,1,3,5;4;2,9;2;1;1
258098466357;258098466432;75;0,1,3,5;4;2,9;2;1;1
258098466432;258098466478;46;0,1,3,5;4;2,9;2;1;1
258098466478;258098466515;37;0,1,3,5;4;2,9;2;1;1
258098466515;258098470920;4405;0,1,3,5;4;2,9;2;1;1
258098470920;258098475210;4290;0,1,3,5;4;2,9;2;1;1
258098475210;258098477062;1852;0,1,3,5;4;2,9;2;1;1
258098477062;258098480611;3549;0,1,3,5;4;2,9;2;1;1
258098480611;258098480777;166;0,1,3,5;4;2,9;2;1;1
258098480777;258098481192;415;0,1,3,5;4;2,9;2;1;1
258098481192;258098481228;36;0,1,3,5;4;2,9;2;1;1
258098481228;258098481758;530;0,1,3,5;4;2,9;2;1;1
258098481758;258098482371;613;0,1,3,5;4;2,9;2;1;1
258098482371;258098490299;7928;0,1,3,5;4;2,9;2;1;1
258098490299;258098490311;12;0,1,3,5;4;2,9;2;1;1
258098490311;258098491758;1447;0,1,3,5;4;2,9;2;1;1
258098491758;258098491848;90;0,1,3,5;4;2,9;2;1;1
258098491848;258098491902;54;0,1,3,5;4;2,9;2;1;1
258098491902;258098492170;268;0,1,3,5;4;2,9;2;1;1
258098492170;258098492731;561;0,1,3,5;4;2,9;2;1;1
258098492731;258098510695;17964;0,1,3,5;4;2,9;2;1;1
258098510695;258098510915;220;0,1,3,5,6;5;2,9;2;1;1
258098510915;258098510957;42;0,1,3,5;4;2,9;2;1;1
258098510957;258098510988;31;0,1,3,5;4;2,9;2;1;1
258098510988;258098511036;48;0,1,3,5;4;2,9;2;1;1
258098511036;258098511108;72;0,1,3,5;4;2,9;2;1;1
258098511108;258098511141;33;0,1,3,5;4;2,9;2;1;1
258098511141;258098511360;219;0,1,3,5;4;2,9;2;1;1
258098511360;258098511507;147;0,1,3,5;4;2,9;2;1;1
258098511507;258098511653;146;0,1,3,5;4;2,9;2;1;1
258098511653;258098520474;8821;0,1,3,5;4;2,9;2;1;1
258098520474;258098531457;10983;0,1,3,5;4;2,9;2;1;1
258098531457;258098576261;44804;0,1,3,5;4;2,9;2;1;1
258098576261;258098587634;11373;0,1,3,5;4;2,9;2;1;1
258098587634;258098608024;20390;0,1,3,5;4;2,9;2;1;1
258098608024;258098611427;3403;0,1,3,5;4;2,9;2;1;1
258098611427;258098611748;321;0,1,3,5;4;2,9;2;1;1
258098611748;258098614993;3245;0,1,3,5;4;2,9;2;1;1
258098614993;258098615067;74;0,1,3,5;4;2,9;2;1;1
258098615067;258098616334;1267;0,1,3,5;4;2,9;2;1;1
258098616334;258098616580;246;0,1,3,5;4;2,9;2;1;1
258098616580;258098616777;197;0,1,3,5,6;5;2,9;2;1;1
258098616777;258098616920;143;0,1,3,5;4;2,9;2;1;1
258098616920;258098617066;146;0,1,3,5;4;2,9;2;1;1
258098617066;258098617330;264;0,1,3,5;4;2,9;2;1;1
258098617330;258098617378;48;0,1,3,5;4;2,9;2;1;1
258098617378;258098617526;148;0,1,3,5;4;2,9;2;1;1
258098617526;258098617748;222;0,1,3,5;4;2,9;2;1;1
258098617748;258098617774;26;0,1,3,5;4;2,9;2;1;1
258098617774;258098617933;159;0,1,3,5;4;2,9;2;1;1
258098617933;258098618394;461;0,1,3,5;4;2,9;2;1;1
258098618394;258098620351;1957;0,1,3,5;4;2,9;2;1;1
258098620351;258098620454;103;0,1,3,5,6;5;2,9;2;1;1
258098620454;258098620477;23;0,1,3,5,6;5;2,9;2;1;1
258098620477;258098620589;112;0,1,3,5,6;5;2,9;2;1;1
258098620589;258098620666;77;0,1,3,5,6;5;2,9;2;1;1
258098620666;258098620797;131;0,1,3,5;4;2,9;2;1;1
258098620797;258098620850;53;0,1,3,5;4;2,9;2;1;1
258098620850;258098620900;50;0,1,3,5;4;2,9;2;1;1
258098620900;258098620962;62;0,1,3,5;4;2,9;2;1;1
258098620962;258098621051;89;0,1,3,5;4;2,9;2;1;1
258098621051;258098627518;6467;0,1,3,5;4;2,9;2;1;1
258098627518;258098628863;1345;0,1,3,5;4;2,9;2;1;1
258098628863;258098632363;3500;0,1,3,5;4;2,9;2;1;1
258098632363;258098636304;3941;0,1,3,5;4;2,9;2;1;1
258098636304;258098636673;369;0,1,3,5;4;2,9;2;1;1
258098636673;258098670579;33906;0,1,3,5;4;2,9;2;1;1
258098670579;258098672236;1657;0,1,3,5;4;2,9;2;1;1
258098672236;258098672499;263;0,1,3,5;4;2,9;2;1;1
258098672499;258098672855;356;0,1,3,5;4;2,9;2;1;1
258098672855;258098672975;120;0,1,3,5;4;2,9;2;1;1
258098672975;258098673022;47;0,1,3,5;4;2,9;2;1;1
258098673022;258098673056;34;0,1,3,5;4;2,9;2;1;1
258098673056;258098673097;41;0,1,3,5;4;2,9;2;1;1
258098673097;258098673147;50;0,1,3,5;4;2,9;2;1;1
258098673147;258098673175;28;0,1,3,5;4;2,9;2;1;1
258098673175;258098673323;148;0,1,3,5,6;5;2,9;2;1;1
258098673323;258098679958;6635;0,1,3,5;4;2,9;2;1;1
258098679958;258098680103;145;0,1,3,5;4;2,9;2;1;1
258098680103;258098694267;14164;0,1,3,5;4;2,9;2;1;1
258098694267;258098711508;17241;0,1,3,5;4;2,9;2;1;1
258098711508;258098720109;8601;0,1,3,5;4;2,9;2;1;1
258098720109;258098720739;630;0,1,3,5;4;2,9;2;1;1
258098720739;258098741018;20279;0,1,3,5;4;2,9;2;1;1
258098741018;258098741153;135;0,1,3,5;4;2,9;2;1;1
258098741153;258098741195;42;0,1,3,5;4;2,9;2;1;1
258098741195;258098741302;107;0,1,3,5;4;2,9;2;1;1
258098741302;258098742004;702;0,1,3,5;4;2,9;2;1;1
258098742004;258098742149;145;0,1,3,5;4;2,9;2;1;1
258098742149;258098742188;39;0,1,3,5;4;2,9;2;1;1
258098742188;258098742280;92;0,1,3,5;4;2,9;2;1;1
258098742280;258098742351;71;0,1,3,5;4;2,9;2;1;1
258098742351;258098743077;726;0,1,3,5;4;2,9;2;1;1
258098743077;258098746167;3090;0,1,3,5;4;2,9;2;1;1
258098746167;258098746241;74;0,1,3,5;4;2,9;2;1;1
258098746241;258098746370;129;0,1,3,5;4;2,9;2;1;1
258098746370;258098746372;2;0,1,3,5;4;2,9;2;1;1
258098746372;258098746522;150;0,1,3,5,6;5;2,9;2;1;1
258098746522;258098746556;34;0,1,3,5,6;5;2,9;2;1;1
258098746556;258098746864;308;0,1,3,5,6;5;2,9;2;1;1
258098746864;258098746902;38;0,1,3,5,6;5;2,9;2;1;1
258098746902;258098747073;171;0,1,3,5;4;2,9;2;1;1
258098747073;258098747114;41;0,1,3,5;4;2,9;2;1;1
258098747114;258098761426;14312;0,1,3,5;4;2,9;2;1;1
258098761426;258098761461;35;0,1,3,5;4;2,9;2;1;1
258098761461;258098761484;23;0,1,3,5;4;2,9;2;1;1
258098761484;258098761541;57;0,1,3,5;4;2,9;2;1;1
258098761541;258098761971;430;0,1,3,5;4;2,9;2;1;1
258098761971;258098763772;1801;0,1,3,5;4;2,9;2;1;1
258098763772;258098764678;906;0,1,3,5;4;2,9;2;1;1
258098764678;258098764776;98;0,1,3,5;4;2,9;2;1;1
258098764776;258098765076;300;0,1,3,5;4;2,9;2;1;1
258098765076;258098765226;150;0,1,3,5;4;2,9;2;1;1
258098765226;258098767162;1936;0,1,3,5;4;2,9;2;1;1
258098767162;258098774601;7439;0,1,3,5;4;2,9;2;1;1
258098774601;258098774634;33;0,1,3,5;4;2,9;2;1;1
258098774634;258098774668;34;0,1,3,5;4;2,9;2;1;1
258098774668;258098775054;386;0,1,3,5;4;2,9;2;1;1
258098775054;258098775155;101;0,1,3,5;4;2,9;2;1;1
258098775155;258098775269;114;0,1,3,5;4;2,9;2;1;1
258098775269;258098775657;388;0,1,3,5;4;2,9;2;1;1
258098775657;258098775696;39;0,1,3,5;4;2,9;2;1;1
258098775696;258098775798;102;0,1,3,5;4;2,9;2;1;1
258098775798;258098776473;675;0,1,3,5;4;2,9;2;1;1
258098776473;258098776511;38;0,1,3,5;4;2,9;2;1;1
258098776511;258098776566;55;0,1,3,5;4;2,9;2;1;1
258098776566;258098776615;49;0,1,3,5;4;2,9;2;1;1
258098776615;258098777057;442;0,1,3,5;4;2,9;2;1;1
258098777057;258098780675;3618;0,1,3,5;4;2,9;2;1;1
258098780675;258098780760;85;0,1,3,5;4;2,9;2;1;1
258098780760;258098780939;179;0,1,3,5;4;2,9;2;1;1
258098780939;258098781154;215;0,1,3,5;4;2,9;2;1;1
258098781154;258098781227;73;0,1,3,5;4;2,9;2;1;1
258098781227;258098781387;160;0,1,3,5;4;2,9;2;1;1
258098781387;258098781402;15;0,1,3,5;4;2,9;2;1;1
258098781402;258098781560;158;0,1,3,5,6;5;2,9;2;1;1
258098781560;258098781607;47;0,1,3,5,6;5;2,9;2;1;1
258098781607;258098781615;8;0,1,3,5,6;5;2,9;2;1;1
258098781615;258098781681;66;0,1,3,5,6;5;2,9;2;1;1
258098781681;258098781731;50;0,1,3,5,6;5;2,9;2;1;1
258098781731;258098781764;33;0,1,3,5,6;5;2,9;2;1;1
258098781764;258098781774;10;0,1,3,5,6;5;2,9;2;1;1
258098781774;258098781817;43;0,1,3,5;4;2,9;2;1;1
258098781817;258098781885;68;0,1,3,5;4;2,9;2;1;1
258098781885;258098781942;57;0,1,3,5;4;2,9;2;1;1
258098781942;258098782078;136;0,1,3,5;4;2,9;2;1;1
258098782078;258098782215;137;0,1,3,5;4;2,9;2;1;1
258098782215;258098786078;3863;0,1,3,5;4;2,9;2;1;1
258098786078;258098787673;1595;0,1,3,5;4;2,9;2;1;1
258098787673;258098792647;4974;0,1,3,5;4;2,9;2;1;1
258098792647;258098794567;1920;0,1,3,5;4;2,9;2;1;1
258098794567;258098794774;207;0,1,3,5;4;2,9;2;1;1
258098794774;258098795078;304;0,1,3,5;4;2,9;2;1;1
258098795078;258098796784;1706;0,1,3,5;4;2,9;2;1;1
258098796784;258098796792;8;0,1,3,5;4;2,9;2;1;1
258098796792;258098796843;51;0,1,3,5;4;2,9;2;1;1
258098796843;258098796851;8;0,1,3,5;4;2,9;2;1;1
258098796851;258098796902;51;0,1,3,5;4;2,9;2;1;1
258098796902;258098796952;50;0,1,3,5;4;2,9;2;1;1
258098796952;258098797720;768;0,1,3,5;4;2,9;2;1;1
258098797720;258098809405;11685;0,1,3,5;4;2,9;2;1;1
258098809405;258098817150;7745;0,1,3,5;4;2,9;2;1;1
258098817150;258098820894;3744;0,1,3,5;4;2,9;2;1;1
258098820894;258098827161;6267;0,1,3,5;4;2,9;2;1;1
258098827161;258098829170;2009;0,1,3,5;4;2,9;2;1;1
258098829170;258098829196;26;0,1,3,5;4;2,9;2;1;1
258098829196;258098830523;1327;0,1,3,5;4;2,9;2;1;1
258098830523;258098830677;154;0,1,3,5;4;2,9;2;1;1
258098830677;258098832457;1780;0,1,3,5;4;2,9;2;1;1
258098832457;258098832572;115;0,1,3,5;4;2,9;2;1;1
258098832572;258098832621;49;0,1,3,5,6;5;2,9;2;1;1
258098832621;258098832874;253;0,1,3,5,6;5;2,9;2;1;1
258098832874;258098832898;24;0,1,3,5,6;5;2,9;2;1;1
258098832898;258098833090;192;0,1,3,5,6;5;2,9;2;1;1
258098833090;258098833116;26;0,1,3,5,6;5;2,9;2;1;1
258098833116;258098833175;59;0,1,3,5,6;5;2,9;2;1;1
258098833175;258098833185;10;0,1,3,5,6;5;2,9;2;1;1
258098833185;258098833242;57;0,1,3,5;4;2,9;2;1;1
258098833242;258098833253;11;0,1,3,5;4;2,9;2;1;1
258098833253;258098833451;198;0,1,3,5,6;5;2,9;2;1;1
258098833451;258098833507;56;0,1,3,5;4;2,9;2;1;1
258098833507;258098833788;281;0,1,3,5;4;2,9;2;1;1
258098833788;258098833981;193;0,1,3,5;4;2,9;2;1;1
258098833981;258098834604;623;0,1,3,5;4;2,9;2;1;1
258098834604;258098834643;39;0,1,3,5;4;2,9;2;1;1
258098834643;258098834826;183;0,1,3,5;4;2,9;2;1;1
258098834826;258098834865;39;0,1,3,5;4;2,9;2;1;1
258098834865;258098834989;124;0,1,3,5;4;2,9;2;1;1
258098834989;258098835045;56;0,1,3,5;4;2,9;2;1;1
258098835045;258098835260;215;0,1,3,5;4;2,9;2;1;1
258098835260;258098835518;258;0,1,3,5;4;2,9;2;1;1
258098835518;258098838359;2841;0,1,3,5;4;2,9;2;1;1
258098838359;258098838544;185;0,1,3,5,6;5;2,9;2;1;1
258098838544;258098838561;17;0,1,3,5,6;5;2,9;2;1;1
258098838561;258098838647;86;0,1,3,5;4;2,9;2;1;1
258098838647;258098838695;48;0,1,3,5;4;2,9;2;1;1
258098838695;258098838751;56;0,1,3,5;4;2,9;2;1;1
258098838751;258098838811;60;0,1,3,5;4;2,9;2;1;1
258098838811;258098838843;32;0,1,3,5;4;2,9;2;1;1
258098838843;258098839009;166;0,1,3,5;4;2,9;2;1;1
258098839009;258098849505;10496;0,1,3,5;4;2,9;2;1;1
258098849505;258098850722;1217;0,1,3,5;4;2,9;2;1;1
258098850722;258098851873;1151;0,1,3,5;4;2,9;2;1;1
258098851873;258098856015;4142;0,1,3,5;4;2,9;2;1;1
258098856015;258098856144;129;0,1,3,5;4;2,9;2;1;1
258098856144;258098856168;24;0,1,3,5,6;5;2,9;2;1;1
258098856168;258098856331;163;0,1,3,5,6;5;2,9;2;1;1
258098856331;258098856348;17;0,1,3,5,6;5;2,9;2;1;1
258098856348;258098856494;146;0,1,3,5,6;5;2,9;2;1;1
258098856494;258098856522;28;0,1,3,5,6;5;2,9;2;1;1
258098856522;258098856622;100;0,1,3,5,6;5;2,9;2;1;1
258098856622;258098856649;27;0,1,3,5,6;5;2,9;2;1;1
258098856649;258098856734;85;0,1,3,5,6;5;2,9;2;1;1
258098856734;258098857141;407;0,1,3,5;4;2,9;2;1;1
258098857141;258098857169;28;0,1,3,5;4;2,9;2;1;1
258098857169;258098857306;137;0,1,3,5;4;2,9;2;1;1
258098857306;258098857645;339;0,1,3,5;4;2,9;2;1;1
258098857645;258098857704;59;0,1,3,5;4;2,9;2;1;1
258098857704;258098857759;55;0,1,3,5;4;2,9;2;1;1
258098857759;258098857792;33;0,1,3,5;4;2,9;2;1;1
258098857792;258098857814;22;0,1,3,5;4;2,9;2;1;1
258098857814;258098857864;50;0,1,3,5;4;2,9;2;1;1
258098857864;258098858245;381;0,1,3,5;4;2,9;2;1;1
258098858245;258098859104;859;0,1,3,5;4;2,9;2;1;1
258098859104;258098859281;177;0,1,3,5;4;2,9;2;1;1
258098859281;258098859918;637;0,1,3,5;4;2,9;2;1;1
258098859918;258098863320;3402;0,1,3,5;4;2,9;2;1;1
258098863320;258098863612;292;0,1,3,5,6;5;2,9;2;1;1
258098863612;258098863638;26;0,1,3,5;4;2,9;2;1;1
258098863638;258098863723;85;0,1,3,5;4;2,9;2;1;1
258098863723;258098863944;221;0,1,3,5;4;2,9;2;1;1
258098863944;258098863967;23;0,1,3,5;4;2,9;2;1;1
258098863967;258098864017;50;0,1,3,5;4;2,9;2;1;1
258098864017;258098864061;44;0,1,3,5;4;2,9;2;1;1
258098864061;258098864170;109;0,1,3,5,6;5;2,9;2;1;1
258098864170;258098864244;74;0,1,3,5,6;5;2,9;2;1;1
258098864244;258098864281;37;0,1,3,5,6;5;2,9;2;1;1
258098864281;258098864462;181;0,1,3,5,6;5;2,9;2;1;1
258098864462;258098864507;45;0,1,3,5,6;5;2,9;2;1;1
258098864507;258098864615;108;0,1,3,5;4;2,9;2;1;1
258098864615;258098864627;12;0,1,3,5;4;2,9;2;1;1
258098864627;258098864717;90;0,1,3,5;4;2,9;2;1;1
258098864717;258098864719;2;0,1,3,5;4;2,9;2;1;1
258098864719;258098864888;169;0,1,3,5;4;2,9;2;1;1
258098864888;258098865074;186;0,1,3,5;4;2,9;2;1;1
258098865074;258098865119;45;0,1,3,5;4;2,9;2;1;1
258098865119;258098865228;109;0,1,3,5;4;2,9;2;1;1
258098865228;258098871480;6252;0,1,3,5;4;2,9;2;1;1
258098871480;258098873028;1548;0,1,3,5;4;2,9;2;1;1
258098873028;258098873036;8;0,1,3,5;4;2,9;2;1;1
258098873036;258098873126;90;0,1,3,5;4;2,9;2;1;1
258098873126;258098873369;243;0,1,3,5;4;2,9;2;1;1
258098873369;258098873412;43;0,1,3,5;4;2,9;2;1;1
258098873412;258098873896;484;0,1,3,5;4;2,9;2;1;1
258098873896;258098874274;378;0,1,3,5;4;2,9;2;1;1
258098874274;258098878233;3959;0,1,3,5;4;2,9;2;1;1
258098878233;258098879324;1091;0,1,3,5;4;2,9;2;1;1
258098879324;258098886791;7467;0,1,3,5;4;2,9;2;1;1
258098886791;258098886811;20;0,1,3,5;4;2,9;2;1;1
258098886811;258098887175;364;0,1,3,5;4;2,9;2;1;1
258098887175;258098888765;1590;0,1,3,5;4;2,9;2;1;1
258098888765;258098888889;124;0,1,3,5;4;2,9;2;1;1
258098888889;258098889151;262;0,1,3,5;4;2,9;2;1;1
258098889151;258098889714;563;0,1,3,5;4;2,9;2;1;1
258098889714;258098889951;237;0,1,3,5;4;2,9;2;1;1
258098889951;258098889989;38;0,1,3,5;4;2,9;2;1;1
258098889989;258098893097;3108;0,1,3,5;4;2,9;2;1;1
258098893097;258098893110;13;0,1,3,5,6;5;2,9;2;1;1
258098893110;258098893235;125;0,1,3,5,6;5;2,9;2;1;1
258098893235;258098893307;72;0,1,3,5,6;5;2,9;2;1;1
258098893307;258098893614;307;0,1,3,5;4;2,9;2;1;1
258098893614;258098893659;45;0,1,3,5;4;2,9;2;1;1
258098893659;258098893809;150;0,1,3,5;4;2,9;2;1;1
258098893809;258098893861;52;0,1,3,5;4;2,9;2;1;1
258098893861;258098894094;233;0,1,3,5;4;2,9;2;1;1
258098894094;258098897923;3829;0,1,3,5;4;2,9;2;1;1
258098897923;258098903266;5343;0,1,3,5;4;2,9;2;1;1
258098903266;258098903382;116;0,1,3,5;4;2,9;2;1;1
258098903382;258098903425;43;0,1,3,5;4;2,9;2;1;1
258098903425;258098903659;234;0,1,3,5;4;2,9;2;1;1
258098903659;258098903877;218;0,1,3,5;4;2,9;2;1;1
258098903877;258098903923;46;0,1,3,5;4;2,9;2;1;1
258098903923;258098904467;544;0,1,3,5;4;2,9;2;1;1
258098904467;258098904533;66;0,1,3,5;4;2,9;2;1;1
258098904533;258098915232;10699;0,1,3,5;4;2,9;2;1;1
258098915232;258098919120;3888;0,1,3,5;4;2,9;2;1;1
258098919120;258098919171;51;0,1,3,5;4;2,9;2;1;1
258098919171;258098919240;69;0,1,3,5;4;2,9;2;1;1
258098919240;258098919447;207;0,1,3,5,6;5;2,9;2;1;1
258098919447;258098919483;36;0,1,3,5,6;5;2,9;2;1;1
258098919483;258098919572;89;0,1,3,5;4;2,9;2;1;1
258098919572;258098919691;119;0,1,3,5;4;2,9;2;1;1
258098919691;258098919888;197;0,1,3,5;4;2,9;2;1;1
258098919888;258098919904;16;0,1,3,5;4;2,9;2;1;1
258098919904;258098919927;23;0,1,3,5;4;2,9;2;1;1
258098919927;258098920045;118;0,1,3,5;4;2,9;2;1;1
258098920045;258098920116;71;0,1,3,5;4;2,9;2;1;1
258098920116;258098920163;47;0,1,3,5;4;2,9;2;1;1
258098920163;258098920228;65;0,1,3,5;4;2,9;2;1;1
258098920228;258098920252;24;0,1,3,5;4;2,9;2;1;1
258098920252;258098920333;81;0,1,3,5;4;2,9;2;1;1
258098920333;258098929058;8725;0,1,3,5;4;2,9;2;1;1
258098929058;258098944862;15804;0,1,3,5;4;2,9;2;1;1
258098944862;258098945258;396;0,1,3,5;4;2,9;2;1;1
258098945258;258098945293;35;0,1,3,5;4;2,9;2;1;1
258098945293;258098945310;17;0,1,3,5;4;2,9;2;1;1
258098945310;258098945389;79;0,1,3,5;4;2,9;2;1;1
258098945389;258098945427;38;0,1,3,5;4;2,9;2;1;1
258098945427;258098945787;360;0,1,3,5;4;2,9;2;1;1
258098945787;258098945795;8;0,1,3,5;4;2,9;2;1;1
258098945795;258098945854;59;0,1,3,5;4;2,9;2;1;1
258098945854;258098945869;15;0,1,3,5;4;2,9;2;1;1
258098945869;258098945939;70;0,1,3,5;4;2,9;2;1;1
258098945939;258098951018;5079;0,1,3,5;4;2,9;2;1;1
258098951018;258098951103;85;0,1,3,5;4;2,9;2;1;1
258098951103;258098951112;9;0,1,3,5,6;5;2,9;2;1;1
258098951112;258098951412;300;0,1,3,5,6;5;2,9;2;1;1
258098951412;258098951432;20;0,1,3,5,6;5;2,9;2;1;1
258098951432;258098951492;60;0,1,3,5,6;5;2,9;2;1;1
258098951492;258098951542;50;0,1,3,5,6;5;2,9;2;1;1
258098951542;258098951589;47;0,1,3,5,6;5;2,9;2;1;1
258098951589;258098951624;35;0,1,3,5,6;5;2,9;2;1;1
258098951624;258098951636;12;0,1,3,5;4;2,9;2;1;1
258098951636;258098951755;119;0,1,3,5;4;2,9;2;1;1
258098951755;258098951770;15;0,1,3,5;4;2,9;2;1;1
258098951770;258098951783;13;0,1,3,5,6;5;2,9;2;1;1
258098951783;258098951903;120;0,1,3,5,6;5;2,9;2;1;1
258098951903;258098951918;15;0,1,3,5,6;5;2,9;2;1;1
258098951918;258098952065;147;0,1,3,5,6;5;2,9;2;1;1
258098952065;258098952088;23;0,1,3,5,6;5;2,9;2;1;1
258098952088;258098952190;102;0,1,3,5,6;5;2,9;2;1;1
258098952190;258098952233;43;0,1,3,5,6;5;2,9;2;1;1
258098952233;258098952378;145;0,1,3,5,6;5;2,9;2;1;1
258098952378;258098957636;5258;0,1,3,5;4;2,9;2;1;1
258098957636;258098957827;191;0,1,3,5,6;5;2,9;2;1;1
258098957827;258098957833;6;0,1,3,5,6;5;2,9;2;1;1
258098957833;258098958112;279;0,1,3,5;4;2,9;2;1;1
258098958112;258098958943;831;0,1,3,5;4;2,9;2;1;1
258098958943;258098959089;146;0,1,3,5;4;2,9;2;1;1
258098959089;258098959368;279;0,1,3,5;4;2,9;2;1;1
258098959368;258098959557;189;0,1,3,5;4;2,9;2;1;1
258098959557;258098959798;241;0,1,3,5;4;2,9;2;1;1
258098959798;258098959820;22;0,1,3,5;4;2,9;2;1;1
258098959820;258098959965;145;0,1,3,5;4;2,9;2;1;1
258098959965;258098961993;2028;0,1,3,5;4;2,9;2;1;1
258098961993;258098962343;350;0,1,3,5;4;2,9;2;1;1
258098962343;258098962847;504;0,1,3,5;4;2,9;2;1;1
258098962847;258098970033;7186;0,1,3,5;4;2,9;2;1;1
258098970033;258098970477;444;0,1,3,5;4;2,9;2;1;1
258098970477;258099006904;36427;0,1,3,5;4;2,9;2;1;1
258099006904;258099007099;195;0,1,3,5,6;5;2,9;2;1;1
258099007099;258099007386;287;0,1,3,5;4;2,9;2;1;1
258099007386;258099007481;95;0,1,3,5;4;2,9;2;1;1
258099007481;258099007668;187;0,1,3,5;4;2,9;2;1;1
258099007668;258099007863;195;0,1,3,5;4;2,9;2;1;1
258099007863;258099007907;44;0,1,3,5;4;2,9;2;1;1
258099007907;258099008107;200;0,1,3,5;4;2,9;2;1;1
258099008107;258099008253;146;0,1,3,5;4;2,9;2;1;1
258099008253;258099008398;145;0,1,3,5;4;2,9;2;1;1
258099008398;258099010021;1623;0,1,3,5;4;2,9;2;1;1
258099010021;258099013207;3186;0,1,3,5;4;2,9;2;1;1
258099013207;258099017072;3865;0,1,3,5;4;2,9;2;1;1
258099017072;258099017221;149;0,1,3,5,6;5;2,9;2;1;1
258099017221;258099017301;80;0,1,3,5;4;2,9;2;1;1
258099017301;258099017338;37;0,1,3,5;4;2,9;2;1;1
258099017338;258099017500;162;0,1,3,5;4;2,9;2;1;1
258099017500;258099017525;25;0,1,3,5;4;2,9;2;1;1
258099017525;258099017652;127;0,1,3,5;4;2,9;2;1;1
258099017652;258099017798;146;0,1,3,5;4;2,9;2;1;1
258099017798;258099017884;86;0,1,3,5;4;2,9;2;1;1
258099017884;258099017914;30;0,1,3,5;4;2,9;2;1;1
258099017914;258099017941;27;0,1,3,5;4;2,9;2;1;1
258099017941;258099019203;1262;0,1,3,5;4;2,9;2;1;1
258099019203;258099022525;3322;0,1,3,5;4;2,9;2;1;1
258099022525;258099022605;80;0,1,3,5;4;2,9;2;1;1
258099022605;258099024134;1529;0,1,3,5;4;2,9;2;1;1
258099024134;258099024167;33;0,1,3,5;4;2,9;2;1;1
258099024167;258099024217;50;0,1,3,5,6;5;2,9;2;1;1
258099024217;258099024278;61;0,1,3,5,6;5;2,9;2;1;1
258099024278;258099024300;22;0,1,3,5,6;5;2,9;2;1;1
258099024300;258099024420;120;0,1,3,5,6;5;2,9;2;1;1
258099024420;258099024448;28;0,1,3,5,6;5;2,9;2;1;1
258099024448;258099024482;34;0,1,3,5,6;5;2,9;2;1;1
258099024482;258099024613;131;0,1,3,5;4;2,9;2;1;1
258099024613;258099024775;162;0,1,3,5;4;2,9;2;1;1
258099024775;258099027482;2707;0,1,3,5;4;2,9;2;1;1
258099027482;258099029950;2468;0,1,3,5;4;2,9;2;1;1
258099029950;258099030135;185;0,1,3,5;4;2,9;2;1;1
258099030135;258099030172;37;0,1,3,5;4;2,9;2;1;1
258099030172;258099030303;131;0,1,3,5,6;5;2,9;2;1;1
258099030303;258099030458;155;0,1,3,5;4;2,9;2;1;1
258099030458;258099030860;402;0,1,3,5;4;2,9;2;1;1
258099030860;258099030999;139;0,1,3,5;4;2,9;2;1;1
258099030999;258099031092;93;0,1,3,5;4;2,9;2;1;1
258099031092;258099031159;67;0,1,3,5;4;2,9;2;1;1
258099031159;258099031194;35;0,1,3,5;4;2,9;2;1;1
258099031194;258099031793;599;0,1,3,5;4;2,9;2;1;1
258099031793;258099031988;195;0,1,3,5,6;5;2,9;2;1;1
258099031988;258099032322;334;0,1,3,5;4;2,9;2;1;1
258099032322;258099032418;96;0,1,3,5;4;2,9;2;1;1
258099032418;258099032623;205;0,1,3,5;4;2,9;2;1;1
258099032623;258099032665;42;0,1,3,5;4;2,9;2;1;1
258099032665;258099032780;115;0,1,3,5;4;2,9;2;1;1
258099032780;258099032821;41;0,1,3,5;4;2,9;2;1;1
258099032821;258099032915;94;0,1,3,5;4;2,9;2;1;1
258099032915;258099033061;146;0,1,3,5;4;2,9;2;1;1
258099033061;258099037797;4736;0,1,3,5;4;2,9;2;1;1
258099037797;258099041132;3335;0,1,3,5;4;2,9;2;1;1
258099041132;258099043055;1923;0,1,3,5;4;2,9;2;1;1
258099043055;258099046358;3303;0,1,3,5;4;2,9;2;1;1
258099046358;258099055978;9620;0,1,3,5;4;2,9;2;1;1
258099055978;258099056022;44;0,1,3,5;4;2,9;2;1;1
258099056022;258099068186;12164;0,1,3,5;4;2,9;2;1;1
258099068186;258099068373;187;0,1,3,5;4;2,9;2;1;1
258099068373;258099068405;32;0,1,3,5;4;2,9;2;1;1
258099068405;258099068455;50;0,1,3,5;4;2,9;2;1;1
258099068455;258099068515;60;0,1,3,5;4;2,9;2;1;1
258099068515;258099068884;369;0,1,3,5;4;2,9;2;1;1
258099068884;258099083030;14146;0,1,3,5;4;2,9;2;1;1
258099083030;258099083039;9;0,1,3,5;4;2,9;2;1;1
258099083039;258099083055;16;0,1,3,5;4;2,9;2;1;1
258099083055;258099083070;15;0,1,3,5;4;2,9;2;1;1
258099083070;258099083164;94;0,1,3,5;4;2,9;2;1;1
258099083164;258099083340;176;0,1,3,5;4;2,9;2;1;1
258099083340;258099085231;1891;0,1,3,5;4;2,9;2;1;1
258099085231;258099098118;12887;0,1,3,5;4;2,9;2;1;1
258099098118;258099098288;170;0,1,3,5;4;2,9;2;1;1
258099098288;258099146983;48695;0,1,3,5;4;2,9;2;1;1
258099146983;258099147080;97;0,1,3,5;4;2,9;2;1;1
258099147080;258099147215;135;0,1,3,5;4;2,9;2;1;1
258099147215;258099147261;46;0,1,3,5;4;2,9;2;1;1
258099147261;258099147282;21;0,1,3,5;4;2,9;2;1;1
258099147282;258099147393;111;0,1,3,5;4;2,9;2;1;1
258099147393;258099147420;27;0,1,3,5;4;2,9;2;1;1
258099147420;258099147428;8;0,1,3,5;4;2,9;2;1;1
258099147428;258099147492;64;0,1,3,5,6;5;2,9;2;1;1
258099147492;258099147642;150;0,1,3,5,6;5;2,9;2;1;1
258099147642;258099147759;117;0,1,3,5,6;5;2,9;2;1;1
258099147759;258099151040;3281;0,1,3,5;4;2,9;2;1;1
258099151040;258099151048;8;0,1,3,5;4;2,9;2;1;1
258099151048;258099151099;51;0,1,3,5;4;2,9;2;1;1
258099151099;258099151116;17;0,1,3,5;4;2,9;2;1;1
258099151116;258099151134;18;0,1,3,5;4;2,9;2;1;1
258099151134;258099151169;35;0,1,3,5;4;2,9;2;1;1
258099151169;258099151193;24;0,1,3,5;4;2,9;2;1;1
258099151193;258099157909;6716;0,1,3,5;4;2,9;2;1;1
258099157909;258099170727;12818;0,1,3,5;4;2,9;2;1;1
258099170727;258099170881;154;0,1,3,5,6;5;2,9;2;1;1
258099170881;258099171037;156;0,1,3,5,6;5;2,9;2;1;1
258099171037;258099171132;95;0,1,3,5;4;2,9;2;1;1
258099171132;258099171159;27;0,1,3,5;4;2,9;2;1;1
258099171159;258099171168;9;0,1,3,5;4;2,9;2;1;1
258099171168;258099171336;168;0,1,3,5;4;2,9;2;1;1
258099171336;258099171378;42;0,1,3,5;4;2,9;2;1;1
258099171378;258099171407;29;0,1,3,5;4;2,9;2;1;1
258099171407;258099171437;30;0,1,3,5;4;2,9;2;1;1
258099171437;258099179856;8419;0,1,3,5;4;2,9;2;1;1
258099179856;258099186890;7034;0,1,3,5;4;2,9;2;1;1
258099186890;258099196703;9813;0,1,3,5;4;2,9;2;1;1
258099196703;258099196901;198;0,1,3,5;4;2,9;2;1;1
258099196901;258099197160;259;0,1,3,5;4;2,9;2;1;1
258099197160;258099197234;74;0,1,3,5;4;2,9;2;1;1
258099197234;258099197603;369;0,1,3,5;4;2,9;2;1;1
258099197603;258099226090;28487;0,1,3,5;4;2,9;2;1;1
258099226090;258099233362;7272;0,1,3,5;4;2,9;2;1;1
258099233362;258099237947;4585;0,1,3,5;4;2,9;2;1;1
258099237947;258099237998;51;0,1,3,5;4;2,9;2;1;1
258099237998;258099238049;51;0,1,3,5;4;2,9;2;1;1
258099238049;258099238100;51;0,1,3,5;4;2,9;2;1;1
258099238100;258099238150;50;0,1,3,5;4;2,9;2;1;1
258099238150;258099238200;50;0,1,3,5;4;2,9;2;1;1
258099238200;258099239169;969;0,1,3,5;4;2,9;2;1;1
258099239169;258099258597;19428;0,1,3,5;4;2,9;2;1;1
258099258597;258099258970;373;0,1,3,5;4;2,9;2;1;1
258099258970;258099259288;318;0,1,3,5;4;2,9;2;1;1
258099259288;258099261867;2579;0,1,3,5;4;2,9;2;1;1
258099261867;258099261916;49;0,1,3,5;4;2,9;2;1;1
258099261916;258099261968;52;0,1,3,5;4;2,9;2;1;1
258099261968;258099262038;70;0,1,3,5;4;2,9;2;1;1
258099262038;258099262820;782;0,1,3,5;4;2,9;2;1;1
258099262820;258099262856;36;0,1,3,5;4;2,9;2;1;1
258099262856;258099266113;3257;0,1,3,5;4;2,9;2;1;1
258099266113;258099266275;162;0,1,3,5,6;5;2,9;2;1;1
258099266275;258099266330;55;0,1,3,5;4;2,9;2;1;1
258099266330;258099266451;121;0,1,3,5;4;2,9;2;1;1
258099266451;258099266789;338;0,1,3,5;4;2,9;2;1;1
258099266789;258099266957;168;0,1,3,5;4;2,9;2;1;1
258099266957;258099267121;164;0,1,3,5;4;2,9;2;1;1
258099267121;258099267412;291;0,1,3,5;4;2,9;2;1;1
258099267412;258099267434;22;0,1,3,5;4;2,9;2;1;1
258099267434;258099267532;98;0,1,3,5;4;2,9;2;1;1
258099267532;258099276225;8693;0,1,3,5;4;2,9;2;1;1
258099276225;258099278773;2548;0,1,3,5;4;2,9;2;1;1
258099278773;258099278795;22;0,1,3,5;4;2,9;2;1;1
258099278795;258099278933;138;0,1,3,5;4;2,9;2;1;1
258099278933;258099278984;51;0,1,3,5;4;2,9;2;1;1
258099278984;258099279298;314;0,1,3,5;4;2,9;2;1;1
258099279298;258099280157;859;0,1,3,5;4;2,9;2;1;1
258099280157;258099281164;1007;0,1,3,5;4;2,9;2;1;1
258099281164;258099281621;457;0,1,3,5;4;2,9;2;1;1
258099281621;258099286308;4687;0,1,3,5;4;2,9;2;1;1
258099286308;258099286357;49;0,1,3,5;4;2,9;2;1;1
258099286357;258099286398;41;0,1,3,5;4;2,9;2;1;1
258099286398;258099286513;115;0,1,3,5;4;2,9;2;1;1
258099286513;258099286580;67;0,1,3,5,6;5;2,9;2;1;1
258099286580;258099286748;168;0,1,3,5,6;5;2,9;2;1;1
258099286748;258099286877;129;0,1,3,5;4;2,9;2;1;1
258099286877;258099286893;16;0,1,3,5;4;2,9;2;1;1
258099286893;258099287059;166;0,1,3,5;4;2,9;2;1;1
258099287059;258099287368;309;0,1,3,5;4;2,9;2;1;1
258099287368;258099290510;3142;0,1,3,5;4;2,9;2;1;1
258099290510;258099290511;1;0,1,3,5;4;2,9;2;1;1
258099290511;258099290548;37;0,1,3,5;4;2,9;2;1;1
258099290548;258099290570;22;0,1,3,5;4;2,9;2;1;1
258099290570;258099290759;189;0,1,3,5,6;5;2,9;2;1;1
258099290759;258099296908;6149;0,1,3,5;4;2,9;2;1;1
258099296908;258099296941;33;0,1,3,5;4;2,9;2;1;1
258099296941;258099297039;98;0,1,3,5;4;2,9;2;1;1
258099297039;258099297075;36;0,1,3,5;4;2,9;2;1;1
258099297075;258099297114;39;0,1,3,5;4;2,9;2;1;1
258099297114;258099297146;32;0,1,3,5;4;2,9;2;1;1
258099297146;258099307183;10037;0,1,3,5;4;2,9;2;1;1
258099307183;258099310246;3063;0,1,3,5;4;2,9;2;1;1
258099310246;258099311110;864;0,1,3,5;4;2,9;2;1;1
258099311110;258099311647;537;0,1,3,5;4;2,9;2;1;1
258099311647;258099311691;44;0,1,3,5;4;2,9;2;1;1
258099311691;258099312034;343;0,1,3,5;4;2,9;2;1;1
258099312034;258099312086;52;0,1,3,5;4;2,9;2;1;1
258099312086;258099312646;560;0,1,3,5;4;2,9;2;1;1
258099312646;258099349298;36652;0,1,3,5;4;2,9;2;1;1
258099349298;258099349391;93;0,1,3,5;4;2,9;2;1;1
258099349391;258099349399;8;0,1,3,5;4;2,9;2;1;1
258099349399;258099349444;45;0,1,3,5,6;5;2,9;2;1;1
258099349444;258099349591;147;0,1,3,5,6;5;2,9;2;1;1
258099349591;258099349600;9;0,1,3,5,6;5;2,9;2;1;1
258099349600;258099349640;40;0,1,3,5,6;5;2,9;2;1;1
258099349640;258099349779;139;0,1,3,5,6;5;2,9;2;1;1
258099349779;258099349962;183;0,1,3,5,6;5;2,9;2;1;1
258099349962;258099349996;34;0,1,3,5,6;5;2,9;2;1;1
258099349996;258099362048;12052;0,1,3,5;4;2,9;2;1;1
258099362048;258099371350;9302;0,1,3,5;4;2,9;2;1;1
258099371350;258099371389;39;0,1,3,5;4;2,9;2;1;1
258099371389;258099371437;48;0,1,3,5;4;2,9;2;1;1
258099371437;258099371447;10;0,1,3,5;4;2,9;2;1;1
258099371447;258099371674;227;0,1,3,5,6;5;2,9;2;1;1
258099371674;258099371755;81;0,1,3,5,6;5;2,9;2;1;1
258099371755;258099371758;3;0,1,3,5;4;2,9;2;1;1
258099371758;258099371784;26;0,1,3,5;4;2,9;2;1;1
258099371784;258099371976;192;0,1,3,5;4;2,9;2;1;1
258099371976;258099372237;261;0,1,3,5;4;2,9;2;1;1
258099372237;258099372504;267;0,1,3,5;4;2,9;2;1;1
258099372504;258099381623;9119;0,1,3,5;4;2,9;2;1;1
258099381623;258099381894;271;0,1,3,5;4;2,9;2;1;1
258099381894;258099384130;2236;0,1,3,5;4;2,9;2;1;1
258099384130;258099392846;8716;0,1,3,5;4;2,9;2;1;1
258099392846;258099392972;126;0,1,3,5;4;2,9;2;1;1
258099392972;258099403409;10437;0,1,3,5;4;2,9;2;1;1
258099403409;258099404622;1213;0,1,3,5;4;2,9;2;1;1
258099404622;258099406936;2314;0,1,3,5;4;2,9;2;1;1
258099406936;258099406967;31;0,1,3,5;4;2,9;2;1;1
258099406967;258099407013;46;0,1,3,5;4;2,9;2;1;1
258099407013;258099407074;61;0,1,3,5;4;2,9;2;1;1
258099407074;258099407220;146;0,1,3,5;4;2,9;2;1;1
258099407220;258099407253;33;0,1,3,5;4;2,9;2;1;1
258099407253;258099407411;158;0,1,3,5,6;5;2,9;2;1;1
258099407411;258099407452;41;0,1,3,5,6;5;2,9;2;1;1
258099407452;258099407556;104;0,1,3,5,6;5;2,9;2;1;1
258099407556;258099407805;249;0,1,3,5,6;5;2,9;2;1;1
258099407805;258099418408;10603;0,1,3,5;4;2,9;2;1;1
258099418408;258099418687;279;0,1,3,5;4;2,9;2;1;1
258099418687;258099429705;11018;0,1,3,5;4;2,9;2;1;1
258099429705;258099429732;27;0,1,3,5;4;2,9;2;1;1
258099429732;258099429810;78;0,1,3,5;4;2,9;2;1;1
258099429810;258099430754;944;0,1,3,5;4;2,9;2;1;1
258099430754;258099430794;40;0,1,3,5;4;2,9;2;1;1
258099430794;258099451201;20407;0,1,3,5;4;2,9;2;1;1
258099451201;258099460763;9562;0,1,3,5;4;2,9;2;1;1
258099460763;258099461006;243;0,1,3,5;4;2,9;2;1;1
258099461006;258099461027;21;0,1,3,5;4;2,9;2;1;1
258099461027;258099461098;71;0,1,3,5;4;2,9;2;1;1
258099461098;258099461124;26;0,1,3,5;4;2,9;2;1;1
258099461124;258099461144;20;0,1,3,5;4;2,9;2;1;1
258099461144;258099461788;644;0,1,3,5;4;2,9;2;1;1
258099461788;258099482500;20712;0,1,3,5;4;2,9;2;1;1
258099482500;258099510159;27659;0,1,3,5;4;2,9;2;1;1
258099510159;258099513394;3235;0,1,3,5;4;2,9;2;1;1
258099513394;258099513410;16;0,1,3,5;4;2,9;2;1;1
258099513410;258099548402;34992;0,1,3,5;4;2,9;2;1;1
258099548402;258099558364;9962;0,1,3,5;4;2,9;2;1;1
258099558364;258099559071;707;0,1,3,5;4;2,9;2;1;1
258099559071;258099559126;55;0,1,3,5;4;2,9;2;1;1
258099559126;258099559174;48;0,1,3,5;4;2,9;2;1;1
258099559174;258099559256;82;0,1,3,5;4;2,9;2;1;1
258099559256;258099562721;3465;0,1,3,5;4;2,9;2;1;1
258099562721;258099562949;228;0,1,3,5;4;2,9;2;1;1
258099562949;258099563095;146;0,1,3,5;4;2,9;2;1;1
258099563095;258099563352;257;0,1,3,5;4;2,9;2;1;1
258099563352;258099563384;32;0,1,3,5;4;2,9;2;1;1
258099563384;258099563838;454;0,1,3,5;4;2,9;2;1;1
258099563838;258099587446;23608;0,1,3,5;4;2,9;2;1;1
258099587446;258099587743;297;0,1,3,5;4;2,9;2;1;1
258099587743;258099588002;259;0,1,3,5;4;2,9;2;1;1
258099588002;258099588116;114;0,1,3,5;4;2,9;2;1;1
258099588116;258099588182;66;0,1,3,5;4;2,9;2;1;1
258099588182;258099588229;47;0,1,3,5;4;2,9;2;1;1
258099588229;258099588292;63;0,1,3,5;4;2,9;2;1;1
258099588292;258099588471;179;0,1,3,5;4;2,9;2;1;1
258099588471;258099588509;38;0,1,3,5;4;2,9;2;1;1
258099588509;258099608046;19537;0,1,3,5;4;2,9;2;1;1
258099608046;258099608393;347;0,1,3,5;4;2,9;2;1;1
258099608393;258099608614;221;0,1,3,5;4;2,9;2;1;1
258099608614;258099611884;3270;0,1,3,5;4;2,9;2;1;1
258099611884;258099612297;413;0,1,3,5;4;2,9;2;1;1
258099612297;258099612564;267;0,1,3,5;4;2,9;2;1;1
258099612564;258099612816;252;0,1,3,5,6;5;2,9;2;1;1
258099612816;258099612946;130;0,1,3,5,6;5;2,9;2;1;1
258099612946;258099612988;42;0,1,3,5,6;5;2,9;2;1;1
258099612988;258099613020;32;0,1,3,5,6;5;2,9;2;1;1
258099613020;258099613199;179;0,1,3,5,6;5;2,9;2;1;1
258099613199;258099613296;97;0,1,3,5,6;5;2,9;2;1;1
258099613296;258099613354;58;0,1,3,5,6;5;2,9;2;1;1
258099613354;258099631466;18112;0,1,3,5;4;2,9;2;1;1
258099631466;258099631590;124;0,1,3,5;4;2,9;2;1;1
258099631590;258099631715;125;0,1,3,5;4;2,9;2;1;1
258099631715;258099633638;1923;0,1,3,5;4;2,9;2;1;1
258099633638;258099634117;479;0,1,3,5;4;2,9;2;1;1
258099634117;258099635008;891;0,1,3,5;4;2,9;2;1;1
258099635008;258099635179;171;0,1,3,5,6;5;2,9;2;1;1
258099635179;258099635282;103;0,1,3,5;4;2,9;2;1;1
258099635282;258099635298;16;0,1,3,5;4;2,9;2;1;1
258099635298;258099635367;69;0,1,3,5;4;2,9;2;1;1
258099635367;258099635402;35;0,1,3,5;4;2,9;2;1;1
258099635402;258099635419;17;0,1,3,5;4;2,9;2;1;1
258099635419;258099635501;82;0,1,3,5;4;2,9;2;1;1
258099635501;258099635530;29;0,1,3,5;4;2,9;2;1;1
258099635530;258099635705;175;0,1,3,5;4;2,9;2;1;1
258099635705;258099645678;9973;0,1,3,5;4;2,9;2;1;1
258099645678;258099645752;74;0,1,3,5;4;2,9;2;1;1
258099645752;258099645807;55;0,1,3,5;4;2,9;2;1;1
258099645807;258099645888;81;0,1,3,5;4;2,9;2;1;1
258099645888;258099645903;15;0,1,3,5;4;2,9;2;1;1
258099645903;258099646197;294;0,1,3,5;4;2,9;2;1;1
258099646197;258099647388;1191;0,1,3,5;4;2,9;2;1;1
258099647388;258099648177;789;0,1,3,5;4;2,9;2;1;1
258099648177;258099648483;306;0,1,3,5;4;2,9;2;1;1
258099648483;258099649197;714;0,1,3,5;4;2,9;2;1;1
258099649197;258099649267;70;0,1,3,5;4;2,9;2;1;1
258099649267;258099649304;37;0,1,3,5;4;2,9;2;1;1
258099649304;258099649367;63;0,1,3,5;4;2,9;2;1;1
258099649367;258099649485;118;0,1,3,5;4;2,9;2;1;1
258099649485;258099670019;20534;0,1,3,5;4;2,9;2;1;1
258099670019;258099680322;10303;0,1,3,5;4;2,9;2;1;1
258099680322;258099680487;165;0,1,3,5,6;5;2,9;2;1;1
258099680487;258099680750;263;0,1,3,5;4;2,9;2;1;1
258099680750;258099681000;250;0,1,3,5;4;2,9;2;1;1
258099681000;258099681192;192;0,1,3,5;4;2,9;2;1;1
258099681192;258099681336;144;0,1,3,5;4;2,9;2;1;1
258099681336;258099681481;145;0,1,3,5;4;2,9;2;1;1
258099681481;258099681625;144;0,1,3,5;4;2,9;2;1;1
258099681625;258099681771;146;0,1,3,5;4;2,9;2;1;1
258099681771;258099681913;142;0,1,3,5;4;2,9;2;1;1
258099681913;258099690399;8486;0,1,3,5;4;2,9;2;1;1
258099690399;258099691147;748;0,1,3,5;4;2,9;2;1;1
258099691147;258099694714;3567;0,1,3,5;4;2,9;2;1;1
258099694714;258099694973;259;0,1,3,5;4;2,9;2;1;1
258099694973;258099736037;41064;0,1,3,5;4;2,9;2;1;1
258099736037;258099744369;8332;0,1,3,5;4;2,9;2;1;1
258099744369;258099744501;132;0,1,3,5,6;5;2,9;2;1;1
258099744501;258099744619;118;0,1,3,5,6;5;2,9;2;1;1
258099744619;258099744739;120;0,1,3,5,6;5;2,9;2;1;1
258099744739;258099744857;118;0,1,3,5;4;2,9;2;1;1
258099744857;258099744986;129;0,1,3,5;4;2,9;2;1;1
258099744986;258099745259;273;0,1,3,5;4;2,9;2;1;1
258099745259;258099745402;143;0,1,3,5;4;2,9;2;1;1
258099745402;258099745549;147;0,1,3,5;4;2,9;2;1;1
258099745549;258099745781;232;0,1,3,5;4;2,9;2;1;1
258099745781;258099745808;27;0,1,3,5;4;2,9;2;1;1
258099745808;258099746202;394;0,1,3,5;4;2,9;2;1;1
258099746202;258099746337;135;0,1,3,5;4;2,9;2;1;1
258099746337;258099746379;42;0,1,3,5;4;2,9;2;1;1
258099746379;258099746744;365;0,1,3,5;4;2,9;2;1;1
258099746744;258099755057;8313;0,1,3,5;4;2,9;2;1;1
258099755057;258099781692;26635;0,1,3,5;4;2,9;2;1;1
258099781692;258099781759;67;0,1,3,5;4;2,9;2;1;1
258099781759;258099781760;1;0,1,3,5;4;2,9;2;1;1
258099781760;258099781768;8;0,1,3,5;4;2,9;2;1;1
258099781768;258099781786;18;0,1,3,5;4;2,9;2;1;1
258099781786;258099781818;32;0,1,3,5;4;2,9;2;1;1
258099781818;258099781868;50;0,1,3,5;4;2,9;2;1;1
258099781868;258099781879;11;0,1,3,5;4;2,9;2;1;1
258099781879;258099781894;15;0,1,3,5;4;2,9;2;1;1
258099781894;258099781979;85;0,1,3,5;4;2,9;2;1;1
258099781979;258099795124;13145;0,1,3,5;4;2,9;2;1;1
258099795124;258099801334;6210;0,1,3,5;4;2,9;2;1;1
258099801334;258099801380;46;0,1,3,5;4;2,9;2;1;1
258099801380;258099801620;240;0,1,3,5;4;2,9;2;1;1
258099801620;258099801659;39;0,1,3,5;4;2,9;2;1;1
258099801659;258099801727;68;0,1,3,5;4;2,9;2;1;1
258099801727;258099802561;834;0,1,3,5;4;2,9;2;1;1
258099802561;258099802605;44;0,1,3,5;4;2,9;2;1;1
258099802605;258099802936;331;0,1,3,5;4;2,9;2;1;1
258099802936;258099814752;11816;0,1,3,5;4;2,9;2;1;1
258099814752;258099819584;4832;0,1,3,5;4;2,9;2;1;1
258099819584;258099819744;160;0,1,3,5,6;5;2,9;2;1;1
258099819744;258099820086;342;0,1,3,5;4;2,9;2;1;1
258099820086;258099820552;466;0,1,3,5;4;2,9;2;1;1
258099820552;258099820665;113;0,1,3,5;4;2,9;2;1;1
258099820665;258099820804;139;0,1,3,5;4;2,9;2;1;1
258099820804;258099820943;139;0,1,3,5;4;2,9;2;1;1
258099820943;258099821090;147;0,1,3,5;4;2,9;2;1;1
258099821090;258099821123;33;0,1,3,5;4;2,9;2;1;1
258099821123;258099821150;27;0,1,3,5;4;2,9;2;1;1
258099821150;258099822987;1837;0,1,3,5;4;2,9;2;1;1
258099822987;258099823942;955;0,1,3,5;4;2,9;2;1;1
258099823942;258099829642;5700;0,1,3,5;4;2,9;2;1;1
258099829642;258099835498;5856;0,1,3,5;4;2,9;2;1;1
258099835498;258099881797;46299;0,1,3,5;4;2,9;2;1;1
258099881797;258099882240;443;0,1,3,5;4;2,9;2;1;1
258099882240;258099882694;454;0,1,3,5;4;2,9;2;1;1
258099882694;258099882762;68;0,1,3,5;4;2,9;2;1;1
258099882762;258099882856;94;0,1,3,5,6;5;2,9;2;1;1
258099882856;258099882982;126;0,1,3,5,6;5;2,9;2;1;1
258099882982;258099883024;42;0,1,3,5,6;5;2,9;2;1;1
258099883024;258099883053;29;0,1,3,5,6;5;2,9;2;1;1
258099883053;258099883089;36;0,1,3,5,6;5;2,9;2;1;1
258099883089;258099883162;73;0,1,3,5,6;5;2,9;2;1;1
258099883162;258099883219;57;0,1,3,5,6;5;2,9;2;1;1
258099883219;258099883283;64;0,1,3,5,6;5;2,9;2;1;1
258099883283;258099883588;305;0,1,3,5;4;2,9;2;1;1
258099883588;258099883621;33;0,1,3,5;4;2,9;2;1;1
258099883621;258099883635;14;0,1,3,5;4;2,9;2;1;1
258099883635;258099883728;93;0,1,3,5;4;2,9;2;1;1
258099883728;258099883787;59;0,1,3,5;4;2,9;2;1;1
258099883787;258099883922;135;0,1,3,5;4;2,9;2;1;1
258099883922;258099884067;145;0,1,3,5;4;2,9;2;1;1
258099884067;258099884103;36;0,1,3,5;4;2,9;2;1;1
258099884103;258099884347;244;0,1,3,5,6;5;2,9;2;1;1
258099884347;258099893603;9256;0,1,3,5;4;2,9;2;1;1
258099893603;258099893734;131;0,1,3,5;4;2,9;2;1;1
258099893734;258099894282;548;0,1,3,5;4;2,9;2;1;1
258099894282;258099894321;39;0,1,3,5;4;2,9;2;1;1
258099894321;258099894535;214;0,1,3,5;4;2,9;2;1;1
258099894535;258099895884;1349;0,1,3,5;4;2,9;2;1;1
258099895884;258099895920;36;0,1,3,5;4;2,9;2;1;1
258099895920;258099899299;3379;0,1,3,5;4;2,9;2;1;1
258099899299;258099899463;164;0,1,3,5,6;5;2,9;2;1;1
258099899463;258099899603;140;0,1,3,5;4;2,9;2;1;1
258099899603;258099899723;120;0,1,3,5;4;2,9;2;1;1
258099899723;258099899749;26;0,1,3,5;4;2,9;2;1;1
258099899749;258099899896;147;0,1,3,5;4;2,9;2;1;1
258099899896;258099899952;56;0,1,3,5;4;2,9;2;1;1
258099899952;258099900097;145;0,1,3,5;4;2,9;2;1;1
258099900097;258099900242;145;0,1,3,5;4;2,9;2;1;1
258099900242;258099900386;144;0,1,3,5;4;2,9;2;1;1
258099900386;258099902744;2358;0,1,3,5;4;2,9;2;1;1
258099902744;258099907915;5171;0,1,3,5;4;2,9;2;1;1
258099907915;258099912559;4644;0,1,3,5;4;2,9;2;1;1
258099912559;258099923530;10971;0,1,3,5;4;2,9;2;1;1
258099923530;258099926940;3410;0,1,3,5;4;2,9;2;1;1
258099926940;258099927001;61;0,1,3,5;4;2,9;2;1;1
258099927001;258099927052;51;0,1,3,5;4;2,9;2;1;1
258099927052;258099927062;10;0,1,3,5;4;2,9;2;1;1
258099927062;258099927652;590;0,1,3,5;4;2,9;2;1;1
258099927652;258099952367;24715;0,1,3,5;4;2,9;2;1;1
258099952367;258099956279;3912;0,1,3,5;4;2,9;2;1;1
258099956279;258099956509;230;0,1,3,5;4;2,9;2;1;1
258099956509;258099956737;228;0,1,3,5;4;2,9;2;1;1
258099956737;258099957169;432;0,1,3,5;4;2,9;2;1;1
258099957169;258099981764;24595;0,1,3,5;4;2,9;2;1;1
258099981764;258099984147;2383;0,1,3,5;4;2,9;2;1;1
258099984147;258099984235;88;0,1,3,5;4;2,9;2;1;1
258099984235;258099984455;220;0,1,3,5;4;2,9;2;1;1
258099984455;258099990835;6380;0,1,3,5;4;2,9;2;1;1
258099990835;258099991101;266;0,1,3,5;4;2,9;2;1;1
258099991101;258099991832;731;0,1,3,5;4;2,9;2;1;1
258099991832;258099991975;143;0,1,3,5;4;2,9;2;1;1
258099991975;258099992116;141;0,1,3,5,6;5;2,9;2;1;1
258099992116;258099992163;47;0,1,3,5,6;5;2,9;2;1;1
258099992163;258099992257;94;0,1,3,5,6;5;2,9;2;1;1
258099992257;258099992335;78;0,1,3,5,6;5;2,9;2;1;1
258099992335;258099992470;135;0,1,3,5,6;5;2,9;2;1;1
258099992470;258099992500;30;0,1,3,5;4;2,9;2;1;1
258099992500;258099992677;177;0,1,3,5;4;2,9;2;1;1
258099992677;258099992908;231;0,1,3,5;4;2,9;2;1;1
258099992908;258099994155;1247;0,1,3,5;4;2,9;2;1;1
258099994155;258099994167;12;0,1,3,5;4;2,9;2;1;1
258099994167;258099994190;23;0,1,3,5;4;2,9;2;1;1
258099994190;258099994586;396;0,1,3,5;4;2,9;2;1;1
258099994586;258100026895;32309;0,1,3,5;4;2,9;2;1;1
258100026895;258100026929;34;0,1,3,5;4;2,9;2;1;1
258100026929;258100027284;355;0,1,3,5;4;2,9;2;1;1
258100027284;258100027341;57;0,1,3,5;4;2,9;2;1;1
258100027341;258100027690;349;0,1,3,5;4;2,9;2;1;1
258100027690;258100049236;21546;0,1,3,5;4;2,9;2;1;1
258100049236;258100053020;3784;0,1,3,5;4;2,9;2;1;1
258100053020;258100053128;108;0,1,3,5;4;2,9;2;1;1
258100053128;258100053442;314;0,1,3,5;4;2,9;2;1;1
258100053442;258100053630;188;0,1,3,5;4;2,9;2;1;1
258100053630;258100079746;26116;0,1,3,5;4;2,9;2;1;1
258100079746;258100083372;3626;0,1,3,5;4;2,9;2;1;1
258100083372;258100085776;2404;0,1,3,5;4;2,9;2;1;1
258100085776;258100087241;1465;0,1,3,5;4;2,9;2;1;1
258100087241;258100088773;1532;0,1,3,5;4;2,9;2;1;1
258100088773;258100089924;1151;0,1,3,5;4;2,9;2;1;1
258100089924;258100089984;60;0,1,3,5;4;2,9;2;1;1
258100089984;258100090169;185;0,1,3,5;4;2,9;2;1;1
258100090169;258100090477;308;0,1,3,5;4;2,9;2;1;1
258100090477;258100090946;469;0,1,3,5;4;2,9;2;1;1
258100090946;258100099695;8749;0,1,3,5;4;2,9;2;1;1
258100099695;258100099744;49;0,1,3,5;4;2,9;2;1;1
258100099744;258100099794;50;0,1,3,5;4;2,9;2;1;1
258100099794;258100099872;78;0,1,3,5;4;2,9;2;1;1
258100099872;258100100287;415;0,1,3,5;4;2,9;2;1;1
258100100287;258100100533;246;0,1,3,5;4;2,9;2;1;1
258100100533;258100105321;4788;0,1,3,5;4;2,9;2;1;1
258100105321;258100105643;322;0,1,3,5;4;2,9;2;1;1
258100105643;258100105731;88;0,1,3,5;4;2,9;2;1;1
258100105731;258100109900;4169;0,1,3,5;4;2,9;2;1;1
258100109900;258100109956;56;0,1,3,5;4;2,9;2;1;1
258100109956;258100110175;219;0,1,3,5;4;2,9;2;1;1
258100110175;258100113197;3022;0,1,3,5;4;2,9;2;1;1
258100113197;258100113460;263;0,1,3,5;4;2,9;2;1;1
258100113460;258100113543;83;0,1,3,5;4;2,9;2;1;1
258100113543;258100113732;189;0,1,3,5;4;2,9;2;1;1
258100113732;258100114778;1046;0,1,3,5;4;2,9;2;1;1
258100114778;258100120471;5693;0,1,3,5;4;2,9;2;1;1
258100120471;258100120520;49;0,1,3,5;4;2,9;2;1;1
258100120520;258100120557;37;0,1,3,5;4;2,9;2;1;1
258100120557;258100126445;5888;0,1,3,5;4;2,9;2;1;1
258100126445;258100129600;3155;0,1,3,5;4;2,9;2;1;1
258100129600;258100129627;27;0,1,3,5;4;2,9;2;1;1
258100129627;258100130391;764;0,1,3,5;4;2,9;2;1;1
258100130391;258100130483;92;0,1,3,5;4;2,9;2;1;1
258100130483;258100135087;4604;0,1,3,5;4;2,9;2;1;1
258100135087;258100140685;5598;0,1,3,5;4;2,9;2;1;1
258100140685;258100140852;167;0,1,3,5;4;2,9;2;1;1
258100140852;258100140905;53;0,1,3,5;4;2,9;2;1;1
258100140905;258100159268;18363;0,1,3,5;4;2,9;2;1;1
258100159268;258100162788;3520;0,1,3,5;4;2,9;2;1;1
258100162788;258100171897;9109;0,1,3,5;4;2,9;2;1;1
258100171897;258100171931;34;0,1,3,5;4;2,9;2;1;1
258100171931;258100172012;81;0,1,3,5;4;2,9;2;1;1
258100172012;258100174206;2194;0,1,3,5;4;2,9;2;1;1
258100174206;258100174432;226;0,1,3,5;4;2,9;2;1;1
258100174432;258100174545;113;0,1,3,5;4;2,9;2;1;1
258100174545;258100174629;84;0,1,3,5,6;5;2,9;2;1;1
258100174629;258100174671;42;0,1,3,5,6;5;2,9;2;1;1
258100174671;258100174786;115;0,1,3,5,6;5;2,9;2;1;1
258100174786;258100174814;28;0,1,3,5,6;5;2,9;2;1;1
258100174814;258100174932;118;0,1,3,5,6;5;2,9;2;1;1
258100174932;258100175152;220;0,1,3,5,6;5;2,9;2;1;1
258100175152;258100175268;116;0,1,3,5,6;5;2,9;2;1;1
258100175268;258100176007;739;0,1,3,5;4;2,9;2;1;1
258100176007;258100186483;10476;0,1,3,5;4;2,9;2;1;1
258100186483;258100186723;240;0,1,3,5,6;5;2,9;2;1;1
258100186723;258100187990;1267;0,1,3,5;4;2,9;2;1;1
258100187990;258100188169;179;0,1,3,5;4;2,9;2;1;1
258100188169;258100188264;95;0,1,3,5;4;2,9;2;1;1
258100188264;258100188404;140;0,1,3,5;4;2,9;2;1;1
258100188404;258100188428;24;0,1,3,5;4;2,9;2;1;1
258100188428;258100188822;394;0,1,3,5;4;2,9;2;1;1
258100188822;258100189023;201;0,1,3,5;4;2,9;2;1;1
258100189023;258100189061;38;0,1,3,5;4;2,9;2;1;1
258100189061;258100199192;10131;0,1,3,5;4;2,9;2;1;1
258100199192;258100199680;488;0,1,3,5;4;2,9;2;1;1
258100199680;258100201792;2112;0,1,3,5;4;2,9;2;1;1
258100201792;258100201859;67;0,1,3,5;4;2,9;2;1;1
258100201859;258100201942;83;0,1,3,5;4;2,9;2;1;1
258100201942;258100201985;43;0,1,3,5;4;2,9;2;1;1
258100201985;258100202092;107;0,1,3,5;4;2,9;2;1;1
258100202092;258100202132;40;0,1,3,5;4;2,9;2;1;1
258100202132;258100202275;143;0,1,3,5;4;2,9;2;1;1
258100202275;258100202308;33;0,1,3,5;4;2,9;2;1;1
258100202308;258100202327;19;0,1,3,5;4;2,9;2;1;1
258100202327;258100202531;204;0,1,3,5,6;5;2,9;2;1;1
258100202531;258100212085;9554;0,1,3,5;4;2,9;2;1;1
258100212085;258100212117;32;0,1,3,5;4;2,9;2;1;1
258100212117;258100212221;104;0,1,3,5;4;2,9;2;1;1
258100212221;258100212250;29;0,1,3,5,6;5;2,9;2;1;1
258100212250;258100212379;129;0,1,3,5,6;5;2,9;2;1;1
258100212379;258100212512;133;0,1,3,5,6;5;2,9;2;1;1
258100212512;258100212692;180;0,1,3,5,6;5;2,9;2;1;1
258100212692;258100212729;37;0,1,3,5,6;5;2,9;2;1;1
258100212729;258100212817;88;0,1,3,5,6;5;2,9;2;1;1
258100212817;258100212824;7;0,1,3,5,6;5;2,9;2;1;1
258100212824;258100218367;5543;0,1,3,5;4;2,9;2;1;1
258100218367;258100218434;67;0,1,3,5;4;2,9;2;1;1
258100218434;258100218476;42;0,1,3,5;4;2,9;2;1;1
258100218476;258100218603;127;0,1,3,5;4;2,9;2;1;1
258100218603;258100218659;56;0,1,3,5;4;2,9;2;1;1
258100218659;258100218671;12;0,1,3,5;4;2,9;2;1;1
258100218671;258100218748;77;0,1,3,5,6;5;2,9;2;1;1
258100218748;258100218823;75;0,1,3,5,6;5;2,9;2;1;1
258100218823;258100218888;65;0,1,3,5,6;5;2,9;2;1;1
258100218888;258100219096;208;0,1,3,5;4;2,9;2;1;1
258100219096;258100222778;3682;0,1,3,5;4;2,9;2;1;1
258100222778;258100229925;7147;0,1,3,5;4;2,9;2;1;1
258100229925;258100238601;8676;0,1,3,5;4;2,9;2;1;1
258100238601;258100240748;2147;0,1,3,5;4;2,9;2;1;1
258100240748;258100260437;19689;0,1,3,5;4;2,9;2;1;1
258100260437;258100260639;202;0,1,3,5;4;2,9;2;1;1
258100260639;258100263502;2863;0,1,3,5;4;2,9;2;1;1
258100263502;258100263558;56;0,1,3,5;4;2,9;2;1;1
258100263558;258100264014;456;0,1,3,5;4;2,9;2;1;1
258100264014;258100273942;9928;0,1,3,5;4;2,9;2;1;1
258100273942;258100274089;147;0,1,3,5,6;5;2,9;2;1;1
258100274089;258100274209;120;0,1,3,5,6;5;2,9;2;1;1
258100274209;258100274341;132;0,1,3,5;4;2,9;2;1;1
258100274341;258100274357;16;0,1,3,5;4;2,9;2;1;1
258100274357;258100274533;176;0,1,3,5;4;2,9;2;1;1
258100274533;258100274592;59;0,1,3,5;4;2,9;2;1;1
258100274592;258100274742;150;0,1,3,5;4;2,9;2;1;1
258100274742;258100274914;172;0,1,3,5;4;2,9;2;1;1
258100274914;258100275131;217;0,1,3,5;4;2,9;2;1;1
258100275131;258100279904;4773;0,1,3,5;4;2,9;2;1;1
258100279904;258100280283;379;0,1,3,5;4;2,9;2;1;1
258100280283;258100290989;10706;0,1,3,5;4;2,9;2;1;1
258100290989;258100293272;2283;0,1,3,5;4;2,9;2;1;1
258100293272;258100293306;34;0,1,3,5;4;2,9;2;1;1
258100293306;258100293575;269;0,1,3,5;4;2,9;2;1;1
258100293575;258100294116;541;0,1,3,5;4;2,9;2;1;1
258100294116;258100294370;254;0,1,3,5;4;2,9;2;1;1
258100294370;258100294609;239;0,1,3,5;4;2,9;2;1;1
258100294609;258100294637;28;0,1,3,5;4;2,9;2;1;1
258100294637;258100297869;3232;0,1,3,5;4;2,9;2;1;1
258100297869;258100297942;73;0,1,3,5;4;2,9;2;1;1
258100297942;258100298015;73;0,1,3,5;4;2,9;2;1;1
258100298015;258100298136;121;0,1,3,5;4;2,9;2;1;1
258100298136;258100298164;28;0,1,3,5;4;2,9;2;1;1
258100298164;258100298205;41;0,1,3,5;4;2,9;2;1;1
258100298205;258100298281;76;0,1,3,5,6;5;2,9;2;1;1
258100298281;258100298576;295;0,1,3,5,6;5;2,9;2;1;1
258100298576;258100298903;327;0,1,3,5,6;5;2,9;2;1;1
258100298903;258100299111;208;0,1,3,5;4;2,9;2;1;1
258100299111;258100303771;4660;0,1,3,5;4;2,9;2;1;1
258100303771;258100303814;43;0,1,3,5;4;2,9;2;1;1
258100303814;258100304006;192;0,1,3,5;4;2,9;2;1;1
258100304006;258100304105;99;0,1,3,5;4;2,9;2;1;1
258100304105;258100304456;351;0,1,3,5;4;2,9;2;1;1
258100304456;258100304834;378;0,1,3,5;4;2,9;2;1;1
258100304834;258100308346;3512;0,1,3,5;4;2,9;2;1;1
258100308346;258100308354;8;0,1,3,5;4;2,9;2;1;1
258100308354;258100308407;53;0,1,3,5;4;2,9;2;1;1
258100308407;258100308415;8;0,1,3,5;4;2,9;2;1;1
258100308415;258100308467;52;0,1,3,5;4;2,9;2;1;1
258100308467;258100308520;53;0,1,3,5;4;2,9;2;1;1
258100308520;258100308613;93;0,1,3,5;4;2,9;2;1;1
258100308613;258100310753;2140;0,1,3,5;4;2,9;2;1;1
258100310753;258100319268;8515;0,1,3,5;4;2,9;2;1;1
258100319268;258100323517;4249;0,1,3,5;4;2,9;2;1;1
258100323517;258100323894;377;0,1,3,5;4;2,9;2;1;1
258100323894;258100340794;16900;0,1,3,5;4;2,9;2;1;1
258100340794;258100369766;28972;0,1,3,5;4;2,9;2;1;1
258100369766;258100369874;108;0,1,3,5;4;2,9;2;1;1
258100369874;258100369898;24;0,1,3,5;4;2,9;2;1;1
258100369898;258100370041;143;0,1,3,5;4;2,9;2;1;1
258100370041;258100370255;214;0,1,3,5;4;2,9;2;1;1
258100370255;258100372515;2260;0,1,3,5;4;2,9;2;1;1
258100372515;258100372577;62;0,1,3,5;4;2,9;2;1;1
258100372577;258100375109;2532;0,1,3,5;4;2,9;2;1;1
258100375109;258100375895;786;0,1,3,5;4;2,9;2;1;1
258100375895;258100376065;170;0,1,3,5,6;5;2,9;2;1;1
258100376065;258100376507;442;0,1,3,5;4;2,9;2;1;1
258100376507;258100376521;14;0,1,3,5;4;2,9;2;1;1
258100376521;258100376569;48;0,1,3,5;4;2,9;2;1;1
258100376569;258100376706;137;0,1,3,5;4;2,9;2;1;1
258100376706;258100376872;166;0,1,3,5;4;2,9;2;1;1
258100376872;258100376993;121;0,1,3,5;4;2,9;2;1;1
258100376993;258100377023;30;0,1,3,5;4;2,9;2;1;1
258100377023;258100377368;345;0,1,3,5;4;2,9;2;1;1
258100377368;258100379091;1723;0,1,3,5;4;2,9;2;1;1
258100379091;258100379538;447;0,1,3,5;4;2,9;2;1;1
258100379538;258100379580;42;0,1,3,5;4;2,9;2;1;1
258100379580;258100379955;375;0,1,3,5;4;2,9;2;1;1
258100379955;258100380218;263;0,1,3,5;4;2,9;2;1;1
258100380218;258100380434;216;0,1,3,5;4;2,9;2;1;1
258100380434;258100380462;28;0,1,3,5;4;2,9;2;1;1
258100380462;258100387718;7256;0,1,3,5;4;2,9;2;1;1
258100387718;258100388217;499;0,1,3,5;4;2,9;2;1;1
258100388217;258100388275;58;0,1,3,5;4;2,9;2;1;1
258100388275;258100388469;194;0,1,3,5;4;2,9;2;1;1
258100388469;258100389151;682;0,1,3,5;4;2,9;2;1;1
258100389151;258100393603;4452;0,1,3,5;4;2,9;2;1;1
258100393603;258100393624;21;0,1,3,5;4;2,9;2;1;1
258100393624;258100393638;14;0,1,3,5;4;2,9;2;1;1
258100393638;258100393679;41;0,1,3,5;4;2,9;2;1;1
258100393679;258100393731;52;0,1,3,5;4;2,9;2;1;1
258100393731;258100393781;50;0,1,3,5;4;2,9;2;1;1
258100393781;258100393808;27;0,1,3,5;4;2,9;2;1;1
258100393808;258100402240;8432;0,1,3,5;4;2,9;2;1;1
258100402240;258100402279;39;0,1,3,5;4;2,9;2;1;1
258100402279;258100402337;58;0,1,3,5;4;2,9;2;1;1
258100402337;258100402510;173;0,1,3,5,6;5;2,9;2;1;1
258100402510;258100402555;45;0,1,3,5;4;2,9;2;1;1
258100402555;258100402637;82;0,1,3,5;4;2,9;2;1;1
258100402637;258100402792;155;0,1,3,5;4;2,9;2;1;1
258100402792;258100402825;33;0,1,3,5;4;2,9;2;1;1
258100402825;258100403013;188;0,1,3,5;4;2,9;2;1;1
258100403013;258100403178;165;0,1,3,5;4;2,9;2;1;1
258100403178;258100410909;7731;0,1,3,5;4;2,9;2;1;1
258100410909;258100411866;957;0,1,3,5;4;2,9;2;1;1
258100411866;258100412209;343;0,1,3,5;4;2,9;2;1;1
258100412209;258100412582;373;0,1,3,5;4;2,9;2;1;1
258100412582;258100412642;60;0,1,3,5;4;2,9;2;1;1
258100412642;258100412749;107;0,1,3,5;4;2,9;2;1;1
258100412749;258100413289;540;0,1,3,5;4;2,9;2;1;1
258100413289;258100413485;196;0,1,3,5;4;2,9;2;1;1
258100413485;258100416436;2951;0,1,3,5;4;2,9;2;1;1
258100416436;258100417141;705;0,1,3,5;4;2,9;2;1;1
258100417141;258100421502;4361;0,1,3,5;4;2,9;2;1;1
258100421502;258100421556;54;0,1,3,5;4;2,9;2;1;1
258100421556;258100421719;163;0,1,3,5,6;5;2,9;2;1;1
258100421719;258100421829;110;0,1,3,5;4;2,9;2;1;1
258100421829;258100421835;6;0,1,3,5;4;2,9;2;1;1
258100421835;258100422129;294;0,1,3,5;4;2,9;2;1;1
258100422129;258100422304;175;0,1,3,5;4;2,9;2;1;1
258100422304;258100422549;245;0,1,3,5;4;2,9;2;1;1
258100422549;258100422587;38;0,1,3,5;4;2,9;2;1;1
258100422587;258100422682;95;0,1,3,5;4;2,9;2;1;1
258100422682;258100422752;70;0,1,3,5;4;2,9;2;1;1
258100422752;258100422818;66;0,1,3,5;4;2,9;2;1;1
258100422818;258100422828;10;0,1,3,5;4;2,9;2;1;1
258100422828;258100422996;168;0,1,3,5;4;2,9;2;1;1
258100422996;258100423633;637;0,1,3,5;4;2,9;2;1;1
258100423633;258100430828;7195;0,1,3,5;4;2,9;2;1;1
258100430828;258100430918;90;0,1,3,5;4;2,9;2;1;1
258100430918;258100430945;27;0,1,3,5;4;2,9;2;1;1
258100430945;258100430961;16;0,1,3,5;4;2,9;2;1;1
258100430961;258100430985;24;0,1,3,5,6;5;2,9;2;1;1
258100430985;258100431001;16;0,1,3,5,6;5;2,9;2;1;1
258100431001;258100431113;112;0,1,3,5,6;5;2,9;2;1;1
258100431113;258100431133;20;0,1,3,5,6;5;2,9;2;1;1
258100431133;258100431148;15;0,1,3,5,6;5;2,9;2;1;1
258100431148;258100431284;136;0,1,3,5,6;5;2,9;2;1;1
258100431284;258100438119;6835;0,1,3,5,6;5;2,9;2;1;1
258100438119;258100438430;311;0,1,3,5,6;5;2,9;2;1;1
258100438430;258100441422;2992;0,1,3,5,6;5;2,9;2;1;1
258100441422;258100441787;365;0,1,3,5,6;5;2,9;2;1;1
258100441787;258100454361;12574;0,1,3,5,6;5;2,9;2;1;1
258100454361;258100456656;2295;0,1,3,5;4;2,9;2;1;1
258100456656;258100459473;2817;0,1,3,5;4;2,9;2;1;1
258100459473;258100459948;475;0,1,3,5;4;2,9;2;1;1
258100459948;258100460162;214;0,1,3,5;4;2,9;2;1;1
258100460162;258100460375;213;0,1,3,5;4;2,9;2;1;1
258100460375;258100460685;310;0,1,3,5;4;2,9;2;1;1
258100460685;258100461242;557;0,1,3,5;4;2,9;2;1;1
258100461242;258100461352;110;0,1,3,5;4;2,9;2;1;1
258100461352;258100461584;232;0,1,3,5;4;2,9;2;1;1
258100461584;258100461773;189;0,1,3,5;4;2,9;2;1;1
258100461773;258100462217;444;0,1,3,5;4;2,9;2;1;1
258100462217;258100462779;562;0,1,3,5;4;2,9;2;1;1
258100462779;258100463502;723;0,1,3,5;4;2,9;2;1;1
258100463502;258100471811;8309;0,1,3,5;4;2,9;2;1;1
258100471811;258100473826;2015;0,1,3,5;4;2,9;2;1;1
258100473826;258100474400;574;0,1,3,5;4;2,9;2;1;1
258100474400;258100474526;126;0,1,3,5,6;5;2,9;2;1;1
258100474526;258100474599;73;0,1,3,5,6;5;2,9;2;1;1
258100474599;258100474726;127;0,1,3,5;4;2,9;2;1;1
258100474726;258100475324;598;0,1,3,5;4;2,9;2;1;1
258100475324;258100475720;396;0,1,3,5;4;2,9;2;1;1
258100475720;258100475883;163;0,1,3,5;4;2,9;2;1;1
258100475883;258100475974;91;0,1,3,5;4;2,9;2;1;1
258100475974;258100476152;178;0,1,3,5;4;2,9;2;1;1
258100476152;258100476224;72;0,1,3,5;4;2,9;2;1;1
258100476224;258100491133;14909;0,1,3,5;4;2,9;2;1;1
258100491133;258100506249;15116;0,1,3,5;4;2,9;2;1;1
258100506249;258100506393;144;0,1,3,5;4;2,9;2;1;1
258100506393;258100506430;37;0,1,3,5;4;2,9;2;1;1
258100506430;258100506434;4;0,1,3,5,6;5;2,9;2;1;1
258100506434;258100506562;128;0,1,3,5,6;5;2,9;2;1;1
258100506562;258100506838;276;0,1,3,5;4;2,9;2;1;1
258100506838;258100507081;243;0,1,3,5;4;2,9;2;1;1
258100507081;258100507122;41;0,1,3,5;4;2,9;2;1;1
258100507122;258100507275;153;0,1,3,5;4;2,9;2;1;1
258100507275;258100507443;168;0,1,3,5;4;2,9;2;1;1
258100507443;258100510966;3523;0,1,3,5;4;2,9;2;1;1
258100510966;258100511117;151;0,1,3,5;4;2,9;2;1;1
258100511117;258100511280;163;0,1,3,5;4;2,9;2;1;1
258100511280;258100511481;201;0,1,3,5;4;2,9;2;1;1
258100511481;258100515279;3798;0,1,3,5;4;2,9;2;1;1
258100515279;258100515316;37;0,1,3,5;4;2,9;2;1;1
258100515316;258100515502;186;0,1,3,5;4;2,9;2;1;1
258100515502;258100518175;2673;0,1,3,5;4;2,9;2;1;1
258100518175;258100518374;199;0,1,3,5;4;2,9;2;1;1
258100518374;258100518472;98;0,1,3,5,6;5;2,9;2;1;1
258100518472;258100518535;63;0,1,3,5,6;5;2,9;2;1;1
258100518535;258100518637;102;0,1,3,5,6;5;2,9;2;1;1
258100518637;258100518800;163;0,1,3,5,6;5;2,9;2;1;1
258100518800;258100518846;46;0,1,3,5,6;5;2,9;2;1;1
258100518846;258100518885;39;0,1,3,5;4;2,9;2;1;1
258100518885;258100519026;141;0,1,3,5;4;2,9;2;1;1
258100519026;258100519161;135;0,1,3,5;4;2,9;2;1;1
258100519161;258100520224;1063;0,1,3,5;4;2,9;2;1;1
258100520224;258100520326;102;0,1,3,5;4;2,9;2;1;1
258100520326;258100520373;47;0,1,3,5;4;2,9;2;1;1
258100520373;258100520381;8;0,1,3,5;4;2,9;2;1;1
258100520381;258100520432;51;0,1,3,5;4;2,9;2;1;1
258100520432;258100520443;11;0,1,3,5;4;2,9;2;1;1
258100520443;258100520467;24;0,1,3,5;4;2,9;2;1;1
258100520467;258100520495;28;0,1,3,5;4;2,9;2;1;1
258100520495;258100521291;796;0,1,3,5;4;2,9;2;1;1
258100521291;258100530002;8711;0,1,3,5;4;2,9;2;1;1
258100530002;258100534393;4391;0,1,3,5;4;2,9;2;1;1
258100534393;258100534401;8;0,1,3,5;4;2,9;2;1;1
258100534401;258100534493;92;0,1,3,5;4;2,9;2;1;1
258100534493;258100534687;194;0,1,3,5;4;2,9;2;1;1
258100534687;258100534749;62;0,1,3,5;4;2,9;2;1;1
258100534749;258100534759;10;0,1,3,5;4;2,9;2;1;1
258100534759;258100534812;53;0,1,3,5;4;2,9;2;1;1
258100534812;258100535187;375;0,1,3,5;4;2,9;2;1;1
258100535187;258100535724;537;0,1,3,5;4;2,9;2;1;1
258100535724;258100535855;131;0,1,3,5,6;5;2,9;2;1;1
258100535855;258100535910;55;0,1,3,5,6;5;2,9;2;1;1
258100535910;258100535956;46;0,1,3,5,6;5;2,9;2;1;1
258100535956;258100535982;26;0,1,3,5,6;5;2,9;2;1;1
258100535982;258100536047;65;0,1,3,5;4;2,9;2;1;1
258100536047;258100536121;74;0,1,3,5;4;2,9;2;1;1
258100536121;258100536122;1;0,1,3,5;4;2,9;2;1;1
258100536122;258100536303;181;0,1,3,5;4;2,9;2;1;1
258100536303;258100536337;34;0,1,3,5;4;2,9;2;1;1
258100536337;258100536368;31;0,1,3,5;4;2,9;2;1;1
258100536368;258100539185;2817;0,1,3,5;4;2,9;2;1;1
258100539185;258100539305;120;0,1,3,5;4;2,9;2;1;1
258100539305;258100539332;27;0,1,3,5;4;2,9;2;1;1
258100539332;258100539713;381;0,1,3,5;4;2,9;2;1;1
258100539713;258100539751;38;0,1,3,5;4;2,9;2;1;1
258100539751;258100539770;19;0,1,3,5;4;2,9;2;1;1
258100539770;258100539898;128;0,1,3,5,6;5;2,9;2;1;1
258100539898;258100540046;148;0,1,3,5,6;5;2,9;2;1;1
258100540046;258100540240;194;0,1,3,5,6;5;2,9;2;1;1
258100540240;258100540371;131;0,1,3,5,6;5;2,9;2;1;1
258100540371;258100546457;6086;0,1,3,5;4;2,9;2;1;1
258100546457;258100547084;627;0,1,3,5;4;2,9;2;1;1
258100547084;258100557321;10237;0,1,3,5;4;2,9;2;1;1
258100557321;258100557344;23;0,1,3,5;4;2,9;2;1;1
258100557344;258100561221;3877;0,1,3,5;4;2,9;2;1;1
258100561221;258100564806;3585;0,1,3,5;4;2,9;2;1;1
258100564806;258100571717;6911;0,1,3,5;4;2,9;2;1;1
258100571717;258100571751;34;0,1,3,5;4;2,9;2;1;1
258100571751;258100607304;35553;0,1,3,5;4;2,9;2;1;1
258100607304;258100664229;56925;0,1,3,5;4;2,9;2;1;1
258100664229;258100664833;604;0,1,3,5;4;2,9;2;1;1
258100664833;258100664899;66;0,1,3,5;4;2,9;2;1;1
258100664899;258100672611;7712;0,1,3,5;4;2,9;2;1;1
258100672611;258100673467;856;0,1,3,5;4;2,9;2;1;1
258100673467;258100673621;154;0,1,3,5;4;2,9;2;1;1
258100673621;258100673666;45;0,1,3,5;4;2,9;2;1;1
258100673666;258100673850;184;0,1,3,5;4;2,9;2;1;1
258100673850;258100674025;175;0,1,3,5;4;2,9;2;1;1
258100674025;258100674217;192;0,1,3,5;4;2,9;2;1;1
258100674217;258100674258;41;0,1,3,5;4;2,9;2;1;1
258100674258;258100674389;131;0,1,3,5;4;2,9;2;1;1
258100674389;258100674891;502;0,1,3,5;4;2,9;2;1;1
258100674891;258100684004;9113;0,1,3,5;4;2,9;2;1;1
258100684004;258100684012;8;0,1,3,5;4;2,9;2;1;1
258100684012;258100684064;52;0,1,3,5;4;2,9;2;1;1
258100684064;258100684106;42;0,1,3,5;4;2,9;2;1;1
258100684106;258100684165;59;0,1,3,5;4;2,9;2;1;1
258100684165;258100684192;27;0,1,3,5;4;2,9;2;1;1
258100684192;258100684249;57;0,1,3,5;4;2,9;2;1;1
258100684249;258100684302;53;0,1,3,5;4;2,9;2;1;1
258100684302;258100684669;367;0,1,3,5;4;2,9;2;1;1
258100684669;258100685057;388;0,1,3,5;4;2,9;2;1;1
258100685057;258100706469;21412;0,1,3,5;4;2,9;2;1;1
258100706469;258100709722;3253;0,1,3,5;4;2,9;2;1;1
258100709722;258100709893;171;0,1,3,5,6;5;2,9;2;1;1
258100709893;258100709972;79;0,1,3,5,6;5;2,9;2;1;1
258100709972;258100710109;137;0,1,3,5;4;2,9;2;1;1
258100710109;258100710209;100;0,1,3,5;4;2,9;2;1;1
258100710209;258100710234;25;0,1,3,5;4;2,9;2;1;1
258100710234;258100710239;5;0,1,3,5;4;2,9;2;1;1
258100710239;258100710289;50;0,1,3,5;4;2,9;2;1;1
258100710289;258100710465;176;0,1,3,5;4;2,9;2;1;1
258100710465;258100710503;38;0,1,3,5;4;2,9;2;1;1
258100710503;258100712965;2462;0,1,3,5;4;2,9;2;1;1
258100712965;258100714174;1209;0,1,3,5;4;2,9;2;1;1
258100714174;258100721519;7345;0,1,3,5;4;2,9;2;1;1
258100721519;258100722225;706;0,1,3,5;4;2,9;2;1;1
258100722225;258100726366;4141;0,1,3,5;4;2,9;2;1;1
258100726366;258100726416;50;0,1,3,5;4;2,9;2;1;1
258100726416;258100753914;27498;0,1,3,5;4;2,9;2;1;1
258100753914;258100753959;45;0,1,3,5;4;2,9;2;1;1
258100753959;258100762610;8651;0,1,3,5;4;2,9;2;1;1
258100762610;258100763164;554;0,1,3,5;4;2,9;2;1;1
258100763164;258100763325;161;0,1,3,5,6;5;2,9;2;1;1
258100763325;258100763532;207;0,1,3,5;4;2,9;2;1;1
258100763532;258100763711;179;0,1,3,5;4;2,9;2;1;1
258100763711;258100763870;159;0,1,3,5;4;2,9;2;1;1
258100763870;258100763941;71;0,1,3,5;4;2,9;2;1;1
258100763941;258100764587;646;0,1,3,5;4;2,9;2;1;1
258100764587;258100764694;107;0,1,3,5;4;2,9;2;1;1
258100764694;258100764816;122;0,1,3,5;4;2,9;2;1;1
258100764816;258100764992;176;0,1,3,5;4;2,9;2;1;1
258100764992;258100765329;337;0,1,3,5;4;2,9;2;1;1
258100765329;258100768947;3618;0,1,3,5;4;2,9;2;1;1
258100768947;258100769119;172;0,1,3,5;4;2,9;2;1;1
258100769119;258100769146;27;0,1,3,5;4;2,9;2;1;1
258100769146;258100769414;268;0,1,3,5;4;2,9;2;1;1
258100769414;258100769465;51;0,1,3,5;4;2,9;2;1;1
258100769465;258100773778;4313;0,1,3,5;4;2,9;2;1;1
258100773778;258100774200;422;0,1,3,5;4;2,9;2;1;1
258100774200;258100774412;212;0,1,3,5,6;5;2,9;2;1;1
258100774412;258100774523;111;0,1,3,5;4;2,9;2;1;1
258100774523;258100774853;330;0,1,3,5;4;2,9;2;1;1
258100774853;258100775029;176;0,1,3,5;4;2,9;2;1;1
258100775029;258100775049;20;0,1,3,5;4;2,9;2;1;1
258100775049;258100775116;67;0,1,3,5;4;2,9;2;1;1
258100775116;258100775217;101;0,1,3,5;4;2,9;2;1;1
258100775217;258100775388;171;0,1,3,5;4;2,9;2;1;1
258100775388;258100775606;218;0,1,3,5;4;2,9;2;1;1
258100775606;258100775778;172;0,1,3,5;4;2,9;2;1;1
258100775778;258100783565;7787;0,1,3,5;4;2,9;2;1;1
258100783565;258100785767;2202;0,1,3,5;4;2,9;2;1;1
258100785767;258100785789;22;0,1,3,5;4;2,9;2;1;1
258100785789;258100786005;216;0,1,3,5;4;2,9;2;1;1
258100786005;258100787140;1135;0,1,3,5;4;2,9;2;1;1
258100787140;258100787194;54;0,1,3,5;4;2,9;2;1;1
258100787194;258100787203;9;0,1,3,5,6;5;2,9;2;1;1
258100787203;258100787234;31;0,1,3,5,6;5;2,9;2;1;1
258100787234;258100787278;44;0,1,3,5,6;5;2,9;2;1;1
258100787278;258100787344;66;0,1,3,5,6;5;2,9;2;1;1
258100787344;258100787404;60;0,1,3,5,6;5;2,9;2;1;1
258100787404;258100787530;126;0,1,3,5,6;5;2,9;2;1;1
258100787530;258100787607;77;0,1,3,5,6;5;2,9;2;1;1
258100787607;258100787820;213;0,1,3,5;4;2,9;2;1;1
258100787820;258100798780;10960;0,1,3,5;4;2,9;2;1;1
258100798780;258100807612;8832;0,1,3,5;4;2,9;2;1;1
258100807612;258100807677;65;0,1,3,5;4;2,9;2;1;1
258100807677;258100808273;596;0,1,3,5;4;2,9;2;1;1
258100808273;258100812464;4191;0,1,3,5;4;2,9;2;1;1
258100812464;258100812488;24;0,1,3,5,6;5;2,9;2;1;1
258100812488;258100812567;79;0,1,3,5,6;5;2,9;2;1;1
258100812567;258100812576;9;0,1,3,5,6;5;2,9;2;1;1
258100812576;258100812676;100;0,1,3,5,6;5;2,9;2;1;1
258100812676;258100812705;29;0,1,3,5,6;5;2,9;2;1;1
258100812705;258100812715;10;0,1,3,5,6;5;2,9;2;1;1
258100812715;258100812773;58;0,1,3,5,6;5;2,9;2;1;1
258100812773;258100812921;148;0,1,3,5,6;5;2,9;2;1;1
258100812921;258100812951;30;0,1,3,5;4;2,9;2;1;1
258100812951;258100825055;12104;0,1,3,5;4;2,9;2;1;1
258100825055;258100847237;22182;0,1,3,5;4;2,9;2;1;1
258100847237;258100849261;2024;0,1,3,5;4;2,9;2;1;1
258100849261;258100850175;914;0,1,3,5;4;2,9;2;1;1
258100850175;258100850182;7;0,1,3,5,6;5;2,9;2;1;1
258100850182;258100850313;131;0,1,3,5,6;5;2,9;2;1;1
258100850313;258100850315;2;0,1,3,5,6;5;2,9;2;1;1
258100850315;258100850350;35;0,1,3,5,6;5;2,9;2;1;1
258100850350;258100850422;72;0,1,3,5,6;5;2,9;2;1;1
258100850422;258100850448;26;0,1,3,5,6;5;2,9;2;1;1
258100850448;258100850563;115;0,1,3,5;4;2,9;2;1;1
258100850563;258100850603;40;0,1,3,5;4;2,9;2;1;1
258100850603;258100850635;32;0,1,3,5;4;2,9;2;1;1
258100850635;258100859973;9338;0,1,3,5;4;2,9;2;1;1
258100859973;258100859981;8;0,1,3,5;4;2,9;2;1;1
258100859981;258100860040;59;0,1,3,5;4;2,9;2;1;1
258100860040;258100860095;55;0,1,3,5;4;2,9;2;1;1
258100860095;258100860131;36;0,1,3,5;4;2,9;2;1;1
258100860131;258100860617;486;0,1,3,5;4;2,9;2;1;1
258100860617;258100860950;333;0,1,3,5;4;2,9;2;1;1
258100860950;258100870845;9895;0,1,3,5;4;2,9;2;1;1
258100870845;258100870898;53;0,1,3,5;4;2,9;2;1;1
258100870898;258100920531;49633;0,1,3,5;4;2,9;2;1;1
258100920531;258100955791;35260;0,1,3,5;4;2,9;2;1;1
258100955791;258100960096;4305;0,1,3,5;4;2,9;2;1;1
258100960096;258100960148;52;0,1,3,5;4;2,9;2;1;1
258100960148;258100960174;26;0,1,3,5;4;2,9;2;1;1
258100960174;258100960233;59;0,1,3,5;4;2,9;2;1;1
258100960233;258100960284;51;0,1,3,5;4;2,9;2;1;1
258100960284;258100961209;925;0,1,3,5;4;2,9;2;1;1
258100961209;258100961247;38;0,1,3,5;4;2,9;2;1;1
258100961247;258100973669;12422;0,1,3,5;4;2,9;2;1;1
258100973669;258100973753;84;0,1,3,5;4;2,9;2;1;1
258100973753;258100973961;208;0,1,3,5;4;2,9;2;1;1
258100973961;258101019443;45482;0,1,3,5;4;2,9;2;1;1
258101019443;258101032497;13054;0,1,3,5;4;2,9;2;1;1
258101032497;258101033024;527;0,1,3,5;4;2,9;2;1;1
258101033024;258101033066;42;0,1,3,5;4;2,9;2;1;1
258101033066;258101054806;21740;0,1,3,5;4;2,9;2;1;1
258101054806;258101062952;8146;0,1,3,5;4;2,9;2;1;1
258101062952;258101066297;3345;0,1,3,5;4;2,9;2;1;1
258101066297;258101066852;555;0,1,3,5;4;2,9;2;1;1
258101066852;258101070500;3648;0,1,3,5;4;2,9;2;1;1
258101070500;258101070599;99;0,1,3,5,6;5;2,9;2;1;1
258101070599;258101070758;159;0,1,3,5,6;5;2,9;2;1;1
258101070758;258101070778;20;0,1,3,5,6;5;2,9;2;1;1
258101070778;258101070888;110;0,1,3,5,6;5;2,9;2;1;1
258101070888;258101071014;126;0,1,3,5,6;5;2,9;2;1;1
258101071014;258101071075;61;0,1,3,5,6;5;2,9;2;1;1
258101071075;258101071176;101;0,1,3,5,6;5;2,9;2;1;1
258101071176;258101071178;2;0,1,3,5,6;5;2,9;2;1;1
258101071178;258101071312;134;0,1,3,5,6;5;2,9;2;1;1
258101071312;258101071376;64;0,1,3,5;4;2,9;2;1;1
258101071376;258101071939;563;0,1,3,5;4;2,9;2;1;1
258101071939;258101072163;224;0,1,3,5;4;2,9;2;1;1
258101072163;258101072503;340;0,1,3,5;4;2,9;2;1;1
258101072503;258101073234;731;0,1,3,5;4;2,9;2;1;1
258101073234;258101073305;71;0,1,3,5;4;2,9;2;1;1
258101073305;258101076223;2918;0,1,3,5;4;2,9;2;1;1
258101076223;258101076392;169;0,1,3,5;4;2,9;2;1;1
258101076392;258101076477;85;0,1,3,5;4;2,9;2;1;1
258101076477;258101076513;36;0,1,3,5;4;2,9;2;1;1
258101076513;258101076874;361;0,1,3,5;4;2,9;2;1;1
258101076874;258101077069;195;0,1,3,5;4;2,9;2;1;1
258101077069;258101077210;141;0,1,3,5;4;2,9;2;1;1
258101077210;258101077760;550;0,1,3,5;4;2,9;2;1;1
258101077760;258101079799;2039;0,1,3,5;4;2,9;2;1;1
258101079799;258101079843;44;0,1,3,5;4;2,9;2;1;1
258101079843;258101079898;55;0,1,3,5;4;2,9;2;1;1
258101079898;258101079943;45;0,1,3,5,6;5;2,9;2;1;1
258101079943;258101080004;61;0,1,3,5,6;5;2,9;2;1;1
258101080004;258101080081;77;0,1,3,5,6;5;2,9;2;1;1
258101080081;258101080104;23;0,1,3,5,6;5;2,9;2;1;1
258101080104;258101080135;31;0,1,3,5,6;5;2,9;2;1;1
258101080135;258101080164;29;0,1,3,5;4;2,9;2;1;1
258101080164;258101080336;172;0,1,3,5;4;2,9;2;1;1
258101080336;258101080347;11;0,1,3,5;4;2,9;2;1;1
258101080347;258101080534;187;0,1,3,5;4;2,9;2;1;1
258101080534;258101080710;176;0,1,3,5;4;2,9;2;1;1
258101080710;258101080914;204;0,1,3,5;4;2,9;2;1;1
258101080914;258101081077;163;0,1,3,5;4;2,9;2;1;1
258101081077;258101081256;179;0,1,3,5;4;2,9;2;1;1
258101081256;258101081304;48;0,1,3,5;4;2,9;2;1;1
258101081304;258101081560;256;0,1,3,5;4;2,9;2;1;1
258101081560;258101081704;144;0,1,3,5;4;2,9;2;1;1
258101081704;258101087518;5814;0,1,3,5;4;2,9;2;1;1
258101087518;258101092321;4803;0,1,3,5;4;2,9;2;1;1
258101092321;258101096907;4586;0,1,3,5;4;2,9;2;1;1
258101096907;258101096933;26;0,1,3,5;4;2,9;2;1;1
258101096933;258101097037;104;0,1,3,5;4;2,9;2;1;1
258101097037;258101097405;368;0,1,3,5;4;2,9;2;1;1
258101097405;258101097764;359;0,1,3,5;4;2,9;2;1;1
258101097764;258101101045;3281;0,1,3,5;4;2,9;2;1;1
258101101045;258101101190;145;0,1,3,5;4;2,9;2;1;1
258101101190;258101101302;112;0,1,3,5;4;2,9;2;1;1
258101101302;258101101337;35;0,1,3,5;4;2,9;2;1;1
258101101337;258101101451;114;0,1,3,5;4;2,9;2;1;1
258101101451;258101101606;155;0,1,3,5;4;2,9;2;1;1
258101101606;258101101632;26;0,1,3,5;4;2,9;2;1;1
258101101632;258101101671;39;0,1,3,5;4;2,9;2;1;1
258101101671;258101101834;163;0,1,3,5,6;5;2,9;2;1;1
258101101834;258101101950;116;0,1,3,5,6;5;2,9;2;1;1
258101101950;258101108861;6911;0,1,3,5;4;2,9;2;1;1
258101108861;258101109098;237;0,1,3,5;4;2,9;2;1;1
258101109098;258101110394;1296;0,1,3,5;4;2,9;2;1;1
258101110394;258101122552;12158;0,1,3,5;4;2,9;2;1;1
258101122552;258101128200;5648;0,1,3,5;4;2,9;2;1;1
258101128200;258101129335;1135;0,1,3,5;4;2,9;2;1;1
258101129335;258101131009;1674;0,1,3,5;4;2,9;2;1;1
258101131009;258101131533;524;0,1,3,5;4;2,9;2;1;1
258101131533;258101131999;466;0,1,3,5;4;2,9;2;1;1
258101131999;258101133365;1366;0,1,3,5;4;2,9;2;1;1
258101133365;258101133741;376;0,1,3,5;4;2,9;2;1;1
258101133741;258101133918;177;0,1,3,5;4;2,9;2;1;1
258101133918;258101134071;153;0,1,3,5,6;5;2,9;2;1;1
258101134071;258101134220;149;0,1,3,5,6;5;2,9;2;1;1
258101134220;258101134356;136;0,1,3,5,6;5;2,9;2;1;1
258101134356;258101134494;138;0,1,3,5,6;5;2,9;2;1;1
258101134494;258101134632;138;0,1,3,5,6;5;2,9;2;1;1
258101134632;258101134766;134;0,1,3,5,6;5;2,9;2;1;1
258101134766;258101134899;133;0,1,3,5,6;5;2,9;2;1;1
258101134899;258101141515;6616;0,1,3,5;4;2,9;2;1;1
258101141515;258101141596;81;0,1,3,5;4;2,9;2;1;1
258101141596;258101143062;1466;0,1,3,5;4;2,9;2;1;1
258101143062;258101152165;9103;0,1,3,5;4;2,9;2;1;1
258101152165;258101152557;392;0,1,3,5;4;2,9;2;1;1
258101152557;258101155352;2795;0,1,3,5;4;2,9;2;1;1
258101155352;258101156594;1242;0,1,3,5,6;5;2,9;2;1;1
258101156594;258101156700;106;0,1,3,5,6;5;2,9;2;1;1
258101156700;258101156738;38;0,1,3,5,6;5;2,9;2;1;1
258101156738;258101157263;525;0,1,3,5,6;5;2,9;2;1;1
258101157263;258101157432;169;0,1,3,5,6;5;2,9;2;1;1
258101157432;258101157476;44;0,1,3,5,6;5;2,9;2;1;1
258101157476;258101157519;43;0,1,3,5,6;5;2,9;2;1;1
258101157519;258101157563;44;0,1,3,5,6;5;2,9;2;1;1
258101157563;258101173804;16241;0,1,3,5,6;5;2,9;2;1;1
258101173804;258101173855;51;0,1,3,5,6;5;2,9;2;1;1
258101173855;258101173995;140;0,1,3,5,6;5;2,9;2;1;1
258101173995;258101177418;3423;0,1,3,5,6;5;2,9;2;1;1
258101177418;258101177601;183;0,1,3,5,6;5;2,9;2;1;1
258101177601;258101177614;13;0,1,3,5,6;5;2,9;2;1;1
258101177614;258101177644;30;0,1,3,5,6;5;2,9;2;1;1
258101177644;258101177649;5;0,1,3,5,6;5;2,9;2;1;1
258101177649;258101177718;69;0,1,3,5,6;5;2,9;2;1;1
258101177718;258101177752;34;0,1,3,5,6;5;2,9;2;1;1
258101177752;258101177845;93;0,1,3,5,6;5;2,9;2;1;1
258101177845;258101177994;149;0,1,3,5,6;5;2,9;2;1;1
258101177994;258101178141;147;0,1,3,5,6;5;2,9;2;1;1
258101178141;258101178320;179;0,1,3,5,6;5;2,9;2;1;1
258101178320;258101182458;4138;0,1,3,5;4;2,9;2;1;1
258101182458;258101184842;2384;0,1,3,5;4;2,9;2;1;1
258101184842;258101188411;3569;0,1,3,5;4;2,9;2;1;1
258101188411;258101190708;2297;0,1,3,5;4;2,9;2;1;1
258101190708;258101201611;10903;0,1,3,5;4;2,9;2;1;1
258101201611;258101201839;228;0,1,3,5;4;2,9;2;1;1
258101201839;258101202085;246;0,1,3,5;4;2,9;2;1;1
258101202085;258101210535;8450;0,1,3,5;4;2,9;2;1;1
258101210535;258101210849;314;0,1,3,5;4;2,9;2;1;1
258101210849;258101221004;10155;0,1,3,5;4;2,9;2;1;1
258101221004;258101221152;148;0,1,3,5;4;2,9;2;1;1
258101221152;258101241261;20109;0,1,3,5;4;2,9;2;1;1
258101241261;258101241272;11;0,1,3,5;4;2,9;2;1;1
258101241272;258101241608;336;0,1,3,5;4;2,9;2;1;1
258101241608;258101241648;40;0,1,3,5;4;2,9;2;1;1
258101241648;258101241743;95;0,1,3,5;4;2,9;2;1;1
258101241743;258101241785;42;0,1,3,5;4;2,9;2;1;1
258101241785;258101241926;141;0,1,3,5;4;2,9;2;1;1
258101241926;258101242076;150;0,1,3,5;4;2,9;2;1;1
258101242076;258101242113;37;0,1,3,5;4;2,9;2;1;1
258101242113;258101260003;17890;0,1,3,5,6;5;2,9;2;1;1
258101260003;258101260671;668;0,1,3,5,6;5;2,9;2;1;1
258101260671;258101261145;474;0,1,3,5;4;2,9;2;1;1
258101261145;258101262028;883;0,1,3,5;4;2,9;2;1;1
258101262028;258101262114;86;0,1,3,5;4;2,9;2;1;1
258101262114;258101265315;3201;0,1,3,5;4;2,9;2;1;1
258101265315;258101265595;280;0,1,3,5;4;2,9;2;1;1
258101265595;258101265801;206;0,1,3,5;4;2,9;2;1;1
258101265801;258101265884;83;0,1,3,5,6;5;2,9;2;1;1
258101265884;258101266058;174;0,1,3,5,6;5;2,9;2;1;1
258101266058;258101266315;257;0,1,3,5,6;5;2,9;2;1;1
258101266315;258101266349;34;0,1,3,5,6;5;2,9;2;1;1
258101266349;258101266442;93;0,1,3,5,6;5;2,9;2;1;1
258101266442;258101266496;54;0,1,3,5;4;2,9;2;1;1
258101266496;258101266658;162;0,1,3,5;4;2,9;2;1;1
258101266658;258101269616;2958;0,1,3,5;4;2,9;2;1;1
258101269616;258101269881;265;0,1,3,5;4;2,9;2;1;1
258101269881;258101270247;366;0,1,3,5;4;2,9;2;1;1
258101270247;258101270272;25;0,1,3,5;4;2,9;2;1;1
258101270272;258101270356;84;0,1,3,5;4;2,9;2;1;1
258101270356;258101270400;44;0,1,3,5;4;2,9;2;1;1
258101270400;258101270465;65;0,1,3,5;4;2,9;2;1;1
258101270465;258101270603;138;0,1,3,5;4;2,9;2;1;1
258101270603;258101270679;76;0,1,3,5;4;2,9;2;1;1
258101270679;258101270704;25;0,1,3,5;4;2,9;2;1;1
258101270704;258101270744;40;0,1,3,5;4;2,9;2;1;1
258101270744;258101270921;177;0,1,3,5,6;5;2,9;2;1;1
258101270921;258101279359;8438;0,1,3,5;4;2,9;2;1;1
258101279359;258101279385;26;0,1,3,5;4;2,9;2;1;1
258101279385;258101279449;64;0,1,3,5;4;2,9;2;1;1
258101279449;258101279475;26;0,1,3,5;4;2,9;2;1;1
258101279475;258101279687;212;0,1,3,5;4;2,9;2;1;1
258101279687;258101286544;6857;0,1,3,5;4;2,9;2;1;1
258101286544;258101287554;1010;0,1,3,5;4;2,9;2;1;1
258101287554;258101287582;28;0,1,3,5;4;2,9;2;1;1
258101287582;258101287631;49;0,1,3,5;4;2,9;2;1;1
258101287631;258101287632;1;0,1,3,5;4;2,9;2;1;1
258101287632;258101287642;10;0,1,3,5;4;2,9;2;1;1
258101287642;258101287666;24;0,1,3,5;4;2,9;2;1;1
258101287666;258101287736;70;0,1,3,5;4;2,9;2;1;1
258101287736;258101288505;769;0,1,3,5;4;2,9;2;1;1
258101288505;258101289204;699;0,1,3,5;4;2,9;2;1;1
258101289204;258101291659;2455;0,1,3,5;4;2,9;2;1;1
258101291659;258101292151;492;0,1,3,5;4;2,9;2;1;1
258101292151;258101292441;290;0,1,3,5;4;2,9;2;1;1
258101292441;258101292447;6;0,1,3,5,6;5;2,9;2;1;1
258101292447;258101292536;89;0,1,3,5,6;5;2,9;2;1;1
258101292536;258101292625;89;0,1,3,5,6;5;2,9;2;1;1
258101292625;258101292636;11;0,1,3,5,6;5;2,9;2;1;1
258101292636;258101292750;114;0,1,3,5;4;2,9;2;1;1
258101292750;258101292976;226;0,1,3,5;4;2,9;2;1;1
258101292976;258101292993;17;0,1,3,5;4;2,9;2;1;1
258101292993;258101294254;1261;0,1,3,5;4;2,9;2;1;1
258101294254;258101294415;161;0,1,3,5;4;2,9;2;1;1
258101294415;258101294582;167;0,1,3,5;4;2,9;2;1;1
258101294582;258101294766;184;0,1,3,5;4;2,9;2;1;1
258101294766;258101294908;142;0,1,3,5;4;2,9;2;1;1
258101294908;258101294950;42;0,1,3,5;4;2,9;2;1;1
258101294950;258101296667;1717;0,1,3,5;4;2,9;2;1;1
258101296667;258101296729;62;0,1,3,5,6;5;2,9;2;1;1
258101296729;258101296814;85;0,1,3,5,6;5;2,9;2;1;1
258101296814;258101296957;143;0,1,3,5;4;2,9;2;1;1
258101296957;258101297349;392;0,1,3,5;4;2,9;2;1;1
258101297349;258101297581;232;0,1,3,5;4;2,9;2;1;1
258101297581;258101297586;5;0,1,3,5;4;2,9;2;1;1
258101297586;258101297749;163;0,1,3,5;4;2,9;2;1;1
258101297749;258101297926;177;0,1,3,5;4;2,9;2;1;1
258101297926;258101297962;36;0,1,3,5;4;2,9;2;1;1
258101297962;258101298140;178;0,1,3,5;4;2,9;2;1;1
258101298140;258101299412;1272;0,1,3,5;4;2,9;2;1;1
258101299412;258101299728;316;0,1,3,5;4;2,9;2;1;1
258101299728;258101302968;3240;0,1,3,5;4;2,9;2;1;1
258101302968;258101303076;108;0,1,3,5;4;2,9;2;1;1
258101303076;258101303391;315;0,1,3,5;4;2,9;2;1;1
258101303391;258101303580;189;0,1,3,5;4;2,9;2;1;1
258101303580;258101307003;3423;0,1,3,5;4;2,9;2;1;1
258101307003;258101309454;2451;0,1,3,5;4;2,9;2;1;1
258101309454;258101339571;30117;0,1,3,5;4;2,9;2;1;1
258101339571;258101342582;3011;0,1,3,5;4;2,9;2;1;1
258101342582;258101342608;26;0,1,3,5;4;2,9;2;1;1
258101342608;258101349124;6516;0,1,3,5;4;2,9;2;1;1
258101349124;258101349692;568;0,1,3,5;4;2,9;2;1;1
258101349692;258101350144;452;0,1,3,5;4;2,9;2;1;1
258101350144;258101350336;192;0,1,3,5;4;2,9;2;1;1
258101350336;258101350534;198;0,1,3,5;4;2,9;2;1;1
258101350534;258101350670;136;0,1,3,5;4;2,9;2;1;1
258101350670;258101350804;134;0,1,3,5;4;2,9;2;1;1
258101350804;258101350942;138;0,1,3,5;4;2,9;2;1;1
258101350942;258101350979;37;0,1,3,5;4;2,9;2;1;1
258101350979;258101351120;141;0,1,3,5,6;5;2,9;2;1;1
258101351120;258101352464;1344;0,1,3,5;4;2,9;2;1;1
258101352464;258101352578;114;0,1,3,5;4;2,9;2;1;1
258101352578;258101352812;234;0,1,3,5;4;2,9;2;1;1
258101352812;258101384900;32088;0,1,3,5;4;2,9;2;1;1
258101384900;258101388401;3501;0,1,3,5;4;2,9;2;1;1
258101388401;258101388419;18;0,1,3,5;4;2,9;2;1;1
258101388419;258101388462;43;0,1,3,5;4;2,9;2;1;1
258101388462;258101388645;183;0,1,3,5;4;2,9;2;1;1
258101388645;258101388927;282;0,1,3,5;4;2,9;2;1;1
258101388927;258101389213;286;0,1,3,5;4;2,9;2;1;1
258101389213;258101427940;38727;0,1,3,5;4;2,9;2;1;1
258101427940;258101434221;6281;0,1,3,5;4;2,9;2;1;1
258101434221;258101434256;35;0,1,3,5;4;2,9;2;1;1
258101434256;258101434324;68;0,1,3,5;4;2,9;2;1;1
258101434324;258101434384;60;0,1,3,5,6;5;2,9;2;1;1
258101434384;258101434549;165;0,1,3,5,6;5;2,9;2;1;1
258101434549;258101434569;20;0,1,3,5,6;5;2,9;2;1;1
258101434569;258101434604;35;0,1,3,5,6;5;2,9;2;1;1
258101434604;258101434753;149;0,1,3,5,6;5;2,9;2;1;1
258101434753;258101434790;37;0,1,3,5,6;5;2,9;2;1;1
258101434790;258101434884;94;0,1,3,5;4;2,9;2;1;1
258101434884;258101445252;10368;0,1,3,5;4;2,9;2;1;1
258101445252;258101459911;14659;0,1,3,5;4;2,9;2;1;1
258101459911;258101459981;70;0,1,3,5;4;2,9;2;1;1
258101459981;258101460008;27;0,1,3,5;4;2,9;2;1;1
258101460008;258101462957;2949;0,1,3,5;4;2,9;2;1;1
258101462957;258101463312;355;0,1,3,5;4;2,9;2;1;1
258101463312;258101463424;112;0,1,3,5,6;5;2,9;2;1;1
258101463424;258101463452;28;0,1,3,5,6;5;2,9;2;1;1
258101463452;258101463460;8;0,1,3,5,6;5;2,9;2;1;1
258101463460;258101463583;123;0,1,3,5,6;5;2,9;2;1;1
258101463583;258101463637;54;0,1,3,5,6;5;2,9;2;1;1
258101463637;258101463676;39;0,1,3,5,6;5;2,9;2;1;1
258101463676;258101463808;132;0,1,3,5;4;2,9;2;1;1
258101463808;258101471384;7576;0,1,3,5;4;2,9;2;1;1
258101471384;258101473666;2282;0,1,3,5;4;2,9;2;1;1
258101473666;258101473795;129;0,1,3,5;4;2,9;2;1;1
258101473795;258101476555;2760;0,1,3,5;4;2,9;2;1;1
258101476555;258101476758;203;0,1,3,5;4;2,9;2;1;1
258101476758;258101477041;283;0,1,3,5;4;2,9;2;1;1
258101477041;258101477322;281;0,1,3,5;4;2,9;2;1;1
258101477322;258101477368;46;0,1,3,5;4;2,9;2;1;1
258101477368;258101482573;5205;0,1,3,5;4;2,9;2;1;1
258101482573;258101504310;21737;0,1,3,5;4;2,9;2;1;1
258101504310;258101519850;15540;0,1,3,5;4;2,9;2;1;1
258101519850;258101530979;11129;0,1,3,5;4;2,9;2;1;1
258101530979;258101530987;8;0,1,3,5;4;2,9;2;1;1
258101530987;258101531037;50;0,1,3,5;4;2,9;2;1;1
258101531037;258101531087;50;0,1,3,5;4;2,9;2;1;1
258101531087;258101531114;27;0,1,3,5;4;2,9;2;1;1
258101531114;258101531168;54;0,1,3,5;4;2,9;2;1;1
258101531168;258101532105;937;0,1,3,5;4;2,9;2;1;1
258101532105;258101556992;24887;0,1,3,5;4;2,9;2;1;1
258101556992;258101597566;40574;0,1,3,5;4;2,9;2;1;1
258101597566;258101600706;3140;0,1,3,5;4;2,9;2;1;1
258101600706;258101600759;53;0,1,3,5;4;2,9;2;1;1
258101600759;258101600793;34;0,1,3,5;4;2,9;2;1;1
258101600793;258101604600;3807;0,1,3,5;4;2,9;2;1;1
258101604600;258101604794;194;0,1,3,5,6;5;2,9;2;1;1
258101604794;258101604862;68;0,1,3,5;4;2,9;2;1;1
258101604862;258101604940;78;0,1,3,5;4;2,9;2;1;1
258101604940;258101605035;95;0,1,3,5;4;2,9;2;1;1
258101605035;258101605108;73;0,1,3,5;4;2,9;2;1;1
258101605108;258101605202;94;0,1,3,5;4;2,9;2;1;1
258101605202;258101605356;154;0,1,3,5;4;2,9;2;1;1
258101605356;258101605450;94;0,1,3,5;4;2,9;2;1;1
258101605450;258101605595;145;0,1,3,5;4;2,9;2;1;1
258101605595;258101616550;10955;0,1,3,5;4;2,9;2;1;1
258101616550;258101655704;39154;0,1,3,5;4;2,9;2;1;1
258101655704;258101656629;925;0,1,3,5;4;2,9;2;1;1
258101656629;258101656659;30;0,1,3,5;4;2,9;2;1;1
258101656659;258101657338;679;0,1,3,5;4;2,9;2;1;1
258101657338;258101657383;45;0,1,3,5;4;2,9;2;1;1
258101657383;258101657436;53;0,1,3,5;4;2,9;2;1;1
258101657436;258101658724;1288;0,1,3,5;4;2,9;2;1;1
258101658724;258101661995;3271;0,1,3,5;4;2,9;2;1;1
258101661995;258101662024;29;0,1,3,5;4;2,9;2;1;1
258101662024;258101662048;24;0,1,3,5;4;2,9;2;1;1
258101662048;258101662147;99;0,1,3,5,6;5;2,9;2;1;1
258101662147;258101662198;51;0,1,3,5,6;5;2,9;2;1;1
258101662198;258101662358;160;0,1,3,5,6;5;2,9;2;1;1
258101662358;258101662362;4;0,1,3,5,6;5;2,9;2;1;1
258101662362;258101662447;85;0,1,3,5,6;5;2,9;2;1;1
258101662447;258101662480;33;0,1,3,5;4;2,9;2;1;1
258101662480;258101662666;186;0,1,3,5;4;2,9;2;1;1
258101662666;258101669881;7215;0,1,3,5;4;2,9;2;1;1
258101669881;258101670625;744;0,1,3,5;4;2,9;2;1;1
258101670625;258101675120;4495;0,1,3,5;4;2,9;2;1;1
258101675120;258101675245;125;0,1,3,5;4;2,9;2;1;1
258101675245;258101675397;152;0,1,3,5;4;2,9;2;1;1
258101675397;258101677768;2371;0,1,3,5;4;2,9;2;1;1
258101677768;258101680098;2330;0,1,3,5;4;2,9;2;1;1
258101680098;258101680211;113;0,1,3,5,6;5;2,9;2;1;1
258101680211;258101680236;25;0,1,3,5,6;5;2,9;2;1;1
258101680236;258101680254;18;0,1,3,5,6;5;2,9;2;1;1
258101680254;258101680291;37;0,1,3,5,6;5;2,9;2;1;1
258101680291;258101680302;11;0,1,3,5,6;5;2,9;2;1;1
258101680302;258101680422;120;0,1,3,5,6;5;2,9;2;1;1
258101680422;258101680437;15;0,1,3,5,6;5;2,9;2;1;1
258101680437;258101680837;400;0,1,3,5;4;2,9;2;1;1
258101680837;258101680983;146;0,1,3,5;4;2,9;2;1;1
258101680983;258101682840;1857;0,1,3,5;4;2,9;2;1;1
258101682840;258101682993;153;0,1,3,5;4;2,9;2;1;1
258101682993;258101683106;113;0,1,3,5;4;2,9;2;1;1
258101683106;258101683366;260;0,1,3,5;4;2,9;2;1;1
258101683366;258101683498;132;0,1,3,5;4;2,9;2;1;1
258101683498;258101683958;460;0,1,3,5;4;2,9;2;1;1
258101683958;258101686844;2886;0,1,3,5;4;2,9;2;1;1
258101686844;258101689754;2910;0,1,3,5;4;2,9;2;1;1
258101689754;258101689827;73;0,1,3,5;4;2,9;2;1;1
258101689827;258101689863;36;0,1,3,5;4;2,9;2;1;1
258101689863;258101689993;130;0,1,3,5;4;2,9;2;1;1
258101689993;258101690331;338;0,1,3,5;4;2,9;2;1;1
258101690331;258101691047;716;0,1,3,5;4;2,9;2;1;1
258101691047;258101725584;34537;0,1,3,5;4;2,9;2;1;1
258101725584;258101731821;6237;0,1,3,5;4;2,9;2;1;1
258101731821;258101731866;45;0,1,3,5;4;2,9;2;1;1
258101731866;258101731909;43;0,1,3,5;4;2,9;2;1;1
258101731909;258101731971;62;0,1,3,5;4;2,9;2;1;1
258101731971;258101732093;122;0,1,3,5;4;2,9;2;1;1
258101732093;258101732243;150;0,1,3,5;4;2,9;2;1;1
258101732243;258101732341;98;0,1,3,5;4;2,9;2;1;1
258101732341;258101732555;214;0,1,3,5;4;2,9;2;1;1
258101732555;258101732716;161;0,1,3,5;4;2,9;2;1;1
258101732716;258101751723;19007;0,1,3,5;4;2,9;2;1;1
258101751723;258101754922;3199;0,1,3,5;4;2,9;2;1;1
258101754922;258101754974;52;0,1,3,5;4;2,9;2;1;1
258101754974;258101755024;50;0,1,3,5;4;2,9;2;1;1
258101755024;258101755075;51;0,1,3,5;4;2,9;2;1;1
258101755075;258101755126;51;0,1,3,5;4;2,9;2;1;1
258101755126;258101765190;10064;0,1,3,5;4;2,9;2;1;1
258101765190;258101765241;51;0,1,3,5;4;2,9;2;1;1
258101765241;258101765398;157;0,1,3,5;4;2,9;2;1;1
258101765398;258101765600;202;0,1,3,5,6;5;2,9;2;1;1
258101765600;258101765608;8;0,1,3,5,6;5;2,9;2;1;1
258101765608;258101765614;6;0,1,3,5,6;5;2,9;2;1;1
258101765614;258101765659;45;0,1,3,5;4;2,9;2;1;1
258101765659;258101765692;33;0,1,3,5;4;2,9;2;1;1
258101765692;258101765861;169;0,1,3,5;4;2,9;2;1;1
258101765861;258101766064;203;0,1,3,5;4;2,9;2;1;1
258101766064;258101766920;856;0,1,3,5;4;2,9;2;1;1
258101766920;258101767083;163;0,1,3,5;4;2,9;2;1;1
258101767083;258101767248;165;0,1,3,5;4;2,9;2;1;1
258101767248;258101767412;164;0,1,3,5;4;2,9;2;1;1
258101767412;258101767577;165;0,1,3,5;4;2,9;2;1;1
258101767577;258101774896;7319;0,1,3,5;4;2,9;2;1;1
258101774896;258101777283;2387;0,1,3,5;4;2,9;2;1;1
258101777283;258101777510;227;0,1,3,5;4;2,9;2;1;1
258101777510;258101777520;10;0,1,3,5;4;2,9;2;1;1
258101777520;258101777651;131;0,1,3,5;4;2,9;2;1;1
258101777651;258101777723;72;0,1,3,5;4;2,9;2;1;1
258101777723;258101777810;87;0,1,3,5;4;2,9;2;1;1
258101777810;258101777991;181;0,1,3,5;4;2,9;2;1;1
258101777991;258101778210;219;0,1,3,5;4;2,9;2;1;1
258101778210;258101778311;101;0,1,3,5;4;2,9;2;1;1
258101778311;258101778471;160;0,1,3,5;4;2,9;2;1;1
258101778471;258101778584;113;0,1,3,5;4;2,9;2;1;1
258101778584;258101778869;285;0,1,3,5;4;2,9;2;1;1
258101778869;258101779206;337;0,1,3,5;4;2,9;2;1;1
258101779206;258101783184;3978;0,1,3,5;4;2,9;2;1;1
258101783184;258101783306;122;0,1,3,5;4;2,9;2;1;1
258101783306;258101783373;67;0,1,3,5;4;2,9;2;1;1
258101783373;258101783717;344;0,1,3,5;4;2,9;2;1;1
258101783717;258101786015;2298;0,1,3,5;4;2,9;2;1;1
258101786015;258101795721;9706;0,1,3,5;4;2,9;2;1;1
258101795721;258101796427;706;0,1,3,5;4;2,9;2;1;1
258101796427;258101796500;73;0,1,3,5,6;5;2,9;2;1;1
258101796500;258101796517;17;0,1,3,5,6;5;2,9;2;1;1
258101796517;258101796636;119;0,1,3,5,6;5;2,9;2;1;1
258101796636;258101796637;1;0,1,3,5;4;2,9;2;1;1
258101796637;258101796729;92;0,1,3,5;4;2,9;2;1;1
258101796729;258101796810;81;0,1,3,5;4;2,9;2;1;1
258101796810;258101796847;37;0,1,3,5;4;2,9;2;1;1
258101796847;258101797019;172;0,1,3,5;4;2,9;2;1;1
258101797019;258101797184;165;0,1,3,5;4;2,9;2;1;1
258101797184;258101797805;621;0,1,3,5;4;2,9;2;1;1
258101797805;258101807634;9829;0,1,3,5;4;2,9;2;1;1
258101807634;258101832982;25348;0,1,3,5;4;2,9;2;1;1
258101832982;258101833159;177;0,1,3,5;4;2,9;2;1;1
258101833159;258101833269;110;0,1,3,5;4;2,9;2;1;1
258101833269;258101833455;186;0,1,3,5;4;2,9;2;1;1
258101833455;258101833512;57;0,1,3,5;4;2,9;2;1;1
258101833512;258101834368;856;0,1,3,5;4;2,9;2;1;1
258101834368;258101834452;84;0,1,3,5;4;2,9;2;1;1
258101834452;258101834877;425;0,1,3,5;4;2,9;2;1;1
258101834877;258101835194;317;0,1,3,5;4;2,9;2;1;1
258101835194;258101835228;34;0,1,3,5;4;2,9;2;1;1
258101835228;258101835363;135;0,1,3,5;4;2,9;2;1;1
258101835363;258101835405;42;0,1,3,5;4;2,9;2;1;1
258101835405;258101835441;36;0,1,3,5;4;2,9;2;1;1
258101835441;258101835493;52;0,1,3,5;4;2,9;2;1;1
258101835493;258101835517;24;0,1,3,5;4;2,9;2;1;1
258101835517;258101835793;276;0,1,3,5;4;2,9;2;1;1
258101835793;258101835921;128;0,1,3,5;4;2,9;2;1;1
258101835921;258101836096;175;0,1,3,5;4;2,9;2;1;1
258101836096;258101836640;544;0,1,3,5;4;2,9;2;1;1
258101836640;258101840197;3557;0,1,3,5;4;2,9;2;1;1
258101840197;258101840278;81;0,1,3,5;4;2,9;2;1;1
258101840278;258101840304;26;0,1,3,5;4;2,9;2;1;1
258101840304;258101840444;140;0,1,3,5;4;2,9;2;1;1
258101840444;258101840536;92;0,1,3,5;4;2,9;2;1;1
258101840536;258101840616;80;0,1,3,5,6;5;2,9;2;1;1
258101840616;258101840639;23;0,1,3,5,6;5;2,9;2;1;1
258101840639;258101840676;37;0,1,3,5,6;5;2,9;2;1;1
258101840676;258101840807;131;0,1,3,5,6;5;2,9;2;1;1
258101840807;258101840914;107;0,1,3,5,6;5;2,9;2;1;1
258101840914;258101841041;127;0,1,3,5,6;5;2,9;2;1;1
258101841041;258101841125;84;0,1,3,5,6;5;2,9;2;1;1
258101841125;258101841195;70;0,1,3,5;4;2,9;2;1;1
258101841195;258101841228;33;0,1,3,5;4;2,9;2;1;1
258101841228;258101841272;44;0,1,3,5;4;2,9;2;1;1
258101841272;258101841519;247;0,1,3,5;4;2,9;2;1;1
258101841519;258101841573;54;0,1,3,5;4;2,9;2;1;1
258101841573;258101841738;165;0,1,3,5;4;2,9;2;1;1
258101841738;258101841924;186;0,1,3,5;4;2,9;2;1;1
258101841924;258101842069;145;0,1,3,5;4;2,9;2;1;1
258101842069;258101842218;149;0,1,3,5;4;2,9;2;1;1
258101842218;258101847550;5332;0,1,3,5;4;2,9;2;1;1
258101847550;258101848992;1442;0,1,3,5;4;2,9;2;1;1
258101848992;258101849136;144;0,1,3,5;4;2,9;2;1;1
258101849136;258101849292;156;0,1,3,5;4;2,9;2;1;1
258101849292;258101854714;5422;0,1,3,5;4;2,9;2;1;1
258101854714;258101856534;1820;0,1,3,5;4;2,9;2;1;1
258101856534;258101856609;75;0,1,3,5;4;2,9;2;1;1
258101856609;258101856695;86;0,1,3,5;4;2,9;2;1;1
258101856695;258101858963;2268;0,1,3,5;4;2,9;2;1;1
258101858963;258101859110;147;0,1,3,5;4;2,9;2;1;1
258101859110;258101859144;34;0,1,3,5;4;2,9;2;1;1
258101859144;258101859180;36;0,1,3,5;4;2,9;2;1;1
258101859180;258101859719;539;0,1,3,5;4;2,9;2;1;1
258101859719;258101861750;2031;0,1,3,5;4;2,9;2;1;1
258101861750;258101861842;92;0,1,3,5,6;5;2,9;2;1;1
258101861842;258101861907;65;0,1,3,5,6;5;2,9;2;1;1
258101861907;258101861916;9;0,1,3,5,6;5;2,9;2;1;1
258101861916;258101862057;141;0,1,3,5,6;5;2,9;2;1;1
258101862057;258101862122;65;0,1,3,5,6;5;2,9;2;1;1
258101862122;258101862177;55;0,1,3,5,6;5;2,9;2;1;1
258101862177;258101862201;24;0,1,3,5,6;5;2,9;2;1;1
258101862201;258101862438;237;0,1,3,5,6;5;2,9;2;1;1
258101862438;258101862471;33;0,1,3,5,6;5;2,9;2;1;1
258101862471;258101873362;10891;0,1,3,5,6;5;2,9;2;1;1
258101873362;258101873418;56;0,1,3,5,6;5;2,9;2;1;1
258101873418;258101873538;120;0,1,3,5,6;5;2,9;2;1;1
258101873538;258101873650;112;0,1,3,5,6;5;2,9;2;1;1
258101873650;258101873826;176;0,1,3,5,6;5;2,9;2;1;1
258101873826;258101873911;85;0,1,3,5,6;5;2,9;2;1;1
258101873911;258101874043;132;0,1,3,5,6;5;2,9;2;1;1
258101874043;258101874275;232;0,1,3,5,6;5;2,9;2;1;1
258101874275;258101874467;192;0,1,3,5,6;5;2,9;2;1;1
258101874467;258101874999;532;0,1,3,5,6;5;2,9;2;1;1
258101874999;258101878696;3697;0,1,3,5,6;5;2,9;2;1;1
258101878696;258101878783;87;0,1,3,5,6;5;2,9;2;1;1
258101878783;258101878842;59;0,1,3,5,6;5;2,9;2;1;1
258101878842;258101878894;52;0,1,3,5,6;5;2,9;2;1;1
258101878894;258101879844;950;0,1,3,5,6;5;2,9;2;1;1
258101879844;258101881523;1679;0,1,3,5,6;5;2,9;2;1;1
258101881523;258101881939;416;0,1,3,5,6;5;2,9;2;1;1
258101881939;258101881979;40;0,1,3,5,6;5;2,9;2;1;1
258101881979;258101882256;277;0,1,3,5,6;5;2,9;2;1;1
258101882256;258101882330;74;0,1,3,5,6;5;2,9;2;1;1
258101882330;258101882442;112;0,1,3,5,6;5;2,9;2;1;1
258101882442;258101883002;560;0,1,3,5,6;5;2,9;2;1;1
258101883002;258101883047;45;0,1,3,5,6;5;2,9;2;1;1
258101883047;258101883253;206;0,1,3,5,6;5;2,9;2;1;1
258101883253;258101883355;102;0,1,3,5,6;5;2,9;2;1;1
258101883355;258101883533;178;0,1,3,5,6;5;2,9;2;1;1
258101883533;258101883703;170;0,1,3,5,6;5;2,9;2;1;1
258101883703;258101883891;188;0,1,3,5,6;5;2,9;2;1;1
258101883891;258101884268;377;0,1,3,5,6;5;2,9;2;1;1
258101884268;258101885031;763;0,1,3,5;4;2,9;2;1;1
258101885031;258101885177;146;0,1,3,5;4;2,9;2;1;1
258101885177;258101885316;139;0,1,3,5,6;5;2,9;2;1;1
258101885316;258101885454;138;0,1,3,5,6;5;2,9;2;1;1
258101885454;258101885666;212;0,1,3,5,6;5;2,9;2;1;1
258101885666;258101885948;282;0,1,3,5;4;2,9;2;1;1
258101885948;258101885965;17;0,1,3,5,6;5;2,9;2;1;1
258101885965;258101886147;182;0,1,3,5,6;5;2,9;2;1;1
258101886147;258101886198;51;0,1,3,5,6;5;2,9;2;1;1
258101886198;258101886295;97;0,1,3,5;4;2,9;2;1;1
258101886295;258101886335;40;0,1,3,5;4;2,9;2;1;1
258101886335;258101886370;35;0,1,3,5;4;2,9;2;1;1
258101886370;258101886425;55;0,1,3,5;4;2,9;2;1;1
258101886425;258101886513;88;0,1,3,5;4;2,9;2;1;1
258101886513;258101886636;123;0,1,3,5;4;2,9;2;1;1
258101886636;258101886813;177;0,1,3,5;4;2,9;2;1;1
258101886813;258101886960;147;0,1,3,5;4;2,9;2;1;1
258101886960;258101887298;338;0,1,3,5;4;2,9;2;1;1
258101887298;258101887561;263;0,1,3,5;4;2,9;2;1;1
258101887561;258101887796;235;0,1,3,5;4;2,9;2;1;1
258101887796;258101889515;1719;0,1,3,5;4;2,9;2;1;1
258101889515;258101896217;6702;0,1,3,5;4;2,9;2;1;1
258101896217;258101897248;1031;0,1,3,5;4;2,9;2;1;1
258101897248;258101900058;2810;0,1,3,5;4;2,9;2;1;1
258101900058;258101900469;411;0,1,3,5;4;2,9;2;1;1
258101900469;258101900605;136;0,1,3,5;4;2,9;2;1;1
258101900605;258101900921;316;0,1,3,5;4;2,9;2;1;1
258101900921;258101901097;176;0,1,3,5;4;2,9;2;1;1
258101901097;258101901478;381;0,1,3,5;4;2,9;2;1;1
258101901478;258101922174;20696;0,1,3,5;4;2,9;2;1;1
258101922174;258101924664;2490;0,1,3,5;4;2,9;2;1;1
258101924664;258101935459;10795;0,1,3,5;4;2,9;2;1;1
258101935459;258101935648;189;0,1,3,5,6;5;2,9;2;1;1
258101935648;258101935712;64;0,1,3,5,6;5;2,9;2;1;1
258101935712;258101935804;92;0,1,3,5;4;2,9;2;1;1
258101935804;258101936574;770;0,1,3,5;4;2,9;2;1;1
258101936574;258101936632;58;0,1,3,5;4;2,9;2;1;1
258101936632;258101936677;45;0,1,3,5;4;2,9;2;1;1
258101936677;258101936721;44;0,1,3,5;4;2,9;2;1;1
258101936721;258101936782;61;0,1,3,5;4;2,9;2;1;1
258101936782;258101937046;264;0,1,3,5;4;2,9;2;1;1
258101937046;258101938575;1529;0,1,3,5;4;2,9;2;1;1
258101938575;258101948994;10419;0,1,3,5;4;2,9;2;1;1
258101948994;258101960588;11594;0,1,3,5;4;2,9;2;1;1
258101960588;258101960654;66;0,1,3,5;4;2,9;2;1;1
258101960654;258101960674;20;0,1,3,5;4;2,9;2;1;1
258101960674;258101960792;118;0,1,3,5,6;5;2,9;2;1;1
258101960792;258101960797;5;0,1,3,5,6;5;2,9;2;1;1
258101960797;258101960935;138;0,1,3,5,6;5;2,9;2;1;1
258101960935;258101961087;152;0,1,3,5,6;5;2,9;2;1;1
258101961087;258101961143;56;0,1,3,5,6;5;2,9;2;1;1
258101961143;258101961260;117;0,1,3,5;4;2,9;2;1;1
258101961260;258101961497;237;0,1,3,5;4;2,9;2;1;1
258101961497;258101969251;7754;0,1,3,5;4;2,9;2;1;1
258101969251;258101969594;343;0,1,3,5;4;2,9;2;1;1
258101969594;258101969811;217;0,1,3,5;4;2,9;2;1;1
258101969811;258101970019;208;0,1,3,5,6;5;2,9;2;1;1
258101970019;258101970043;24;0,1,3,5,6;5;2,9;2;1;1
258101970043;258101970146;103;0,1,3,5,6;5;2,9;2;1;1
258101970146;258101970189;43;0,1,3,5,6;5;2,9;2;1;1
258101970189;258101970336;147;0,1,3,5,6;5;2,9;2;1;1
258101970336;258101970457;121;0,1,3,5,6;5;2,9;2;1;1
258101970457;258101970499;42;0,1,3,5,6;5;2,9;2;1;1
258101970499;258101971370;871;0,1,3,5;4;2,9;2;1;1
258101971370;258101999393;28023;0,1,3,5;4;2,9;2;1;1
258101999393;258102263960;264567;0,1,3,5;4;2,9;2;1;1
258102263960;258102273716;9756;0,1,3,5;4;2,9;2;1;1
258102273716;258102273768;52;0,1,3,5;4;2,9;2;1;1
258102273768;258102301517;27749;0,1,3,5;4;2,9;2;1;1
258102301517;258102302484;967;0,1,3,5;4;2,9;2;1;1
258102302484;258102302546;62;0,1,3,5;4;2,9;2;1;1
258102302546;258102302571;25;0,1,3,5;4;2,9;2;1;1
258102302571;258102302811;240;0,1,3,5;4;2,9;2;1;1
258102302811;258102302860;49;0,1,3,5;4;2,9;2;1;1
258102302860;258102302888;28;0,1,3,5;4;2,9;2;1;1
258102302888;258102303225;337;0,1,3,5;4;2,9;2;1;1
258102303225;258102303399;174;0,1,3,5;4;2,9;2;1;1
258102303399;258102303546;147;0,1,3,5;4;2,9;2;1;1
258102303546;258102303730;184;0,1,3,5;4;2,9;2;1;1
258102303730;258102350631;46901;0,1,3,5;4;2,9;2;1;1
258102350631;258102350870;239;0,1,3,5;4;2,9;2;1;1
258102350870;258102352515;1645;0,1,3,5;4;2,9;2;1;1
258102352515;258102353012;497;0,1,3,5;4;2,9;2;1;1
258102353012;258102353315;303;0,1,3,5;4;2,9;2;1;1
258102353315;258102353571;256;0,1,3,5;4;2,9;2;1;1
258102353571;258102355480;1909;0,1,3,5;4;2,9;2;1;1
258102355480;258102359470;3990;0,1,3,5;4;2,9;2;1;1
258102359470;258102359696;226;0,1,3,5;4;2,9;2;1;1
258102359696;258102370476;10780;0,1,3,5;4;2,9;2;1;1
258102370476;258102370808;332;0,1,3,5;4;2,9;2;1;1
258102370808;258102370977;169;0,1,3,5;4;2,9;2;1;1
258102370977;258102371014;37;0,1,3,5;4;2,9;2;1;1
258102371014;258102371032;18;0,1,3,5;4;2,9;2;1;1
258102371032;258102373237;2205;0,1,3,5;4;2,9;2;1;1
258102373237;258102373378;141;0,1,3,5;4;2,9;2;1;1
258102373378;258102383602;10224;0,1,3,5;4;2,9;2;1;1
258102383602;258102383674;72;0,1,3,5;4;2,9;2;1;1
258102383674;258102384024;350;0,1,3,5;4;2,9;2;1;1
258102384024;258102384578;554;0,1,3,5;4;2,9;2;1;1
258102384578;258102385003;425;0,1,3,5;4;2,9;2;1;1
258102385003;258102385040;37;0,1,3,5;4;2,9;2;1;1
258102385040;258102404196;19156;0,1,3,5;4;2,9;2;1;1
258102404196;258102405567;1371;0,1,3,5;4;2,9;2;1;1
258102405567;258102417357;11790;0,1,3,5;4;2,9;2;1;1
258102417357;258102417413;56;0,1,3,5;4;2,9;2;1;1
258102417413;258102417517;104;0,1,3,5;4;2,9;2;1;1
258102417517;258102417529;12;0,1,3,5;4;2,9;2;1;1
258102417529;258102417551;22;0,1,3,5;4;2,9;2;1;1
258102417551;258102417910;359;0,1,3,5;4;2,9;2;1;1
258102417910;258102417937;27;0,1,3,5;4;2,9;2;1;1
258102417937;258102418249;312;0,1,3,5;4;2,9;2;1;1
258102418249;258102418548;299;0,1,3,5;4;2,9;2;1;1
258102418548;258102418636;88;0,1,3,5;4;2,9;2;1;1
258102418636;258102419329;693;0,1,3,5;4;2,9;2;1;1
258102419329;258102421096;1767;0,1,3,5;4;2,9;2;1;1
258102421096;258102421147;51;0,1,3,5;4;2,9;2;1;1
258102421147;258102421198;51;0,1,3,5;4;2,9;2;1;1
258102421198;258102421249;51;0,1,3,5;4;2,9;2;1;1
258102421249;258102421299;50;0,1,3,5;4;2,9;2;1;1
258102421299;258102421349;50;0,1,3,5;4;2,9;2;1;1
258102421349;258102422299;950;0,1,3,5;4;2,9;2;1;1
258102422299;258102445423;23124;0,1,3,5;4;2,9;2;1;1
258102445423;258102448280;2857;0,1,3,5;4;2,9;2;1;1
258102448280;258102448386;106;0,1,3,5;4;2,9;2;1;1
258102448386;258102448416;30;0,1,3,5;4;2,9;2;1;1
258102448416;258102448564;148;0,1,3,5;4;2,9;2;1;1
258102448564;258102448586;22;0,1,3,5;4;2,9;2;1;1
258102448586;258102448667;81;0,1,3,5,6;5;2,9;2;1;1
258102448667;258102448795;128;0,1,3,5,6;5;2,9;2;1;1
258102448795;258102448839;44;0,1,3,5,6;5;2,9;2;1;1
258102448839;258102448871;32;0,1,3,5,6;5;2,9;2;1;1
258102448871;258102448921;50;0,1,3,5,6;5;2,9;2;1;1
258102448921;258102449024;103;0,1,3,5,6;5;2,9;2;1;1
258102449024;258102449048;24;0,1,3,5,6;5;2,9;2;1;1
258102449048;258102449163;115;0,1,3,5,6;5;2,9;2;1;1
258102449163;258102449182;19;0,1,3,5,6;5;2,9;2;1;1
258102449182;258102449406;224;0,1,3,5,6;5;2,9;2;1;1
258102449406;258102449446;40;0,1,3,5,6;5;2,9;2;1;1
258102449446;258102449592;146;0,1,3,5,6;5;2,9;2;1;1
258102449592;258102449742;150;0,1,3,5,6;5;2,9;2;1;1
258102449742;258102449781;39;0,1,3,5,6;5;2,9;2;1;1
258102449781;258102449878;97;0,1,3,5;4;2,9;2;1;1
258102449878;258102457634;7756;0,1,3,5;4;2,9;2;1;1
258102457634;258102457719;85;0,1,3,5;4;2,9;2;1;1
258102457719;258102457926;207;0,1,3,5;4;2,9;2;1;1
258102457926;258102457957;31;0,1,3,5;4;2,9;2;1;1
258102457957;258102458048;91;0,1,3,5;4;2,9;2;1;1
258102458048;258102458198;150;0,1,3,5;4;2,9;2;1;1
258102458198;258102460063;1865;0,1,3,5;4;2,9;2;1;1
258102460063;258102460137;74;0,1,3,5;4;2,9;2;1;1
258102460137;258102460163;26;0,1,3,5;4;2,9;2;1;1
258102460163;258102460223;60;0,1,3,5;4;2,9;2;1;1
258102460223;258102460249;26;0,1,3,5;4;2,9;2;1;1
258102460249;258102460739;490;0,1,3,5;4;2,9;2;1;1
258102460739;258102461051;312;0,1,3,5;4;2,9;2;1;1
258102461051;258102479292;18241;0,1,3,5;4;2,9;2;1;1
258102479292;258102479318;26;0,1,3,5;4;2,9;2;1;1
258102479318;258102479374;56;0,1,3,5;4;2,9;2;1;1
258102479374;258102479387;13;0,1,3,5;4;2,9;2;1;1
258102479387;258102479410;23;0,1,3,5;4;2,9;2;1;1
258102479410;258102479424;14;0,1,3,5;4;2,9;2;1;1
258102479424;258102479447;23;0,1,3,5;4;2,9;2;1;1
258102479447;258102479971;524;0,1,3,5;4;2,9;2;1;1
258102479971;258102484547;4576;0,1,3,5;4;2,9;2;1;1
258102484547;258102494912;10365;0,1,3,5;4;2,9;2;1;1
258102494912;258102505484;10572;0,1,3,5;4;2,9;2;1;1
258102505484;258102505486;2;0,1,3,5;4;2,9;2;1;1
258102505486;258102505565;79;0,1,3,5;4;2,9;2;1;1
258102505565;258102505576;11;0,1,3,5;4;2,9;2;1;1
258102505576;258102505641;65;0,1,3,5;4;2,9;2;1;1
258102505641;258102505725;84;0,1,3,5;4;2,9;2;1;1
258102505725;258102505774;49;0,1,3,5;4;2,9;2;1;1
258102505774;258102505781;7;0,1,3,5;4;2,9;2;1;1
258102505781;258102506094;313;0,1,3,5;4;2,9;2;1;1
258102506094;258102506339;245;0,1,3,5;4;2,9;2;1;1
258102506339;258102507194;855;0,1,3,5;4;2,9;2;1;1
258102507194;258102507207;13;0,1,3,5;4;2,9;2;1;1
258102507207;258102507458;251;0,1,3,5;4;2,9;2;1;1
258102507458;258102507526;68;0,1,3,5;4;2,9;2;1;1
258102507526;258102510285;2759;0,1,3,5;4;2,9;2;1;1
258102510285;258102513790;3505;0,1,3,5;4;2,9;2;1;1
258102513790;258102513839;49;0,1,3,5;4;2,9;2;1;1
258102513839;258102517021;3182;0,1,3,5;4;2,9;2;1;1
258102517021;258102526010;8989;0,1,3,5;4;2,9;2;1;1
258102526010;258102540038;14028;0,1,3,5;4;2,9;2;1;1
258102540038;258102557412;17374;0,1,3,5;4;2,9;2;1;1
258102557412;258102563145;5733;0,1,3,5;4;2,9;2;1;1
258102563145;258102563166;21;0,1,3,5;4;2,9;2;1;1
258102563166;258102563215;49;0,1,3,5;4;2,9;2;1;1
258102563215;258102563266;51;0,1,3,5;4;2,9;2;1;1
258102563266;258102563292;26;0,1,3,5;4;2,9;2;1;1
258102563292;258102563347;55;0,1,3,5;4;2,9;2;1;1
258102563347;258102570178;6831;0,1,3,5;4;2,9;2;1;1
258102570178;258102570960;782;0,1,3,5;4;2,9;2;1;1
258102570960;258102571252;292;0,1,3,5;4;2,9;2;1;1
258102571252;258102571654;402;0,1,3,5;4;2,9;2;1;1
258102571654;258102571813;159;0,1,3,5;4;2,9;2;1;1
258102571813;258102571956;143;0,1,3,5;4;2,9;2;1;1
258102571956;258102572068;112;0,1,3,5;4;2,9;2;1;1
258102572068;258102572099;31;0,1,3,5;4;2,9;2;1;1
258102572099;258102581250;9151;0,1,3,5;4;2,9;2;1;1
258102581250;258102585585;4335;0,1,3,5;4;2,9;2;1;1
258102585585;258102588687;3102;0,1,3,5;4;2,9;2;1;1
258102588687;258102588953;266;0,1,3,5;4;2,9;2;1;1
258102588953;258102589244;291;0,1,3,5,6;5;2,9;2;1;1
258102589244;258102589488;244;0,1,3,5;4;2,9;2;1;1
258102589488;258102589609;121;0,1,3,5;4;2,9;2;1;1
258102589609;258102589667;58;0,1,3,5;4;2,9;2;1;1
258102589667;258102589670;3;0,1,3,5;4;2,9;2;1;1
258102589670;258102589678;8;0,1,3,5;4;2,9;2;1;1
258102589678;258102589729;51;0,1,3,5;4;2,9;2;1;1
258102589729;258102589760;31;0,1,3,5;4;2,9;2;1;1
258102589760;258102589780;20;0,1,3,5;4;2,9;2;1;1
258102589780;258102589832;52;0,1,3,5;4;2,9;2;1;1
258102589832;258102589881;49;0,1,3,5;4;2,9;2;1;1
258102589881;258102590050;169;0,1,3,5;4;2,9;2;1;1
258102590050;258102590313;263;0,1,3,5;4;2,9;2;1;1
258102590313;258102590372;59;0,1,3,5;4;2,9;2;1;1
258102590372;258102590493;121;0,1,3,5;4;2,9;2;1;1
258102590493;258102590538;45;0,1,3,5;4;2,9;2;1;1
258102590538;258102593134;2596;0,1,3,5;4;2,9;2;1;1
258102593134;258102593196;62;0,1,3,5;4;2,9;2;1;1
258102593196;258102593359;163;0,1,3,5,6;5;2,9;2;1;1
258102593359;258102593478;119;0,1,3,5;4;2,9;2;1;1
258102593478;258102593844;366;0,1,3,5;4;2,9;2;1;1
258102593844;258102593961;117;0,1,3,5;4;2,9;2;1;1
258102593961;258102593992;31;0,1,3,5;4;2,9;2;1;1
258102593992;258102594202;210;0,1,3,5;4;2,9;2;1;1
258102594202;258102594243;41;0,1,3,5;4;2,9;2;1;1
258102594243;258102594306;63;0,1,3,5;4;2,9;2;1;1
258102594306;258102603220;8914;0,1,3,5;4;2,9;2;1;1
258102603220;258102605253;2033;0,1,3,5;4;2,9;2;1;1
258102605253;258102624949;19696;0,1,3,5;4;2,9;2;1;1
258102624949;258102648527;23578;0,1,3,5;4;2,9;2;1;1
258102648527;258102648935;408;0,1,3,5;4;2,9;2;1;1
258102648935;258102649132;197;0,1,3,5;4;2,9;2;1;1
258102649132;258102649363;231;0,1,3,5;4;2,9;2;1;1
258102649363;258102649406;43;0,1,3,5;4;2,9;2;1;1
258102649406;258102649506;100;0,1,3,5;4;2,9;2;1;1
258102649506;258102649549;43;0,1,3,5;4;2,9;2;1;1
258102649549;258102649696;147;0,1,3,5;4;2,9;2;1;1
258102649696;258102649844;148;0,1,3,5;4;2,9;2;1;1
258102649844;258102649970;126;0,1,3,5;4;2,9;2;1;1
258102649970;258102650042;72;0,1,3,5;4;2,9;2;1;1
258102650042;258102653798;3756;0,1,3,5;4;2,9;2;1;1
258102653798;258102653960;162;0,1,3,5,6;5;2,9;2;1;1
258102653960;258102654108;148;0,1,3,5;4;2,9;2;1;1
258102654108;258102654143;35;0,1,3,5;4;2,9;2;1;1
258102654143;258102654244;101;0,1,3,5;4;2,9;2;1;1
258102654244;258102654655;411;0,1,3,5;4;2,9;2;1;1
258102654655;258102654819;164;0,1,3,5;4;2,9;2;1;1
258102654819;258102655145;326;0,1,3,5;4;2,9;2;1;1
258102655145;258102655227;82;0,1,3,5;4;2,9;2;1;1
258102655227;258102655278;51;0,1,3,5;4;2,9;2;1;1
258102655278;258102663040;7762;0,1,3,5;4;2,9;2;1;1
258102663040;258102664684;1644;0,1,3,5;4;2,9;2;1;1
258102664684;258102666103;1419;0,1,3,5;4;2,9;2;1;1
258102666103;258102668057;1954;0,1,3,5;4;2,9;2;1;1
258102668057;258102668147;90;0,1,3,5;4;2,9;2;1;1
258102668147;258102668412;265;0,1,3,5;4;2,9;2;1;1
258102668412;258102668535;123;0,1,3,5,6;5;2,9;2;1;1
258102668535;258102668589;54;0,1,3,5,6;5;2,9;2;1;1
258102668589;258102668743;154;0,1,3,5,6;5;2,9;2;1;1
258102668743;258102668950;207;0,1,3,5,6;5;2,9;2;1;1
258102668950;258102668972;22;0,1,3,5,6;5;2,9;2;1;1
258102668972;258102669007;35;0,1,3,5,6;5;2,9;2;1;1
258102669007;258102669100;93;0,1,3,5;4;2,9;2;1;1
258102669100;258102669135;35;0,1,3,5;4;2,9;2;1;1
258102669135;258102669137;2;0,1,3,5;4;2,9;2;1;1
258102669137;258102669158;21;0,1,3,5;4;2,9;2;1;1
258102669158;258102669292;134;0,1,3,5;4;2,9;2;1;1
258102669292;258102669302;10;0,1,3,5;4;2,9;2;1;1
258102669302;258102670557;1255;0,1,3,5;4;2,9;2;1;1
258102670557;258102671515;958;0,1,3,5;4;2,9;2;1;1
258102671515;258102677602;6087;0,1,3,5;4;2,9;2;1;1
258102677602;258102689766;12164;0,1,3,5;4;2,9;2;1;1
258102689766;258102698194;8428;0,1,3,5;4;2,9;2;1;1
258102698194;258102711550;13356;0,1,3,5;4;2,9;2;1;1
258102711550;258102720325;8775;0,1,3,5;4;2,9;2;1;1
258102720325;258102721832;1507;0,1,3,5;4;2,9;2;1;1
258102721832;258102724860;3028;0,1,3,5;4;2,9;2;1;1
258102724860;258102724877;17;0,1,3,5;4;2,9;2;1;1
258102724877;258102725482;605;0,1,3,5;4;2,9;2;1;1
258102725482;258102727383;1901;0,1,3,5;4;2,9;2;1;1
258102727383;258102765241;37858;0,1,3,5;4;2,9;2;1;1
258102765241;258102765351;110;0,1,3,5;4;2,9;2;1;1
258102765351;258102765390;39;0,1,3,5;4;2,9;2;1;1
258102765390;258102765416;26;0,1,3,5;4;2,9;2;1;1
258102765416;258102765436;20;0,1,3,5;4;2,9;2;1;1
258102765436;258102765584;148;0,1,3,5;4;2,9;2;1;1
258102765584;258102765591;7;0,1,3,5;4;2,9;2;1;1
258102765591;258102765793;202;0,1,3,5;4;2,9;2;1;1
258102765793;258102765833;40;0,1,3,5;4;2,9;2;1;1
258102765833;258102767906;2073;0,1,3,5;4;2,9;2;1;1
258102767906;258102777990;10084;0,1,3,5;4;2,9;2;1;1
258102777990;258102778013;23;0,1,3,5;4;2,9;2;1;1
258102778013;258102792315;14302;0,1,3,5;4;2,9;2;1;1
258102792315;258102792352;37;0,1,3,5;4;2,9;2;1;1
258102792352;258102792384;32;0,1,3,5;4;2,9;2;1;1
258102792384;258102792448;64;0,1,3,5;4;2,9;2;1;1
258102792448;258102792552;104;0,1,3,5,6;5;2,9;2;1;1
258102792552;258102792673;121;0,1,3,5,6;5;2,9;2;1;1
258102792673;258102792701;28;0,1,3,5,6;5;2,9;2;1;1
258102792701;258102792733;32;0,1,3,5;4;2,9;2;1;1
258102792733;258102792792;59;0,1,3,5;4;2,9;2;1;1
258102792792;258102798376;5584;0,1,3,5;4;2,9;2;1;1
258102798376;258102800081;1705;0,1,3,5;4;2,9;2;1;1
258102800081;258102808752;8671;0,1,3,5;4;2,9;2;1;1
258102808752;258102808929;177;0,1,3,5;4;2,9;2;1;1
258102808929;258102811175;2246;0,1,3,5;4;2,9;2;1;1
258102811175;258102830384;19209;0,1,3,5;4;2,9;2;1;1
258102830384;258102838711;8327;0,1,3,5;4;2,9;2;1;1
258102838711;258102849231;10520;0,1,3,5;4;2,9;2;1;1
258102849231;258102849264;33;0,1,3,5;4;2,9;2;1;1
258102849264;258102864459;15195;0,1,3,5;4;2,9;2;1;1
258102864459;258102864472;13;0,1,3,5;4;2,9;2;1;1
258102864472;258102864495;23;0,1,3,5;4;2,9;2;1;1
258102864495;258102864524;29;0,1,3,5;4;2,9;2;1;1
258102864524;258102865125;601;0,1,3,5;4;2,9;2;1;1
258102865125;258102865183;58;0,1,3,5;4;2,9;2;1;1
258102865183;258102865474;291;0,1,3,5;4;2,9;2;1;1
258102865474;258102869342;3868;0,1,3,5;4;2,9;2;1;1
258102869342;258102869469;127;0,1,3,5;4;2,9;2;1;1
258102869469;258102869522;53;0,1,3,5;4;2,9;2;1;1
258102869522;258102869556;34;0,1,3,5;4;2,9;2;1;1
258102869556;258102869578;22;0,1,3,5,6;5;2,9;2;1;1
258102869578;258102869607;29;0,1,3,5,6;5;2,9;2;1;1
258102869607;258102869656;49;0,1,3,5,6;5;2,9;2;1;1
258102869656;258102869767;111;0,1,3,5,6;5;2,9;2;1;1
258102869767;258102869787;20;0,1,3,5,6;5;2,9;2;1;1
258102869787;258102869824;37;0,1,3,5;4;2,9;2;1;1
258102869824;258102869828;4;0,1,3,5;4;2,9;2;1;1
258102869828;258102869867;39;0,1,3,5;4;2,9;2;1;1
258102869867;258102869902;35;0,1,3,5;4;2,9;2;1;1
258102869902;258102869942;40;0,1,3,5;4;2,9;2;1;1
258102869942;258102869947;5;0,1,3,5;4;2,9;2;1;1
258102869947;258102869961;14;0,1,3,5;4;2,9;2;1;1
258102869961;258102870219;258;0,1,3,5;4;2,9;2;1;1
258102870219;258102870379;160;0,1,3,5;4;2,9;2;1;1
258102870379;258102870537;158;0,1,3,5;4;2,9;2;1;1
258102870537;258102870824;287;0,1,3,5;4;2,9;2;1;1
258102870824;258102871133;309;0,1,3,5;4;2,9;2;1;1
258102871133;258102875527;4394;0,1,3,5;4;2,9;2;1;1
258102875527;258102875651;124;0,1,3,5,6;5;2,9;2;1;1
258102875651;258102875731;80;0,1,3,5,6;5;2,9;2;1;1
258102875731;258102875980;249;0,1,3,5,6;5;2,9;2;1;1
258102875980;258102876023;43;0,1,3,5,6;5;2,9;2;1;1
258102876023;258102876277;254;0,1,3,5,6;5;2,9;2;1;1
258102876277;258102876566;289;0,1,3,5,6;5;2,9;2;1;1
258102876566;258102876617;51;0,1,3,5,6;5;2,9;2;1;1
258102876617;258102876750;133;0,1,3,5,6;5;2,9;2;1;1
258102876750;258102878378;1628;0,1,3,5,6;5;2,9;2;1;1
258102878378;258102878466;88;0,1,3,5,6;5;2,9;2;1;1
258102878466;258102878549;83;0,1,3,5,6;5;2,9;2;1;1
258102878549;258102878604;55;0,1,3,5,6;5;2,9;2;1;1
258102878604;258102878655;51;0,1,3,5,6;5;2,9;2;1;1
258102878655;258102878823;168;0,1,3,5,6;5;2,9;2;1;1
258102878823;258102878931;108;0,1,3,5,6;5;2,9;2;1;1
258102878931;258102879004;73;0,1,3,5,6;5;2,9;2;1;1
258102879004;258102880914;1910;0,1,3,5,6;5;2,9;2;1;1
258102880914;258102884152;3238;0,1,3,5,6;5;2,9;2;1;1
258102884152;258102884377;225;0,1,3,5,6;5;2,9;2;1;1
258102884377;258102884601;224;0,1,3,5,6;5;2,9;2;1;1
258102884601;258102887290;2689;0,1,3,5,6;5;2,9;2;1;1
258102887290;258102887651;361;0,1,3,5,6;5;2,9;2;1;1
258102887651;258102887723;72;0,1,3,5,6;5;2,9;2;1;1
258102887723;258102888014;291;0,1,3,5,6;5;2,9;2;1;1
258102888014;258102888337;323;0,1,3,5,6;5;2,9;2;1;1
258102888337;258102888582;245;0,1,3,5,6;5;2,9;2;1;1
258102888582;258102888793;211;0,1,3,5,6;5;2,9;2;1;1
258102888793;258102889079;286;0,1,3,5,6;5;2,9;2;1;1
258102889079;258102901011;11932;0,1,3,5,6;5;2,9;2;1;1
258102901011;258102901031;20;0,1,3,5,6;5;2,9;2;1;1
258102901031;258102901601;570;0,1,3,5,6;5;2,9;2;1;1
258102901601;258102901654;53;0,1,3,5,6;5;2,9;2;1;1
258102901654;258102901841;187;0,1,3,5,6;5;2,9;2;1;1
258102901841;258102901884;43;0,1,3,5,6;5;2,9;2;1;1
258102901884;258102902234;350;0,1,3,5,6;5;2,9;2;1;1
258102902234;258102902247;13;0,1,3,5,6;5;2,9;2;1;1
258102902247;258102902303;56;0,1,3,5,6;5;2,9;2;1;1
258102902303;258102902534;231;0,1,3,5,6;5;2,9;2;1;1
258102902534;258102902819;285;0,1,3,5,6;5;2,9;2;1;1
258102902819;258102903152;333;0,1,3,5,6;5;2,9;2;1;1
258102903152;258102903316;164;0,1,3,5,6;5;2,9;2;1;1
258102903316;258102903580;264;0,1,3,5,6;5;2,9;2;1;1
258102903580;258102903945;365;0,1,3,5,6;5;2,9;2;1;1
258102903945;258102903988;43;0,1,3,5,6;5;2,9;2;1;1
258102903988;258102904076;88;0,1,3,5,6;5;2,9;2;1;1
258102904076;258102904110;34;0,1,3,5,6;5;2,9;2;1;1
258102904110;258102904272;162;0,1,3,5,6;5;2,9;2;1;1
258102904272;258102904447;175;0,1,3,5,6;5;2,9;2;1;1
258102904447;258102904617;170;0,1,3,5,6;5;2,9;2;1;1
258102904617;258102907121;2504;0,1,3,5,6;5;2,9;2;1;1
258102907121;258102907257;136;0,1,3,5,6;5;2,9;2;1;1
258102907257;258102907299;42;0,1,3,5,6;5;2,9;2;1;1
258102907299;258102907379;80;0,1,3,5,6;5;2,9;2;1;1
258102907379;258102907513;134;0,1,3,5,6;5;2,9;2;1;1
258102907513;258102907673;160;0,1,3,5,6;5;2,9;2;1;1
258102907673;258102907862;189;0,1,3,5,6;5;2,9;2;1;1
258102907862;258102907901;39;0,1,3,5,6;5;2,9;2;1;1
258102907901;258102908206;305;0,1,3,5,6;5;2,9;2;1;1
258102908206;258102909938;1732;0,1,3,5,6;5;2,9;2;1;1
258102909938;258102913945;4007;0,1,3,5,6;5;2,9;2;1;1
258102913945;258102918686;4741;0,1,3,5,6;5;2,9;2;1;1
258102918686;258102918835;149;0,1,3,5,6;5;2,9;2;1;1
258102918835;258102918873;38;0,1,3,5,6;5;2,9;2;1;1
258102918873;258102920562;1689;0,1,3,5,6;5;2,9;2;1;1
258102920562;258102921061;499;0,1,3,5,6;5;2,9;2;1;1
258102921061;258102921107;46;0,1,3,5,6;5;2,9;2;1;1
258102921107;258102921158;51;0,1,3,5,6;5;2,9;2;1;1
258102921158;258102921453;295;0,1,3,5,6;5;2,9;2;1;1
258102921453;258102921485;32;0,1,3,5,6;5;2,9;2;1;1
258102921485;258102921628;143;0,1,3,5,6;5;2,9;2;1;1
258102921628;258102921675;47;0,1,3,5,6;5;2,9;2;1;1
258102921675;258102922938;1263;0,1,3,5,6;5;2,9;2;1;1
258102922938;258102926465;3527;0,1,3,5,6;5;2,9;2;1;1
258102926465;258102926865;400;0,1,3,5,6;5;2,9;2;1;1
258102926865;258102929084;2219;0,1,3,5,6;5;2,9;2;1;1
258102929084;258102931181;2097;0,1,3,5,6;5;2,9;2;1;1
258102931181;258102941471;10290;0,1,3,5,6;5;2,9;2;1;1
258102941471;258102963973;22502;0,1,3,5;4;2,9;2;1;1
258102963973;258102966795;2822;0,1,3,5;4;2,9;2;1;1
258102966795;258102970513;3718;0,1,3,5;4;2,9;2;1;1
258102970513;258102970714;201;0,1,3,5,6;5;2,9;2;1;1
258102970714;258102970975;261;0,1,3,5;4;2,9;2;1;1
258102970975;258102971408;433;0,1,3,5;4;2,9;2;1;1
258102971408;258102971450;42;0,1,3,5;4;2,9;2;1;1
258102971450;258102971570;120;0,1,3,5;4;2,9;2;1;1
258102971570;258102971629;59;0,1,3,5;4;2,9;2;1;1
258102971629;258102971840;211;0,1,3,5;4;2,9;2;1;1
258102971840;258102971877;37;0,1,3,5;4;2,9;2;1;1
258102971877;258102971916;39;0,1,3,5;4;2,9;2;1;1
258102971916;258102975250;3334;0,1,3,5;4;2,9;2;1;1
258102975250;258102978728;3478;0,1,3,5;4;2,9;2;1;1
258102978728;258102979817;1089;0,1,3,5;4;2,9;2;1;1
258102979817;258102987935;8118;0,1,3,5;4;2,9;2;1;1
258102987935;258102997252;9317;0,1,3,5;4;2,9;2;1;1
258102997252;258103006108;8856;0,1,3,5;4;2,9;2;1;1
258103006108;258103006121;13;0,1,3,5;4;2,9;2;1;1
258103006121;258103006143;22;0,1,3,5;4;2,9;2;1;1
258103006143;258103006247;104;0,1,3,5;4;2,9;2;1;1
258103006247;258103034415;28168;0,1,3,5;4;2,9;2;1;1
258103034415;258103045245;10830;0,1,3,5;4;2,9;2;1;1
258103045245;258103045757;512;0,1,3,5;4;2,9;2;1;1
258103045757;258103047669;1912;0,1,3,5;4;2,9;2;1;1
258103047669;258103047723;54;0,1,3,5;4;2,9;2;1;1
258103047723;258103047738;15;0,1,3,5;4;2,9;2;1;1
258103047738;258103047854;116;0,1,3,5;4;2,9;2;1;1
258103047854;258103048088;234;0,1,3,5;4;2,9;2;1;1
258103048088;258103064532;16444;0,1,3,5;4;2,9;2;1;1
258103064532;258103065557;1025;0,1,3,5;4;2,9;2;1;1
258103065557;258103065989;432;0,1,3,5;4;2,9;2;1;1
258103065989;258103068030;2041;0,1,3,5;4;2,9;2;1;1
258103068030;258103068063;33;0,1,3,5;4;2,9;2;1;1
258103068063;258103068133;70;0,1,3,5;4;2,9;2;1;1
258103068133;258103071378;3245;0,1,3,5;4;2,9;2;1;1
258103071378;258103071541;163;0,1,3,5,6;5;2,9;2;1;1
258103071541;258103071756;215;0,1,3,5;4;2,9;2;1;1
258103071756;258103071786;30;0,1,3,5;4;2,9;2;1;1
258103071786;258103071844;58;0,1,3,5;4;2,9;2;1;1
258103071844;258103071902;58;0,1,3,5;4;2,9;2;1;1
258103071902;258103071946;44;0,1,3,5;4;2,9;2;1;1
258103071946;258103071986;40;0,1,3,5;4;2,9;2;1;1
258103071986;258103072023;37;0,1,3,5;4;2,9;2;1;1
258103072023;258103072131;108;0,1,3,5;4;2,9;2;1;1
258103072131;258103076205;4074;0,1,3,5;4;2,9;2;1;1
258103076205;258103076377;172;0,1,3,5;4;2,9;2;1;1
258103076377;258103076618;241;0,1,3,5;4;2,9;2;1;1
258103076618;258103076776;158;0,1,3,5,6;5;2,9;2;1;1
258103076776;258103076998;222;0,1,3,5,6;5;2,9;2;1;1
258103076998;258103077201;203;0,1,3,5,6;5;2,9;2;1;1
258103077201;258103077403;202;0,1,3,5,6;5;2,9;2;1;1
258103077403;258103077615;212;0,1,3,5,6;5;2,9;2;1;1
258103077615;258103077755;140;0,1,3,5,6;5;2,9;2;1;1
258103077755;258103081661;3906;0,1,3,5,6;5;2,9;2;1;1
258103081661;258103081845;184;0,1,3,5,6;5;2,9;2;1;1
258103081845;258103082087;242;0,1,3,5,6;5;2,9;2;1;1
258103082087;258103082158;71;0,1,3,5,6;5;2,9;2;1;1
258103082158;258103082301;143;0,1,3,5,6;5;2,9;2;1;1
258103082301;258103082443;142;0,1,3,5,6;5;2,9;2;1;1
258103082443;258103082472;29;0,1,3,5,6;5;2,9;2;1;1
258103082472;258103082636;164;0,1,3,5,6;5;2,9;2;1;1
258103082636;258103082672;36;0,1,3,5,6;5;2,9;2;1;1
258103082672;258103082704;32;0,1,3,5,6;5;2,9;2;1;1
258103082704;258103082898;194;0,1,3,5,6;5;2,9;2;1;1
258103082898;258103083386;488;0,1,3,5,6;5;2,9;2;1;1
258103083386;258103083965;579;0,1,3,5,6;5;2,9;2;1;1
258103083965;258103086823;2858;0,1,3,5,6;5;2,9;2;1;1
258103086823;258103086930;107;0,1,3,5,6;5;2,9;2;1;1
258103086930;258103087243;313;0,1,3,5,6;5;2,9;2;1;1
258103087243;258103087432;189;0,1,3,5,6;5;2,9;2;1;1
258103087432;258103088347;915;0,1,3,5,6;5;2,9;2;1;1
258103088347;258103088356;9;0,1,3,5,6;5;2,9;2;1;1
258103088356;258103088371;15;0,1,3,5,6;5;2,9;2;1;1
258103088371;258103088425;54;0,1,3,5,6;5;2,9;2;1;1
258103088425;258103093157;4732;0,1,3,5,6;5;2,9;2;1;1
258103093157;258103097724;4567;0,1,3,5,6;5;2,9;2;1;1
258103097724;258103114259;16535;0,1,3,5;4;2,9;2;1;1
258103114259;258103119175;4916;0,1,3,5;4;2,9;2;1;1
258103119175;258103124160;4985;0,1,3,5;4;2,9;2;1;1
258103124160;258103134122;9962;0,1,3,5;4;2,9;2;1;1
258103134122;258103134209;87;0,1,3,5;4;2,9;2;1;1
258103134209;258103137032;2823;0,1,3,5;4;2,9;2;1;1
258103137032;258103166703;29671;0,1,3,5;4;2,9;2;1;1
258103166703;258103169465;2762;0,1,3,5;4;2,9;2;1;1
258103169465;258103169674;209;0,1,3,5;4;2,9;2;1;1
258103169674;258103179644;9970;0,1,3,5;4;2,9;2;1;1
258103179644;258103179861;217;0,1,3,5;4;2,9;2;1;1
258103179861;258103179911;50;0,1,3,5;4;2,9;2;1;1
258103179911;258103194147;14236;0,1,3,5;4;2,9;2;1;1
258103194147;258103194153;6;0,1,3,5;4;2,9;2;1;1
258103194153;258103195112;959;0,1,3,5;4;2,9;2;1;1
258103195112;258103196144;1032;0,1,3,5;4;2,9;2;1;1
258103196144;258103198893;2749;0,1,3,5;4;2,9;2;1;1
258103198893;258103199100;207;0,1,3,5;4;2,9;2;1;1
258103199100;258103199113;13;0,1,3,5;4;2,9;2;1;1
258103199113;258103199274;161;0,1,3,5;4;2,9;2;1;1
258103199274;258103199310;36;0,1,3,5;4;2,9;2;1;1
258103199310;258103218888;19578;0,1,3,5;4;2,9;2;1;1
258103218888;258103220199;1311;0,1,3,5;4;2,9;2;1;1
258103220199;258103220706;507;0,1,3,5;4;2,9;2;1;1
258103220706;258103220904;198;0,1,3,5;4;2,9;2;1;1
258103220904;258103220985;81;0,1,3,5;4;2,9;2;1;1
258103220985;258103221069;84;0,1,3,5;4;2,9;2;1;1
258103221069;258103230529;9460;0,1,3,5;4;2,9;2;1;1
258103230529;258103231386;857;0,1,3,5;4;2,9;2;1;1
258103231386;258103233766;2380;0,1,3,5;4;2,9;2;1;1
258103233766;258103233781;15;0,1,3,5;4;2,9;2;1;1
258103233781;258103233856;75;0,1,3,5;4;2,9;2;1;1
258103233856;258103237119;3263;0,1,3,5;4;2,9;2;1;1
258103237119;258103237177;58;0,1,3,5;4;2,9;2;1;1
258103237177;258103237576;399;0,1,3,5;4;2,9;2;1;1
258103237576;258103237666;90;0,1,3,5,6;5;2,9;2;1;1
258103237666;258103237695;29;0,1,3,5,6;5;2,9;2;1;1
258103237695;258103237708;13;0,1,3,5,6;5;2,9;2;1;1
258103237708;258103237821;113;0,1,3,5,6;5;2,9;2;1;1
258103237821;258103237841;20;0,1,3,5,6;5;2,9;2;1;1
258103237841;258103238190;349;0,1,3,5,6;5;2,9;2;1;1
258103238190;258103238339;149;0,1,3,5,6;5;2,9;2;1;1
258103238339;258103238404;65;0,1,3,5,6;5;2,9;2;1;1
258103238404;258103238869;465;0,1,3,5,6;5;2,9;2;1;1
258103238869;258103239158;289;0,1,3,5,6;5;2,9;2;1;1
258103239158;258103256868;17710;0,1,3,5,6;5;2,9;2;1;1
258103256868;258103258882;2014;0,1,3,5;4;2,9;2;1;1
258103258882;258103259075;193;0,1,3,5;4;2,9;2;1;1
258103259075;258103259118;43;0,1,3,5;4;2,9;2;1;1
258103259118;258103259186;68;0,1,3,5;4;2,9;2;1;1
258103259186;258103259221;35;0,1,3,5,6;5;2,9;2;1;1
258103259221;258103259414;193;0,1,3,5,6;5;2,9;2;1;1
258103259414;258103259451;37;0,1,3,5,6;5;2,9;2;1;1
258103259451;258103259599;148;0,1,3,5,6;5;2,9;2;1;1
258103259599;258103259636;37;0,1,3,5,6;5;2,9;2;1;1
258103259636;258103259731;95;0,1,3,5;4;2,9;2;1;1
258103259731;258103266890;7159;0,1,3,5;4;2,9;2;1;1
258103266890;258103267637;747;0,1,3,5;4;2,9;2;1;1
258103267637;258103282639;15002;0,1,3,5;4;2,9;2;1;1
258103282639;258103298424;15785;0,1,3,5;4;2,9;2;1;1
258103298424;258103298466;42;0,1,3,5;4;2,9;2;1;1
258103298466;258103298508;42;0,1,3,5;4;2,9;2;1;1
258103298508;258103302851;4343;0,1,3,5;4;2,9;2;1;1
258103302851;258103303046;195;0,1,3,5,6;5;2,9;2;1;1
258103303046;258103303313;267;0,1,3,5;4;2,9;2;1;1
258103303313;258103303491;178;0,1,3,5;4;2,9;2;1;1
258103303491;258103303511;20;0,1,3,5;4;2,9;2;1;1
258103303511;258103303662;151;0,1,3,5;4;2,9;2;1;1
258103303662;258103303731;69;0,1,3,5;4;2,9;2;1;1
258103303731;258103303895;164;0,1,3,5;4;2,9;2;1;1
258103303895;258103304061;166;0,1,3,5;4;2,9;2;1;1
258103304061;258103304225;164;0,1,3,5;4;2,9;2;1;1
258103304225;258103309286;5061;0,1,3,5;4;2,9;2;1;1
258103309286;258103309338;52;0,1,3,5;4;2,9;2;1;1
258103309338;258103309465;127;0,1,3,5;4;2,9;2;1;1
258103309465;258103310739;1274;0,1,3,5;4;2,9;2;1;1
258103310739;258103310809;70;0,1,3,5;4;2,9;2;1;1
258103310809;258103310834;25;0,1,3,5;4;2,9;2;1;1
258103310834;258103310908;74;0,1,3,5;4;2,9;2;1;1
258103310908;258103310982;74;0,1,3,5;4;2,9;2;1;1
258103310982;258103311067;85;0,1,3,5;4;2,9;2;1;1
258103311067;258103311145;78;0,1,3,5;4;2,9;2;1;1
258103311145;258103311238;93;0,1,3,5;4;2,9;2;1;1
258103311238;258103311354;116;0,1,3,5;4;2,9;2;1;1
258103311354;258103311448;94;0,1,3,5;4;2,9;2;1;1
258103311448;258103312548;1100;0,1,3,5;4;2,9;2;1;1
258103312548;258103312895;347;0,1,3,5;4;2,9;2;1;1
258103312895;258103313250;355;0,1,3,5;4;2,9;2;1;1
258103313250;258103313330;80;0,1,3,5;4;2,9;2;1;1
258103313330;258103314632;1302;0,1,3,5;4;2,9;2;1;1
258103314632;258103317487;2855;0,1,3,5;4;2,9;2;1;1
258103317487;258103317635;148;0,1,3,5;4;2,9;2;1;1
258103317635;258103317741;106;0,1,3,5,6;5;2,9;2;1;1
258103317741;258103317781;40;0,1,3,5,6;5;2,9;2;1;1
258103317781;258103317824;43;0,1,3,5,6;5;2,9;2;1;1
258103317824;258103317905;81;0,1,3,5,6;5;2,9;2;1;1
258103317905;258103318081;176;0,1,3,5,6;5;2,9;2;1;1
258103318081;258103318110;29;0,1,3,5;4;2,9;2;1;1
258103318110;258103318175;65;0,1,3,5;4;2,9;2;1;1
258103318175;258103318270;95;0,1,3,5,6;5;2,9;2;1;1
258103318270;258103318333;63;0,1,3,5,6;5;2,9;2;1;1
258103318333;258103318365;32;0,1,3,5,6;5;2,9;2;1;1
258103318365;258103318440;75;0,1,3,5,6;5;2,9;2;1;1
258103318440;258103318498;58;0,1,3,5;4;2,9;2;1;1
258103318498;258103318637;139;0,1,3,5;4;2,9;2;1;1
258103318637;258103318827;190;0,1,3,5;4;2,9;2;1;1
258103318827;258103318847;20;0,1,3,5;4;2,9;2;1;1
258103318847;258103318889;42;0,1,3,5;4;2,9;2;1;1
258103318889;258103319139;250;0,1,3,5;4;2,9;2;1;1
258103319139;258103319176;37;0,1,3,5;4;2,9;2;1;1
258103319176;258103319427;251;0,1,3,5;4;2,9;2;1;1
258103319427;258103319572;145;0,1,3,5;4;2,9;2;1;1
258103319572;258103325126;5554;0,1,3,5;4;2,9;2;1;1
258103325126;258103325669;543;0,1,3,5;4;2,9;2;1;1
258103325669;258103325844;175;0,1,3,5;4;2,9;2;1;1
258103325844;258103325875;31;0,1,3,5;4;2,9;2;1;1
258103325875;258103326396;521;0,1,3,5;4;2,9;2;1;1
258103326396;258103331764;5368;0,1,3,5;4;2,9;2;1;1
258103331764;258103332137;373;0,1,3,5;4;2,9;2;1;1
258103332137;258103332212;75;0,1,3,5;4;2,9;2;1;1
258103332212;258103332275;63;0,1,3,5;4;2,9;2;1;1
258103332275;258103333584;1309;0,1,3,5;4;2,9;2;1;1
258103333584;258103333597;13;0,1,3,5;4;2,9;2;1;1
258103333597;258103333782;185;0,1,3,5;4;2,9;2;1;1
258103333782;258103334388;606;0,1,3,5;4;2,9;2;1;1
258103334388;258103363655;29267;0,1,3,5;4;2,9;2;1;1
258103363655;258103367819;4164;0,1,3,5;4;2,9;2;1;1
258103367819;258103367840;21;0,1,3,5;4;2,9;2;1;1
258103367840;258103367854;14;0,1,3,5;4;2,9;2;1;1
258103367854;258103367895;41;0,1,3,5;4;2,9;2;1;1
258103367895;258103367947;52;0,1,3,5;4;2,9;2;1;1
258103367947;258103367997;50;0,1,3,5;4;2,9;2;1;1
258103367997;258103368024;27;0,1,3,5;4;2,9;2;1;1
258103368024;258103372852;4828;0,1,3,5;4;2,9;2;1;1
258103372852;258103383618;10766;0,1,3,5;4;2,9;2;1;1
258103383618;258103383671;53;0,1,3,5;4;2,9;2;1;1
258103383671;258103383707;36;0,1,3,5;4;2,9;2;1;1
258103383707;258103383737;30;0,1,3,5;4;2,9;2;1;1
258103383737;258103383756;19;0,1,3,5;4;2,9;2;1;1
258103383756;258103383787;31;0,1,3,5;4;2,9;2;1;1
258103383787;258103384446;659;0,1,3,5;4;2,9;2;1;1
258103384446;258103401750;17304;0,1,3,5;4;2,9;2;1;1
258103401750;258103402038;288;0,1,3,5;4;2,9;2;1;1
258103402038;258103405819;3781;0,1,3,5;4;2,9;2;1;1
258103405819;258103405866;47;0,1,3,5;4;2,9;2;1;1
258103405866;258103405906;40;0,1,3,5;4;2,9;2;1;1
258103405906;258103405960;54;0,1,3,5,6;5;2,9;2;1;1
258103405960;258103405972;12;0,1,3,5,6;5;2,9;2;1;1
258103405972;258103406003;31;0,1,3,5,6;5;2,9;2;1;1
258103406003;258103406086;83;0,1,3,5,6;5;2,9;2;1;1
258103406086;258103406230;144;0,1,3,5;4;2,9;2;1;1
258103406230;258103406299;69;0,1,3,5;4;2,9;2;1;1
258103406299;258103406430;131;0,1,3,5;4;2,9;2;1;1
258103406430;258103408509;2079;0,1,3,5;4;2,9;2;1;1
258103408509;258103408712;203;0,1,3,5,6;5;2,9;2;1;1
258103408712;258103409397;685;0,1,3,5;4;2,9;2;1;1
258103409397;258103409585;188;0,1,3,5;4;2,9;2;1;1
258103409585;258103409626;41;0,1,3,5;4;2,9;2;1;1
258103409626;258103409782;156;0,1,3,5;4;2,9;2;1;1
258103409782;258103409950;168;0,1,3,5;4;2,9;2;1;1
258103409950;258103410118;168;0,1,3,5;4;2,9;2;1;1
258103410118;258103410287;169;0,1,3,5;4;2,9;2;1;1
258103410287;258103410453;166;0,1,3,5;4;2,9;2;1;1
258103410453;258103413755;3302;0,1,3,5;4;2,9;2;1;1
258103413755;258103413869;114;0,1,3,5;4;2,9;2;1;1
258103413869;258103413900;31;0,1,3,5,6;5;2,9;2;1;1
258103413900;258103414082;182;0,1,3,5,6;5;2,9;2;1;1
258103414082;258103414269;187;0,1,3,5,6;5;2,9;2;1;1
258103414269;258103414308;39;0,1,3,5,6;5;2,9;2;1;1
258103414308;258103414438;130;0,1,3,5,6;5;2,9;2;1;1
258103414438;258103414581;143;0,1,3,5,6;5;2,9;2;1;1
258103414581;258103414802;221;0,1,3,5;4;2,9;2;1;1
258103414802;258103414926;124;0,1,3,5;4;2,9;2;1;1
258103414926;258103416563;1637;0,1,3,5;4;2,9;2;1;1
258103416563;258103420517;3954;0,1,3,5;4;2,9;2;1;1
258103420517;258103424413;3896;0,1,3,5;4;2,9;2;1;1
258103424413;258103429691;5278;0,1,3,5;4;2,9;2;1;1
258103429691;258103429724;33;0,1,3,5;4;2,9;2;1;1
258103429724;258103429804;80;0,1,3,5;4;2,9;2;1;1
258103429804;258103440846;11042;0,1,3,5;4;2,9;2;1;1
258103440846;258103442688;1842;0,1,3,5;4;2,9;2;1;1
258103442688;258103442738;50;0,1,3,5;4;2,9;2;1;1
258103442738;258103442788;50;0,1,3,5;4;2,9;2;1;1
258103442788;258103442823;35;0,1,3,5;4;2,9;2;1;1
258103442823;258103442845;22;0,1,3,5;4;2,9;2;1;1
258103442845;258103444104;1259;0,1,3,5;4;2,9;2;1;1
258103444104;258103445086;982;0,1,3,5;4;2,9;2;1;1
258103445086;258103445391;305;0,1,3,5;4;2,9;2;1;1
258103445391;258103450588;5197;0,1,3,5;4;2,9;2;1;1
258103450588;258103450731;143;0,1,3,5,6;5;2,9;2;1;1
258103450731;258103450803;72;0,1,3,5,6;5;2,9;2;1;1
258103450803;258103450871;68;0,1,3,5,6;5;2,9;2;1;1
258103450871;258103450947;76;0,1,3,5,6;5;2,9;2;1;1
258103450947;258103450968;21;0,1,3,5;4;2,9;2;1;1
258103450968;258103451134;166;0,1,3,5;4;2,9;2;1;1
258103451134;258103451317;183;0,1,3,5;4;2,9;2;1;1
258103451317;258103451356;39;0,1,3,5;4;2,9;2;1;1
258103451356;258103451578;222;0,1,3,5;4;2,9;2;1;1
258103451578;258103451600;22;0,1,3,5;4;2,9;2;1;1
258103451600;258103455082;3482;0,1,3,5;4;2,9;2;1;1
258103455082;258103455290;208;0,1,3,5;4;2,9;2;1;1
258103455290;258103455780;490;0,1,3,5;4;2,9;2;1;1
258103455780;258103455913;133;0,1,3,5;4;2,9;2;1;1
258103455913;258103455970;57;0,1,3,5;4;2,9;2;1;1
258103455970;258103455989;19;0,1,3,5;4;2,9;2;1;1
258103455989;258103456067;78;0,1,3,5;4;2,9;2;1;1
258103456067;258103456198;131;0,1,3,5;4;2,9;2;1;1
258103456198;258103456245;47;0,1,3,5;4;2,9;2;1;1
258103456245;258103456303;58;0,1,3,5;4;2,9;2;1;1
258103456303;258103456353;50;0,1,3,5;4;2,9;2;1;1
258103456353;258103456407;54;0,1,3,5;4;2,9;2;1;1
258103456407;258103456467;60;0,1,3,5;4;2,9;2;1;1
258103456467;258103456606;139;0,1,3,5;4;2,9;2;1;1
258103456606;258103456806;200;0,1,3,5;4;2,9;2;1;1
258103456806;258103457242;436;0,1,3,5;4;2,9;2;1;1
258103457242;258103457277;35;0,1,3,5;4;2,9;2;1;1
258103457277;258103471257;13980;0,1,3,5;4;2,9;2;1;1
258103471257;258103493025;21768;0,1,3,5;4;2,9;2;1;1
258103493025;258103495550;2525;0,1,3,5;4;2,9;2;1;1
258103495550;258103497023;1473;0,1,3,5;4;2,9;2;1;1
258103497023;258103509583;12560;0,1,3,5;4;2,9;2;1;1
258103509583;258103513367;3784;0,1,3,5;4;2,9;2;1;1
258103513367;258103513555;188;0,1,3,5;4;2,9;2;1;1
258103513555;258103514069;514;0,1,3,5;4;2,9;2;1;1
258103514069;258103514766;697;0,1,3,5;4;2,9;2;1;1
258103514766;258103516672;1906;0,1,3,5;4;2,9;2;1;1
258103516672;258103516680;8;0,1,3,5;4;2,9;2;1;1
258103516680;258103516736;56;0,1,3,5;4;2,9;2;1;1
258103516736;258103516789;53;0,1,3,5;4;2,9;2;1;1
258103516789;258103517888;1099;0,1,3,5;4;2,9;2;1;1
258103517888;258103518248;360;0,1,3,5;4;2,9;2;1;1
258103518248;258103518415;167;0,1,3,5;4;2,9;2;1;1
258103518415;258103518689;274;0,1,3,5;4;2,9;2;1;1
258103518689;258103520043;1354;0,1,3,5;4;2,9;2;1;1
258103520043;258103520217;174;0,1,3,5,6;5;2,9;2;1;1
258103520217;258103520575;358;0,1,3,5;4;2,9;2;1;1
258103520575;258103520620;45;0,1,3,5;4;2,9;2;1;1
258103520620;258103520736;116;0,1,3,5;4;2,9;2;1;1
258103520736;258103520743;7;0,1,3,5;4;2,9;2;1;1
258103520743;258103520810;67;0,1,3,5;4;2,9;2;1;1
258103520810;258103520910;100;0,1,3,5;4;2,9;2;1;1
258103520910;258103520961;51;0,1,3,5;4;2,9;2;1;1
258103520961;258103521217;256;0,1,3,5;4;2,9;2;1;1
258103521217;258103522265;1048;0,1,3,5;4;2,9;2;1;1
258103522265;258103522474;209;0,1,3,5,6;5;2,9;2;1;1
258103522474;258103522496;22;0,1,3,5;4;2,9;2;1;1
258103522496;258103522532;36;0,1,3,5;4;2,9;2;1;1
258103522532;258103522652;120;0,1,3,5;4;2,9;2;1;1
258103522652;258103522999;347;0,1,3,5;4;2,9;2;1;1
258103522999;258103523238;239;0,1,3,5;4;2,9;2;1;1
258103523238;258103523402;164;0,1,3,5;4;2,9;2;1;1
258103523402;258103523570;168;0,1,3,5;4;2,9;2;1;1
258103523570;258103523735;165;0,1,3,5;4;2,9;2;1;1
258103523735;258103530213;6478;0,1,3,5;4;2,9;2;1;1
258103530213;258103533563;3350;0,1,3,5;4;2,9;2;1;1
258103533563;258103538065;4502;0,1,3,5;4;2,9;2;1;1
258103538065;258103540683;2618;0,1,3,5;4;2,9;2;1;1
258103540683;258103540795;112;0,1,3,5;4;2,9;2;1;1
258103540795;258103541019;224;0,1,3,5,6;5;2,9;2;1;1
258103541019;258103541062;43;0,1,3,5,6;5;2,9;2;1;1
258103541062;258103541097;35;0,1,3,5,6;5;2,9;2;1;1
258103541097;258103541164;67;0,1,3,5,6;5;2,9;2;1;1
258103541164;258103541223;59;0,1,3,5,6;5;2,9;2;1;1
258103541223;258103541302;79;0,1,3,5;4;2,9;2;1;1
258103541302;258103541307;5;0,1,3,5;4;2,9;2;1;1
258103541307;258103541482;175;0,1,3,5;4;2,9;2;1;1
258103541482;258103546441;4959;0,1,3,5;4;2,9;2;1;1
258103546441;258103546501;60;0,1,3,5;4;2,9;2;1;1
258103546501;258103546545;44;0,1,3,5;4;2,9;2;1;1
258103546545;258103547125;580;0,1,3,5;4;2,9;2;1;1
258103547125;258103548849;1724;0,1,3,5;4;2,9;2;1;1
258103548849;258103548887;38;0,1,3,5;4;2,9;2;1;1
258103548887;258103549749;862;0,1,3,5;4;2,9;2;1;1
258103549749;258103550221;472;0,1,3,5;4;2,9;2;1;1
258103550221;258103550258;37;0,1,3,5;4;2,9;2;1;1
258103550258;258103554984;4726;0,1,3,5;4;2,9;2;1;1
258103554984;258103587332;32348;0,1,3,5;4;2,9;2;1;1
258103587332;258103597511;10179;0,1,3,5;4;2,9;2;1;1
258103597511;258103597534;23;0,1,3,5;4;2,9;2;1;1
258103597534;258103611259;13725;0,1,3,5;4;2,9;2;1;1
258103611259;258103611502;243;0,1,3,5;4;2,9;2;1;1
258103611502;258103625324;13822;0,1,3,5;4;2,9;2;1;1
258103625324;258103625608;284;0,1,3,5;4;2,9;2;1;1
258103625608;258103632456;6848;0,1,3,5;4;2,9;2;1;1
258103632456;258103637701;5245;0,1,3,5;4;2,9;2;1;1
258103637701;258103638054;353;0,1,3,5;4;2,9;2;1;1
258103638054;258103638430;376;0,1,3,5;4;2,9;2;1;1
258103638430;258103638577;147;0,1,3,5;4;2,9;2;1;1
258103638577;258103638715;138;0,1,3,5;4;2,9;2;1;1
258103638715;258103638849;134;0,1,3,5;4;2,9;2;1;1
258103638849;258103638984;135;0,1,3,5;4;2,9;2;1;1
258103638984;258103639120;136;0,1,3,5;4;2,9;2;1;1
258103639120;258103639156;36;0,1,3,5;4;2,9;2;1;1
258103639156;258103639297;141;0,1,3,5,6;5;2,9;2;1;1
258103639297;258103642239;2942;0,1,3,5;4;2,9;2;1;1
258103642239;258103642309;70;0,1,3,5;4;2,9;2;1;1
258103642309;258103661524;19215;0,1,3,5;4;2,9;2;1;1
258103661524;258103673124;11600;0,1,3,5;4;2,9;2;1;1
258103673124;258103686695;13571;0,1,3,5;4;2,9;2;1;1
258103686695;258103686715;20;0,1,3,5;4;2,9;2;1;1
258103686715;258103686731;16;0,1,3,5;4;2,9;2;1;1
258103686731;258103686989;258;0,1,3,5;4;2,9;2;1;1
258103686989;258103687251;262;0,1,3,5;4;2,9;2;1;1
258103687251;258103687755;504;0,1,3,5;4;2,9;2;1;1
258103687755;258103694623;6868;0,1,3,5;4;2,9;2;1;1
258103694623;258103696102;1479;0,1,3,5;4;2,9;2;1;1
258103696102;258103696152;50;0,1,3,5;4;2,9;2;1;1
258103696152;258103696201;49;0,1,3,5;4;2,9;2;1;1
258103696201;258103696210;9;0,1,3,5;4;2,9;2;1;1
258103696210;258103696261;51;0,1,3,5;4;2,9;2;1;1
258103696261;258103696287;26;0,1,3,5;4;2,9;2;1;1
258103696287;258103700483;4196;0,1,3,5;4;2,9;2;1;1
258103700483;258103700498;15;0,1,3,5,6;5;2,9;2;1;1
258103700498;258103700635;137;0,1,3,5,6;5;2,9;2;1;1
258103700635;258103700777;142;0,1,3,5;4;2,9;2;1;1
258103700777;258103700810;33;0,1,3,5;4;2,9;2;1;1
258103700810;258103700915;105;0,1,3,5;4;2,9;2;1;1
258103700915;258103700938;23;0,1,3,5;4;2,9;2;1;1
258103700938;258103701119;181;0,1,3,5;4;2,9;2;1;1
258103701119;258103701159;40;0,1,3,5;4;2,9;2;1;1
258103701159;258103701314;155;0,1,3,5;4;2,9;2;1;1
258103701314;258103703643;2329;0,1,3,5;4;2,9;2;1;1
258103703643;258103704278;635;0,1,3,5;4;2,9;2;1;1
258103704278;258103704716;438;0,1,3,5;4;2,9;2;1;1
258103704716;258103705441;725;0,1,3,5;4;2,9;2;1;1
258103705441;258103705460;19;0,1,3,5;4;2,9;2;1;1
258103705460;258103705517;57;0,1,3,5,6;5;2,9;2;1;1
258103705517;258103705606;89;0,1,3,5,6;5;2,9;2;1;1
258103705606;258103705759;153;0,1,3,5,6;5;2,9;2;1;1
258103705759;258103706126;367;0,1,3,5,6;5;2,9;2;1;1
258103706126;258103706246;120;0,1,3,5,6;5;2,9;2;1;1
258103706246;258103706294;48;0,1,3,5,6;5;2,9;2;1;1
258103706294;258103706574;280;0,1,3,5,6;5;2,9;2;1;1
258103706574;258103708475;1901;0,1,3,5,6;5;2,9;2;1;1
258103708475;258103708587;112;0,1,3,5,6;5;2,9;2;1;1
258103708587;258103708622;35;0,1,3,5,6;5;2,9;2;1;1
258103708622;258103717170;8548;0,1,3,5,6;5;2,9;2;1;1
258103717170;258103717481;311;0,1,3,5,6;5;2,9;2;1;1
258103717481;258103717762;281;0,1,3,5,6;5;2,9;2;1;1
258103717762;258103718827;1065;0,1,3,5,6;5;2,9;2;1;1
258103718827;258103719520;693;0,1,3,5,6;5;2,9;2;1;1
258103719520;258103720668;1148;0,1,3,5,6;5;2,9;2;1;1
258103720668;258103727357;6689;0,1,3,5,6;5;2,9;2;1;1
258103727357;258103727793;436;0,1,3,5;4;2,9;2;1;1
258103727793;258103728531;738;0,1,3,5;4;2,9;2;1;1
258103728531;258103728603;72;0,1,3,5;4;2,9;2;1;1
258103728603;258103728797;194;0,1,3,5;4;2,9;2;1;1
258103728797;258103728884;87;0,1,3,5;4;2,9;2;1;1
258103728884;258103728898;14;0,1,3,5;4;2,9;2;1;1
258103728898;258103728940;42;0,1,3,5;4;2,9;2;1;1
258103728940;258103728943;3;0,1,3,5,6;5;2,9;2;1;1
258103728943;258103729111;168;0,1,3,5,6;5;2,9;2;1;1
258103729111;258103729145;34;0,1,3,5;4;2,9;2;1;1
258103729145;258103729243;98;0,1,3,5;4;2,9;2;1;1
258103729243;258103729305;62;0,1,3,5;4;2,9;2;1;1
258103729305;258103729461;156;0,1,3,5;4;2,9;2;1;1
258103729461;258103732875;3414;0,1,3,5;4;2,9;2;1;1
258103732875;258103732929;54;0,1,3,5,6;5;2,9;2;1;1
258103732929;258103732992;63;0,1,3,5,6;5;2,9;2;1;1
258103732992;258103733139;147;0,1,3,5,6;5;2,9;2;1;1
258103733139;258103733246;107;0,1,3,5,6;5;2,9;2;1;1
258103733246;258103733283;37;0,1,3,5;4;2,9;2;1;1
258103733283;258103733285;2;0,1,3,5;4;2,9;2;1;1
258103733285;258103733426;141;0,1,3,5;4;2,9;2;1;1
258103733426;258103733562;136;0,1,3,5;4;2,9;2;1;1
258103733562;258103733600;38;0,1,3,5;4;2,9;2;1;1
258103733600;258103733700;100;0,1,3,5;4;2,9;2;1;1
258103733700;258103740763;7063;0,1,3,5;4;2,9;2;1;1
258103740763;258103743203;2440;0,1,3,5;4;2,9;2;1;1
258103743203;258103764462;21259;0,1,3,5;4;2,9;2;1;1
258103764462;258103775814;11352;0,1,3,5;4;2,9;2;1;1
258103775814;258103776008;194;0,1,3,5;4;2,9;2;1;1
258103776008;258103776066;58;0,1,3,5;4;2,9;2;1;1
258103776066;258103776158;92;0,1,3,5;4;2,9;2;1;1
258103776158;258103776749;591;0,1,3,5;4;2,9;2;1;1
258103776749;258103776783;34;0,1,3,5;4;2,9;2;1;1
258103776783;258103776786;3;0,1,3,5;4;2,9;2;1;1
258103776786;258103776823;37;0,1,3,5;4;2,9;2;1;1
258103776823;258103776848;25;0,1,3,5,6;5;2,9;2;1;1
258103776848;258103776963;115;0,1,3,5,6;5;2,9;2;1;1
258103776963;258103777053;90;0,1,3,5;4;2,9;2;1;1
258103777053;258103777411;358;0,1,3,5;4;2,9;2;1;1
258103777411;258103777558;147;0,1,3,5;4;2,9;2;1;1
258103777558;258103777706;148;0,1,3,5;4;2,9;2;1;1
258103777706;258103777897;191;0,1,3,5;4;2,9;2;1;1
258103777897;258103778043;146;0,1,3,5;4;2,9;2;1;1
258103778043;258103790466;12423;0,1,3,5;4;2,9;2;1;1
258103790466;258103800024;9558;0,1,3,5;4;2,9;2;1;1
258103800024;258103808749;8725;0,1,3,5;4;2,9;2;1;1
258103808749;258103808886;137;0,1,3,5;4;2,9;2;1;1
258103808886;258103809023;137;0,1,3,5;4;2,9;2;1;1
258103809023;258103809150;127;0,1,3,5;4;2,9;2;1;1
258103809150;258103809273;123;0,1,3,5;4;2,9;2;1;1
258103809273;258103809773;500;0,1,3,5;4;2,9;2;1;1
258103809773;258103810313;540;0,1,3,5;4;2,9;2;1;1
258103810313;258103810609;296;0,1,3,5;4;2,9;2;1;1
258103810609;258103811293;684;0,1,3,5;4;9;1;1;1
258103811293;258103811319;26;0,1,3,5;4;9;1;1;1
258103811319;258103811373;54;0,1,3,5;4;9;1;1;1
258103811373;258103814846;3473;0,1,3,5;4;9;1;1;1
258103814846;258103814862;16;0,1,3,5;4;9;1;1;1
258103814862;258103814899;37;0,1,3,5;4;9;1;1;1
258103814899;258103814928;29;0,1,3,5,6;5;9;1;1;1
258103814928;258103814944;16;0,1,3,5,6;5;9;1;1;1
258103814944;258103814970;26;0,1,3,5,6;5;9;1;1;1
258103814970;258103815018;48;0,1,3,5,6;5;9;1;1;1
258103815018;258103815063;45;0,1,3,5,6;5;9;1;1;1
258103815063;258103815182;119;0,1,3,5,6;5;9;1;1;1
258103815182;258103815195;13;0,1,3,5;4;9;1;1;1
258103815195;258103815773;578;0,1,3,5;4;9;1;1;1
258103815773;258103815942;169;0,1,3,5,6;5;9;1;1;1
258103815942;258103816152;210;0,1,3,5;4;9;1;1;1
258103816152;258103816299;147;0,1,3,5;4;9;1;1;1
258103816299;258103816318;19;0,1,3,5;4;9;1;1;1
258103816318;258103816336;18;0,1,3,5;4;9;1;1;1
258103816336;258103816442;106;0,1,3,5;4;9;1;1;1
258103816442;258103816477;35;0,1,3,5;4;9;1;1;1
258103816477;258103816649;172;0,1,3,5;4;9;1;1;1
258103816649;258103816864;215;0,1,3,5;4;9;1;1;1
258103816864;258103824779;7915;0,1,3,5;4;9;1;1;1
258103824779;258103836768;11989;0,1,3,5;4;9;1;1;1
258103836768;258103881318;44550;0,1,3,5;4;9;1;1;1
258103881318;258103881535;217;0,1,3,5;4;9;1;1;1
258103881535;258103883038;1503;0,1,3,5;4;9;1;1;1
258103883038;258103884108;1070;0,1,3,5;4;9;1;1;1
258103884108;258103884544;436;0,1,3,5;4;9;1;1;1
258103884544;258103884915;371;0,1,3,5;4;9;1;1;1
258103884915;258103884943;28;0,1,3,5;4;9;1;1;1
258103884943;258103885081;138;0,1,3,5;4;9;1;1;1
258103885081;258103890442;5361;0,1,3,5;4;9;1;1;1
258103890442;258103892474;2032;0,1,3,5;4;9;1;1;1
258103892474;258103892920;446;0,1,3,5;4;9;1;1;1
258103892920;258103906770;13850;0,1,3,5;4;9;1;1;1
258103906770;258103940298;33528;0,1,3,5;4;9;1;1;1
258103940298;258103940443;145;0,1,3,5;4;9;1;1;1
258103940443;258103940460;17;0,1,3,5;4;9;1;1;1
258103940460;258103940468;8;0,1,3,5;4;9;1;1;1
258103940468;258103940573;105;0,1,3,5;4;9;1;1;1
258103940573;258103940783;210;0,1,3,5;4;9;1;1;1
258103940783;258103940930;147;0,1,3,5;4;9;1;1;1
258103940930;258103941089;159;0,1,3,5;4;9;1;1;1
258103941089;258103968722;27633;0,1,3,5;4;9;1;1;1
258103968722;258103978080;9358;0,1,3,5;4;9;1;1;1
258103978080;258103979811;1731;0,1,3,5;4;9;1;1;1
258103979811;258103979861;50;0,1,3,5;4;9;1;1;1
258103979861;258103979911;50;0,1,3,5;4;9;1;1;1
258103979911;258103980667;756;0,1,3,5;4;9;1;1;1
258103980667;258103982928;2261;0,1,3,5;4;9;1;1;1
258103982928;258103983000;72;0,1,3,5;4;9;1;1;1
258103983000;258103983042;42;0,1,3,5;4;9;1;1;1
258103983042;258103987989;4947;0,1,3,5;4;9;1;1;1
258103987989;258103988039;50;0,1,3,5;4;9;1;1;1
258103988039;258103988101;62;0,1,3,5;4;9;1;1;1
258103988101;258103988112;11;0,1,3,5;4;9;1;1;1
258103988112;258103988136;24;0,1,3,5;4;9;1;1;1
258103988136;258103992080;3944;0,1,3,5;4;9;1;1;1
258103992080;258104026958;34878;0,1,3,5;4;9;1;1;1
258104026958;258104030497;3539;0,1,3,5;4;9;1;1;1
258104030497;258104030556;59;0,1,3,5;4;9;1;1;1
258104030556;258104030704;148;0,1,3,5;4;9;1;1;1
258104030704;258104030951;247;0,1,3,5;4;9;1;1;1
258104030951;258104030989;38;0,1,3,5;4;9;1;1;1
258104030989;258104031007;18;0,1,3,5;4;9;1;1;1
258104031007;258104031124;117;0,1,3,5,6;5;9;1;1;1
258104031124;258104031259;135;0,1,3,5,6;5;9;1;1;1
258104031259;258104031408;149;0,1,3,5,6;5;9;1;1;1
258104031408;258104031527;119;0,1,3,5,6;5;9;1;1;1
258104031527;258104039563;8036;0,1,3,5;4;9;1;1;1
258104039563;258104042181;2618;0,1,3,5;4;9;1;1;1
258104042181;258104042285;104;0,1,3,5;4;9;1;1;1
258104042285;258104042504;219;0,1,3,5;4;9;1;1;1
258104042504;258104042530;26;0,1,3,5;4;9;1;1;1
258104042530;258104044232;1702;0,1,3,5;4;9;1;1;1
258104044232;258104044543;311;0,1,3,5;4;9;1;1;1
258104044543;258104044579;36;0,1,3,5;4;9;1;1;1
258104044579;258104044803;224;0,1,3,5;4;9;1;1;1
258104044803;258104072206;27403;0,1,3,5;4;9;1;1;1
258104072206;258104081651;9445;0,1,3,5;4;9;1;1;1
258104081651;258104081809;158;0,1,3,5;4;9;1;1;1
258104081809;258104081860;51;0,1,3,5;4;9;1;1;1
258104081860;258104081869;9;0,1,3,5;4;9;1;1;1
258104081869;258104119302;37433;0,1,3,5;4;9;1;1;1
258104119302;258104129988;10686;0,1,3,5;4;9;1;1;1
258104129988;258104130075;87;0,1,3,5;4;9;1;1;1
258104130075;258104130143;68;0,1,3,5;4;9;1;1;1
258104130143;258104130216;73;0,1,3,5;4;9;1;1;1
258104130216;258104130284;68;0,1,3,5;4;9;1;1;1
258104130284;258104130335;51;0,1,3,5;4;9;1;1;1
258104130335;258104131697;1362;0,1,3,5;4;9;1;1;1
258104131697;258104134363;2666;0,1,3,5;4;9;1;1;1
258104134363;258104134465;102;0,1,3,5;4;9;1;1;1
258104134465;258104134601;136;0,1,3,5;4;9;1;1;1
258104134601;258104134779;178;0,1,3,5;4;9;1;1;1
258104134779;258104134858;79;0,1,3,5;4;9;1;1;1
258104134858;258104134953;95;0,1,3,5;4;9;1;1;1
258104134953;258104149948;14995;0,1,3,5;4;9;1;1;1
258104149948;258104150056;108;0,1,3,5;4;9;1;1;1
258104150056;258104172257;22201;0,1,3,5;4;9;1;1;1
258104172257;258104212361;40104;0,1,3,5;4;9;1;1;1
258104212361;258104226089;13728;0,1,3,5;4;9;1;1;1
258104226089;258104234798;8709;0,1,3,5;4;9;1;1;1
258104234798;258104235021;223;0,1,3,5;4;9;1;1;1
258104235021;258104235063;42;0,1,3,5;4;9;1;1;1
258104235063;258104235097;34;0,1,3,5;4;9;1;1;1
258104235097;258104235379;282;0,1,3,5;4;9;1;1;1
258104235379;258104273039;37660;0,1,3,5;4;9;1;1;1
258104273039;258104304863;31824;0,1,3,5;4;9;1;1;1
258104304863;258104338397;33534;0,1,3,5;4;9;1;1;1
258104338397;258104339030;633;0,1,3,5;4;9;1;1;1
258104339030;258104340000;970;0,1,3,5;4;9;1;1;1
258104340000;258104364388;24388;0,1,3,5;4;9;1;1;1
258104364388;258104364417;29;0,1,3,5;4;9;1;1;1
258104364417;258104364462;45;0,1,3,5;4;9;1;1;1
258104364462;258104364561;99;0,1,3,5;4;9;1;1;1
258104364561;258104364591;30;0,1,3,5;4;9;1;1;1
258104364591;258104364603;12;0,1,3,5;4;9;1;1;1
258104364603;258104364621;18;0,1,3,5;4;9;1;1;1
258104364621;258104364748;127;0,1,3,5;4;9;1;1;1
258104364748;258104364782;34;0,1,3,5;4;9;1;1;1
258104364782;258104373828;9046;0,1,3,5;4;9;1;1;1
258104373828;258104377034;3206;0,1,3,5;4;9;1;1;1
258104377034;258104377049;15;0,1,3,5;4;9;1;1;1
258104377049;258104377065;16;0,1,3,5;4;9;1;1;1
258104377065;258104377188;123;0,1,3,5,6;5;9;1;1;1
258104377188;258104377256;68;0,1,3,5,6;5;9;1;1;1
258104377256;258104377330;74;0,1,3,5,6;5;9;1;1;1
258104377330;258104377496;166;0,1,3,5,6;5;9;1;1;1
258104377496;258104377572;76;0,1,3,5;4;9;1;1;1
258104377572;258104377602;30;0,1,3,5;4;9;1;1;1
258104377602;258104377632;30;0,1,3,5;4;9;1;1;1
258104377632;258104377634;2;0,1,3,5;4;9;1;1;1
258104377634;258104377731;97;0,1,3,5;4;9;1;1;1
258104377731;258104377813;82;0,1,3,5;4;9;1;1;1
258104377813;258104377845;32;0,1,3,5;4;9;1;1;1
258104377845;258104377985;140;0,1,3,5;4;9;1;1;1
258104377985;258104378022;37;0,1,3,5;4;9;1;1;1
258104378022;258104381008;2986;0,1,3,5;4;9;1;1;1
258104381008;258104381012;4;0,1,3,5,6;5;9;1;1;1
258104381012;258104381107;95;0,1,3,5,6;5;9;1;1;1
258104381107;258104381151;44;0,1,3,5,6;5;9;1;1;1
258104381151;258104381289;138;0,1,3,5,6;5;9;1;1;1
258104381289;258104381316;27;0,1,3,5,6;5;9;1;1;1
258104381316;258104381354;38;0,1,3,5;4;9;1;1;1
258104381354;258104381421;67;0,1,3,5;4;9;1;1;1
258104381421;258104381905;484;0,1,3,5;4;9;1;1;1
258104381905;258104381943;38;0,1,3,5;4;9;1;1;1
258104381943;258104384309;2366;0,1,3,5;4;9;1;1;1
258104384309;258104384348;39;0,1,3,5;4;9;1;1;1
258104384348;258104384485;137;0,1,3,5,6;5;9;1;1;1
258104384485;258104384548;63;0,1,3,5,6;5;9;1;1;1
258104384548;258104384647;99;0,1,3,5,6;5;9;1;1;1
258104384647;258104384745;98;0,1,3,5;4;9;1;1;1
258104384745;258104384890;145;0,1,3,5;4;9;1;1;1
258104384890;258104384983;93;0,1,3,5;4;9;1;1;1
258104384983;258104385019;36;0,1,3,5;4;9;1;1;1
258104385019;258104385055;36;0,1,3,5;4;9;1;1;1
258104385055;258104385839;784;0,1,3,5;4;9;1;1;1
258104385839;258104395229;9390;0,1,3,5;4;9;1;1;1
258104395229;258104396401;1172;0,1,3,5;4;9;1;1;1
258104396401;258104396500;99;0,1,3,5;4;9;1;1;1
258104396500;258104399890;3390;0,1,3,5;4;9;1;1;1
258104399890;258104400247;357;0,1,3,5;4;9;1;1;1
258104400247;258104401527;1280;0,1,3,5;4;9;1;1;1
258104401527;258104401578;51;0,1,3,5;4;9;1;1;1
258104401578;258104401670;92;0,1,3,5;4;9;1;1;1
258104401670;258104403026;1356;0,1,3,5;4;9;1;1;1
258104403026;258104406612;3586;0,1,3,5;4;9;1;1;1
258104406612;258104406808;196;0,1,3,5;4;9;1;1;1
258104406808;258104406816;8;0,1,3,5;4;9;1;1;1
258104406816;258104406868;52;0,1,3,5;4;9;1;1;1
258104406868;258104406918;50;0,1,3,5;4;9;1;1;1
258104406918;258104406970;52;0,1,3,5;4;9;1;1;1
258104406970;258104407021;51;0,1,3,5;4;9;1;1;1
258104407021;258104407332;311;0,1,3,5;4;9;1;1;1
258104407332;258104408430;1098;0,1,3,5;4;9;1;1;1
258104408430;258104411162;2732;0,1,3,5;4;9;1;1;1
258104411162;258104439286;28124;0,1,3,5;4;9;1;1;1
258104439286;258104449703;10417;0,1,3,5;4;9;1;1;1
258104449703;258104450010;307;0,1,3,5;4;9;1;1;1
258104450010;258104500468;50458;0,1,3,5;4;9;1;1;1
258104500468;258104500606;138;0,1,3,5;4;9;1;1;1
258104500606;258104500627;21;0,1,3,5;4;9;1;1;1
258104500627;258104500816;189;0,1,3,5;4;9;1;1;1
258104500816;258104500844;28;0,1,3,5;4;9;1;1;1
258104500844;258104500962;118;0,1,3,5;4;9;1;1;1
258104500962;258104501008;46;0,1,3,5;4;9;1;1;1
258104501008;258104501164;156;0,1,3,5;4;9;1;1;1
258104501164;258104501238;74;0,1,3,5;4;9;1;1;1
258104501238;258104501290;52;0,1,3,5;4;9;1;1;1
258104501290;258104501377;87;0,1,3,5;4;9;1;1;1
258104501377;258104501678;301;0,1,3,5;4;9;1;1;1
258104501678;258104502419;741;0,1,3,5;4;9;1;1;1
258104502419;258104502896;477;0,1,3,5;4;9;1;1;1
258104502896;258104503076;180;0,1,3,5;4;9;1;1;1
258104503076;258104504156;1080;0,1,3,5;4;9;1;1;1
258104504156;258104504214;58;0,1,3,5;4;9;1;1;1
258104504214;258104508589;4375;0,1,3,5;4;9;1;1;1
258104508589;258104508664;75;0,1,3,5,6;5;9;1;1;1
258104508664;258104508760;96;0,1,3,5,6;5;9;1;1;1
258104508760;258104508797;37;0,1,3,5,6;5;9;1;1;1
258104508797;258104508802;5;0,1,3,5;4;9;1;1;1
258104508802;258104509007;205;0,1,3,5;4;9;1;1;1
258104509007;258104509043;36;0,1,3,5;4;9;1;1;1
258104509043;258104509073;30;0,1,3,5;4;9;1;1;1
258104509073;258104509372;299;0,1,3,5;4;9;1;1;1
258104509372;258104509899;527;0,1,3,5;4;9;1;1;1
258104509899;258104511405;1506;0,1,3,5;4;9;1;1;1
258104511405;258104511514;109;0,1,3,5;4;9;1;1;1
258104511514;258104512016;502;0,1,3,5;4;9;1;1;1
258104512016;258104514622;2606;0,1,3,5;4;9;1;1;1
258104514622;258104514707;85;0,1,3,5;4;9;1;1;1
258104514707;258104515784;1077;0,1,3,5;4;9;1;1;1
258104515784;258104515953;169;0,1,3,5;4;9;1;1;1
258104515953;258104515996;43;0,1,3,5,6;5;9;1;1;1
258104515996;258104516064;68;0,1,3,5,6;5;9;1;1;1
258104516064;258104516092;28;0,1,3,5,6;5;9;1;1;1
258104516092;258104516142;50;0,1,3,5,6;5;9;1;1;1
258104516142;258104516149;7;0,1,3,5;4;9;1;1;1
258104516149;258104516174;25;0,1,3,5;4;9;1;1;1
258104516174;258104516273;99;0,1,3,5;4;9;1;1;1
258104516273;258104516346;73;0,1,3,5;4;9;1;1;1
258104516346;258104516394;48;0,1,3,5;4;9;1;1;1
258104516394;258104516405;11;0,1,3,5;4;9;1;1;1
258104516405;258104516430;25;0,1,3,5;4;9;1;1;1
258104516430;258104516475;45;0,1,3,5;4;9;1;1;1
258104516475;258104516758;283;0,1,3,5;4;9;1;1;1
258104516758;258104516803;45;0,1,3,5;4;9;1;1;1
258104516803;258104517051;248;0,1,3,5;4;9;1;1;1
258104517051;258104517485;434;0,1,3,5;4;9;1;1;1
258104517485;258104517542;57;0,1,3,5;4;9;1;1;1
258104517542;258104518453;911;0,1,3,5;4;9;1;1;1
258104518453;258104518470;17;0,1,3,5;4;9;1;1;1
258104518470;258104518675;205;0,1,3,5,6;5;9;1;1;1
258104518675;258104518859;184;0,1,3,5;4;9;1;1;1
258104518859;258104518905;46;0,1,3,5;4;9;1;1;1
258104518905;258104519001;96;0,1,3,5;4;9;1;1;1
258104519001;258104519129;128;0,1,3,5;4;9;1;1;1
258104519129;258104519350;221;0,1,3,5;4;9;1;1;1
258104519350;258104519520;170;0,1,3,5;4;9;1;1;1
258104519520;258104519698;178;0,1,3,5;4;9;1;1;1
258104519698;258104530259;10561;0,1,3,5;4;9;1;1;1
258104530259;258104533504;3245;0,1,3,5;4;9;1;1;1
258104533504;258104538500;4996;0,1,3,5;4;9;1;1;1
258104538500;258104546407;7907;0,1,3,5;4;9;1;1;1
258104546407;258104551025;4618;0,1,3,5;4;9;1;1;1
258104551025;258104557281;6256;0,1,3,5;4;9;1;1;1
258104557281;258104558753;1472;0,1,3,5;4;9;1;1;1
258104558753;258104558804;51;0,1,3,5;4;9;1;1;1
258104558804;258104558829;25;0,1,3,5;4;9;1;1;1
258104558829;258104558885;56;0,1,3,5;4;9;1;1;1
258104558885;258104558897;12;0,1,3,5;4;9;1;1;1
258104558897;258104558920;23;0,1,3,5;4;9;1;1;1
258104558920;258104559643;723;0,1,3,5;4;9;1;1;1
258104559643;258104561886;2243;0,1,3,5;4;9;1;1;1
258104561886;258104561937;51;0,1,3,5;4;9;1;1;1
258104561937;258104578847;16910;0,1,3,5;4;9;1;1;1
258104578847;258104578873;26;0,1,3,5;4;9;1;1;1
258104578873;258104579242;369;0,1,3,5;4;9;1;1;1
258104579242;258104579508;266;0,1,3,5;4;9;1;1;1
258104579508;258104579524;16;0,1,3,5;4;9;1;1;1
258104579524;258104579683;159;0,1,3,5;4;9;1;1;1
258104579683;258104579752;69;0,1,3,5;4;9;1;1;1
258104579752;258104579791;39;0,1,3,5;4;9;1;1;1
258104579791;258104607053;27262;0,1,3,5;4;9;1;1;1
258104607053;258104607438;385;0,1,3,5;4;9;1;1;1
258104607438;258104607696;258;0,1,3,5;4;9;1;1;1
258104607696;258104607822;126;0,1,3,5;4;9;1;1;1
258104607822;258104607870;48;0,1,3,5;4;9;1;1;1
258104607870;258104607899;29;0,1,3,5;4;9;1;1;1
258104607899;258104607934;35;0,1,3,5,6;5;9;1;1;1
258104607934;258104608013;79;0,1,3,5,6;5;9;1;1;1
258104608013;258104608059;46;0,1,3,5,6;5;9;1;1;1
258104608059;258104610635;2576;0,1,3,5,6;5;9;1;1;1
258104610635;258104610791;156;0,1,3,5,6;5;9;1;1;1
258104610791;258104611327;536;0,1,3,5,6;5;9;1;1;1
258104611327;258104612483;1156;0,1,3,5,6;5;9;1;1;1
258104612483;258104613298;815;0,1,3,5,6;5;9;1;1;1
258104613298;258104613497;199;0,1,3,5,6;5;9;1;1;1
258104613497;258104613538;41;0,1,3,5,6;5;9;1;1;1
258104613538;258104613583;45;0,1,3,5,6;5;9;1;1;1
258104613583;258104613727;144;0,1,3,5,6;5;9;1;1;1
258104613727;258104613787;60;0,1,3,5,6;5;9;1;1;1
258104613787;258104613817;30;0,1,3,5,6;5;9;1;1;1
258104613817;258104613982;165;0,1,3,5,6;5;9;1;1;1
258104613982;258104614008;26;0,1,3,5,6;5;9;1;1;1
258104614008;258104614089;81;0,1,3,5,6;5;9;1;1;1
258104614089;258104614106;17;0,1,3,5,6;5;9;1;1;1
258104614106;258104624056;9950;0,1,3,5,6;5;9;1;1;1
258104624056;258104633099;9043;0,1,3,5;4;9;1;1;1
258104633099;258104653714;20615;0,1,3,5;4;9;1;1;1
258104653714;258104655433;1719;0,1,3,5;4;9;1;1;1
258104655433;258104666137;10704;0,1,3,5;4;9;1;1;1
258104666137;258104666151;14;0,1,3,5;4;9;1;1;1
258104666151;258104666202;51;0,1,3,5;4;9;1;1;1
258104666202;258104666210;8;0,1,3,5;4;9;1;1;1
258104666210;258104666238;28;0,1,3,5;4;9;1;1;1
258104666238;258104672558;6320;0,1,3,5;4;9;1;1;1
258104672558;258104672849;291;0,1,3,5;4;9;1;1;1
258104672849;258104673011;162;0,1,3,4,5;5;2,9;2;1;1
258104673011;258104673208;197;0,1,3,4,5;5;2,9;2;1;1
258104673208;258104673225;17;0,1,3,4,5;5;2,9;2;1;1
258104673225;258104673238;13;0,1,3,4,5;5;2,9;2;1;1
258104673238;258104673268;30;0,1,3,4,5;5;2,9;2;1;1
258104673268;258104680673;7405;0,1,3,4,5;5;2,9;2;1;1
258104680673;258104681133;460;0,1,3,4,5;5;2,9;2;1;1
258104681133;258104681138;5;0,1,3,4,5;5;2,9;2;1;1
258104681138;258104681217;79;0,1,3,4,5;5;2,9;2;1;1
258104681217;258104681594;377;0,1,3,4,5;5;2,9;2;1;1
258104681594;258104681678;84;0,1,3,4,5;5;2,9;2;1;1
258104681678;258104681875;197;0,1,3,4,5;5;2,9;2;1;1
258104681875;258104681897;22;0,1,3,4,5;5;2,9;2;1;1
258104681897;258104681933;36;0,1,3,4,5;5;2,9;2;1;1
258104681933;258104681947;14;0,1,3,4,5;5;2,9;2;1;1
258104681947;258104682110;163;0,1,3,4,5;5;2,9;2;1;1
258104682110;258104695823;13713;0,1,3,4,5;5;2,9;2;1;1
258104695823;258104703889;8066;0,1,3,4,5;5;2,9;2;1;1
258104703889;258104704362;473;0,1,3,4,5;5;2,9;2;1;1
258104704362;258104704581;219;0,1,3,4,5;5;2,9;2;1;1
258104704581;258104704878;297;0,1,3,4,5,6;6;2,9;2;1;1
258104704878;258104705073;195;0,1,3,4,5,6;6;2,9;2;1;1
258104705073;258104705125;52;0,1,3,4,5,6;6;2,9;2;1;1
258104705125;258104705397;272;0,1,3,4,5,6;6;2,9;2;1;1
258104705397;258104705635;238;0,1,3,4,5,6;6;2,9;2;1;1
258104705635;258104705676;41;0,1,3,4,5,6;6;2,9;2;1;1
258104705676;258104705775;99;0,1,3,4,5;5;2,9;2;1;1
258104705775;258104706241;466;0,1,3,4,5;5;2,9;2;1;1
258104706241;258104706629;388;0,1,3,4,5;5;2,9;2;1;1
258104706629;258104710747;4118;0,1,3,4,5;5;2,9;2;1;1
258104710747;258104710919;172;0,1,3,4,5,6;6;2,9;2;1;1
258104710919;258104711068;149;0,1,3,4,5;5;2,9;2;1;1
258104711068;258104711386;318;0,1,3,4,5;5;2,9;2;1;1
258104711386;258104711426;40;0,1,3,4,5;5;2,9;2;1;1
258104711426;258104711713;287;0,1,3,4,5;5;2,9;2;1;1
258104711713;258104711782;69;0,1,3,4,5;5;2,9;2;1;1
258104711782;258104712160;378;0,1,3,4,5;5;2,9;2;1;1
258104712160;258104712358;198;0,1,3,4,5;5;2,9;2;1;1
258104712358;258104712529;171;0,1,3,4,5;5;2,9;2;1;1
258104712529;258104717808;5279;0,1,3,4,5;5;2,9;2;1;1
258104717808;258104719681;1873;0,1,3,4,5;5;2,9;2;1;1
258104719681;258104722555;2874;0,1,3,4,5;5;2,9;2;1;1
258104722555;258104723127;572;0,1,3,4,5;5;2,9;2;1;1
258104723127;258104723323;196;0,1,3,4,5,6;6;2,9;2;1;1
258104723323;258104723403;80;0,1,3,4,5;5;2,9;2;1;1
258104723403;258104723456;53;0,1,3,4,5;5;2,9;2;1;1
258104723456;258104723517;61;0,1,3,4,5;5;2,9;2;1;1
258104723517;258104723553;36;0,1,3,4,5;5;2,9;2;1;1
258104723553;258104723577;24;0,1,3,4,5;5;2,9;2;1;1
258104723577;258104723757;180;0,1,3,4,5;5;2,9;2;1;1
258104723757;258104723793;36;0,1,3,4,5;5;2,9;2;1;1
258104723793;258104723915;122;0,1,3,4,5;5;2,9;2;1;1
258104723915;258104724614;699;0,1,3,4,5;5;2,9;2;1;1
258104724614;258104729672;5058;0,1,3,4,5;5;2,9;2;1;1
258104729672;258104734179;4507;0,1,3,4,5;5;2,9;2;1;1
258104734179;258104735308;1129;0,1,3,4,5;5;2,9;2;1;1
258104735308;258104737890;2582;0,1,3,4,5;5;2,9;2;1;1
258104737890;258104748039;10149;0,1,3,4,5;5;2,9;2;1;1
258104748039;258104748073;34;0,1,3,4,5;5;2,9;2;1;1
258104748073;258104748769;696;0,1,3,4,5;5;2,9;2;1;1
258104748769;258104752198;3429;0,1,3,4,5;5;2,9;2;1;1
258104752198;258104769304;17106;0,1,3,5;4;9;1;1;1
258104769304;258104769489;185;0,1,3,5;4;9;1;1;1
258104769489;258104769653;164;0,1,3,5;4;9;1;1;1
258104769653;258104769999;346;0,1,3,5;4;9;1;1;1
258104769999;258104773129;3130;0,1,3,5;4;9;1;1;1
258104773129;258104773444;315;0,1,3,5;4;9;1;1;1
258104773444;258104773625;181;0,1,3,5,6;5;9;1;1;1
258104773625;258104774127;502;0,1,3,5;4;9;1;1;1
258104774127;258104774164;37;0,1,3,5;4;9;1;1;1
258104774164;258104774546;382;0,1,3,5;4;9;1;1;1
258104774546;258104774696;150;0,1,3,5;4;9;1;1;1
258104774696;258104774922;226;0,1,3,5;4;9;1;1;1
258104774922;258104775119;197;0,1,3,5;4;9;1;1;1
258104775119;258104775321;202;0,1,3,5;4;9;1;1;1
258104775321;258104775390;69;0,1,3,5;4;9;1;1;1
258104775390;258104775395;5;0,1,3,4,5;5;2,9;2;1;1
258104775395;258104775552;157;0,1,3,4,5;5;2,9;2;1;1
258104775552;258104775855;303;0,1,3,4,5;5;2,9;2;1;1
258104775855;258104775897;42;0,1,3,4,5;5;2,9;2;1;1
258104775897;258104775919;22;0,1,3,4,5;5;2,9;2;1;1
258104775919;258104775954;35;0,1,3,5;4;9;1;1;1
258104775954;258104776060;106;0,1,3,5,6;5;9;1;1;1
258104776060;258104776176;116;0,1,3,5,6;5;9;1;1;1
258104776176;258104776309;133;0,1,3,5;4;9;1;1;1
258104776309;258104776628;319;0,1,3,5;4;9;1;1;1
258104776628;258104776693;65;0,1,3,5;4;9;1;1;1
258104776693;258104776756;63;0,1,3,5;4;9;1;1;1
258104776756;258104776787;31;0,1,3,5;4;9;1;1;1
258104776787;258104776831;44;0,1,3,5;4;9;1;1;1
258104776831;258104777095;264;0,1,3,5;4;9;1;1;1
258104777095;258104780532;3437;0,1,3,5;4;9;1;1;1
258104780532;258104780735;203;0,1,3,5,6;5;9;1;1;1
258104780735;258104780770;35;0,1,3,5;4;9;1;1;1
258104780770;258104780806;36;0,1,3,5;4;9;1;1;1
258104780806;258104780828;22;0,1,3,5;4;9;1;1;1
258104780828;258104781015;187;0,1,3,5;4;9;1;1;1
258104781015;258104781180;165;0,1,3,5;4;9;1;1;1
258104781180;258104781429;249;0,1,3,5;4;9;1;1;1
258104781429;258104781577;148;0,1,3,5;4;9;1;1;1
258104781577;258104781722;145;0,1,3,5;4;9;1;1;1
258104781722;258104782384;662;0,1,3,5;4;9;1;1;1
258104782384;258104785745;3361;0,1,3,5;4;9;1;1;1
258104785745;258104786062;317;0,1,3,5;4;9;1;1;1
258104786062;258104789269;3207;0,1,3,5;4;9;1;1;1
258104789269;258104796943;7674;0,1,3,5;4;9;1;1;1
258104796943;258104801454;4511;0,1,3,5;4;9;1;1;1
258104801454;258104809141;7687;0,1,3,5;4;9;1;1;1
258104809141;258104810840;1699;0,1,3,4,5;5;2,9;2;1;1
258104810840;258104812208;1368;0,1,3,4,5;5;2,9;2;1;1
258104812208;258104818970;6762;0,1,3,4,5;5;2,9;2;1;1
258104818970;258104819375;405;0,1,3,4,5;5;2,9;2;1;1
258104819375;258104819508;133;0,1,3,4,5;5;2,9;2;1;1
258104819508;258104819727;219;0,1,3,4,5;5;2,9;2;1;1
258104819727;258104819935;208;0,1,3,4,5,6;6;2,9;2;1;1
258104819935;258104819959;24;0,1,3,4,5,6;6;2,9;2;1;1
258104819959;258104820062;103;0,1,3,4,5,6;6;2,9;2;1;1
258104820062;258104820106;44;0,1,3,4,5,6;6;2,9;2;1;1
258104820106;258104820292;186;0,1,3,4,5,6;6;2,9;2;1;1
258104820292;258104820409;117;0,1,3,4,5,6;6;2,9;2;1;1
258104820409;258104820451;42;0,1,3,4,5,6;6;2,9;2;1;1
258104820451;258104823000;2549;0,1,3,4,5;5;2,9;2;1;1
258104823000;258104827024;4024;0,1,3,4,5;5;2,9;2;1;1
258104827024;258104832327;5303;0,1,3,4,5;5;2,9;2;1;1
258104832327;258104843504;11177;0,1,3,4,5;5;2,9;2;1;1
258104843504;258104845668;2164;0,1,3,4,5;5;2,9;2;1;1
258104845668;258104847462;1794;0,1,3,4,5;5;2,9;2;1;1
258104847462;258104849070;1608;0,1,3,4,5;5;2,9;2;1;1
258104849070;258104849212;142;0,1,3,4,5;5;2,9;2;1;1
258104849212;258104849632;420;0,1,3,4,5;5;2,9;2;1;1
258104849632;258104850203;571;0,1,3,4,5;5;2,9;2;1;1
258104850203;258104852634;2431;0,1,3,4,5;5;2,9;2;1;1
258104852634;258104852912;278;0,1,3,4,5;5;2,9;2;1;1
258104852912;258104854109;1197;0,1,3,4,5;5;2,9;2;1;1
258104854109;258104855279;1170;0,1,3,4,5;5;2,9;2;1;1
258104855279;258104855424;145;0,1,3,4,5;5;2,9;2;1;1
258104855424;258104855799;375;0,1,3,4,5;5;2,9;2;1;1
258104855799;258104856422;623;0,1,3,4,5;5;2,9;2;1;1
258104856422;258104857795;1373;0,1,3,4,5;5;2,9;2;1;1
258104857795;258104857862;67;0,1,3,4,5,6;6;2,9;2;1;1
258104857862;258104857938;76;0,1,3,4,5,6;6;2,9;2;1;1
258104857938;258104858146;208;0,1,3,4,5,6;6;2,9;2;1;1
258104858146;258104858192;46;0,1,3,4,5;5;2,9;2;1;1
258104858192;258104858216;24;0,1,3,4,5;5;2,9;2;1;1
258104858216;258104858238;22;0,1,3,4,5;5;2,9;2;1;1
258104858238;258104858350;112;0,1,3,4,5;5;2,9;2;1;1
258104858350;258104858478;128;0,1,3,4,5;5;2,9;2;1;1
258104858478;258104858624;146;0,1,3,4,5;5;2,9;2;1;1
258104858624;258104859505;881;0,1,3,4,5;5;2,9;2;1;1
258104859505;258104864224;4719;0,1,3,5;4;9;1;1;1
258104864224;258104868839;4615;0,1,3,5;4;9;1;1;1
258104868839;258104873214;4375;0,1,3,5;4;9;1;1;1
258104873214;258104873435;221;0,1,3,5;4;9;1;1;1
258104873435;258104878834;5399;0,1,3,5;4;9;1;1;1
258104878834;258104878899;65;0,1,3,5;4;9;1;1;1
258104878899;258104878931;32;0,1,3,5;4;9;1;1;1
258104878931;258104904150;25219;0,1,3,5;4;9;1;1;1
258104904150;258104908634;4484;0,1,3,5;4;9;1;1;1
258104908634;258104908706;72;0,1,3,5;4;9;1;1;1
258104908706;258104908740;34;0,1,3,5;4;9;1;1;1
258104908740;258104908907;167;0,1,3,5;4;9;1;1;1
258104908907;258104921762;12855;0,1,3,5;4;9;1;1;1
258104921762;258104936960;15198;0,1,3,4,5;5;2,9;2;1;1
258104936960;258104937519;559;0,1,3,4,5;5;2,9;2;1;1
258104937519;258104938517;998;0,1,3,4,5;5;2,9;2;1;1
258104938517;258104941296;2779;0,1,3,4,5;5;2,9;2;1;1
258104941296;258104948381;7085;0,1,3,4,5;5;2,9;2;1;1
258104948381;258104951385;3004;0,1,3,5;4;9;1;1;1
258104951385;258104951653;268;0,1,3,5;4;9;1;1;1
258104951653;258104951682;29;0,1,3,5;4;9;1;1;1
258104951682;258104951915;233;0,1,3,5;4;9;1;1;1
258104951915;258104952053;138;0,1,3,5;4;9;1;1;1
258104952053;258104956821;4768;0,1,3,5;4;9;1;1;1
258104956821;258104957091;270;0,1,3,5;4;9;1;1;1
258104957091;258104957124;33;0,1,3,5;4;9;1;1;1
258104957124;258104957354;230;0,1,3,5,6;5;9;1;1;1
258104957354;258104957397;43;0,1,3,5,6;5;9;1;1;1
258104957397;258104957494;97;0,1,3,5,6;5;9;1;1;1
258104957494;258104957585;91;0,1,3,5,6;5;9;1;1;1
258104957585;258104957818;233;0,1,3,5,6;5;9;1;1;1
258104957818;258104958011;193;0,1,3,5,6;5;9;1;1;1
258104958011;258104958054;43;0,1,3,5,6;5;9;1;1;1
258104958054;258104961479;3425;0,1,3,5;4;9;1;1;1
258104961479;258104961665;186;0,1,3,5;4;9;1;1;1
258104961665;258104961896;231;0,1,3,5;4;9;1;1;1
258104961896;258104962072;176;0,1,3,5;4;9;1;1;1
258104962072;258104962340;268;0,1,3,5;4;9;1;1;1
258104962340;258104962672;332;0,1,3,5;4;9;1;1;1
258104962672;258104962879;207;0,1,3,5;4;9;1;1;1
258104962879;258104962955;76;0,1,3,5;4;9;1;1;1
258104962955;258104962981;26;0,1,3,5;4;9;1;1;1
258104962981;258104963299;318;0,1,3,5,6;5;9;1;1;1
258104963299;258104963652;353;0,1,3,5;4;9;1;1;1
258104963652;258104963701;49;0,1,3,5;4;9;1;1;1
258104963701;258104964452;751;0,1,3,5;4;9;1;1;1
258104964452;258104964514;62;0,1,3,5;4;9;1;1;1
258104964514;258104965117;603;0,1,3,5;4;9;1;1;1
258104965117;258104965147;30;0,1,3,5;4;9;1;1;1
258104965147;258104965271;124;0,1,3,5;4;9;1;1;1
258104965271;258104967105;1834;0,1,3,5;4;9;1;1;1
258104967105;258104970148;3043;0,1,3,5;4;9;1;1;1
258104970148;258104974372;4224;0,1,3,5;4;9;1;1;1
258104974372;258104975452;1080;0,1,3,4,5;5;2,9;2;1;1
258104975452;258104975797;345;0,1,3,4,5;5;2,9;2;1;1
258104975797;258104979065;3268;0,1,3,4,5;5;2,9;2;1;1
258104979065;258104980932;1867;0,1,3,4,5;5;2,9;2;1;1
258104980932;258104982429;1497;0,1,3,4,5;5;2,9;2;1;1
258104982429;258104986177;3748;0,1,3,5;4;9;1;1;1
258104986177;258104986240;63;0,1,3,5;4;9;1;1;1
258104986240;258104986251;11;0,1,3,5;4;9;1;1;1
258104986251;258104986275;24;0,1,3,5;4;9;1;1;1
258104986275;258104986853;578;0,1,3,5;4;9;1;1;1
258104986853;258104988242;1389;0,1,3,5;4;9;1;1;1
258104988242;258104989452;1210;0,1,3,4,5;5;2,9;2;1;1
258104989452;258104990628;1176;0,1,3,5;4;9;1;1;1
258104990628;258104992367;1739;0,1,3,4,5;5;2,9;2;1;1
258104992367;258104993235;868;0,1,3,4,5;5;2,9;2;1;1
258104993235;258104995561;2326;0,1,3,4,5;5;2,9;2;1;1
258104995561;258104996259;698;0,1,3,4,5;5;2,9;2;1;1
258104996259;258105000674;4415;0,1,3,4,5;5;2,9;2;1;1
258105000674;258105001782;1108;0,1,3,4,5;5;2,9;2;1;1
258105001782;258105001832;50;0,1,3,4,5;5;2,9;2;1;1
258105001832;258105001863;31;0,1,3,4,5;5;2,9;2;1;1
258105001863;258105002230;367;0,1,3,4,5;5;2,9;2;1;1
258105002230;258105002304;74;0,1,3,4,5;5;2,9;2;1;1
258105002304;258105002320;16;0,1,3,4,5;5;2,9;2;1;1
258105002320;258105002381;61;0,1,3,4,5;5;2,9;2;1;1
258105002381;258105003904;1523;0,1,3,4,5;5;2,9;2;1;1
258105003904;258105004407;503;0,1,3,4,5;5;2,9;2;1;1
258105004407;258105004602;195;0,1,3,4,5;5;2,9;2;1;1
258105004602;258105005277;675;0,1,3,4,5;5;2,9;2;1;1
258105005277;258105005779;502;0,1,3,5;4;9;1;1;1
258105005779;258105006485;706;0,1,3,4,5;5;2,9;2;1;1
258105006485;258105031978;25493;0,1,3,5;4;9;1;1;1
258105031978;258105041696;9718;0,1,3,5;4;9;1;1;1
258105041696;258105041913;217;0,1,3,5;4;9;1;1;1
258105041913;258105045623;3710;0,1,3,5;4;9;1;1;1
258105045623;258105045899;276;0,1,3,5;4;9;1;1;1
258105045899;258105045935;36;0,1,3,5;4;9;1;1;1
258105045935;258105046295;360;0,1,3,5;4;9;1;1;1
258105046295;258105046329;34;0,1,3,5;4;9;1;1;1
258105046329;258105046456;127;0,1,3,4,5;5;2,9;2;1;1
258105046456;258105049018;2562;0,1,3,4,5;5;2,9;2;1;1
258105049018;258105049601;583;0,1,3,4,5;5;2,9;2;1;1
258105049601;258105049918;317;0,1,3,4,5;5;2,9;2;1;1
258105049918;258105049954;36;0,1,3,4,5,6;6;2,9;2;1;1
258105049954;258105050081;127;0,1,3,4,5,6;6;2,9;2;1;1
258105050081;258105050173;92;0,1,3,4,5,6;6;2,9;2;1;1
258105050173;258105050217;44;0,1,3,4,5,6;6;2,9;2;1;1
258105050217;258105050280;63;0,1,3,4,5,6;6;2,9;2;1;1
258105050280;258105050332;52;0,1,3,4,5,6;6;2,9;2;1;1
258105050332;258105050358;26;0,1,3,4,5;5;2,9;2;1;1
258105050358;258105050378;20;0,1,3,4,5;5;2,9;2;1;1
258105050378;258105050469;91;0,1,3,4,5;5;2,9;2;1;1
258105050469;258105050599;130;0,1,3,4,5;5;2,9;2;1;1
258105050599;258105050604;5;0,1,3,4,5;5;2,9;2;1;1
258105050604;258105050710;106;0,1,3,4,5;5;2,9;2;1;1
258105050710;258105050789;79;0,1,3,4,5;5;2,9;2;1;1
258105050789;258105050833;44;0,1,3,4,5;5;2,9;2;1;1
258105050833;258105050838;5;0,1,3,4,5;5;2,9;2;1;1
258105050838;258105050908;70;0,1,3,4,5;5;2,9;2;1;1
258105050908;258105050964;56;0,1,3,4,5;5;2,9;2;1;1
258105050964;258105051004;40;0,1,3,4,5;5;2,9;2;1;1
258105051004;258105051215;211;0,1,3,4,5;5;2,9;2;1;1
258105051215;258105055531;4316;0,1,3,4,5;5;2,9;2;1;1
258105055531;258105057995;2464;0,1,3,4,5;5;2,9;2;1;1
258105057995;258105063514;5519;0,1,3,4,5;5;2,9;2;1;1
258105063514;258105066809;3295;0,1,3,4,5;5;2,9;2;1;1
258105066809;258105067054;245;0,1,3,4,5;5;2,9;2;1;1
258105067054;258105069504;2450;0,1,3,4,5;5;2,9;2;1;1
258105069504;258105069555;51;0,1,3,4,5;5;2,9;2;1;1
258105069555;258105069605;50;0,1,3,4,5;5;2,9;2;1;1
258105069605;258105069658;53;0,1,3,4,5;5;2,9;2;1;1
258105069658;258105069692;34;0,1,3,4,5;5;2,9;2;1;1
258105069692;258105069715;23;0,1,3,4,5;5;2,9;2;1;1
258105069715;258105071575;1860;0,1,3,4,5;5;2,9;2;1;1
258105071575;258105071623;48;0,1,3,4,5;5;2,9;2;1;1
258105071623;258105071650;27;0,1,3,4,5;5;2,9;2;1;1
258105071650;258105071793;143;0,1,3,4,5,6;6;2,9;2;1;1
258105071793;258105071927;134;0,1,3,4,5;5;2,9;2;1;1
258105071927;258105072099;172;0,1,3,4,5;5;2,9;2;1;1
258105072099;258105072284;185;0,1,3,4,5;5;2,9;2;1;1
258105072284;258105072311;27;0,1,3,4,5;5;2,9;2;1;1
258105072311;258105072514;203;0,1,3,4,5;5;2,9;2;1;1
258105072514;258105072555;41;0,1,3,4,5;5;2,9;2;1;1
258105072555;258105074175;1620;0,1,3,4,5;5;2,9;2;1;1
258105074175;258105077195;3020;0,1,3,4,5;5;2,9;2;1;1
258105077195;258105081731;4536;0,1,3,4,5;5;2,9;2;1;1
258105081731;258105083557;1826;0,1,3,4,5;5;2,9;2;1;1
258105083557;258105085861;2304;0,1,3,4,5;5;2,9;2;1;1
258105085861;258105086887;1026;0,1,3,4,5;5;2,9;2;1;1
258105086887;258105087006;119;0,1,3,4,5;5;2,9;2;1;1
258105087006;258105087487;481;0,1,3,4,5;5;2,9;2;1;1
258105087487;258105087500;13;0,1,3,4,5;5;2,9;2;1;1
258105087500;258105087533;33;0,1,3,4,5;5;2,9;2;1;1
258105087533;258105087621;88;0,1,3,4,5,6;6;2,9;2;1;1
258105087621;258105087636;15;0,1,3,4,5,6;6;2,9;2;1;1
258105087636;258105087733;97;0,1,3,4,5,6;6;2,9;2;1;1
258105087733;258105088013;280;0,1,3,4,5;5;2,9;2;1;1
258105088013;258105088212;199;0,1,3,4,5;5;2,9;2;1;1
258105088212;258105088379;167;0,1,3,4,5;5;2,9;2;1;1
258105088379;258105088863;484;0,1,3,4,5;5;2,9;2;1;1
258105088863;258105089133;270;0,1,3,5;4;9;1;1;1
258105089133;258105089163;30;0,1,3,5;4;9;1;1;1
258105089163;258105089273;110;0,1,3,5;4;9;1;1;1
258105089273;258105089385;112;0,1,3,5;4;9;1;1;1
258105089385;258105089522;137;0,1,3,5;4;9;1;1;1
258105089522;258105089910;388;0,1,3,5;4;9;1;1;1
258105089910;258105092235;2325;0,1,3,5;4;9;1;1;1
258105092235;258105092254;19;0,1,3,5;4;9;1;1;1
258105092254;258105092406;152;0,1,3,5,6;5;9;1;1;1
258105092406;258105092505;99;0,1,3,5,6;5;9;1;1;1
258105092505;258105092532;27;0,1,3,5;4;9;1;1;1
258105092532;258105092566;34;0,1,3,5;4;9;1;1;1
258105092566;258105092763;197;0,1,3,5;4;9;1;1;1
258105092763;258105092769;6;0,1,3,5;4;9;1;1;1
258105092769;258105092883;114;0,1,3,5;4;9;1;1;1
258105092883;258105092937;54;0,1,3,5,6;5;9;1;1;1
258105092937;258105092967;30;0,1,3,5,6;5;9;1;1;1
258105092967;258105093037;70;0,1,3,5,6;5;9;1;1;1
258105093037;258105093065;28;0,1,3,5,6;5;9;1;1;1
258105093065;258105093264;199;0,1,3,5,6;5;9;1;1;1
258105093264;258105093298;34;0,1,3,5,6;5;9;1;1;1
258105093298;258105093480;182;0,1,3,5,6;5;9;1;1;1
258105093480;258105093630;150;0,1,3,5,6;5;9;1;1;1
258105093630;258105093668;38;0,1,3,5,6;5;9;1;1;1
258105093668;258105093761;93;0,1,3,5;4;9;1;1;1
258105093761;258105093881;120;0,1,3,5;4;9;1;1;1
258105093881;258105094001;120;0,1,3,5;4;9;1;1;1
258105094001;258105094476;475;0,1,3,5;4;9;1;1;1
258105094476;258105098304;3828;0,1,3,5;4;9;1;1;1
258105098304;258105098788;484;0,1,3,5;4;9;1;1;1
258105098788;258105103526;4738;0,1,3,5;4;9;1;1;1
258105103526;258105103859;333;0,1,3,5;4;9;1;1;1
258105103859;258105104174;315;0,1,3,5;4;9;1;1;1
258105104174;258105104225;51;0,1,3,5;4;9;1;1;1
258105104225;258105104275;50;0,1,3,5;4;9;1;1;1
258105104275;258105104348;73;0,1,3,5;4;9;1;1;1
258105104348;258105104358;10;0,1,3,5;4;9;1;1;1
258105104358;258105104374;16;0,1,3,5;4;9;1;1;1
258105104374;258105104436;62;0,1,3,5;4;9;1;1;1
258105104436;258105104443;7;0,1,3,5;4;9;1;1;1
258105104443;258105105465;1022;0,1,3,5;4;9;1;1;1
258105105465;258105107381;1916;0,1,3,5;4;9;1;1;1
258105107381;258105107719;338;0,1,3,5;4;9;1;1;1
258105107719;258105107772;53;0,1,3,5;4;9;1;1;1
258105107772;258105107808;36;0,1,3,5;4;9;1;1;1
258105107808;258105109413;1605;0,1,3,5;4;9;1;1;1
258105109413;258105115829;6416;0,1,3,5;4;9;1;1;1
258105115829;258105116467;638;0,1,3,5;4;9;1;1;1
258105116467;258105116965;498;0,1,3,5;4;9;1;1;1
258105116965;258105116973;8;0,1,3,5;4;9;1;1;1
258105116973;258105117055;82;0,1,3,5;4;9;1;1;1
258105117055;258105117277;222;0,1,3,5;4;9;1;1;1
258105117277;258105117348;71;0,1,3,5;4;9;1;1;1
258105117348;258105118020;672;0,1,3,5;4;9;1;1;1
258105118020;258105120738;2718;0,1,3,5;4;9;1;1;1
258105120738;258105120927;189;0,1,3,5;4;9;1;1;1
258105120927;258105121064;137;0,1,3,5;4;9;1;1;1
258105121064;258105121130;66;0,1,3,5;4;9;1;1;1
258105121130;258105121515;385;0,1,3,5;4;9;1;1;1
258105121515;258105124350;2835;0,1,3,5;4;9;1;1;1
258105124350;258105126631;2281;0,1,3,5;4;9;1;1;1
258105126631;258105127209;578;0,1,3,5;4;9;1;1;1
258105127209;258105127383;174;0,1,3,5;4;9;1;1;1
258105127383;258105128668;1285;0,1,3,5;4;9;1;1;1
258105128668;258105129592;924;0,1,3,5;4;9;1;1;1
258105129592;258105138689;9097;0,1,3,5;4;9;1;1;1
258105138689;258105139307;618;0,1,3,5;4;9;1;1;1
258105139307;258105140048;741;0,1,3,5;4;9;1;1;1
258105140048;258105141076;1028;0,1,3,5;4;9;1;1;1
258105141076;258105142260;1184;0,1,3,4,5;5;2,9;2;1;1
258105142260;258105143898;1638;0,1,3,4,5;5;2,9;2;1;1
258105143898;258105144628;730;0,1,3,4,5;5;2,9;2;1;1
258105144628;258105150675;6047;0,1,3,4,5;5;2,9;2;1;1
258105150675;258105152960;2285;0,1,3,4,5;5;2,9;2;1;1
258105152960;258105153347;387;0,1,3,4,5;5;2,9;2;1;1
258105153347;258105154938;1591;0,1,3,4,5;5;2,9;2;1;1
258105154938;258105157746;2808;0,1,3,4,5;5;2,9;2;1;1
258105157746;258105158227;481;0,1,3,4,5;5;2,9;2;1;1
258105158227;258105159881;1654;0,1,3,4,5;5;2,9;2;1;1
258105159881;258105160179;298;0,1,3,4,5,6;6;2,9;2;1;1
258105160179;258105160317;138;0,1,3,4,5;5;2,9;2;1;1
258105160317;258105160319;2;0,1,3,4,5;5;2,9;2;1;1
258105160319;258105160478;159;0,1,3,4,5;5;2,9;2;1;1
258105160478;258105160862;384;0,1,3,4,5;5;2,9;2;1;1
258105160862;258105160913;51;0,1,3,4,5;5;2,9;2;1;1
258105160913;258105161142;229;0,1,3,4,5;5;2,9;2;1;1
258105161142;258105161188;46;0,1,3,4,5;5;2,9;2;1;1
258105161188;258105161351;163;0,1,3,4,5;5;2,9;2;1;1
258105161351;258105164259;2908;0,1,3,4,5;5;2,9;2;1;1
258105164259;258105165553;1294;0,1,3,4,5;5;2,9;2;1;1
258105165553;258105169468;3915;0,1,3,4,5;5;2,9;2;1;1
258105169468;258105169518;50;0,1,3,4,5;5;2,9;2;1;1
258105169518;258105171074;1556;0,1,3,4,5;5;2,9;2;1;1
258105171074;258105172989;1915;0,1,3,4,5;5;2,9;2;1;1
258105172989;258105173034;45;0,1,3,4,5;5;2,9;2;1;1
258105173034;258105173089;55;0,1,3,4,5;5;2,9;2;1;1
258105173089;258105173090;1;0,1,3,4,5,6;6;2,9;2;1;1
258105173090;258105173266;176;0,1,3,4,5,6;6;2,9;2;1;1
258105173266;258105173427;161;0,1,3,4,5,6;6;2,9;2;1;1
258105173427;258105173460;33;0,1,3,4,5,6;6;2,9;2;1;1
258105173460;258105173505;45;0,1,3,4,5;5;2,9;2;1;1
258105173505;258105173568;63;0,1,3,4,5;5;2,9;2;1;1
258105173568;258105173609;41;0,1,3,4,5;5;2,9;2;1;1
258105173609;258105173797;188;0,1,3,4,5;5;2,9;2;1;1
258105173797;258105174390;593;0,1,3,4,5;5;2,9;2;1;1
258105174390;258105175952;1562;0,1,3,4,5;5;2,9;2;1;1
258105175952;258105176204;252;0,1,3,4,5;5;2,9;2;1;1
258105176204;258105179544;3340;0,1,3,4,5;5;2,9;2;1;1
258105179544;258105180525;981;0,1,3,4,5;5;2,9;2;1;1
258105180525;258105185305;4780;0,1,3,4,5;5;2,9;2;1;1
258105185305;258105185600;295;0,1,3,4,5;5;2,9;2;1;1
258105185600;258105185704;104;0,1,3,4,5;5;2,9;2;1;1
258105185704;258105185891;187;0,1,3,4,5;5;2,9;2;1;1
258105185891;258105186520;629;0,1,3,4,5;5;2,9;2;1;1
258105186520;258105187473;953;0,1,3,4,5;5;2,9;2;1;1
258105187473;258105188305;832;0,1,3,4,5;5;2,9;2;1;1
258105188305;258105188952;647;0,1,3,4,5;5;2,9;2;1;1
258105188952;258105189630;678;0,1,3,4,5;5;2,9;2;1;1
258105189630;258105197373;7743;0,1,3,4,5;5;2,9;2;1;1
258105197373;258105198105;732;0,1,3,5;4;9;1;1;1
258105198105;258105198191;86;0,1,3,5;4;9;1;1;1
258105198191;258105198225;34;0,1,3,5;4;9;1;1;1
258105198225;258105198432;207;0,1,3,5;4;9;1;1;1
258105198432;258105198498;66;0,1,3,5;4;9;1;1;1
258105198498;258105205384;6886;0,1,3,5;4;9;1;1;1
258105205384;258105205778;394;0,1,3,5,6;5;9;1;1;1
258105205778;258105205936;158;0,1,3,5;4;9;1;1;1
258105205936;258105206342;406;0,1,3,5;4;9;1;1;1
258105206342;258105206556;214;0,1,3,5;4;9;1;1;1
258105206556;258105206682;126;0,1,3,5;4;9;1;1;1
258105206682;258105206724;42;0,1,3,5;4;9;1;1;1
258105206724;258105206753;29;0,1,3,5;4;9;1;1;1
258105206753;258105206897;144;0,1,3,5;4;9;1;1;1
258105206897;258105207230;333;0,1,3,5;4;9;1;1;1
258105207230;258105208569;1339;0,1,3,5;4;9;1;1;1
258105208569;258105208679;110;0,1,3,5;4;9;1;1;1
258105208679;258105212078;3399;0,1,3,5;4;9;1;1;1
258105212078;258105214313;2235;0,1,3,5;4;9;1;1;1
258105214313;258105214363;50;0,1,3,5;4;9;1;1;1
258105214363;258105214376;13;0,1,3,5;4;9;1;1;1
258105214376;258105214396;20;0,1,3,5;4;9;1;1;1
258105214396;258105214564;168;0,1,3,5;4;9;1;1;1
258105214564;258105214999;435;0,1,3,5;4;9;1;1;1
258105214999;258105218206;3207;0,1,3,5;4;9;1;1;1
258105218206;258105218243;37;0,1,3,5,6;5;9;1;1;1
258105218243;258105218349;106;0,1,3,5,6;5;9;1;1;1
258105218349;258105218487;138;0,1,3,5,6;5;9;1;1;1
258105218487;258105218532;45;0,1,3,5,6;5;9;1;1;1
258105218532;258105218572;40;0,1,3,5,6;5;9;1;1;1
258105218572;258105218577;5;0,1,3,5,6;5;9;1;1;1
258105218577;258105218728;151;0,1,3,5;4;9;1;1;1
258105218728;258105218895;167;0,1,3,5;4;9;1;1;1
258105218895;258105219071;176;0,1,3,5;4;9;1;1;1
258105219071;258105219570;499;0,1,3,5;4;9;1;1;1
258105219570;258105228707;9137;0,1,3,5;4;9;1;1;1
258105228707;258105229035;328;0,1,3,5;4;9;1;1;1
258105229035;258105229755;720;0,1,3,5;4;9;1;1;1
258105229755;258105240428;10673;0,1,3,5;4;9;1;1;1
258105240428;258105251947;11519;0,1,3,5;4;9;1;1;1
258105251947;258105256214;4267;0,1,3,5;4;9;1;1;1
258105256214;258105257840;1626;0,1,3,4,5;5;2,9;2;1;1
258105257840;258105260660;2820;0,1,3,4,5;5;2,9;2;1;1
258105260660;258105261596;936;0,1,3,4,5;5;2,9;2;1;1
258105261596;258105261604;8;0,1,3,4,5;5;2,9;2;1;1
258105261604;258105261656;52;0,1,3,4,5;5;2,9;2;1;1
258105261656;258105261943;287;0,1,3,4,5;5;2,9;2;1;1
258105261943;258105270034;8091;0,1,3,4,5;5;2,9;2;1;1
258105270034;258105272300;2266;0,1,3,4,5;5;2,9;2;1;1
258105272300;258105273728;1428;0,1,3,4,5;5;2,9;2;1;1
258105273728;258105278395;4667;0,1,3,4,5;5;2,9;2;1;1
258105278395;258105278402;7;0,1,3,4,5;5;2,9;2;1;1
258105278402;258105278462;60;0,1,3,4,5;5;2,9;2;1;1
258105278462;258105278672;210;0,1,3,4,5,6;6;2,9;2;1;1
258105278672;258105278708;36;0,1,3,4,5,6;6;2,9;2;1;1
258105278708;258105278802;94;0,1,3,4,5;5;2,9;2;1;1
258105278802;258105278923;121;0,1,3,4,5;5;2,9;2;1;1
258105278923;258105279163;240;0,1,3,4,5;5;2,9;2;1;1
258105279163;258105279287;124;0,1,3,4,5;5;2,9;2;1;1
258105279287;258105279409;122;0,1,3,4,5;5;2,9;2;1;1
258105279409;258105282107;2698;0,1,3,4,5;5;2,9;2;1;1
258105282107;258105283406;1299;0,1,3,4,5;5;2,9;2;1;1
258105283406;258105284303;897;0,1,3,4,5;5;2,9;2;1;1
258105284303;258105287543;3240;0,1,3,4,5;5;2,9;2;1;1
258105287543;258105288739;1196;0,1,3,4,5;5;2,9;2;1;1
258105288739;258105289008;269;0,1,3,4,5;5;2,9;2;1;1
258105289008;258105294429;5421;0,1,3,4,5;5;2,9;2;1;1
258105294429;258105294557;128;0,1,3,4,5;5;2,9;2;1;1
258105294557;258105294820;263;0,1,3,4,5;5;2,9;2;1;1
258105294820;258105294899;79;0,1,3,4,5;5;2,9;2;1;1
258105294899;258105295624;725;0,1,3,4,5;5;2,9;2;1;1
258105295624;258105295671;47;0,1,3,4,5;5;2,9;2;1;1
258105295671;258105295709;38;0,1,3,4,5;5;2,9;2;1;1
258105295709;258105295747;38;0,1,3,4,5;5;2,9;2;1;1
258105295747;258105298823;3076;0,1,3,4,5;5;2,9;2;1;1
258105298823;258105299378;555;0,1,3,4,5;5;2,9;2;1;1
258105299378;258105299424;46;0,1,3,4,5;5;2,9;2;1;1
258105299424;258105299460;36;0,1,3,4,5;5;2,9;2;1;1
258105299460;258105299496;36;0,1,3,4,5;5;2,9;2;1;1
258105299496;258105299923;427;0,1,3,4,5;5;2,9;2;1;1
258105299923;258105299930;7;0,1,3,4,5;5;2,9;2;1;1
258105299930;258105299966;36;0,1,3,4,5;5;2,9;2;1;1
258105299966;258105300537;571;0,1,3,4,5;5;2,9;2;1;1
258105300537;258105301216;679;0,1,3,4,5;5;2,9;2;1;1
258105301216;258105301880;664;0,1,3,4,5;5;2,9;2;1;1
258105301880;258105304459;2579;0,1,3,4,5;5;2,9;2;1;1
258105304459;258105305342;883;0,1,3,4,5;5;2,9;2;1;1
258105305342;258105305634;292;0,1,3,4,5;5;2,9;2;1;1
258105305634;258105306141;507;0,1,3,4,5;5;2,9;2;1;1
258105306141;258105306754;613;0,1,3,4,5;5;2,9;2;1;1
258105306754;258105307816;1062;0,1,3,4,5;5;2,9;2;1;1
258105307816;258105315808;7992;0,1,3,4,5;5;2,9;2;1;1
258105315808;258105315844;36;0,1,3,4,5;5;2,9;2;1;1
258105315844;258105315912;68;0,1,3,4,5;5;2,9;2;1;1
258105315912;258105316237;325;0,1,3,4,5;5;2,9;2;1;1
258105316237;258105320197;3960;0,1,3,4,5;5;2,9;2;1;1
258105320197;258105332772;12575;0,1,3,5;4;9;1;1;1
258105332772;258105337508;4736;0,1,3,4,5;5;2,9;2;1;1
258105337508;258105338603;1095;0,1,3,4,5;5;2,9;2;1;1
258105338603;258105343760;5157;0,1,3,4,5;5;2,9;2;1;1
258105343760;258105358608;14848;0,1,3,4,5;5;2,9;2;1;1
258105358608;258105364047;5439;0,1,3,4,5;5;2,9;2;1;1
258105364047;258105364978;931;0,1,3,4,5;5;2,9;2;1;1
258105364978;258105365766;788;0,1,3,4,5;5;2,9;2;1;1
258105365766;258105366695;929;0,1,3,4,5;5;2,9;2;1;1
258105366695;258105371354;4659;0,1,3,4,5;5;2,9;2;1;1
258105371354;258105372022;668;0,1,3,4,5;5;2,9;2;1;1
258105372022;258105372186;164;0,1,3,4,5;5;2,9;2;1;1
258105372186;258105375966;3780;0,1,3,4,5;5;2,9;2;1;1
258105375966;258105377250;1284;0,1,3,4,5;5;2,9;2;1;1
258105377250;258105377416;166;0,1,3,4,5,6;6;2,9;2;1;1
258105377416;258105378009;593;0,1,3,4,5;5;2,9;2;1;1
258105378009;258105378427;418;0,1,3,4,5;5;2,9;2;1;1
258105378427;258105378462;35;0,1,3,4,5;5;2,9;2;1;1
258105378462;258105378505;43;0,1,3,4,5;5;2,9;2;1;1
258105378505;258105378547;42;0,1,3,4,5;5;2,9;2;1;1
258105378547;258105378598;51;0,1,3,4,5;5;2,9;2;1;1
258105378598;258105378640;42;0,1,3,4,5;5;2,9;2;1;1
258105378640;258105378680;40;0,1,3,4,5;5;2,9;2;1;1
258105378680;258105385374;6694;0,1,3,4,5;5;2,9;2;1;1
258105385374;258105385986;612;0,1,3,4,5;5;2,9;2;1;1
258105385986;258105386302;316;0,1,3,4,5;5;2,9;2;1;1
258105386302;258105401814;15512;0,1,3,4,5;5;2,9;2;1;1
258105401814;258105413494;11680;0,1,3,5;4;9;1;1;1
258105413494;258105413947;453;0,1,3,5;4;9;1;1;1
258105413947;258105417157;3210;0,1,3,5;4;9;1;1;1
258105417157;258105417500;343;0,1,3,5;4;9;1;1;1
258105417500;258105417566;66;0,1,3,5;4;9;1;1;1
258105417566;258105417900;334;0,1,3,5;4;9;1;1;1
258105417900;258105417934;34;0,1,3,5;4;9;1;1;1
258105417934;258105418041;107;0,1,3,5;4;9;1;1;1
258105418041;258105418112;71;0,1,3,5,6;5;9;1;1;1
258105418112;258105418133;21;0,1,3,5,6;5;9;1;1;1
258105418133;258105418147;14;0,1,3,5,6;5;9;1;1;1
258105418147;258105418228;81;0,1,3,5,6;5;9;1;1;1
258105418228;258105418288;60;0,1,3,5,6;5;9;1;1;1
258105418288;258105418318;30;0,1,3,5;4;9;1;1;1
258105418318;258105418420;102;0,1,3,5;4;9;1;1;1
258105418420;258105423593;5173;0,1,3,5;4;9;1;1;1
258105423593;258105423692;99;0,1,3,5;4;9;1;1;1
258105423692;258105423701;9;0,1,3,5;4;9;1;1;1
258105423701;258105423929;228;0,1,3,5;4;9;1;1;1
258105423929;258105424316;387;0,1,3,5;4;9;1;1;1
258105424316;258105424993;677;0,1,3,5;4;9;1;1;1
258105424993;258105428580;3587;0,1,3,5;4;9;1;1;1
258105428580;258105428600;20;0,1,3,5;4;9;1;1;1
258105428600;258105428887;287;0,1,3,5;4;9;1;1;1
258105428887;258105429664;777;0,1,3,5;4;9;1;1;1
258105429664;258105429749;85;0,1,3,5,6;5;9;1;1;1
258105429749;258105429779;30;0,1,3,5,6;5;9;1;1;1
258105429779;258105430022;243;0,1,3,5,6;5;9;1;1;1
258105430022;258105430480;458;0,1,3,5;4;9;1;1;1
258105430480;258105430672;192;0,1,3,5;4;9;1;1;1
258105430672;258105430936;264;0,1,3,5;4;9;1;1;1
258105430936;258105431149;213;0,1,3,5;4;9;1;1;1
258105431149;258105431249;100;0,1,3,5;4;9;1;1;1
258105431249;258105431869;620;0,1,3,5;4;9;1;1;1
258105431869;258105432349;480;0,1,3,5;4;9;1;1;1
258105432349;258105432385;36;0,1,3,5;4;9;1;1;1
258105432385;258105433712;1327;0,1,3,5;4;9;1;1;1
258105433712;258105435486;1774;0,1,3,4,5;5;2,9;2;1;1
258105435486;258105437525;2039;0,1,3,4,5;5;2,9;2;1;1
258105437525;258105439397;1872;0,1,3,4,5;5;2,9;2;1;1
258105439397;258105440886;1489;0,1,3,4,5;5;2,9;2;1;1
258105440886;258105441396;510;0,1,3,4,5;5;2,9;2;1;1
258105441396;258105441431;35;0,1,3,4,5;5;2,9;2;1;1
258105441431;258105441466;35;0,1,3,4,5;5;2,9;2;1;1
258105441466;258105441631;165;0,1,3,4,5;5;2,9;2;1;1
258105441631;258105444255;2624;0,1,3,4,5;5;2,9;2;1;1
258105444255;258105447049;2794;0,1,3,4,5;5;2,9;2;1;1
258105447049;258105447164;115;0,1,3,4,5;5;2,9;2;1;1
258105447164;258105452004;4840;0,1,3,4,5;5;2,9;2;1;1
258105452004;258105452041;37;0,1,3,4,5;5;2,9;2;1;1
258105452041;258105452432;391;0,1,3,4,5;5;2,9;2;1;1
258105452432;258105452449;17;0,1,3,4,5;5;2,9;2;1;1
258105452449;258105452555;106;0,1,3,4,5;5;2,9;2;1;1
258105452555;258105452661;106;0,1,3,4,5;5;2,9;2;1;1
258105452661;258105452752;91;0,1,3,4,5;5;2,9;2;1;1
258105452752;258105453164;412;0,1,3,4,5;5;2,9;2;1;1
258105453164;258105457014;3850;0,1,3,4,5;5;2,9;2;1;1
258105457014;258105457409;395;0,1,3,4,5;5;2,9;2;1;1
258105457409;258105457499;90;0,1,3,4,5;5;2,9;2;1;1
258105457499;258105457527;28;0,1,3,4,5;5;2,9;2;1;1
258105457527;258105457629;102;0,1,3,4,5;5;2,9;2;1;1
258105457629;258105457780;151;0,1,3,4,5;5;2,9;2;1;1
258105457780;258105458167;387;0,1,3,4,5;5;2,9;2;1;1
258105458167;258105458221;54;0,1,3,4,5,6;6;2,9;2;1;1
258105458221;258105458305;84;0,1,3,4,5,6;6;2,9;2;1;1
258105458305;258105458472;167;0,1,3,4,5,6;6;2,9;2;1;1
258105458472;258105458520;48;0,1,3,4,5,6;6;2,9;2;1;1
258105458520;258105458886;366;0,1,3,4,5;5;2,9;2;1;1
258105458886;258105458956;70;0,1,3,4,5;5;2,9;2;1;1
258105458956;258105459196;240;0,1,3,4,5;5;2,9;2;1;1
258105459196;258105459565;369;0,1,3,4,5;5;2,9;2;1;1
258105459565;258105459769;204;0,1,3,4,5;5;2,9;2;1;1
258105459769;258105459810;41;0,1,3,4,5;5;2,9;2;1;1
258105459810;258105459882;72;0,1,3,4,5;5;2,9;2;1;1
258105459882;258105460040;158;0,1,3,4,5;5;2,9;2;1;1
258105460040;258105461717;1677;0,1,3,4,5;5;2,9;2;1;1
258105461717;258105466275;4558;0,1,3,4,5;5;2,9;2;1;1
258105466275;258105467275;1000;0,1,3,4,5;5;2,9;2;1;1
258105467275;258105468603;1328;0,1,3,4,5;5;2,9;2;1;1
258105468603;258105468673;70;0,1,3,4,5;5;2,9;2;1;1
258105468673;258105477267;8594;0,1,3,4,5;5;2,9;2;1;1
258105477267;258105479020;1753;0,1,3,4,5;5;2,9;2;1;1
258105479020;258105480154;1134;0,1,3,4,5;5;2,9;2;1;1
258105480154;258105482007;1853;0,1,3,4,5;5;2,9;2;1;1
258105482007;258105482317;310;0,1,3,4,5;5;2,9;2;1;1
258105482317;258105482914;597;0,1,3,4,5;5;2,9;2;1;1
258105482914;258105483625;711;0,1,3,4,5;5;2,9;2;1;1
258105483625;258105483904;279;0,1,3,4,5;5;2,9;2;1;1
258105483904;258105484198;294;0,1,3,4,5;5;2,9;2;1;1
258105484198;258105484772;574;0,1,3,4,5;5;2,9;2;1;1
258105484772;258105486607;1835;0,1,3,5;4;9;1;1;1
258105486607;258105486903;296;0,1,3,5;4;9;1;1;1
258105486903;258105512886;25983;0,1,3,5;4;9;1;1;1
258105512886;258105513140;254;0,1,3,5;4;9;1;1;1
258105513140;258105513191;51;0,1,3,5;4;9;1;1;1
258105513191;258105513217;26;0,1,3,5;4;9;1;1;1
258105513217;258105513240;23;0,1,3,5;4;9;1;1;1
258105513240;258105513618;378;0,1,3,5;4;9;1;1;1
258105513618;258105514740;1122;0,1,3,5;4;9;1;1;1
258105514740;258105514756;16;0,1,3,5;4;9;1;1;1
258105514756;258105516407;1651;0,1,3,5;4;9;1;1;1
258105516407;258105526929;10522;0,1,3,5;4;9;1;1;1
258105526929;258105533261;6332;0,1,3,5;4;9;1;1;1
258105533261;258105537465;4204;0,1,3,5;4;9;1;1;1
258105537465;258105537710;245;0,1,3,5;4;9;1;1;1
258105537710;258105538015;305;0,1,3,5;4;9;1;1;1
258105538015;258105538445;430;0,1,3,5;4;9;1;1;1
258105538445;258105538474;29;0,1,3,5;4;9;1;1;1
258105538474;258105542005;3531;0,1,3,5;4;9;1;1;1
258105542005;258105542049;44;0,1,3,5,6;5;9;1;1;1
258105542049;258105542126;77;0,1,3,5,6;5;9;1;1;1
258105542126;258105542153;27;0,1,3,5,6;5;9;1;1;1
258105542153;258105542309;156;0,1,3,5,6;5;9;1;1;1
258105542309;258105542491;182;0,1,3,5;4;9;1;1;1
258105542491;258105542659;168;0,1,3,5;4;9;1;1;1
258105542659;258105542688;29;0,1,3,5;4;9;1;1;1
258105542688;258105542732;44;0,1,3,5;4;9;1;1;1
258105542732;258105542847;115;0,1,3,5;4;9;1;1;1
258105542847;258105550539;7692;0,1,3,5;4;9;1;1;1
258105550539;258105551426;887;0,1,3,5;4;9;1;1;1
258105551426;258105559787;8361;0,1,3,4,5;5;2,9;2;1;1
258105559787;258105559994;207;0,1,3,4,5;5;2,9;2;1;1
258105559994;258105564073;4079;0,1,3,4,5;5;2,9;2;1;1
258105564073;258105575015;10942;0,1,3,4,5;5;2,9;2;1;1
258105575015;258105577764;2749;0,1,3,4,5;5;2,9;2;1;1
258105577764;258105577938;174;0,1,3,4,5;5;2,9;2;1;1
258105577938;258105580000;2062;0,1,3,4,5;5;2,9;2;1;1
258105580000;258105582274;2274;0,1,3,4,5;5;2,9;2;1;1
258105582274;258105585709;3435;0,1,3,4,5;5;2,9;2;1;1
258105585709;258105588279;2570;0,1,3,4,5;5;2,9;2;1;1
258105588279;258105588287;8;0,1,3,4,5;5;2,9;2;1;1
258105588287;258105588314;27;0,1,3,4,5;5;2,9;2;1;1
258105588314;258105588369;55;0,1,3,4,5;5;2,9;2;1;1
258105588369;258105588882;513;0,1,3,4,5;5;2,9;2;1;1
258105588882;258105588893;11;0,1,3,4,5;5;2,9;2;1;1
258105588893;258105589034;141;0,1,3,4,5;5;2,9;2;1;1
258105589034;258105590503;1469;0,1,3,4,5;5;2,9;2;1;1
258105590503;258105590979;476;0,1,3,4,5;5;2,9;2;1;1
258105590979;258105591781;802;0,1,3,4,5;5;2,9;2;1;1
258105591781;258105593688;1907;0,1,3,4,5;5;2,9;2;1;1
258105593688;258105593900;212;0,1,3,4,5;5;2,9;2;1;1
258105593900;258105598385;4485;0,1,3,4,5;5;2,9;2;1;1
258105598385;258105599498;1113;0,1,3,4,5;5;2,9;2;1;1
258105599498;258105599527;29;0,1,3,4,5;5;2,9;2;1;1
258105599527;258105600516;989;0,1,3,4,5;5;2,9;2;1;1
258105600516;258105600537;21;0,1,3,5;4;9;1;1;1
258105600537;258105600699;162;0,1,3,5;4;9;1;1;1
258105600699;258105601670;971;0,1,3,5;4;9;1;1;1
258105601670;258105604705;3035;0,1,3,5;4;9;1;1;1
258105604705;258105604723;18;0,1,3,5,6;5;9;1;1;1
258105604723;258105604748;25;0,1,3,5,6;5;9;1;1;1
258105604748;258105604822;74;0,1,3,5,6;5;9;1;1;1
258105604822;258105604889;67;0,1,3,5,6;5;9;1;1;1
258105604889;258105604914;25;0,1,3,5,6;5;9;1;1;1
258105604914;258105604967;53;0,1,3,5,6;5;9;1;1;1
258105604967;258105605085;118;0,1,3,5,6;5;9;1;1;1
258105605085;258105605111;26;0,1,3,5,6;5;9;1;1;1
258105605111;258105605178;67;0,1,3,5,6;5;9;1;1;1
258105605178;258105607201;2023;0,1,3,5;4;9;1;1;1
258105607201;258105607233;32;0,1,3,5;4;9;1;1;1
258105607233;258105607361;128;0,1,3,5;4;9;1;1;1
258105607361;258105607363;2;0,1,3,5;4;9;1;1;1
258105607363;258105607365;2;0,1,3,5;4;9;1;1;1
258105607365;258105607559;194;0,1,3,5;4;9;1;1;1
258105607559;258105607600;41;0,1,3,5;4;9;1;1;1
258105607600;258105607729;129;0,1,3,5;4;9;1;1;1
258105607729;258105608199;470;0,1,3,5;4;9;1;1;1
258105608199;258105616538;8339;0,1,3,5;4;9;1;1;1
258105616538;258105621811;5273;0,1,3,5;4;9;1;1;1
258105621811;258105623550;1739;0,1,3,5;4;9;1;1;1
258105623550;258105625491;1941;0,1,3,5;4;9;1;1;1
258105625491;258105625549;58;0,1,3,5;4;9;1;1;1
258105625549;258105626056;507;0,1,3,5;4;9;1;1;1
258105626056;258105626073;17;0,1,3,5;4;9;1;1;1
258105626073;258105626092;19;0,1,3,5;4;9;1;1;1
258105626092;258105626465;373;0,1,3,5;4;9;1;1;1
258105626465;258105626706;241;0,1,3,5;4;9;1;1;1
258105626706;258105638054;11348;0,1,3,5;4;9;1;1;1
258105638054;258105638104;50;0,1,3,5;4;9;1;1;1
258105638104;258105638164;60;0,1,3,5;4;9;1;1;1
258105638164;258105638177;13;0,1,3,5;4;9;1;1;1
258105638177;258105638971;794;0,1,3,5;4;9;1;1;1
258105638971;258105647079;8108;0,1,3,5;4;9;1;1;1
258105647079;258105648838;1759;0,1,3,4,5;5;2,9;2;1;1
258105648838;258105650862;2024;0,1,3,4,5;5;2,9;2;1;1
258105650862;258105650929;67;0,1,3,4,5;5;2,9;2;1;1
258105650929;258105650995;66;0,1,3,4,5;5;2,9;2;1;1
258105650995;258105653846;2851;0,1,3,4,5;5;2,9;2;1;1
258105653846;258105666446;12600;0,1,3,4,5;5;2,9;2;1;1
258105666446;258105666519;73;0,1,3,4,5;5;2,9;2;1;1
258105666519;258105667588;1069;0,1,3,4,5;5;2,9;2;1;1
258105667588;258105668253;665;0,1,3,4,5;5;2,9;2;1;1
258105668253;258105673334;5081;0,1,3,4,5;5;2,9;2;1;1
258105673334;258105680635;7301;0,1,3,4,5;5;2,9;2;1;1
258105680635;258105680782;147;0,1,3,4,5;5;2,9;2;1;1
258105680782;258105682797;2015;0,1,3,4,5;5;2,9;2;1;1
258105682797;258105685125;2328;0,1,3,4,5;5;2,9;2;1;1
258105685125;258105685441;316;0,1,3,4,5;5;2,9;2;1;1
258105685441;258105685495;54;0,1,3,4,5;5;2,9;2;1;1
258105685495;258105685734;239;0,1,3,4,5;5;2,9;2;1;1
258105685734;258105685762;28;0,1,3,4,5;5;2,9;2;1;1
258105685762;258105685834;72;0,1,3,4,5;5;2,9;2;1;1
258105685834;258105686545;711;0,1,3,4,5;5;2,9;2;1;1
258105686545;258105686972;427;0,1,3,4,5;5;2,9;2;1;1
258105686972;258105688468;1496;0,1,3,4,5;5;2,9;2;1;1
258105688468;258105689607;1139;0,1,3,4,5;5;2,9;2;1;1
258105689607;258105690221;614;0,1,3,4,5;5;2,9;2;1;1
258105690221;258105691317;1096;0,1,3,4,5;5;2,9;2;1;1
258105691317;258105696686;5369;0,1,3,5;4;9;1;1;1
258105696686;258105696856;170;0,1,3,5;4;9;1;1;1
258105696856;258105713451;16595;0,1,3,5;4;9;1;1;1
258105713451;258105738838;25387;0,1,3,5;4;9;1;1;1
258105738838;258105748614;9776;0,1,3,5;4;9;1;1;1
258105748614;258105748761;147;0,1,3,5;4;9;1;1;1
258105748761;258105753992;5231;0,1,3,5;4;9;1;1;1
258105753992;258105755493;1501;0,1,3,4,5;5;2,9;2;1;1
258105755493;258105761626;6133;0,1,3,4,5;5;2,9;2;1;1
258105761626;258105763673;2047;0,1,3,4,5;5;2,9;2;1;1
258105763673;258105768171;4498;0,1,3,4,5;5;2,9;2;1;1
258105768171;258105770854;2683;0,1,3,4,5;5;2,9;2;1;1
258105770854;258105773680;2826;0,1,3,4,5;5;2,9;2;1;1
258105773680;258105780189;6509;0,1,3,4,5;5;2,9;2;1;1
258105780189;258105786047;5858;0,1,3,4,5;5;2,9;2;1;1
258105786047;258105788979;2932;0,1,3,4,5;5;2,9;2;1;1
258105788979;258105790345;1366;0,1,3,4,5;5;2,9;2;1;1
258105790345;258105790600;255;0,1,3,4,5;5;2,9;2;1;1
258105790600;258105790730;130;0,1,3,4,5;5;2,9;2;1;1
258105790730;258105790799;69;0,1,3,4,5;5;2,9;2;1;1
258105790799;258105791204;405;0,1,3,4,5;5;2,9;2;1;1
258105791204;258105791246;42;0,1,3,4,5;5;2,9;2;1;1
258105791246;258105791874;628;0,1,3,4,5;5;2,9;2;1;1
258105791874;258105791924;50;0,1,3,4,5;5;2,9;2;1;1
258105791924;258105791978;54;0,1,3,4,5;5;2,9;2;1;1
258105791978;258105796069;4091;0,1,3,4,5;5;2,9;2;1;1
258105796069;258105796147;78;0,1,3,4,5;5;2,9;2;1;1
258105796147;258105796244;97;0,1,3,4,5;5;2,9;2;1;1
258105796244;258105796350;106;0,1,3,4,5;5;2,9;2;1;1
258105796350;258105796428;78;0,1,3,4,5;5;2,9;2;1;1
258105796428;258105797169;741;0,1,3,4,5;5;2,9;2;1;1
258105797169;258105797449;280;0,1,3,4,5;5;2,9;2;1;1
258105797449;258105798002;553;0,1,3,4,5;5;2,9;2;1;1
258105798002;258105798449;447;0,1,3,4,5;5;2,9;2;1;1
258105798449;258105798616;167;0,1,3,4,5,6;6;2,9;2;1;1
258105798616;258105798641;25;0,1,3,4,5,6;6;2,9;2;1;1
258105798641;258105798743;102;0,1,3,4,5,6;6;2,9;2;1;1
258105798743;258105798788;45;0,1,3,4,5,6;6;2,9;2;1;1
258105798788;258105798806;18;0,1,3,4,5;5;2,9;2;1;1
258105798806;258105798845;39;0,1,3,4,5;5;2,9;2;1;1
258105798845;258105799018;173;0,1,3,4,5;5;2,9;2;1;1
258105799018;258105799195;177;0,1,3,4,5;5;2,9;2;1;1
258105799195;258105799299;104;0,1,3,4,5;5;2,9;2;1;1
258105799299;258105799505;206;0,1,3,4,5;5;2,9;2;1;1
258105799505;258105799576;71;0,1,3,4,5;5;2,9;2;1;1
258105799576;258105799607;31;0,1,3,4,5;5;2,9;2;1;1
258105799607;258105799868;261;0,1,3,4,5;5;2,9;2;1;1
258105799868;258105800466;598;0,1,3,4,5;5;2,9;2;1;1
258105800466;258105800592;126;0,1,3,4,5;5;2,9;2;1;1
258105800592;258105800908;316;0,1,3,4,5;5;2,9;2;1;1
258105800908;258105805644;4736;0,1,3,4,5;5;2,9;2;1;1
258105805644;258105807579;1935;0,1,3,4,5;5;2,9;2;1;1
258105807579;258105811660;4081;0,1,3,5;4;9;1;1;1
258105811660;258105837601;25941;0,1,3,5;4;9;1;1;1
258105837601;258105837634;33;0,1,3,5;4;9;1;1;1
258105837634;258105837651;17;0,1,3,5;4;9;1;1;1
258105837651;258105837928;277;0,1,3,5;4;9;1;1;1
258105837928;258105838010;82;0,1,3,5;4;9;1;1;1
258105838010;258105838140;130;0,1,3,5;4;9;1;1;1
258105838140;258105838621;481;0,1,3,5;4;9;1;1;1
258105838621;258105840090;1469;0,1,3,5;4;9;1;1;1
258105840090;258105840176;86;0,1,3,5;4;9;1;1;1
258105840176;258105840305;129;0,1,3,5;4;9;1;1;1
258105840305;258105840398;93;0,1,3,5;4;9;1;1;1
258105840398;258105840514;116;0,1,3,5;4;9;1;1;1
258105840514;258105840775;261;0,1,3,5;4;9;1;1;1
258105840775;258105841108;333;0,1,3,5;4;9;1;1;1
258105841108;258105862125;21017;0,1,3,5;4;9;1;1;1
258105862125;258105862148;23;0,1,3,5;4;9;1;1;1
258105862148;258105862202;54;0,1,3,5;4;9;1;1;1
258105862202;258105862252;50;0,1,3,5;4;9;1;1;1
258105862252;258105862302;50;0,1,3,5;4;9;1;1;1
258105862302;258105862353;51;0,1,3,5;4;9;1;1;1
258105862353;258105862402;49;0,1,3,5;4;9;1;1;1
258105862402;258105863037;635;0,1,3,5;4;9;1;1;1
258105863037;258105865482;2445;0,1,3,4,5;5;2,9;2;1;1
258105865482;258105865937;455;0,1,3,4,5;5;2,9;2;1;1
258105865937;258105866076;139;0,1,3,4,5;5;2,9;2;1;1
258105866076;258105866130;54;0,1,3,4,5;5;2,9;2;1;1
258105866130;258105866163;33;0,1,3,4,5;5;2,9;2;1;1
258105866163;258105866205;42;0,1,3,4,5;5;2,9;2;1;1
258105866205;258105867488;1283;0,1,3,4,5;5;2,9;2;1;1
258105867488;258105867516;28;0,1,3,4,5;5;2,9;2;1;1
258105867516;258105867543;27;0,1,3,4,5;5;2,9;2;1;1
258105867543;258105868878;1335;0,1,3,4,5;5;2,9;2;1;1
258105868878;258105871604;2726;0,1,3,4,5;5;2,9;2;1;1
258105871604;258105871767;163;0,1,3,4,5,6;6;2,9;2;1;1
258105871767;258105871783;16;0,1,3,4,5,6;6;2,9;2;1;1
258105871783;258105871836;53;0,1,3,4,5,6;6;2,9;2;1;1
258105871836;258105871895;59;0,1,3,4,5,6;6;2,9;2;1;1
258105871895;258105872019;124;0,1,3,4,5,6;6;2,9;2;1;1
258105872019;258105872025;6;0,1,3,4,5,6;6;2,9;2;1;1
258105872025;258105872065;40;0,1,3,4,5,6;6;2,9;2;1;1
258105872065;258105872244;179;0,1,3,4,5;5;2,9;2;1;1
258105872244;258105872331;87;0,1,3,4,5;5;2,9;2;1;1
258105872331;258105872425;94;0,1,3,4,5;5;2,9;2;1;1
258105872425;258105872628;203;0,1,3,4,5;5;2,9;2;1;1
258105872628;258105872630;2;0,1,3,4,5;5;2,9;2;1;1
258105872630;258105872666;36;0,1,3,4,5;5;2,9;2;1;1
258105872666;258105872694;28;0,1,3,4,5;5;2,9;2;1;1
258105872694;258105872790;96;0,1,3,4,5;5;2,9;2;1;1
258105872790;258105872845;55;0,1,3,4,5;5;2,9;2;1;1
258105872845;258105872870;25;0,1,3,4,5;5;2,9;2;1;1
258105872870;258105872886;16;0,1,3,4,5;5;2,9;2;1;1
258105872886;258105872896;10;0,1,3,4,5;5;2,9;2;1;1
258105872896;258105873091;195;0,1,3,4,5;5;2,9;2;1;1
258105873091;258105882463;9372;0,1,3,4,5;5;2,9;2;1;1
258105882463;258105883091;628;0,1,3,4,5;5;2,9;2;1;1
258105883091;258105883112;21;0,1,3,4,5;5;2,9;2;1;1
258105883112;258105883719;607;0,1,3,4,5;5;2,9;2;1;1
258105883719;258105884221;502;0,1,3,4,5;5;2,9;2;1;1
258105884221;258105884255;34;0,1,3,4,5;5;2,9;2;1;1
258105884255;258105888416;4161;0,1,3,4,5;5;2,9;2;1;1
258105888416;258105892416;4000;0,1,3,4,5;5;2,9;2;1;1
258105892416;258105897393;4977;0,1,3,4,5;5;2,9;2;1;1
258105897393;258105899121;1728;0,1,3,4,5;5;2,9;2;1;1
258105899121;258105899480;359;0,1,3,4,5;5;2,9;2;1;1
258105899480;258105899607;127;0,1,3,4,5;5;2,9;2;1;1
258105899607;258105900218;611;0,1,3,4,5;5;2,9;2;1;1
258105900218;258105901001;783;0,1,3,4,5;5;2,9;2;1;1
258105901001;258105901669;668;0,1,3,4,5;5;2,9;2;1;1
258105901669;258105904506;2837;0,1,3,4,5;5;2,9;2;1;1
258105904506;258105907036;2530;0,1,3,5;4;9;1;1;1
258105907036;258105915547;8511;0,1,3,5;4;9;1;1;1
258105915547;258105915583;36;0,1,3,5;4;9;1;1;1
258105915583;258105916011;428;0,1,3,5;4;9;1;1;1
258105916011;258105916046;35;0,1,3,5;4;9;1;1;1
258105916046;258105916069;23;0,1,3,5;4;9;1;1;1
258105916069;258105916978;909;0,1,3,5;4;9;1;1;1
258105916978;258105920051;3073;0,1,3,5;4;9;1;1;1
258105920051;258105920137;86;0,1,3,5;4;9;1;1;1
258105920137;258105920171;34;0,1,3,5;4;9;1;1;1
258105920171;258105920234;63;0,1,3,5;4;9;1;1;1
258105920234;258105920328;94;0,1,3,5,6;5;9;1;1;1
258105920328;258105920338;10;0,1,3,5,6;5;9;1;1;1
258105920338;258105920498;160;0,1,3,5,6;5;9;1;1;1
258105920498;258105920534;36;0,1,3,5,6;5;9;1;1;1
258105920534;258105920604;70;0,1,3,5,6;5;9;1;1;1
258105920604;258105920759;155;0,1,3,5,6;5;9;1;1;1
258105920759;258105930827;10068;0,1,3,5;4;9;1;1;1
258105930827;258105930856;29;0,1,3,5;4;9;1;1;1
258105930856;258105930913;57;0,1,3,5;4;9;1;1;1
258105930913;258105931119;206;0,1,3,5;4;9;1;1;1
258105931119;258105931136;17;0,1,3,5;4;9;1;1;1
258105931136;258105931513;377;0,1,3,5;4;9;1;1;1
258105931513;258105931567;54;0,1,3,5;4;9;1;1;1
258105931567;258105931580;13;0,1,3,5;4;9;1;1;1
258105931580;258105931914;334;0,1,3,5;4;9;1;1;1
258105931914;258105939932;8018;0,1,3,5;4;9;1;1;1
258105939932;258105943424;3492;0,1,3,5;4;9;1;1;1
258105943424;258105948692;5268;0,1,3,5;4;9;1;1;1
258105948692;258105956663;7971;0,1,3,5;4;9;1;1;1
258105956663;258105957402;739;0,1,3,5;4;9;1;1;1
258105957402;258105957553;151;0,1,3,5;4;9;1;1;1
258105957553;258105957971;418;0,1,3,5;4;9;1;1;1
258105957971;258105958044;73;0,1,3,5;4;9;1;1;1
258105958044;258105961779;3735;0,1,3,5;4;9;1;1;1
258105961779;258105962060;281;0,1,3,5,6;5;9;1;1;1
258105962060;258105962226;166;0,1,3,5;4;9;1;1;1
258105962226;258105962306;80;0,1,3,5;4;9;1;1;1
258105962306;258105962315;9;0,1,3,5;4;9;1;1;1
258105962315;258105962458;143;0,1,3,5;4;9;1;1;1
258105962458;258105962541;83;0,1,3,5;4;9;1;1;1
258105962541;258105962588;47;0,1,3,5;4;9;1;1;1
258105962588;258105962614;26;0,1,3,5,6;5;9;1;1;1
258105962614;258105962700;86;0,1,3,5,6;5;9;1;1;1
258105962700;258105962726;26;0,1,3,5,6;5;9;1;1;1
258105962726;258105962789;63;0,1,3,5,6;5;9;1;1;1
258105962789;258105962911;122;0,1,3,5;4;9;1;1;1
258105962911;258105963011;100;0,1,3,5;4;9;1;1;1
258105963011;258105963116;105;0,1,3,5;4;9;1;1;1
258105963116;258105963300;184;0,1,3,5;4;9;1;1;1
258105963300;258105963456;156;0,1,3,5;4;9;1;1;1
258105963456;258105963489;33;0,1,3,5;4;9;1;1;1
258105963489;258105963679;190;0,1,3,5;4;9;1;1;1
258105963679;258105964366;687;0,1,3,5;4;9;1;1;1
258105964366;258105965703;1337;0,1,3,5;4;9;1;1;1
258105965703;258105966236;533;0,1,3,4,5;5;2,9;2;1;1
258105966236;258105971080;4844;0,1,3,5;4;9;1;1;1
258105971080;258105972513;1433;0,1,3,5;4;9;1;1;1
258105972513;258105973936;1423;0,1,3,5;4;9;1;1;1
258105973936;258105973969;33;0,1,3,5;4;9;1;1;1
258105973969;258105973992;23;0,1,3,5;4;9;1;1;1
258105973992;258105974043;51;0,1,3,5;4;9;1;1;1
258105974043;258105974125;82;0,1,3,5;4;9;1;1;1
258105974125;258105974177;52;0,1,3,5;4;9;1;1;1
258105974177;258105974229;52;0,1,3,5;4;9;1;1;1
258105974229;258105975892;1663;0,1,3,5;4;9;1;1;1
258105975892;258105976413;521;0,1,3,5;4;9;1;1;1
258105976413;258105977711;1298;0,1,3,5;4;9;1;1;1
258105977711;258105985602;7891;0,1,3,5;4;9;1;1;1
258105985602;258105985816;214;0,1,3,5;4;9;1;1;1
258105985816;258106001549;15733;0,1,3,5;4;9;1;1;1
258106001549;258106006880;5331;0,1,3,5;4;9;1;1;1
258106006880;258106011507;4627;0,1,3,5;4;9;1;1;1
258106011507;258106011906;399;0,1,3,5;4;9;1;1;1
258106011906;258106021021;9115;0,1,3,5;4;9;1;1;1
258106021021;258106021071;50;0,1,3,5;4;9;1;1;1
258106021071;258106027593;6522;0,1,3,5;4;9;1;1;1
258106027593;258106027840;247;0,1,3,5;4;9;1;1;1
258106027840;258106028248;408;0,1,3,5;4;9;1;1;1
258106028248;258106028344;96;0,1,3,5;4;9;1;1;1
258106028344;258106028379;35;0,1,3,5;4;9;1;1;1
258106028379;258106028417;38;0,1,3,5;4;9;1;1;1
258106028417;258106028461;44;0,1,3,5;4;9;1;1;1
258106028461;258106028531;70;0,1,3,5;4;9;1;1;1
258106028531;258106028570;39;0,1,3,5;4;9;1;1;1
258106028570;258106028718;148;0,1,3,5,6;5;9;1;1;1
258106028718;258106036978;8260;0,1,3,5;4;9;1;1;1
258106036978;258106037808;830;0,1,3,4,5;5;2,9;2;1;1
258106037808;258106039813;2005;0,1,3,5;4;9;1;1;1
258106039813;258106040048;235;0,1,3,4,5;5;2,9;2;1;1
258106040048;258106044751;4703;0,1,3,4,5;5;2,9;2;1;1
258106044751;258106045998;1247;0,1,3,5;4;9;1;1;1
258106045998;258106047343;1345;0,1,3,4,5;5;2,9;2;1;1
258106047343;258106048836;1493;0,1,3,5;4;9;1;1;1
258106048836;258106050308;1472;0,1,3,5;4;9;1;1;1
258106050308;258106052673;2365;0,1,3,4,5;5;2,9;2;1;1
258106052673;258106053035;362;0,1,3,4,5;5;2,9;2;1;1
258106053035;258106055760;2725;0,1,3,4,5;5;2,9;2;1;1
258106055760;258106056610;850;0,1,3,4,5;5;2,9;2;1;1
258106056610;258106057406;796;0,1,3,4,5;5;2,9;2;1;1
258106057406;258106057718;312;0,1,3,5;4;9;1;1;1
258106057718;258106058170;452;0,1,3,4,5;5;2,9;2;1;1
258106058170;258106058226;56;0,1,3,4,5;5;2,9;2;1;1
258106058226;258106061265;3039;0,1,3,4,5;5;2,9;2;1;1
258106061265;258106061353;88;0,1,3,4,5;5;2,9;2;1;1
258106061353;258106062159;806;0,1,3,4,5;5;2,9;2;1;1
258106062159;258106062461;302;0,1,3,4,5;5;2,9;2;1;1
258106062461;258106063072;611;0,1,3,4,5;5;2,9;2;1;1
258106063072;258106063155;83;0,1,3,4,5;5;2,9;2;1;1
258106063155;258106067503;4348;0,1,3,5;4;9;1;1;1
258106067503;258106068658;1155;0,1,3,4,5;5;2,9;2;1;1
258106068658;258106071134;2476;0,1,3,5;4;9;1;1;1
258106071134;258106071157;23;0,1,3,4,5;5;2,9;2;1;1
258106071157;258106071223;66;0,1,3,4,5;5;2,9;2;1;1
258106071223;258106071309;86;0,1,3,4,5;5;2,9;2;1;1
258106071309;258106071370;61;0,1,3,4,5;5;2,9;2;1;1
258106071370;258106071714;344;0,1,3,4,5;5;2,9;2;1;1
258106071714;258106072128;414;0,1,3,5;4;9;1;1;1
258106072128;258106088204;16076;0,1,3,5;4;9;1;1;1
258106088204;258106094232;6028;0,1,3,5;4;9;1;1;1
258106094232;258106100869;6637;0,1,3,5;4;9;1;1;1
258106100869;258106101193;324;0,1,3,5;4;9;1;1;1
258106101193;258106101437;244;0,1,3,5;4;9;1;1;1
258106101437;258106101634;197;0,1,3,5,6;5;9;1;1;1
258106101634;258106102439;805;0,1,3,5;4;9;1;1;1
258106102439;258106102554;115;0,1,3,5;4;9;1;1;1
258106102554;258106102683;129;0,1,3,5;4;9;1;1;1
258106102683;258106102717;34;0,1,3,5;4;9;1;1;1
258106102717;258106103193;476;0,1,3,5;4;9;1;1;1
258106103193;258106103344;151;0,1,3,5;4;9;1;1;1
258106103344;258106103412;68;0,1,3,5;4;9;1;1;1
258106103412;258106103656;244;0,1,3,5;4;9;1;1;1
258106103656;258106103845;189;0,1,3,5;4;9;1;1;1
258106103845;258106105894;2049;0,1,3,5;4;9;1;1;1
258106105894;258106106056;162;0,1,3,5,6;5;9;1;1;1
258106106056;258106106356;300;0,1,3,5;4;9;1;1;1
258106106356;258106106389;33;0,1,3,5;4;9;1;1;1
258106106389;258106106589;200;0,1,3,5;4;9;1;1;1
258106106589;258106106631;42;0,1,3,5;4;9;1;1;1
258106106631;258106106842;211;0,1,3,5;4;9;1;1;1
258106106842;258106107018;176;0,1,3,5;4;9;1;1;1
258106107018;258106107064;46;0,1,3,5;4;9;1;1;1
258106107064;258106107112;48;0,1,3,5;4;9;1;1;1
258106107112;258106112909;5797;0,1,3,5;4;9;1;1;1
258106112909;258106115175;2266;0,1,3,4,5;5;2,9;2;1;1
258106115175;258106115483;308;0,1,3,4,5;5;2,9;2;1;1
258106115483;258106115633;150;0,1,3,4,5;5;2,9;2;1;1
258106115633;258106118167;2534;0,1,3,4,5;5;2,9;2;1;1
258106118167;258106118241;74;0,1,3,4,5;5;2,9;2;1;1
258106118241;258106118538;297;0,1,3,4,5;5;2,9;2;1;1
258106118538;258106118566;28;0,1,3,4,5;5;2,9;2;1;1
258106118566;258106118897;331;0,1,3,4,5;5;2,9;2;1;1
258106118897;258106118976;79;0,1,3,4,5;5;2,9;2;1;1
258106118976;258106118986;10;0,1,3,4,5;5;2,9;2;1;1
258106118986;258106120869;1883;0,1,3,4,5;5;2,9;2;1;1
258106120869;258106121235;366;0,1,3,4,5;5;2,9;2;1;1
258106121235;258106122044;809;0,1,3,4,5;5;2,9;2;1;1
258106122044;258106122150;106;0,1,3,4,5;5;2,9;2;1;1
258106122150;258106122158;8;0,1,3,4,5;5;2,9;2;1;1
258106122158;258106122193;35;0,1,3,4,5;5;2,9;2;1;1
258106122193;258106122556;363;0,1,3,4,5;5;2,9;2;1;1
258106122556;258106127705;5149;0,1,3,4,5;5;2,9;2;1;1
258106127705;258106142497;14792;0,1,3,4,5;5;2,9;2;1;1
258106142497;258106144476;1979;0,1,3,4,5;5;2,9;2;1;1
258106144476;258106145010;534;0,1,3,4,5;5;2,9;2;1;1
258106145010;258106146021;1011;0,1,3,4,5;5;2,9;2;1;1
258106146021;258106146557;536;0,1,3,4,5;5;2,9;2;1;1
258106146557;258106146741;184;0,1,3,4,5,6;6;2,9;2;1;1
258106146741;258106146770;29;0,1,3,4,5,6;6;2,9;2;1;1
258106146770;258106146837;67;0,1,3,4,5,6;6;2,9;2;1;1
258106146837;258106146889;52;0,1,3,4,5,6;6;2,9;2;1;1
258106146889;258106146908;19;0,1,3,4,5,6;6;2,9;2;1;1
258106146908;258106146977;69;0,1,3,4,5,6;6;2,9;2;1;1
258106146977;258106147114;137;0,1,3,4,5,6;6;2,9;2;1;1
258106147114;258106147336;222;0,1,3,4,5;5;2,9;2;1;1
258106147336;258106147371;35;0,1,3,4,5;5;2,9;2;1;1
258106147371;258106147401;30;0,1,3,4,5;5;2,9;2;1;1
258106147401;258106147467;66;0,1,3,4,5;5;2,9;2;1;1
258106147467;258106148386;919;0,1,3,4,5;5;2,9;2;1;1
258106148386;258106149016;630;0,1,3,4,5;5;2,9;2;1;1
258106149016;258106149058;42;0,1,3,4,5;5;2,9;2;1;1
258106149058;258106149164;106;0,1,3,4,5;5;2,9;2;1;1
258106149164;258106149741;577;0,1,3,4,5;5;2,9;2;1;1
258106149741;258106150791;1050;0,1,3,4,5;5;2,9;2;1;1
258106150791;258106154154;3363;0,1,3,4,5;5;2,9;2;1;1
258106154154;258106156912;2758;0,1,3,5;4;9;1;1;1
258106156912;258106164321;7409;0,1,3,5;4;9;1;1;1
258106164321;258106167608;3287;0,1,3,5;4;9;1;1;1
258106167608;258106167740;132;0,1,3,5;4;9;1;1;1
258106167740;258106167868;128;0,1,3,5;4;9;1;1;1
258106167868;258106167936;68;0,1,3,5;4;9;1;1;1
258106167936;258106168070;134;0,1,3,5;4;9;1;1;1
258106168070;258106168099;29;0,1,3,5;4;9;1;1;1
258106168099;258106168126;27;0,1,3,5;4;9;1;1;1
258106168126;258106196091;27965;0,1,3,5;4;9;1;1;1
258106196091;258106196832;741;0,1,3,5;4;9;1;1;1
258106196832;258106199553;2721;0,1,3,5;4;9;1;1;1
258106199553;258106205710;6157;0,1,3,5;4;9;1;1;1
258106205710;258106205858;148;0,1,3,5,6;5;9;1;1;1
258106205858;258106205928;70;0,1,3,5,6;5;9;1;1;1
258106205928;258106206000;72;0,1,3,5,6;5;9;1;1;1
258106206000;258106206170;170;0,1,3,5;4;9;1;1;1
258106206170;258106206244;74;0,1,3,5;4;9;1;1;1
258106206244;258106206294;50;0,1,3,5;4;9;1;1;1
258106206294;258106206316;22;0,1,3,5;4;9;1;1;1
258106206316;258106206497;181;0,1,3,5;4;9;1;1;1
258106206497;258106206769;272;0,1,3,5;4;9;1;1;1
258106206769;258106206815;46;0,1,3,5;4;9;1;1;1
258106206815;258106210735;3920;0,1,3,5;4;9;1;1;1
258106210735;258106210808;73;0,1,3,5;4;9;1;1;1
258106210808;258106210886;78;0,1,3,5;4;9;1;1;1
258106210886;258106211093;207;0,1,3,5;4;9;1;1;1
258106211093;258106211944;851;0,1,3,5;4;9;1;1;1
258106211944;258106213338;1394;0,1,3,5;4;9;1;1;1
258106213338;258106213438;100;0,1,3,5;4;9;1;1;1
258106213438;258106213545;107;0,1,3,5;4;9;1;1;1
258106213545;258106213694;149;0,1,3,5;4;9;1;1;1
258106213694;258106213826;132;0,1,3,5;4;9;1;1;1
258106213826;258106213968;142;0,1,3,5;4;9;1;1;1
258106213968;258106229338;15370;0,1,3,5;4;9;1;1;1
258106229338;258106241675;12337;0,1,3,5;4;9;1;1;1
258106241675;258106242291;616;0,1,3,5;4;9;1;1;1
258106242291;258106242603;312;0,1,3,5;4;9;1;1;1
258106242603;258106260584;17981;0,1,3,5;4;9;1;1;1
258106260584;258106261647;1063;0,1,3,5;4;9;1;1;1
258106261647;258106261861;214;0,1,3,5;4;9;1;1;1
258106261861;258106261930;69;0,1,3,5;4;9;1;1;1
258106261930;258106261949;19;0,1,3,5;4;9;1;1;1
258106261949;258106262372;423;0,1,3,5;4;9;1;1;1
258106262372;258106263147;775;0,1,3,5;4;9;1;1;1
258106263147;258106263181;34;0,1,3,5;4;9;1;1;1
258106263181;258106265151;1970;0,1,3,5;4;9;1;1;1
258106265151;258106265871;720;0,1,3,5;4;9;1;1;1
258106265871;258106266444;573;0,1,3,5;4;9;1;1;1
258106266444;258106266553;109;0,1,3,5,6;5;9;1;1;1
258106266553;258106266609;56;0,1,3,5,6;5;9;1;1;1
258106266609;258106266619;10;0,1,3,5,6;5;9;1;1;1
258106266619;258106266764;145;0,1,3,5,6;5;9;1;1;1
258106266764;258106266776;12;0,1,3,5,6;5;9;1;1;1
258106266776;258106266889;113;0,1,3,5;4;9;1;1;1
258106266889;258106266915;26;0,1,3,5;4;9;1;1;1
258106266915;258106266933;18;0,1,3,5;4;9;1;1;1
258106266933;258106267102;169;0,1,3,5;4;9;1;1;1
258106267102;258106268435;1333;0,1,3,5;4;9;1;1;1
258106268435;258106268453;18;0,1,3,5;4;9;1;1;1
258106268453;258106268477;24;0,1,3,5;4;9;1;1;1
258106268477;258106268802;325;0,1,3,5;4;9;1;1;1
258106268802;258106268804;2;0,1,3,5;4;9;1;1;1
258106268804;258106268840;36;0,1,3,5;4;9;1;1;1
258106268840;258106268882;42;0,1,3,5;4;9;1;1;1
258106268882;258106268950;68;0,1,3,5;4;9;1;1;1
258106268950;258106268958;8;0,1,3,5;4;9;1;1;1
258106268958;258106269108;150;0,1,3,5;4;9;1;1;1
258106269108;258106269146;38;0,1,3,5;4;9;1;1;1
258106269146;258106269322;176;0,1,3,5,6;5;9;1;1;1
258106269322;258106269362;40;0,1,3,5;4;9;1;1;1
258106269362;258106269501;139;0,1,3,5,6;5;9;1;1;1
258106269501;258106269729;228;0,1,3,5;4;9;1;1;1
258106269729;258106269947;218;0,1,3,5;4;9;1;1;1
258106269947;258106270141;194;0,1,3,5;4;9;1;1;1
258106270141;258106270151;10;0,1,3,5;4;9;1;1;1
258106270151;258106270347;196;0,1,3,5,6;5;9;1;1;1
258106270347;258106270405;58;0,1,3,5,6;5;9;1;1;1
258106270405;258106270412;7;0,1,3,5,6;5;9;1;1;1
258106270412;258106270445;33;0,1,3,5,6;5;9;1;1;1
258106270445;258106270447;2;0,1,3,5;4;9;1;1;1
258106270447;258106270459;12;0,1,3,5;4;9;1;1;1
258106270459;258106270536;77;0,1,3,5;4;9;1;1;1
258106270536;258106270616;80;0,1,3,5;4;9;1;1;1
258106270616;258106270654;38;0,1,3,5;4;9;1;1;1
258106270654;258106271074;420;0,1,3,5;4;9;1;1;1
258106271074;258106271238;164;0,1,3,5;4;9;1;1;1
258106271238;258106271414;176;0,1,3,5;4;9;1;1;1
258106271414;258106273387;1973;0,1,3,5;4;9;1;1;1
258106273387;258106273615;228;0,1,3,5;4;9;1;1;1
258106273615;258106273666;51;0,1,3,5;4;9;1;1;1
258106273666;258106273685;19;0,1,3,5;4;9;1;1;1
258106273685;258106279462;5777;0,1,3,5;4;9;1;1;1
258106279462;258106281552;2090;0,1,3,5;4;9;1;1;1
258106281552;258106282017;465;0,1,3,5;4;9;1;1;1
258106282017;258106284203;2186;0,1,3,5;4;9;1;1;1
258106284203;258106291743;7540;0,1,3,5;4;9;1;1;1
258106291743;258106295363;3620;0,1,3,5;4;9;1;1;1
258106295363;258106295395;32;0,1,3,5;4;9;1;1;1
258106295395;258106299501;4106;0,1,3,5;4;9;1;1;1
258106299501;258106302929;3428;0,1,3,4,5;5;2,9;2;1;1
258106302929;258106303141;212;0,1,3,4,5;5;2,9;2;1;1
258106303141;258106303372;231;0,1,3,4,5;5;2,9;2;1;1
258106303372;258106303408;36;0,1,3,4,5;5;2,9;2;1;1
258106303408;258106303509;101;0,1,3,4,5,6;6;2,9;2;1;1
258106303509;258106303517;8;0,1,3,4,5,6;6;2,9;2;1;1
258106303517;258106303559;42;0,1,3,4,5,6;6;2,9;2;1;1
258106303559;258106303679;120;0,1,3,4,5,6;6;2,9;2;1;1
258106303679;258106303723;44;0,1,3,4,5,6;6;2,9;2;1;1
258106303723;258106303739;16;0,1,3,4,5;5;2,9;2;1;1
258106303739;258106303742;3;0,1,3,4,5;5;2,9;2;1;1
258106303742;258106311376;7634;0,1,3,4,5;5;2,9;2;1;1
258106311376;258106311486;110;0,1,3,4,5;5;2,9;2;1;1
258106311486;258106316903;5417;0,1,3,4,5;5;2,9;2;1;1
258106316903;258106324433;7530;0,1,3,4,5;5;2,9;2;1;1
258106324433;258106329591;5158;0,1,3,4,5;5;2,9;2;1;1
258106329591;258106330415;824;0,1,3,4,5;5;2,9;2;1;1
258106330415;258106332951;2536;0,1,3,4,5;5;2,9;2;1;1
258106332951;258106335343;2392;0,1,3,4,5;5;2,9;2;1;1
258106335343;258106336305;962;0,1,3,4,5;5;2,9;2;1;1
258106336305;258106342456;6151;0,1,3,4,5;5;2,9;2;1;1
258106342456;258106342767;311;0,1,3,4,5;5;2,9;2;1;1
258106342767;258106342903;136;0,1,3,4,5;5;2,9;2;1;1
258106342903;258106343418;515;0,1,3,4,5;5;2,9;2;1;1
258106343418;258106345434;2016;0,1,3,4,5;5;2,9;2;1;1
258106345434;258106345965;531;0,1,3,4,5;5;2,9;2;1;1
258106345965;258106351161;5196;0,1,3,4,5;5;2,9;2;1;1
258106351161;258106351655;494;0,1,3,4,5;5;2,9;2;1;1
258106351655;258106352511;856;0,1,3,4,5;5;2,9;2;1;1
258106352511;258106352750;239;0,1,3,4,5;5;2,9;2;1;1
258106352750;258106353609;859;0,1,3,4,5;5;2,9;2;1;1
258106353609;258106355387;1778;0,1,3,5;4;9;1;1;1
258106355387;258106355700;313;0,1,3,5;4;9;1;1;1
258106355700;258106356332;632;0,1,3,4,5;5;2,9;2;1;1
258106356332;258106359566;3234;0,1,3,5;4;9;1;1;1
258106359566;258106364896;5330;0,1,3,5;4;9;1;1;1
258106364896;258106364945;49;0,1,3,5;4;9;1;1;1
258106364945;258106365393;448;0,1,3,5;4;9;1;1;1
258106365393;258106365435;42;0,1,3,5;4;9;1;1;1
258106365435;258106365655;220;0,1,3,5;4;9;1;1;1
258106365655;258106369666;4011;0,1,3,5;4;9;1;1;1
258106369666;258106369674;8;0,1,3,5;4;9;1;1;1
258106369674;258106369724;50;0,1,3,5;4;9;1;1;1
258106369724;258106369735;11;0,1,3,5;4;9;1;1;1
258106369735;258106369759;24;0,1,3,5;4;9;1;1;1
258106369759;258106369787;28;0,1,3,5;4;9;1;1;1
258106369787;258106369840;53;0,1,3,5;4;9;1;1;1
258106369840;258106417162;47322;0,1,3,5;4;9;1;1;1
258106417162;258106417184;22;0,1,3,5;4;9;1;1;1
258106417184;258106417266;82;0,1,3,5;4;9;1;1;1
258106417266;258106426257;8991;0,1,3,5;4;9;1;1;1
258106426257;258106426932;675;0,1,3,4,5;5;2,9;2;1;1
258106426932;258106427673;741;0,1,3,4,5;5;2,9;2;1;1
258106427673;258106427683;10;0,1,3,4,5;5;2,9;2;1;1
258106427683;258106431097;3414;0,1,3,4,5;5;2,9;2;1;1
258106431097;258106431148;51;0,1,3,4,5,6;6;2,9;2;1;1
258106431148;258106431161;13;0,1,3,4,5,6;6;2,9;2;1;1
258106431161;258106431192;31;0,1,3,4,5,6;6;2,9;2;1;1
258106431192;258106431252;60;0,1,3,4,5,6;6;2,9;2;1;1
258106431252;258106431420;168;0,1,3,4,5,6;6;2,9;2;1;1
258106431420;258106431424;4;0,1,3,4,5,6;6;2,9;2;1;1
258106431424;258106431541;117;0,1,3,4,5,6;6;2,9;2;1;1
258106431541;258106431571;30;0,1,3,4,5;5;2,9;2;1;1
258106431571;258106431602;31;0,1,3,4,5;5;2,9;2;1;1
258106431602;258106432158;556;0,1,3,4,5;5;2,9;2;1;1
258106432158;258106436750;4592;0,1,3,4,5;5;2,9;2;1;1
258106436750;258106440311;3561;0,1,3,4,5;5;2,9;2;1;1
258106440311;258106443630;3319;0,1,3,4,5;5;2,9;2;1;1
258106443630;258106444518;888;0,1,3,4,5;5;2,9;2;1;1
258106444518;258106457589;13071;0,1,3,4,5;5;2,9;2;1;1
258106457589;258106459172;1583;0,1,3,4,5;5;2,9;2;1;1
258106459172;258106460213;1041;0,1,3,4,5;5;2,9;2;1;1
258106460213;258106467562;7349;0,1,3,4,5;5;2,9;2;1;1
258106467562;258106470330;2768;0,1,3,4,5;5;2,9;2;1;1
258106470330;258106470981;651;0,1,3,4,5;5;2,9;2;1;1
258106470981;258106471666;685;0,1,3,4,5;5;2,9;2;1;1
258106471666;258106473614;1948;0,1,3,4,5;5;2,9;2;1;1
258106473614;258106474153;539;0,1,3,4,5;5;2,9;2;1;1
258106474153;258106474970;817;0,1,3,4,5;5;2,9;2;1;1
258106474970;258106477175;2205;0,1,3,4,5;5;2,9;2;1;1
258106477175;258106477651;476;0,1,3,4,5;5;2,9;2;1;1
258106477651;258106479395;1744;0,1,3,5;4;9;1;1;1
258106479395;258106492205;12810;0,1,3,5;4;9;1;1;1
258106492205;258106502438;10233;0,1,3,5;4;9;1;1;1
258106502438;258106502653;215;0,1,3,5;4;9;1;1;1
258106502653;258106503127;474;0,1,3,5;4;9;1;1;1
258106503127;258106510721;7594;0,1,3,5;4;9;1;1;1
258106510721;258106522454;11733;0,1,3,4,5;5;2,9;2;1;1
258106522454;258106523404;950;0,1,3,4,5;5;2,9;2;1;1
258106523404;258106523447;43;0,1,3,4,5;5;2,9;2;1;1
258106523447;258106525344;1897;0,1,3,4,5;5;2,9;2;1;1
258106525344;258106525395;51;0,1,3,4,5;5;2,9;2;1;1
258106525395;258106525407;12;0,1,3,4,5;5;2,9;2;1;1
258106525407;258106525428;21;0,1,3,4,5;5;2,9;2;1;1
258106525428;258106525463;35;0,1,3,4,5;5;2,9;2;1;1
258106525463;258106525723;260;0,1,3,4,5;5;2,9;2;1;1
258106525723;258106525740;17;0,1,3,4,5;5;2,9;2;1;1
258106525740;258106525809;69;0,1,3,4,5;5;2,9;2;1;1
258106525809;258106525927;118;0,1,3,4,5;5;2,9;2;1;1
258106525927;258106526203;276;0,1,3,4,5;5;2,9;2;1;1
258106526203;258106529079;2876;0,1,3,4,5;5;2,9;2;1;1
258106529079;258106529165;86;0,1,3,4,5,6;6;2,9;2;1;1
258106529165;258106529171;6;0,1,3,4,5,6;6;2,9;2;1;1
258106529171;258106529238;67;0,1,3,4,5,6;6;2,9;2;1;1
258106529238;258106529360;122;0,1,3,4,5;5;2,9;2;1;1
258106529360;258106529394;34;0,1,3,4,5;5;2,9;2;1;1
258106529394;258106529638;244;0,1,3,4,5;5;2,9;2;1;1
258106529638;258106529813;175;0,1,3,4,5;5;2,9;2;1;1
258106529813;258106529963;150;0,1,3,4,5;5;2,9;2;1;1
258106529963;258106530175;212;0,1,3,4,5;5;2,9;2;1;1
258106530175;258106531262;1087;0,1,3,4,5;5;2,9;2;1;1
258106531262;258106536396;5134;0,1,3,4,5;5;2,9;2;1;1
258106536396;258106538594;2198;0,1,3,5;4;9;1;1;1
258106538594;258106539938;1344;0,1,3,5;4;9;1;1;1
258106539938;258106539987;49;0,1,3,5;4;9;1;1;1
258106539987;258106540079;92;0,1,3,5;4;9;1;1;1
258106540079;258106554418;14339;0,1,3,5;4;9;1;1;1
258106554418;258106555073;655;0,1,3,5;4;9;1;1;1
258106555073;258106555193;120;0,1,3,5;4;9;1;1;1
258106555193;258106555311;118;0,1,3,5;4;9;1;1;1
258106555311;258106555348;37;0,1,3,5;4;9;1;1;1
258106555348;258106555582;234;0,1,3,5;4;9;1;1;1
258106555582;258106571800;16218;0,1,3,5;4;9;1;1;1
258106571800;258106584981;13181;0,1,3,5;4;9;1;1;1
258106584981;258106594525;9544;0,1,3,5;4;9;1;1;1
258106594525;258106601064;6539;0,1,3,5;4;9;1;1;1
258106601064;258106603524;2460;0,1,3,4,5;5;2,9;2;1;1
258106603524;258106611623;8099;0,1,3,4,5;5;2,9;2;1;1
258106611623;258106611828;205;0,1,3,4,5;5;2,9;2;1;1
258106611828;258106611831;3;0,1,3,4,5;5;2,9;2;1;1
258106611831;258106611855;24;0,1,3,4,5;5;2,9;2;1;1
258106611855;258106611909;54;0,1,3,4,5;5;2,9;2;1;1
258106611909;258106611972;63;0,1,3,4,5;5;2,9;2;1;1
258106611972;258106612507;535;0,1,3,4,5;5;2,9;2;1;1
258106612507;258106612536;29;0,1,3,4,5;5;2,9;2;1;1
258106612536;258106613009;473;0,1,3,4,5;5;2,9;2;1;1
258106613009;258106613044;35;0,1,3,4,5;5;2,9;2;1;1
258106613044;258106613077;33;0,1,3,4,5;5;2,9;2;1;1
258106613077;258106613309;232;0,1,3,4,5;5;2,9;2;1;1
258106613309;258106613487;178;0,1,3,4,5;5;2,9;2;1;1
258106613487;258106614750;1263;0,1,3,4,5;5;2,9;2;1;1
258106614750;258106616045;1295;0,1,3,4,5;5;2,9;2;1;1
258106616045;258106618421;2376;0,1,3,4,5;5;2,9;2;1;1
258106618421;258106618498;77;0,1,3,4,5;5;2,9;2;1;1
258106618498;258106618564;66;0,1,3,4,5;5;2,9;2;1;1
258106618564;258106618575;11;0,1,3,4,5;5;2,9;2;1;1
258106618575;258106618643;68;0,1,3,4,5,6;6;2,9;2;1;1
258106618643;258106618714;71;0,1,3,4,5,6;6;2,9;2;1;1
258106618714;258106619012;298;0,1,3,4,5,6;6;2,9;2;1;1
258106619012;258106619049;37;0,1,3,4,5,6;6;2,9;2;1;1
258106619049;258106619144;95;0,1,3,4,5;5;2,9;2;1;1
258106619144;258106619197;53;0,1,3,4,5;5;2,9;2;1;1
258106619197;258106621962;2765;0,1,3,4,5;5;2,9;2;1;1
258106621962;258106625886;3924;0,1,3,4,5;5;2,9;2;1;1
258106625886;258106627847;1961;0,1,3,4,5;5;2,9;2;1;1
258106627847;258106627869;22;0,1,3,4,5;5;2,9;2;1;1
258106627869;258106628138;269;0,1,3,4,5;5;2,9;2;1;1
258106628138;258106628397;259;0,1,3,4,5,6;6;2,9;2;1;1
258106628397;258106628509;112;0,1,3,4,5,6;6;2,9;2;1;1
258106628509;258106628554;45;0,1,3,4,5,6;6;2,9;2;1;1
258106628554;258106628588;34;0,1,3,4,5,6;6;2,9;2;1;1
258106628588;258106628725;137;0,1,3,4,5,6;6;2,9;2;1;1
258106628725;258106628755;30;0,1,3,4,5,6;6;2,9;2;1;1
258106628755;258106628854;99;0,1,3,4,5,6;6;2,9;2;1;1
258106628854;258106628871;17;0,1,3,4,5,6;6;2,9;2;1;1
258106628871;258106630104;1233;0,1,3,4,5;5;2,9;2;1;1
258106630104;258106631820;1716;0,1,3,4,5;5;2,9;2;1;1
258106631820;258106633972;2152;0,1,3,4,5;5;2,9;2;1;1
258106633972;258106634385;413;0,1,3,4,5;5;2,9;2;1;1
258106634385;258106637931;3546;0,1,3,4,5;5;2,9;2;1;1
258106637931;258106638591;660;0,1,3,4,5;5;2,9;2;1;1
258106638591;258106639558;967;0,1,3,4,5;5;2,9;2;1;1
258106639558;258106640259;701;0,1,3,4,5;5;2,9;2;1;1
258106640259;258106641693;1434;0,1,3,4,5;5;2,9;2;1;1
258106641693;258106643794;2101;0,1,3,4,5;5;2,9;2;1;1
258106643794;258106646115;2321;0,1,3,4,5;5;2,9;2;1;1
258106646115;258106649290;3175;0,1,3,4,5;5;2,9;2;1;1
258106649290;258106649426;136;0,1,3,5;4;9;1;1;1
258106649426;258106653432;4006;0,1,3,5;4;9;1;1;1
258106653432;258106653475;43;0,1,3,5;4;9;1;1;1
258106653475;258106653491;16;0,1,3,5;4;9;1;1;1
258106653491;258106653536;45;0,1,3,5;4;9;1;1;1
258106653536;258106653698;162;0,1,3,5;4;9;1;1;1
258106653698;258106655212;1514;0,1,3,5;4;9;1;1;1
258106655212;258106655925;713;0,1,3,5;4;9;1;1;1
258106655925;258106656025;100;0,1,3,5;4;9;1;1;1
258106656025;258106656090;65;0,1,3,5;4;9;1;1;1
258106656090;258106656135;45;0,1,3,5;4;9;1;1;1
258106656135;258106656198;63;0,1,3,5;4;9;1;1;1
258106656198;258106656982;784;0,1,3,5;4;9;1;1;1
258106656982;258106673039;16057;0,1,3,5;4;9;1;1;1
258106673039;258106673740;701;0,1,3,5;4;9;1;1;1
258106673740;258106674608;868;0,1,3,5;4;9;1;1;1
258106674608;258106675151;543;0,1,3,5;4;9;1;1;1
258106675151;258106677024;1873;0,1,3,5;4;9;1;1;1
258106677024;258106677078;54;0,1,3,5;4;9;1;1;1
258106677078;258106677130;52;0,1,3,5;4;9;1;1;1
258106677130;258106677156;26;0,1,3,5;4;9;1;1;1
258106677156;258106677272;116;0,1,3,5;4;9;1;1;1
258106677272;258106677910;638;0,1,3,5;4;9;1;1;1
258106677910;258106680171;2261;0,1,3,5;4;9;1;1;1
258106680171;258106680384;213;0,1,3,5;4;9;1;1;1
258106680384;258106697431;17047;0,1,3,5;4;9;1;1;1
258106697431;258106698290;859;0,1,3,5;4;9;1;1;1
258106698290;258106698730;440;0,1,3,5;4;9;1;1;1
258106698730;258106698954;224;0,1,3,5;4;9;1;1;1
258106698954;258106699129;175;0,1,3,5;4;9;1;1;1
258106699129;258106699204;75;0,1,3,5;4;9;1;1;1
258106699204;258106707195;7991;0,1,3,5;4;9;1;1;1
258106707195;258106708279;1084;0,1,3,5;4;9;1;1;1
258106708279;258106708360;81;0,1,3,5;4;9;1;1;1
258106708360;258106718725;10365;0,1,3,5;4;9;1;1;1
258106718725;258106720114;1389;0,1,3,5;4;9;1;1;1
258106720114;258106722793;2679;0,1,3,4,5;5;2,9;2;1;1
258106722793;258106722827;34;0,1,3,4,5;5;2,9;2;1;1
258106722827;258106722915;88;0,1,3,4,5;5;2,9;2;1;1
258106722915;258106723091;176;0,1,3,4,5;5;2,9;2;1;1
258106723091;258106728748;5657;0,1,3,4,5;5;2,9;2;1;1
258106728748;258106728983;235;0,1,3,4,5;5;2,9;2;1;1
258106728983;258106730657;1674;0,1,3,4,5;5;2,9;2;1;1
258106730657;258106730927;270;0,1,3,4,5,6;6;2,9;2;1;1
258106730927;258106731080;153;0,1,3,4,5;5;2,9;2;1;1
258106731080;258106731259;179;0,1,3,4,5;5;2,9;2;1;1
258106731259;258106731300;41;0,1,3,4,5;5;2,9;2;1;1
258106731300;258106731332;32;0,1,3,4,5;5;2,9;2;1;1
258106731332;258106731477;145;0,1,3,4,5;5;2,9;2;1;1
258106731477;258106731737;260;0,1,3,4,5;5;2,9;2;1;1
258106731737;258106731882;145;0,1,3,4,5;5;2,9;2;1;1
258106731882;258106732028;146;0,1,3,4,5;5;2,9;2;1;1
258106732028;258106738384;6356;0,1,3,4,5;5;2,9;2;1;1
258106738384;258106742257;3873;0,1,3,4,5;5;2,9;2;1;1
258106742257;258106742370;113;0,1,3,4,5;5;2,9;2;1;1
258106742370;258106742397;27;0,1,3,4,5;5;2,9;2;1;1
258106742397;258106742461;64;0,1,3,4,5;5;2,9;2;1;1
258106742461;258106742500;39;0,1,3,4,5;5;2,9;2;1;1
258106742500;258106742512;12;0,1,3,4,5;5;2,9;2;1;1
258106742512;258106746432;3920;0,1,3,4,5;5;2,9;2;1;1
258106746432;258106775734;29302;0,1,3,5;4;9;1;1;1
258106775734;258106776396;662;0,1,3,4,5;5;2,9;2;1;1
258106776396;258106783344;6948;0,1,3,5;4;9;1;1;1
258106783344;258106788065;4721;0,1,3,5;4;9;1;1;1
258106788065;258106788081;16;0,1,3,5;4;9;1;1;1
258106788081;258106788101;20;0,1,3,5;4;9;1;1;1
258106788101;258106788136;35;0,1,3,5;4;9;1;1;1
258106788136;258106788187;51;0,1,3,5;4;9;1;1;1
258106788187;258106788238;51;0,1,3,5;4;9;1;1;1
258106788238;258106788265;27;0,1,3,5;4;9;1;1;1
258106788265;258106788460;195;0,1,3,5;4;9;1;1;1
258106788460;258106788481;21;0,1,3,5;4;9;1;1;1
258106788481;258106788588;107;0,1,3,5;4;9;1;1;1
258106788588;258106806495;17907;0,1,3,5;4;9;1;1;1
258106806495;258106806601;106;0,1,3,5;4;9;1;1;1
258106806601;258106806713;112;0,1,3,5;4;9;1;1;1
258106806713;258106823360;16647;0,1,3,5;4;9;1;1;1
258106823360;258106823871;511;0,1,3,5;4;9;1;1;1
258106823871;258106823940;69;0,1,3,5;4;9;1;1;1
258106823940;258106824053;113;0,1,3,5;4;9;1;1;1
258106824053;258106824361;308;0,1,3,5;4;9;1;1;1
258106824361;258106830380;6019;0,1,3,5;4;9;1;1;1
258106830380;258106834233;3853;0,1,3,5;4;9;1;1;1
258106834233;258106837003;2770;0,1,3,5;4;9;1;1;1
258106837003;258106837152;149;0,1,3,5;4;9;1;1;1
258106837152;258106837240;88;0,1,3,5;4;9;1;1;1
258106837240;258106837347;107;0,1,3,5;4;9;1;1;1
258106837347;258106837721;374;0,1,3,5;4;9;1;1;1
258106837721;258106837761;40;0,1,3,5;4;9;1;1;1
258106837761;258106838170;409;0,1,3,5;4;9;1;1;1
258106838170;258106838258;88;0,1,3,5;4;9;1;1;1
258106838258;258106839431;1173;0,1,3,5;4;9;1;1;1
258106839431;258106841575;2144;0,1,3,4,5;5;2,9;2;1;1
258106841575;258106848373;6798;0,1,3,4,5;5;2,9;2;1;1
258106848373;258106850962;2589;0,1,3,4,5;5;2,9;2;1;1
258106850962;258106852097;1135;0,1,3,4,5;5;2,9;2;1;1
258106852097;258106852846;749;0,1,3,4,5;5;2,9;2;1;1
258106852846;258106860581;7735;0,1,3,4,5;5;2,9;2;1;1
258106860581;258106866469;5888;0,1,3,4,5;5;2,9;2;1;1
258106866469;258106869091;2622;0,1,3,4,5;5;2,9;2;1;1
258106869091;258106871934;2843;0,1,3,4,5;5;2,9;2;1;1
258106871934;258106872650;716;0,1,3,4,5;5;2,9;2;1;1
258106872650;258106873481;831;0,1,3,4,5;5;2,9;2;1;1
258106873481;258106873597;116;0,1,3,4,5;5;2,9;2;1;1
258106873597;258106873619;22;0,1,3,4,5;5;2,9;2;1;1
258106873619;258106873881;262;0,1,3,4,5;5;2,9;2;1;1
258106873881;258106874171;290;0,1,3,4,5;5;2,9;2;1;1
258106874171;258106879332;5161;0,1,3,4,5;5;2,9;2;1;1
258106879332;258106881353;2021;0,1,3,4,5;5;2,9;2;1;1
258106881353;258106887746;6393;0,1,3,4,5;5;2,9;2;1;1
258106887746;258106888959;1213;0,1,3,4,5;5;2,9;2;1;1
258106888959;258106888994;35;0,1,3,4,5;5;2,9;2;1;1
258106888994;258106889015;21;0,1,3,4,5;5;2,9;2;1;1
258106889015;258106889310;295;0,1,3,4,5;5;2,9;2;1;1
258106889310;258106889482;172;0,1,3,4,5;5;2,9;2;1;1
258106889482;258106891149;1667;0,1,3,4,5;5;2,9;2;1;1
258106891149;258106891180;31;0,1,3,4,5;5;2,9;2;1;1
258106891180;258106891235;55;0,1,3,4,5;5;2,9;2;1;1
258106891235;258106891367;132;0,1,3,4,5;5;2,9;2;1;1
258106891367;258106891500;133;0,1,3,4,5;5;2,9;2;1;1
258106891500;258106891602;102;0,1,3,4,5;5;2,9;2;1;1
258106891602;258106891865;263;0,1,3,4,5;5;2,9;2;1;1
258106891865;258106893886;2021;0,1,3,4,5;5;2,9;2;1;1
258106893886;258106894409;523;0,1,3,4,5;5;2,9;2;1;1
258106894409;258106894678;269;0,1,3,4,5;5;2,9;2;1;1
258106894678;258106896511;1833;0,1,3,4,5;5;2,9;2;1;1
258106896511;258106896789;278;0,1,3,4,5;5;2,9;2;1;1
258106896789;258106899149;2360;0,1,3,4,5;5;2,9;2;1;1
258106899149;258106900327;1178;0,1,3,4,5;5;2,9;2;1;1
258106900327;258106901141;814;0,1,3,4,5;5;2,9;2;1;1
258106901141;258106902272;1131;0,1,3,4,5;5;2,9;2;1;1
258106902272;258106915868;13596;0,1,3,5;4;9;1;1;1
258106915868;258106915917;49;0,1,3,5;4;9;1;1;1
258106915917;258106915929;12;0,1,3,5;4;9;1;1;1
258106915929;258106916005;76;0,1,3,5;4;9;1;1;1
258106916005;258106916060;55;0,1,3,5;4;9;1;1;1
258106916060;258106916447;387;0,1,3,5;4;9;1;1;1
258106916447;258106937702;21255;0,1,3,5;4;9;1;1;1
258106937702;258106940725;3023;0,1,3,5;4;9;1;1;1
258106940725;258106940748;23;0,1,3,5;4;9;1;1;1
258106940748;258106940786;38;0,1,3,5;4;9;1;1;1
258106940786;258106941026;240;0,1,3,5;4;9;1;1;1
258106941026;258106950057;9031;0,1,3,5;4;9;1;1;1
258106950057;258106950826;769;0,1,3,4,5;5;2,9;2;1;1
258106950826;258106952605;1779;0,1,3,4,5;5;2,9;2;1;1
258106952605;258106957029;4424;0,1,3,4,5;5;2,9;2;1;1
258106957029;258106957941;912;0,1,3,4,5;5;2,9;2;1;1
258106957941;258106959398;1457;0,1,3,4,5;5;2,9;2;1;1
258106959398;258106965422;6024;0,1,3,4,5;5;2,9;2;1;1
258106965422;258106967717;2295;0,1,3,4,5;5;2,9;2;1;1
258106967717;258106972757;5040;0,1,3,4,5;5;2,9;2;1;1
258106972757;258106979024;6267;0,1,3,4,5;5;2,9;2;1;1
258106979024;258106980682;1658;0,1,3,4,5;5;2,9;2;1;1
258106980682;258106986108;5426;0,1,3,4,5;5;2,9;2;1;1
258106986108;258106990196;4088;0,1,3,4,5;5;2,9;2;1;1
258106990196;258106997483;7287;0,1,3,4,5;5;2,9;2;1;1
258106997483;258106998752;1269;0,1,3,4,5;5;2,9;2;1;1
258106998752;258106999357;605;0,1,3,4,5;5;2,9;2;1;1
258106999357;258106999926;569;0,1,3,4,5;5;2,9;2;1;1
258106999926;258107000087;161;0,1,3,4,5;5;2,9;2;1;1
258107000087;258107000572;485;0,1,3,4,5;5;2,9;2;1;1
258107000572;258107000691;119;0,1,3,4,5;5;2,9;2;1;1
258107000691;258107001599;908;0,1,3,4,5;5;2,9;2;1;1
258107001599;258107001678;79;0,1,3,4,5;5;2,9;2;1;1
258107001678;258107003950;2272;0,1,3,4,5;5;2,9;2;1;1
258107003950;258107005043;1093;0,1,3,4,5;5;2,9;2;1;1
258107005043;258107009121;4078;0,1,3,4,5;5;2,9;2;1;1
258107009121;258107009887;766;0,1,3,4,5;5;2,9;2;1;1
258107009887;258107011931;2044;0,1,3,4,5;5;2,9;2;1;1
258107011931;258107022612;10681;0,1,3,4,5;5;2,9;2;1;1
258107022612;258107022621;9;0,1,3,4,5;5;2,9;2;1;1
258107022621;258107022658;37;0,1,3,4,5;5;2,9;2;1;1
258107022658;258107022686;28;0,1,3,4,5;5;2,9;2;1;1
258107022686;258107022739;53;0,1,3,4,5;5;2,9;2;1;1
258107022739;258107022793;54;0,1,3,4,5;5;2,9;2;1;1
258107022793;258107022924;131;0,1,3,4,5;5;2,9;2;1;1
258107022924;258107022975;51;0,1,3,4,5;5;2,9;2;1;1
258107022975;258107023689;714;0,1,3,4,5;5;2,9;2;1;1
258107023689;258107026017;2328;0,1,3,4,5;5;2,9;2;1;1
258107026017;258107026740;723;0,1,3,4,5;5;2,9;2;1;1
258107026740;258107048115;21375;0,1,3,5;4;9;1;1;1
258107048115;258107049345;1230;0,1,3,5;4;9;1;1;1
258107049345;258107049520;175;0,1,3,5;4;9;1;1;1
258107049520;258107087610;38090;0,1,3,5;4;9;1;1;1
258107087610;258107087830;220;0,1,3,5;4;9;1;1;1
258107087830;258107087861;31;0,1,3,5;4;9;1;1;1
258107087861;258107088475;614;0,1,3,5;4;9;1;1;1
258107088475;258107088583;108;0,1,3,5;4;9;1;1;1
258107088583;258107088771;188;0,1,3,5;4;9;1;1;1
258107088771;258107089171;400;0,1,3,5;4;9;1;1;1
258107089171;258107089543;372;0,1,3,5;4;9;1;1;1
258107089543;258107089886;343;0,1,3,5;4;9;1;1;1
258107089886;258107089962;76;0,1,3,5;4;9;1;1;1
258107089962;258107091954;1992;0,1,3,5;4;9;1;1;1
258107091954;258107094548;2594;0,1,3,5;4;9;1;1;1
258107094548;258107095157;609;0,1,3,5;4;9;1;1;1
258107095157;258107095511;354;0,1,3,5;4;9;1;1;1
258107095511;258107096211;700;0,1,3,5;4;9;1;1;1
258107096211;258107096880;669;0,1,3,5;4;9;1;1;1
258107096880;258107096923;43;0,1,3,5;4;9;1;1;1
258107096923;258107097044;121;0,1,3,5;4;9;1;1;1
258107097044;258107097176;132;0,1,3,5;4;9;1;1;1
258107097176;258107097405;229;0,1,3,5,6;5;9;1;1;1
258107097405;258107097654;249;0,1,3,5,6;5;9;1;1;1
258107097654;258107097700;46;0,1,3,5,6;5;9;1;1;1
258107097700;258107097705;5;0,1,3,5;4;9;1;1;1
258107097705;258107097771;66;0,1,3,5;4;9;1;1;1
258107097771;258107097845;74;0,1,3,5;4;9;1;1;1
258107097845;258107097954;109;0,1,3,5;4;9;1;1;1
258107097954;258107098427;473;0,1,3,5;4;9;1;1;1
258107098427;258107103575;5148;0,1,3,5;4;9;1;1;1
258107103575;258107103915;340;0,1,3,5;4;9;1;1;1
258107103915;258107104055;140;0,1,3,5;4;9;1;1;1
258107104055;258107104123;68;0,1,3,5;4;9;1;1;1
258107104123;258107104148;25;0,1,3,5;4;9;1;1;1
258107104148;258107104247;99;0,1,3,5;4;9;1;1;1
258107104247;258107104257;10;0,1,3,5;4;9;1;1;1
258107104257;258107104284;27;0,1,3,5;4;9;1;1;1
258107104284;258107106225;1941;0,1,3,5;4;9;1;1;1
258107106225;258107106261;36;0,1,3,5;4;9;1;1;1
258107106261;258107106678;417;0,1,3,5;4;9;1;1;1
258107106678;258107108305;1627;0,1,3,5;4;9;1;1;1
258107108305;258107108340;35;0,1,3,5;4;9;1;1;1
258107108340;258107112041;3701;0,1,3,5;4;9;1;1;1
258107112041;258107112643;602;0,1,3,4,5;5;2,9;2;1;1
258107112643;258107118956;6313;0,1,3,4,5;5;2,9;2;1;1
258107118956;258107128353;9397;0,1,3,4,5;5;2,9;2;1;1
258107128353;258107131567;3214;0,1,3,4,5;5;2,9;2;1;1
258107131567;258107132047;480;0,1,3,4,5;5;2,9;2;1;1
258107132047;258107132528;481;0,1,3,4,5;5;2,9;2;1;1
258107132528;258107135550;3022;0,1,3,4,5;5;2,9;2;1;1
258107135550;258107141741;6191;0,1,3,4,5;5;2,9;2;1;1
258107141741;258107141845;104;0,1,3,4,5,6;6;2,9;2;1;1
258107141845;258107141846;1;0,1,3,4,5,6;6;2,9;2;1;1
258107141846;258107141877;31;0,1,3,4,5,6;6;2,9;2;1;1
258107141877;258107142031;154;0,1,3,4,5,6;6;2,9;2;1;1
258107142031;258107142038;7;0,1,3,4,5;5;2,9;2;1;1
258107142038;258107142183;145;0,1,3,4,5;5;2,9;2;1;1
258107142183;258107142219;36;0,1,3,4,5;5;2,9;2;1;1
258107142219;258107142315;96;0,1,3,4,5;5;2,9;2;1;1
258107142315;258107142495;180;0,1,3,4,5;5;2,9;2;1;1
258107142495;258107144927;2432;0,1,3,4,5;5;2,9;2;1;1
258107144927;258107148236;3309;0,1,3,4,5;5;2,9;2;1;1
258107148236;258107149294;1058;0,1,3,4,5;5;2,9;2;1;1
258107149294;258107150122;828;0,1,3,4,5;5;2,9;2;1;1
258107150122;258107150625;503;0,1,3,4,5;5;2,9;2;1;1
258107150625;258107150643;18;0,1,3,4,5;5;2,9;2;1;1
258107150643;258107150659;16;0,1,3,4,5;5;2,9;2;1;1
258107150659;258107150694;35;0,1,3,4,5;5;2,9;2;1;1
258107150694;258107150718;24;0,1,3,4,5;5;2,9;2;1;1
258107150718;258107150773;55;0,1,3,4,5;5;2,9;2;1;1
258107150773;258107151101;328;0,1,3,4,5;5;2,9;2;1;1
258107151101;258107157202;6101;0,1,3,4,5;5;2,9;2;1;1
258107157202;258107158111;909;0,1,3,4,5;5;2,9;2;1;1
258107158111;258107158799;688;0,1,3,4,5;5;2,9;2;1;1
258107158799;258107159017;218;0,1,3,4,5;5;2,9;2;1;1
258107159017;258107160159;1142;0,1,3,4,5;5;2,9;2;1;1
258107160159;258107160373;214;0,1,3,4,5;5;2,9;2;1;1
258107160373;258107161584;1211;0,1,3,4,5;5;2,9;2;1;1
258107161584;258107162196;612;0,1,3,4,5;5;2,9;2;1;1
258107162196;258107163041;845;0,1,3,4,5;5;2,9;2;1;1
258107163041;258107164525;1484;0,1,3,4,5;5;2,9;2;1;1
258107164525;258107165469;944;0,1,3,4,5;5;2,9;2;1;1
258107165469;258107165896;427;0,1,3,4,5;5;2,9;2;1;1
258107165896;258107166597;701;0,1,3,4,5;5;2,9;2;1;1
258107166597;258107177151;10554;0,1,3,5;4;9;1;1;1
258107177151;258107197124;19973;0,1,3,5;4;9;1;1;1
258107197124;258107206384;9260;0,1,3,5;4;9;1;1;1
258107206384;258107206670;286;0,1,3,5;4;9;1;1;1
258107206670;258107221675;15005;0,1,3,5;4;9;1;1;1
258107221675;258107222204;529;0,1,3,5;4;9;1;1;1
258107222204;258107227325;5121;0,1,3,5;4;9;1;1;1
258107227325;258107231749;4424;0,1,3,4,5;5;2,9;2;1;1
258107231749;258107234134;2385;0,1,3,4,5;5;2,9;2;1;1
258107234134;258107236267;2133;0,1,3,4,5;5;2,9;2;1;1
258107236267;258107252114;15847;0,1,3,4,5;5;2,9;2;1;1
258107252114;258107255629;3515;0,1,3,4,5;5;2,9;2;1;1
258107255629;258107260274;4645;0,1,3,4,5;5;2,9;2;1;1
258107260274;258107261975;1701;0,1,3,4,5;5;2,9;2;1;1
258107261975;258107263657;1682;0,1,3,4,5;5;2,9;2;1;1
258107263657;258107265282;1625;0,1,3,4,5;5;2,9;2;1;1
258107265282;258107265383;101;0,1,3,4,5;5;2,9;2;1;1
258107265383;258107265867;484;0,1,3,4,5;5;2,9;2;1;1
258107265867;258107266999;1132;0,1,3,4,5;5;2,9;2;1;1
258107266999;258107267998;999;0,1,3,4,5;5;2,9;2;1;1
258107267998;258107271616;3618;0,1,3,4,5;5;2,9;2;1;1
258107271616;258107272336;720;0,1,3,4,5;5;2,9;2;1;1
258107272336;258107272414;78;0,1,3,4,5;5;2,9;2;1;1
258107272414;258107273025;611;0,1,3,4,5;5;2,9;2;1;1
258107273025;258107294033;21008;0,1,3,5;4;9;1;1;1
258107294033;258107294134;101;0,1,3,5;4;9;1;1;1
258107294134;258107294215;81;0,1,3,5;4;9;1;1;1
258107294215;258107294274;59;0,1,3,5;4;9;1;1;1
258107294274;258107294913;639;0,1,3,5;4;9;1;1;1
258107294913;258107295007;94;0,1,3,5;4;9;1;1;1
258107295007;258107295698;691;0,1,3,5;4;9;1;1;1
258107295698;258107295797;99;0,1,3,5;4;9;1;1;1
258107295797;258107318977;23180;0,1,3,5;4;9;1;1;1
258107318977;258107319005;28;0,1,3,5;4;9;1;1;1
258107319005;258107319072;67;0,1,3,5;4;9;1;1;1
258107319072;258107319094;22;0,1,3,5;4;9;1;1;1
258107319094;258107319186;92;0,1,3,5;4;9;1;1;1
258107319186;258107319337;151;0,1,3,5;4;9;1;1;1
258107319337;258107328148;8811;0,1,3,5;4;9;1;1;1
258107328148;258107340067;11919;0,1,3,5;4;9;1;1;1
258107340067;258107340192;125;0,1,3,5;4;9;1;1;1
258107340192;258107340319;127;0,1,3,5;4;9;1;1;1
258107340319;258107341183;864;0,1,3,5;4;9;1;1;1
258107341183;258107342194;1011;0,1,3,5;4;9;1;1;1
258107342194;258107343052;858;0,1,3,4,5;5;2,9;2;1;1
258107343052;258107343231;179;0,1,3,4,5;5;2,9;2;1;1
258107343231;258107344319;1088;0,1,3,4,5;5;2,9;2;1;1
258107344319;258107344398;79;0,1,3,4,5;5;2,9;2;1;1
258107344398;258107344452;54;0,1,3,4,5;5;2,9;2;1;1
258107344452;258107344700;248;0,1,3,4,5;5;2,9;2;1;1
258107344700;258107344844;144;0,1,3,4,5;5;2,9;2;1;1
258107344844;258107345285;441;0,1,3,4,5;5;2,9;2;1;1
258107345285;258107345682;397;0,1,3,4,5;5;2,9;2;1;1
258107345682;258107345851;169;0,1,3,4,5;5;2,9;2;1;1
258107345851;258107345916;65;0,1,3,4,5;5;2,9;2;1;1
258107345916;258107345936;20;0,1,3,4,5;5;2,9;2;1;1
258107345936;258107346021;85;0,1,3,4,5;5;2,9;2;1;1
258107346021;258107349509;3488;0,1,3,4,5;5;2,9;2;1;1
258107349509;258107350906;1397;0,1,3,4,5;5;2,9;2;1;1
258107350906;258107352048;1142;0,1,3,4,5;5;2,9;2;1;1
258107352048;258107352099;51;0,1,3,4,5;5;2,9;2;1;1
258107352099;258107352127;28;0,1,3,4,5;5;2,9;2;1;1
258107352127;258107352242;115;0,1,3,4,5;5;2,9;2;1;1
258107352242;258107352320;78;0,1,3,4,5;5;2,9;2;1;1
258107352320;258107352720;400;0,1,3,4,5;5;2,9;2;1;1
258107352720;258107352776;56;0,1,3,4,5;5;2,9;2;1;1
258107352776;258107353375;599;0,1,3,4,5;5;2,9;2;1;1
258107353375;258107357390;4015;0,1,3,4,5;5;2,9;2;1;1
258107357390;258107364089;6699;0,1,3,4,5;5;2,9;2;1;1
258107364089;258107364709;620;0,1,3,4,5;5;2,9;2;1;1
258107364709;258107367653;2944;0,1,3,4,5;5;2,9;2;1;1
258107367653;258107374603;6950;0,1,3,4,5;5;2,9;2;1;1
258107374603;258107376498;1895;0,1,3,4,5;5;2,9;2;1;1
258107376498;258107378826;2328;0,1,3,4,5;5;2,9;2;1;1
258107378826;258107379467;641;0,1,3,4,5;5;2,9;2;1;1
258107379467;258107379932;465;0,1,3,4,5;5;2,9;2;1;1
258107379932;258107386288;6356;0,1,3,4,5;5;2,9;2;1;1
258107386288;258107386487;199;0,1,3,4,5;5;2,9;2;1;1
258107386487;258107386607;120;0,1,3,4,5;5;2,9;2;1;1
258107386607;258107387515;908;0,1,3,4,5;5;2,9;2;1;1
258107387515;258107387577;62;0,1,3,4,5;5;2,9;2;1;1
258107387577;258107387613;36;0,1,3,4,5;5;2,9;2;1;1
258107387613;258107394396;6783;0,1,3,4,5;5;2,9;2;1;1
258107394396;258107394826;430;0,1,3,4,5;5;2,9;2;1;1
258107394826;258107396343;1517;0,1,3,4,5;5;2,9;2;1;1
258107396343;258107397543;1200;0,1,3,4,5;5;2,9;2;1;1
258107397543;258107399065;1522;0,1,3,4,5;5;2,9;2;1;1
258107399065;258107399639;574;0,1,3,4,5;5;2,9;2;1;1
258107399639;258107400426;787;0,1,3,4,5;5;2,9;2;1;1
258107400426;258107408393;7967;0,1,3,5;4;9;1;1;1
258107408393;258107413643;5250;0,1,3,5;4;9;1;1;1
258107413643;258107420344;6701;0,1,3,5;4;9;1;1;1
258107420344;258107420570;226;0,1,3,5;4;9;1;1;1
258107420570;258107420705;135;0,1,3,5;4;9;1;1;1
258107420705;258107420975;270;0,1,3,5;4;9;1;1;1
258107420975;258107421203;228;0,1,3,5;4;9;1;1;1
258107421203;258107421308;105;0,1,3,5;4;9;1;1;1
258107421308;258107421509;201;0,1,3,5;4;9;1;1;1
258107421509;258107422998;1489;0,1,3,5;4;9;1;1;1
258107422998;258107423346;348;0,1,3,5;4;9;1;1;1
258107423346;258107423354;8;0,1,3,5;4;9;1;1;1
258107423354;258107423405;51;0,1,3,5;4;9;1;1;1
258107423405;258107430707;7302;0,1,3,5;4;9;1;1;1
258107430707;258107435941;5234;0,1,3,5;4;9;1;1;1
258107435941;258107442358;6417;0,1,3,5;4;9;1;1;1
258107442358;258107443412;1054;0,1,3,5;4;9;1;1;1
258107443412;258107443493;81;0,1,3,5;4;9;1;1;1
258107443493;258107447675;4182;0,1,3,5;4;9;1;1;1
258107447675;258107457901;10226;0,1,3,5;4;9;1;1;1
258107457901;258107464332;6431;0,1,3,4,5;5;2,9;2;1;1
258107464332;258107464849;517;0,1,3,4,5;5;2,9;2;1;1
258107464849;258107464969;120;0,1,3,4,5;5;2,9;2;1;1
258107464969;258107467217;2248;0,1,3,4,5;5;2,9;2;1;1
258107467217;258107467863;646;0,1,3,4,5;5;2,9;2;1;1
258107467863;258107468554;691;0,1,3,4,5;5;2,9;2;1;1
258107468554;258107468564;10;0,1,3,4,5;5;2,9;2;1;1
258107468564;258107468589;25;0,1,3,4,5;5;2,9;2;1;1
258107468589;258107468846;257;0,1,3,4,5;5;2,9;2;1;1
258107468846;258107471221;2375;0,1,3,4,5;5;2,9;2;1;1
258107471221;258107484410;13189;0,1,3,4,5;5;2,9;2;1;1
258107484410;258107485735;1325;0,1,3,4,5;5;2,9;2;1;1
258107485735;258107488215;2480;0,1,3,4,5;5;2,9;2;1;1
258107488215;258107488567;352;0,1,3,4,5;5;2,9;2;1;1
258107488567;258107497979;9412;0,1,3,4,5;5;2,9;2;1;1
258107497979;258107498569;590;0,1,3,4,5;5;2,9;2;1;1
258107498569;258107499004;435;0,1,3,4,5;5;2,9;2;1;1
258107499004;258107499095;91;0,1,3,4,5;5;2,9;2;1;1
258107499095;258107515321;16226;0,1,3,4,5;5;2,9;2;1;1
258107515321;258107517401;2080;0,1,3,4,5;5;2,9;2;1;1
258107517401;258107518026;625;0,1,3,4,5;5;2,9;2;1;1
258107518026;258107518901;875;0,1,3,4,5;5;2,9;2;1;1
258107518901;258107519533;632;0,1,3,4,5;5;2,9;2;1;1
258107519533;258107520496;963;0,1,3,4,5;5;2,9;2;1;1
258107520496;258107521557;1061;0,1,3,4,5;5;2,9;2;1;1
258107521557;258107522608;1051;0,1,3,4,5;5;2,9;2;1;1
258107522608;258107583930;61322;0,1,3,5;4;9;1;1;1
258107583930;258107585155;1225;0,1,3,4,5;5;2,9;2;1;1
258107585155;258107587367;2212;0,1,3,4,5;5;2,9;2;1;1
258107587367;258107591714;4347;0,1,3,4,5;5;2,9;2;1;1
258107591714;258107596483;4769;0,1,3,4,5;5;2,9;2;1;1
258107596483;258107596720;237;0,1,3,4,5,6;6;2,9;2;1;1
258107596720;258107596844;124;0,1,3,4,5,6;6;2,9;2;1;1
258107596844;258107598396;1552;0,1,3,4,5;5;2,9;2;1;1
258107598396;258107598728;332;0,1,3,4,5,6;6;2,9;2;1;1
258107598728;258107598992;264;0,1,3,4,5,6;6;2,9;2;1;1
258107598992;258107599046;54;0,1,3,4,5,6;6;2,9;2;1;1
258107599046;258107601161;2115;0,1,3,4,5;5;2,9;2;1;1
258107601161;258107601411;250;0,1,3,4,5;5;2,9;2;1;1
258107601411;258107601747;336;0,1,3,4,5;5;2,9;2;1;1
258107601747;258107601793;46;0,1,3,4,5;5;2,9;2;1;1
258107601793;258107602008;215;0,1,3,4,5;5;2,9;2;1;1
258107602008;258107602043;35;0,1,3,4,5,6;6;2,9;2;1;1
258107602043;258107602347;304;0,1,3,4,5,6;6;2,9;2;1;1
258107602347;258107602552;205;0,1,3,4,5,6;6;2,9;2;1;1
258107602552;258107602809;257;0,1,3,4,5,6;6;2,9;2;1;1
258107602809;258107603003;194;0,1,3,4,5,6;6;2,9;2;1;1
258107603003;258107603231;228;0,1,3,4,5;5;2,9;2;1;1
258107603231;258107603267;36;0,1,3,4,5;5;2,9;2;1;1
258107603267;258107603494;227;0,1,3,4,5,6;6;2,9;2;1;1
258107603494;258107603617;123;0,1,3,4,5,6;6;2,9;2;1;1
258107603617;258107603627;10;0,1,3,4,5,6;6;2,9;2;1;1
258107603627;258107603672;45;0,1,3,4,5,6;6;2,9;2;1;1
258107603672;258107603690;18;0,1,3,4,5,6;6;2,9;2;1;1
258107603690;258107603833;143;0,1,3,4,5,6;6;2,9;2;1;1
258107603833;258107603840;7;0,1,3,4,5,6;6;2,9;2;1;1
258107603840;258107603870;30;0,1,3,4,5,6;6;2,9;2;1;1
258107603870;258107603886;16;0,1,3,4,5,6;6;2,9;2;1;1
258107603886;258107603896;10;0,1,3,4,5,6;6;2,9;2;1;1
258107603896;258107603964;68;0,1,3,4,5,6;6;2,9;2;1;1
258107603964;258107604066;102;0,1,3,4,5,6;6;2,9;2;1;1
258107604066;258107604214;148;0,1,3,4,5,6;6;2,9;2;1;1
258107604214;258107604286;72;0,1,3,4,5,6;6;2,9;2;1;1
258107604286;258107604309;23;0,1,3,4,5,6;6;2,9;2;1;1
258107604309;258107604348;39;0,1,3,4,5,6;6;2,9;2;1;1
258107604348;258107604355;7;0,1,3,4,5,6;6;2,9;2;1;1
258107604355;258107604404;49;0,1,3,4,5,6;6;2,9;2;1;1
258107604404;258107604417;13;0,1,3,4,5,6;6;2,9;2;1;1
258107604417;258107604578;161;0,1,3,4,5;5;2,9;2;1;1
258107604578;258107605687;1109;0,1,3,4,5;5;2,9;2;1;1
258107605687;258107606059;372;0,1,3,4,5,6;6;2,9;2;1;1
258107606059;258107606073;14;0,1,3,4,5,6;6;2,9;2;1;1
258107606073;258107606198;125;0,1,3,4,5,6;6;2,9;2;1;1
258107606198;258107606432;234;0,1,3,4,5,6;6;2,9;2;1;1
258107606432;258107606447;15;0,1,3,4,5,6;6;2,9;2;1;1
258107606447;258107606450;3;0,1,3,4,5,6;6;2,9;2;1;1
258107606450;258107606493;43;0,1,3,4,5,6;6;2,9;2;1;1
258107606493;258107606691;198;0,1,3,4,5,6;6;2,9;2;1;1
258107606691;258107606772;81;0,1,3,4,5,6;6;2,9;2;1;1
258107606772;258107606833;61;0,1,3,4,5,6;6;2,9;2;1;1
258107606833;258107606932;99;0,1,3,4,5,6;6;2,9;2;1;1
258107606932;258107606989;57;0,1,3,4,5,6;6;2,9;2;1;1
258107606989;258107606993;4;0,1,3,4,5,6;6;2,9;2;1;1
258107606993;258107607002;9;0,1,3,4,5,6;6;2,9;2;1;1
258107607002;258107607041;39;0,1,3,4,5,6;6;2,9;2;1;1
258107607041;258107607067;26;0,1,3,4,5,6;6;2,9;2;1;1
258107607067;258107607127;60;0,1,3,4,5,6;6;2,9;2;1;1
258107607127;258107607143;16;0,1,3,4,5,6;6;2,9;2;1;1
258107607143;258107607155;12;0,1,3,4,5,6;6;2,9;2;1;1
258107607155;258107607300;145;0,1,3,4,5,6;6;2,9;2;1;1
258107607300;258107607338;38;0,1,3,4,5,6;6;2,9;2;1;1
258107607338;258107607355;17;0,1,3,4,5,6;6;2,9;2;1;1
258107607355;258107607405;50;0,1,3,4,5,6;6;2,9;2;1;1
258107607405;258107607542;137;0,1,3,4,5;5;2,9;2;1;1
258107607542;258107607774;232;0,1,3,4,5;5;2,9;2;1;1
258107607774;258107607813;39;0,1,3,4,5,6;6;2,9;2;1;1
258107607813;258107607982;169;0,1,3,4,5,6;6;2,9;2;1;1
258107607982;258107608071;89;0,1,3,4,5,6;6;2,9;2;1;1
258107608071;258107608091;20;0,1,3,4,5,6;6;2,9;2;1;1
258107608091;258107608241;150;0,1,3,4,5,6;6;2,9;2;1;1
258107608241;258107608455;214;0,1,3,4,5,6;6;2,9;2;1;1
258107608455;258107608536;81;0,1,3,4,5,6;6;2,9;2;1;1
258107608536;258107608692;156;0,1,3,4,5,6;6;2,9;2;1;1
258107608692;258107608721;29;0,1,3,4,5,6;6;2,9;2;1;1
258107608721;258107608873;152;0,1,3,4,5,6;6;2,9;2;1;1
258107608873;258107608938;65;0,1,3,4,5,6;6;2,9;2;1;1
258107608938;258107608967;29;0,1,3,4,5,6;6;2,9;2;1;1
258107608967;258107609018;51;0,1,3,4,5,6;6;2,9;2;1;1
258107609018;258107609165;147;0,1,3,4,5,6;6;2,9;2;1;1
258107609165;258107609191;26;0,1,3,4,5,6;6;2,9;2;1;1
258107609191;258107609344;153;0,1,3,4,5,6;6;2,9;2;1;1
258107609344;258107609358;14;0,1,3,4,5,6;6;2,9;2;1;1
258107609358;258107609417;59;0,1,3,4,5,6;6;2,9;2;1;1
258107609417;258107609482;65;0,1,3,4,5,6;6;2,9;2;1;1
258107609482;258107609546;64;0,1,3,4,5,6;6;2,9;2;1;1
258107609546;258107609581;35;0,1,3,4,5,6;6;2,9;2;1;1
258107609581;258107609608;27;0,1,3,4,5,6;6;2,9;2;1;1
258107609608;258107609845;237;0,1,3,4,5,6;6;2,9;2;1;1
258107609845;258107609848;3;0,1,3,4,5,6;6;2,9;2;1;1
258107609848;258107609918;70;0,1,3,4,5,6;6;2,9;2;1;1
258107609918;258107609942;24;0,1,3,4,5,6;6;2,9;2;1;1
258107609942;258107610042;100;0,1,3,4,5,6;6;2,9;2;1;1
258107610042;258107610151;109;0,1,3,4,5,6;6;2,9;2;1;1
258107610151;258107610205;54;0,1,3,4,5,6;6;2,9;2;1;1
258107610205;258107610282;77;0,1,3,4,5,6;6;2,9;2;1;1
258107610282;258107610389;107;0,1,3,4,5,6;6;2,9;2;1;1
258107610389;258107610441;52;0,1,3,4,5,6;6;2,9;2;1;1
258107610441;258107610455;14;0,1,3,4,5,6;6;2,9;2;1;1
258107610455;258107610564;109;0,1,3,4,5,6;6;2,9;2;1;1
258107610564;258107610584;20;0,1,3,4,5,6;6;2,9;2;1;1
258107610584;258107610823;239;0,1,3,4,5,6;6;2,9;2;1;1
258107610823;258107610923;100;0,1,3,4,5,6;6;2,9;2;1;1
258107610923;258107610932;9;0,1,3,4,5,6;6;2,9;2;1;1
258107610932;258107611024;92;0,1,3,4,5,6;6;2,9;2;1;1
258107611024;258107611065;41;0,1,3,4,5,6;6;2,9;2;1;1
258107611065;258107611095;30;0,1,3,4,5,6;6;2,9;2;1;1
258107611095;258107611119;24;0,1,3,4,5,6;6;2,9;2;1;1
258107611119;258107611151;32;0,1,3,4,5,6;6;2,9;2;1;1
258107611151;258107611372;221;0,1,3,4,5,6;6;2,9;2;1;1
258107611372;258107611432;60;0,1,3,4,5,6;6;2,9;2;1;1
258107611432;258107611456;24;0,1,3,4,5,6;6;2,9;2;1;1
258107611456;258107611493;37;0,1,3,4,5,6;6;2,9;2;1;1
258107611493;258107611581;88;0,1,3,4,5,6;6;2,9;2;1;1
258107611581;258107611782;201;0,1,3,4,5,6;6;2,9;2;1;1
258107611782;258107612004;222;0,1,3,4,5,6;6;2,9;2;1;1
258107612004;258107612049;45;0,1,3,4,5,6;6;2,9;2;1;1
258107612049;258107612060;11;0,1,3,4,5,6;6;2,9;2;1;1
258107612060;258107612241;181;0,1,3,4,5,6;6;2,9;2;1;1
258107612241;258107612331;90;0,1,3,4,5,6;6;2,9;2;1;1
258107612331;258107612401;70;0,1,3,4,5,6;6;2,9;2;1;1
258107612401;258107612667;266;0,1,3,4,5,6;6;2,9;2;1;1
258107612667;258107612999;332;0,1,3,4,5,6;6;2,9;2;1;1
258107612999;258107613177;178;0,1,3,4,5;5;2,9;2;1;1
258107613177;258107613229;52;0,1,3,4,5;5;2,9;2;1;1
258107613229;258107613275;46;0,1,3,4,5;5;2,9;2;1;1
258107613275;258107613696;421;0,1,3,4,5,6;6;2,9;2;1;1
258107613696;258107613739;43;0,1,3,4,5,6;6;2,9;2;1;1
258107613739;258107613927;188;0,1,3,4,5,6;6;2,9;2;1;1
258107613927;258107613966;39;0,1,3,4,5,6;6;2,9;2;1;1
258107613966;258107614155;189;0,1,3,4,5,6;6;2,9;2;1;1
258107614155;258107614174;19;0,1,3,4,5,6;6;2,9;2;1;1
258107614174;258107614218;44;0,1,3,4,5,6;6;2,9;2;1;1
258107614218;258107614342;124;0,1,3,4,5,6;6;2,9;2;1;1
258107614342;258107614358;16;0,1,3,4,5,6;6;2,9;2;1;1
258107614358;258107614420;62;0,1,3,4,5,6;6;2,9;2;1;1
258107614420;258107614589;169;0,1,3,4,5,6;6;2,9;2;1;1
258107614589;258107614655;66;0,1,3,4,5,6;6;2,9;2;1;1
258107614655;258107614716;61;0,1,3,4,5,6;6;2,9;2;1;1
258107614716;258107614865;149;0,1,3,4,5,6;6;2,9;2;1;1
258107614865;258107615196;331;0,1,3,4,5,6;6;2,9;2;1;1
258107615196;258107615227;31;0,1,3,4,5,6;6;2,9;2;1;1
258107615227;258107615295;68;0,1,3,4,5,6;6;2,9;2;1;1
258107615295;258107615316;21;0,1,3,4,5,6;6;2,9;2;1;1
258107615316;258107615632;316;0,1,3,4,5,6;6;2,9;2;1;1
258107615632;258107615674;42;0,1,3,4,5,6;6;2,9;2;1;1
258107615674;258107615728;54;0,1,3,4,5,6;6;2,9;2;1;1
258107615728;258107615787;59;0,1,3,4,5,6;6;2,9;2;1;1
258107615787;258107615835;48;0,1,3,4,5,6;6;2,9;2;1;1
258107615835;258107615998;163;0,1,3,4,5,6;6;2,9;2;1;1
258107615998;258107616059;61;0,1,3,4,5,6;6;2,9;2;1;1
258107616059;258107616060;1;0,1,3,4,5,6;6;2,9;2;1;1
258107616060;258107616090;30;0,1,3,4,5,6;6;2,9;2;1;1
258107616090;258107616171;81;0,1,3,4,5,6;6;2,9;2;1;1
258107616171;258107616183;12;0,1,3,4,5,6;6;2,9;2;1;1
258107616183;258107616211;28;0,1,3,4,5,6;6;2,9;2;1;1
258107616211;258107616292;81;0,1,3,4,5,6;6;2,9;2;1;1
258107616292;258107616339;47;0,1,3,4,5,6;6;2,9;2;1;1
258107616339;258107616357;18;0,1,3,4,5,6;6;2,9;2;1;1
258107616357;258107616631;274;0,1,3,4,5,6;6;2,9;2;1;1
258107616631;258107616673;42;0,1,3,4,5,6;6;2,9;2;1;1
258107616673;258107616718;45;0,1,3,4,5,6;6;2,9;2;1;1
258107616718;258107616746;28;0,1,3,4,5,6;6;2,9;2;1;1
258107616746;258107616759;13;0,1,3,4,5,6;6;2,9;2;1;1
258107616759;258107616802;43;0,1,3,4,5,6;6;2,9;2;1;1
258107616802;258107616873;71;0,1,3,4,5,6;6;2,9;2;1;1
258107616873;258107616877;4;0,1,3,4,5,6;6;2,9;2;1;1
258107616877;258107616929;52;0,1,3,4,5,6;6;2,9;2;1;1
258107616929;258107616952;23;0,1,3,4,5,6;6;2,9;2;1;1
258107616952;258107617074;122;0,1,3,4,5,6;6;2,9;2;1;1
258107617074;258107617147;73;0,1,3,4,5,6;6;2,9;2;1;1
258107617147;258107617216;69;0,1,3,4,5,6;6;2,9;2;1;1
258107617216;258107617426;210;0,1,3,4,5,6;6;2,9;2;1;1
258107617426;258107617757;331;0,1,3,4,5,6;6;2,9;2;1;1
258107617757;258107618067;310;0,1,3,4,5,6;6;2,9;2;1;1
258107618067;258107618460;393;0,1,3,4,5,6;6;2,9;2;1;1
258107618460;258107618515;55;0,1,3,4,5,6;6;2,9;2;1;1
258107618515;258107618566;51;0,1,3,4,5,6;6;2,9;2;1;1
258107618566;258107618626;60;0,1,3,4,5,6;6;2,9;2;1;1
258107618626;258107618788;162;0,1,3,4,5,6;6;2,9;2;1;1
258107618788;258107618818;30;0,1,3,4,5,6;6;2,9;2;1;1
258107618818;258107618935;117;0,1,3,4,5,6;6;2,9;2;1;1
258107618935;258107619012;77;0,1,3,4,5,6;6;2,9;2;1;1
258107619012;258107619111;99;0,1,3,4,5,6;6;2,9;2;1;1
258107619111;258107619127;16;0,1,3,4,5,6;6;2,9;2;1;1
258107619127;258107619188;61;0,1,3,4,5,6;6;2,9;2;1;1
258107619188;258107619240;52;0,1,3,4,5,6;6;2,9;2;1;1
258107619240;258107619345;105;0,1,3,4,5,6;6;2,9;2;1;1
258107619345;258107619444;99;0,1,3,4,5,6;6;2,9;2;1;1
258107619444;258107619594;150;0,1,3,4,5,6;6;2,9;2;1;1
258107619594;258107619789;195;0,1,3,4,5,6;6;2,9;2;1;1
258107619789;258107620003;214;0,1,3,4,5,6;6;2,9;2;1;1
258107620003;258107620532;529;0,1,3,4,5,6;6;2,9;2;1;1
258107620532;258107621357;825;0,1,3,4,5,6;6;2,9;2;1;1
258107621357;258107622631;1274;0,1,3,4,5,6;6;2,9;2;1;1
258107622631;258107624185;1554;0,1,3,4,5,6;6;2,9;2;1;1
258107624185;258107624438;253;0,1,3,4,5,6;6;2,9;2;1;1
258107624438;258107625048;610;0,1,3,4,5,6;6;2,9;2;1;1
258107625048;258107690728;65680;0,1,3,5,6;5;9;1;1;1
258107690728;258107690802;74;0,1,3,5,6;5;9;1;1;1
258107690802;258107690926;124;0,1,3,5,6;5;9;1;1;1
258107690926;258107691348;422;0,1,3,5,6;5;9;1;1;1
258107691348;258107691602;254;0,1,3,5,6;5;9;1;1;1
258107691602;258107691778;176;0,1,3,5,6;5;9;1;1;1
258107691778;258107696156;4378;0,1,3,5,6;5;9;1;1;1
258107696156;258107696447;291;0,1,3,5,6;5;9;1;1;1
258107696447;258107696496;49;0,1,3,5,6;5;9;1;1;1
258107696496;258107696906;410;0,1,3,5,6;5;9;1;1;1
258107696906;258107696952;46;0,1,3,4,5,6;6;2,9;2;1;1
258107696952;258107697025;73;0,1,3,4,5,6;6;2,9;2;1;1
258107697025;258107697178;153;0,1,3,4,5,6;6;2,9;2;1;1
258107697178;258107697330;152;0,1,3,4,5,6;6;2,9;2;1;1
258107697330;258107697372;42;0,1,3,4,5,6;6;2,9;2;1;1
258107697372;258107698415;1043;0,1,3,4,5,6;6;2,9;2;1;1
258107698415;258107698438;23;0,1,3,4,5,6;6;2,9;2;1;1
258107698438;258107700532;2094;0,1,3,4,5,6;6;2,9;2;1;1
258107700532;258107704612;4080;0,1,3,4,5,6;6;2,9;2;1;1
258107704612;258107705192;580;0,1,3,4,5,6;6;2,9;2;1;1
258107705192;258107705265;73;0,1,3,4,5,6;6;2,9;2;1;1
258107705265;258107705457;192;0,1,3,4,5,6;6;2,9;2;1;1
258107705457;258107705600;143;0,1,3,4,5,6;6;2,9;2;1;1
258107705600;258107705650;50;0,1,3,4,5,6;6;2,9;2;1;1
258107705650;258107706625;975;0,1,3,4,5,6;6;2,9;2;1;1
258107706625;258107706626;1;0,1,3,4,5,6;6;2,9;2;1;1
258107706626;258107706748;122;0,1,3,4,5,6;6;2,9;2;1;1
258107706748;258107706840;92;0,1,3,4,5,6;6;2,9;2;1;1
258107706840;258107707250;410;0,1,3,4,5,6;6;2,9;2;1;1
258107707250;258107707890;640;0,1,3,4,5,6;6;2,9;2;1;1
258107707890;258107708167;277;0,1,3,4,5,6;6;2,9;2;1;1
258107708167;258107708330;163;0,1,3,4,5,6;6;2,9;2;1;1
258107708330;258107708488;158;0,1,3,4,5,6;6;2,9;2;1;1
258107708488;258107708628;140;0,1,3,4,5,6;6;2,9;2;1;1
258107708628;258107709165;537;0,1,3,4,5,6;6;2,9;2;1;1
258107709165;258107709206;41;0,1,3,4,5,6;6;2,9;2;1;1
258107709206;258107710146;940;0,1,3,4,5,6;6;2,9;2;1;1
258107710146;258107710351;205;0,1,3,4,5,6;6;2,9;2;1;1
258107710351;258107710913;562;0,1,3,4,5,6;6;2,9;2;1;1
258107710913;258107711053;140;0,1,3,4,5,6;6;2,9;2;1;1
258107711053;258107711648;595;0,1,3,4,5,6;6;2,9;2;1;1
258107711648;258107711748;100;0,1,3,4,5,6;6;2,9;2;1;1
258107711748;258107711781;33;0,1,3,4,5,6;6;2,9;2;1;1
258107711781;258107711821;40;0,1,3,4,5,6;6;2,9;2;1;1
258107711821;258107712032;211;0,1,3,4,5,6;6;2,9;2;1;1
258107712032;258107712217;185;0,1,3,4,5,6;6;2,9;2;1;1
258107712217;258107712261;44;0,1,3,4,5,6;6;2,9;2;1;1
258107712261;258107712364;103;0,1,3,4,5,6;6;2,9;2;1;1
258107712364;258107712636;272;0,1,3,4,5,6;6;2,9;2;1;1
258107712636;258107712638;2;0,1,3,4,5,6;6;2,9;2;1;1
258107712638;258107712648;10;0,1,3,4,5,6;6;2,9;2;1;1
258107712648;258107712721;73;0,1,3,4,5,6;6;2,9;2;1;1
258107712721;258107712725;4;0,1,3,4,5,6;6;2,9;2;1;1
258107712725;258107712736;11;0,1,3,4,5,6;6;2,9;2;1;1
258107712736;258107712805;69;0,1,3,4,5,6;6;2,9;2;1;1
258107712805;258107712900;95;0,1,3,4,5,6;6;2,9;2;1;1
258107712900;258107712979;79;0,1,3,4,5,6;6;2,9;2;1;1
258107712979;258107713156;177;0,1,3,4,5,6;6;2,9;2;1;1
258107713156;258107713176;20;0,1,3,4,5,6;6;2,9;2;1;1
258107713176;258107713249;73;0,1,3,4,5,6;6;2,9;2;1;1
258107713249;258107713368;119;0,1,3,4,5,6;6;2,9;2;1;1
258107713368;258107713395;27;0,1,3,4,5,6;6;2,9;2;1;1
258107713395;258107713453;58;0,1,3,4,5,6;6;2,9;2;1;1
258107713453;258107713576;123;0,1,3,4,5,6;6;2,9;2;1;1
258107713576;258107713749;173;0,1,3,4,5,6;6;2,9;2;1;1
258107713749;258107713828;79;0,1,3,4,5,6;6;2,9;2;1;1
258107713828;258107713880;52;0,1,3,4,5,6;6;2,9;2;1;1
258107713880;258107713886;6;0,1,3,4,5,6;6;2,9;2;1;1
258107713886;258107713897;11;0,1,3,4,5,6;6;2,9;2;1;1
258107713897;258107713923;26;0,1,3,4,5,6;6;2,9;2;1;1
258107713923;258107714059;136;0,1,3,4,5,6;6;2,9;2;1;1
258107714059;258107714074;15;0,1,3,4,5,6;6;2,9;2;1;1
258107714074;258107714098;24;0,1,3,4,5,6;6;2,9;2;1;1
258107714098;258107714196;98;0,1,3,4,5,6;6;2,9;2;1;1
258107714196;258107714240;44;0,1,3,4,5,6;6;2,9;2;1;1
258107714240;258107714277;37;0,1,3,4,5,6;6;2,9;2;1;1
258107714277;258107714321;44;0,1,3,4,5,6;6;2,9;2;1;1
258107714321;258107714384;63;0,1,3,4,5,6;6;2,9;2;1;1
258107714384;258107714457;73;0,1,3,4,5,6;6;2,9;2;1;1
258107714457;258107714491;34;0,1,3,4,5,6;6;2,9;2;1;1
258107714491;258107714502;11;0,1,3,4,5,6;6;2,9;2;1;1
258107714502;258107714615;113;0,1,3,4,5,6;6;2,9;2;1;1
258107714615;258107714619;4;0,1,3,4,5,6;6;2,9;2;1;1
258107714619;258107714669;50;0,1,3,4,5,6;6;2,9;2;1;1
258107714669;258107714754;85;0,1,3,4,5,6;6;2,9;2;1;1
258107714754;258107714999;245;0,1,3,4,5,6;6;2,9;2;1;1
258107714999;258107715134;135;0,1,3,4,5,6;6;2,9;2;1;1
258107715134;258107715270;136;0,1,3,4,5,6;6;2,9;2;1;1
258107715270;258107715605;335;0,1,3,4,5,6;6;2,9;2;1;1
258107715605;258107715857;252;0,1,3,4,5,6;6;2,9;2;1;1
258107715857;258107715914;57;0,1,3,4,5,6;6;2,9;2;1;1
258107715914;258107716061;147;0,1,3,4,5,6;6;2,9;2;1;1
258107716061;258107716103;42;0,1,3,4,5,6;6;2,9;2;1;1
258107716103;258107716650;547;0,1,3,4,5,6;6;2,9;2;1;1
258107716650;258107716984;334;0,1,3,4,5,6;6;2,9;2;1;1
258107716984;258107717207;223;0,1,3,4,5,6;6;2,9;2;1;1
258107717207;258107717279;72;0,1,3,4,5,6;6;2,9;2;1;1
258107717279;258107717518;239;0,1,3,4,5,6;6;2,9;2;1;1
258107717518;258107717724;206;0,1,3,4,5,6;6;2,9;2;1;1
258107717724;258107717851;127;0,1,3,4,5,6;6;2,9;2;1;1
258107717851;258107717923;72;0,1,3,4,5,6;6;2,9;2;1;1
258107717923;258107718464;541;0,1,3,4,5,6;6;2,9;2;1;1
258107718464;258107720772;2308;0,1,3,4,5,6;6;2,9;2;1;1
258107720772;258107720877;105;0,1,3,4,5,6;6;2,9;2;1;1
258107720877;258107721238;361;0,1,3,4,5,6;6;2,9;2;1;1
258107721238;258107721380;142;0,1,3,4,5,6;6;2,9;2;1;1
258107721380;258107721444;64;0,1,3,4,5,6;6;2,9;2;1;1
258107721444;258107721861;417;0,1,3,4,5,6;6;2,9;2;1;1
258107721861;258107722066;205;0,1,3,4,5,6;6;2,9;2;1;1
258107722066;258107722546;480;0,1,3,4,5,6;6;2,9;2;1;1
258107722546;258107723242;696;0,1,3,4,5,6;6;2,9;2;1;1
258107723242;258107723347;105;0,1,3,4,5,6;6;2,9;2;1;1
258107723347;258107723441;94;0,1,3,4,5,6;6;2,9;2;1;1
258107723441;258107723653;212;0,1,3,4,5,6;6;2,9;2;1;1
258107723653;258107723920;267;0,1,3,4,5,6;6;2,9;2;1;1
258107723920;258107723997;77;0,1,3,4,5,6;6;2,9;2;1;1
258107723997;258107724255;258;0,1,3,4,5,6;6;2,9;2;1;1
258107724255;258107724289;34;0,1,3,4,5,6;6;2,9;2;1;1
258107724289;258107724399;110;0,1,3,4,5,6;6;2,9;2;1;1
258107724399;258107724509;110;0,1,3,4,5,6;6;2,9;2;1;1
258107724509;258107724645;136;0,1,3,4,5,6;6;2,9;2;1;1
258107724645;258107724692;47;0,1,3,4,5,6;6;2,9;2;1;1
258107724692;258107724745;53;0,1,3,4,5,6;6;2,9;2;1;1
258107724745;258107724951;206;0,1,3,4,5,6;6;2,9;2;1;1
258107724951;258107725229;278;0,1,3,4,5,6;6;2,9;2;1;1
258107725229;258107725488;259;0,1,3,4,5,6;6;2,9;2;1;1
258107725488;258107725948;460;0,1,3,4,5,6;6;2,9;2;1;1
258107725948;258107726098;150;0,1,3,4,5,6;6;2,9;2;1;1
258107726098;258107726242;144;0,1,3,4,5,6;6;2,9;2;1;1
258107726242;258107726251;9;0,1,3,4,5,6;6;2,9;2;1;1
258107726251;258107726408;157;0,1,3,4,5,6;6;2,9;2;1;1
258107726408;258107726423;15;0,1,3,5,6;5;9;1;1;1
258107726423;258107726567;144;0,1,3,5,6;5;9;1;1;1
258107726567;258107726607;40;0,1,3,5,6;5;9;1;1;1
258107726607;258107726648;41;0,1,3,5,6;5;9;1;1;1
258107726648;258107726666;18;0,1,3,5,6;5;9;1;1;1
258107726666;258107726670;4;0,1,3,5,6;5;9;1;1;1
258107726670;258107726728;58;0,1,3,5,6;5;9;1;1;1
258107726728;258107726813;85;0,1,3,5,6;5;9;1;1;1
258107726813;258107726855;42;0,1,3,5,6;5;9;1;1;1
258107726855;258107726863;8;0,1,3,5,6;5;9;1;1;1
258107726863;258107726906;43;0,1,3,5,6;5;9;1;1;1
258107726906;258107726968;62;0,1,3,5,6;5;9;1;1;1
258107726968;258107727004;36;0,1,3,5,6;5;9;1;1;1
258107727004;258107727042;38;0,1,3,5,6;5;9;1;1;1
258107727042;258107727090;48;0,1,3,5,6;5;9;1;1;1
258107727090;258107727137;47;0,1,3,5,6;5;9;1;1;1
258107727137;258107727202;65;0,1,3,5,6;5;9;1;1;1
258107727202;258107727219;17;0,1,3,5,6;5;9;1;1;1
258107727219;258107727292;73;0,1,3,5,6;5;9;1;1;1
258107727292;258107727333;41;0,1,3,5,6;5;9;1;1;1
258107727333;258107727454;121;0,1,3,5,6;5;9;1;1;1
258107727454;258107727568;114;0,1,3,5,6;5;9;1;1;1
258107727568;258107727595;27;0,1,3,5,6;5;9;1;1;1
258107727595;258107727641;46;0,1,3,5;4;9;1;1;1
258107727641;258107727668;27;0,1,3,5;4;9;1;1;1
258107727668;258107728034;366;0,1,3,5;4;9;1;1;1
258107728034;258107728628;594;0,1,3,5;4;9;1;1;1
258107728628;258107728803;175;0,1,3,5;4;9;1;1;1
258107728803;258107729462;659;0,1,3,5;4;9;1;1;1
258107729462;258107729504;42;0,1,3,5;4;9;1;1;1
258107729504;258107729919;415;0,1,3,5;4;9;1;1;1
258107729919;258107735096;5177;0,1,3,5;4;9;1;1;1
258107735096;258107735712;616;0,1,3,5;4;9;1;1;1
258107735712;258107735915;203;0,1,3,5;4;9;1;1;1
258107735915;258107736136;221;0,1,3,5;4;9;1;1;1
258107736136;258107736275;139;0,1,3,5;4;9;1;1;1
258107736275;258107738617;2342;0,1,3,5;4;9;1;1;1
258107738617;258107738737;120;0,1,3,5;4;9;1;1;1
258107738737;258107738832;95;0,1,3,5;4;9;1;1;1
258107738832;258107738982;150;0,1,3,5;4;9;1;1;1
258107738982;258107739120;138;0,1,3,5;4;9;1;1;1
258107739120;258107739879;759;0,1,3,5;4;9;1;1;1
258107739879;258107740217;338;0,1,3,5;4;9;1;1;1
258107740217;258107740448;231;0,1,3,5;4;9;1;1;1
258107740448;258107740618;170;0,1,3,5;4;9;1;1;1
258107740618;258107740864;246;0,1,3,5;4;9;1;1;1
258107740864;258107741072;208;0,1,3,5;4;9;1;1;1
258107741072;258107741485;413;0,1,3,5;4;9;1;1;1
258107741485;258107741644;159;0,1,3,5;4;9;1;1;1
258107741644;258107741817;173;0,1,3,5;4;9;1;1;1
258107741817;258107741910;93;0,1,3,5;4;9;1;1;1
258107741910;258107741957;47;0,1,3,5;4;9;1;1;1
258107741957;258107742025;68;0,1,3,5;4;9;1;1;1
258107742025;258107742120;95;0,1,3,5;4;9;1;1;1
258107742120;258107742382;262;0,1,3,5;4;9;1;1;1
258107742382;258107745310;2928;0,1,3,5;4;9;1;1;1
258107745310;258107745609;299;0,1,3,5;4;9;1;1;1
258107745609;258107745663;54;0,1,3,5;4;9;1;1;1
258107745663;258107745895;232;0,1,3,5;4;9;1;1;1
258107745895;258107745903;8;0,1,3,5;4;9;1;1;1
258107745903;258107745954;51;0,1,3,5;4;9;1;1;1
258107745954;258107746047;93;0,1,3,5;4;9;1;1;1
258107746047;258107746165;118;0,1,3,5;4;9;1;1;1
258107746165;258107746305;140;0,1,3,5;4;9;1;1;1
258107746305;258107746352;47;0,1,3,5;4;9;1;1;1
258107746352;258107746831;479;0,1,3,5;4;9;1;1;1
258107746831;258107747691;860;0,1,3,5;4;9;1;1;1
258107747691;258107748674;983;0,1,3,5;4;9;1;1;1
258107748674;258107748982;308;0,1,3,5;4;9;1;1;1
258107748982;258107749133;151;0,1,3,5;4;9;1;1;1
258107749133;258107749300;167;0,1,3,5;4;9;1;1;1
258107749300;258107749875;575;0,1,3,5;4;9;1;1;1
258107749875;258107749925;50;0,1,3,5;4;9;1;1;1
258107749925;258107750053;128;0,1,3,5;4;9;1;1;1
258107750053;258107750077;24;0,1,3,5;4;9;1;1;1
258107750077;258107750216;139;0,1,3,5;4;9;1;1;1
258107750216;258107750258;42;0,1,3,5;4;9;1;1;1
258107750258;258107750465;207;0,1,3,5;4;9;1;1;1
258107750465;258107750557;92;0,1,3,5;4;9;1;1;1
258107750557;258107751029;472;0,1,3,5;4;9;1;1;1
258107751029;258107752788;1759;0,1,3,5;4;9;1;1;1
258107752788;258107755147;2359;0,1,3,5;4;9;1;1;1
258107755147;258107755161;14;0,1,3,5;4;9;1;1;1
258107755161;258107756672;1511;0,1,3,5;4;9;1;1;1
258107756672;258107756785;113;0,1,3,5;4;9;1;1;1
258107756785;258107756955;170;0,1,3,5;4;9;1;1;1
258107756955;258107758956;2001;0,1,3,4,5;5;2,9;2;1;1
258107758956;258107759062;106;0,1,3,4,5;5;2,9;2;1;1
258107759062;258107759532;470;0,1,3,4,5;5;2,9;2;1;1
258107759532;258107759556;24;0,1,3,4,5;5;2,9;2;1;1
258107759556;258107759836;280;0,1,3,4,5;5;2,9;2;1;1
258107759836;258107759856;20;0,1,3,4,5;5;2,9;2;1;1
258107759856;258107759877;21;0,1,3,4,5;5;2,9;2;1;1
258107759877;258107760226;349;0,1,3,4,5;5;2,9;2;1;1
258107760226;258107760345;119;0,1,3,4,5;5;2,9;2;1;1
258107760345;258107760681;336;0,1,3,4,5;5;2,9;2;1;1
258107760681;258107760954;273;0,1,3,4,5;5;2,9;2;1;1
258107760954;258107761920;966;0,1,3,4,5;5;2,9;2;1;1
258107761920;258107762219;299;0,1,3,4,5;5;2,9;2;1;1
258107762219;258107763738;1519;0,1,3,4,5;5;2,9;2;1;1
258107763738;258107764265;527;0,1,3,4,5;5;2,9;2;1;1
258107764265;258107765738;1473;0,1,3,4,5;5;2,9;2;1;1
258107765738;258107766031;293;0,1,3,4,5;5;2,9;2;1;1
258107766031;258107766243;212;0,1,3,5;4;9;1;1;1
258107766243;258107766470;227;0,1,3,5;4;9;1;1;1
258107766470;258107766913;443;0,1,3,5;4;9;1;1;1
258107766913;258107767213;300;0,1,3,5;4;9;1;1;1
258107767213;258107767836;623;0,1,3,5;4;9;1;1;1
258107767836;258107768540;704;0,1,3,5;4;9;1;1;1
258107768540;258107769501;961;0,1,3,5;4;9;1;1;1
258107769501;258107771376;1875;0,1,3,4,5;5;2,9;2;1;1
258107771376;258107771425;49;0,1,3,4,5;5;2,9;2;1;1
258107771425;258107771535;110;0,1,3,4,5;5;2,9;2;1;1
258107771535;258107771579;44;0,1,3,4,5;5;2,9;2;1;1
258107771579;258107771691;112;0,1,3,4,5;5;2,9;2;1;1
258107771691;258107772994;1303;0,1,3,4,5;5;2,9;2;1;1
258107772994;258107774359;1365;0,1,3,4,5;5;2,9;2;1;1
258107774359;258107775366;1007;0,1,3,5;4;9;1;1;1
258107775366;258107776901;1535;0,1,3,5;4;9;1;1;1
258107776901;258107777475;574;0,1,3,5;4;9;1;1;1
258107777475;258107778039;564;0,1,3,4,5;5;2,9;2;1;1
258107778039;258107778654;615;0,1,3,4,5;5;2,9;2;1;1
258107778654;258107778690;36;0,1,3,4,5;5;2,9;2;1;1
258107778690;258107779679;989;0,1,3,4,5;5;2,9;2;1;1
258107779679;258107780243;564;0,1,3,4,5;5;2,9;2;1;1
258107780243;258107782880;2637;0,1,3,5;4;9;1;1;1
258107782880;258107783045;165;0,1,3,5;4;9;1;1;1
258107783045;258107783155;110;0,1,3,5;4;9;1;1;1
258107783155;258107784461;1306;0,1,3,5;4;9;1;1;1
258107784461;258107784580;119;0,1,3,5;4;9;1;1;1
258107784580;258107784782;202;0,1,3,5;4;9;1;1;1
258107784782;258107784902;120;0,1,3,5;4;9;1;1;1
258107784902;258107785062;160;0,1,3,5;4;9;1;1;1
258107785062;258107785454;392;0,1,3,5;4;9;1;1;1
258107785454;258107785642;188;0,1,3,5;4;9;1;1;1
258107785642;258107788394;2752;0,1,3,5;4;9;1;1;1
258107788394;258107788607;213;0,1,3,5;4;9;1;1;1
258107788607;258107788682;75;0,1,3,5;4;9;1;1;1
258107788682;258107789714;1032;0,1,3,5;4;9;1;1;1
258107789714;258107791325;1611;0,1,3,5;4;9;1;1;1
258107791325;258107792602;1277;0,1,3,4,5;5;2,9;2;1;1
258107792602;258107793457;855;0,1,3,5;4;9;1;1;1
258107793457;258107793619;162;0,1,3,5;4;9;1;1;1
258107793619;258107793739;120;0,1,3,5;4;9;1;1;1
258107793739;258107793899;160;0,1,3,5;4;9;1;1;1
258107793899;258107794661;762;0,1,3,4,5;5;2,9;2;1;1
258107794661;258107794875;214;0,1,3,4,5;5;2,9;2;1;1
258107794875;258107795187;312;0,1,3,4,5;5;2,9;2;1;1
258107795187;258107795747;560;0,1,3,4,5;5;2,9;2;1;1
258107795747;258107796628;881;0,1,3,4,5;5;2,9;2;1;1
258107796628;258107796740;112;0,1,3,4,5;5;2,9;2;1;1
258107796740;258107797475;735;0,1,3,4,5;5;2,9;2;1;1
258107797475;258107798236;761;0,1,3,4,5;5;2,9;2;1;1
258107798236;258107799758;1522;0,1,3,5;4;9;1;1;1
258107799758;258107801252;1494;0,1,3,5;4;9;1;1;1
258107801252;258107801964;712;0,1,3,4,5;5;2,9;2;1;1
258107801964;258107802126;162;0,1,3,5;4;9;1;1;1
258107802126;258107802702;576;0,1,3,4,5;5;2,9;2;1;1
258107802702;258107802861;159;0,1,3,4,5;5;2,9;2;1;1
258107802861;258107803306;445;0,1,3,4,5;5;2,9;2;1;1
258107803306;258107803480;174;0,1,3,4,5;5;2,9;2;1;1
258107803480;258107803817;337;0,1,3,4,5;5;2,9;2;1;1
258107803817;258107804016;199;0,1,3,4,5;5;2,9;2;1;1
258107804016;258107804289;273;0,1,3,4,5;5;2,9;2;1;1
258107804289;258107805385;1096;0,1,3,5;4;9;1;1;1
258107805385;258107805441;56;0,1,3,5;4;9;1;1;1
258107805441;258107807020;1579;0,1,3,5;4;9;1;1;1
258107807020;258107808353;1333;0,1,3,5;4;9;1;1;1
258107808353;258107809532;1179;0,1,3,5;4;9;1;1;1
258107809532;258107811912;2380;0,1,3,5;4;9;1;1;1
258107811912;258107812086;174;0,1,3,5;4;9;1;1;1
258107812086;258107812229;143;0,1,3,5;4;9;1;1;1
258107812229;258107812543;314;0,1,3,5;4;9;1;1;1
258107812543;258107813382;839;0,1,3,5;4;9;1;1;1
258107813382;258107814317;935;0,1,3,5;4;9;1;1;1
258107814317;258107814434;117;0,1,3,5;4;9;1;1;1
258107814434;258107814527;93;0,1,3,5;4;9;1;1;1
258107814527;258107815015;488;0,1,3,5;4;9;1;1;1
258107815015;258107816918;1903;0,1,3,5;4;9;1;1;1
258107816918;258107817122;204;0,1,3,5;4;9;1;1;1
258107817122;258107818617;1495;0,1,3,5;4;9;1;1;1
258107818617;258107818875;258;0,1,3,5;4;9;1;1;1
258107818875;258107818996;121;0,1,3,5;4;9;1;1;1
258107818996;258107819194;198;0,1,3,5;4;9;1;1;1
258107819194;258107819536;342;0,1,3,5;4;9;1;1;1
258107819536;258107819608;72;0,1,3,5;4;9;1;1;1
258107819608;258107820167;559;0,1,3,5;4;9;1;1;1
258107820167;258107820265;98;0,1,3,5;4;9;1;1;1
258107820265;258107820343;78;0,1,3,5;4;9;1;1;1
258107820343;258107820479;136;0,1,3,5;4;9;1;1;1
258107820479;258107820866;387;0,1,3,5;4;9;1;1;1
258107820866;258107821148;282;0,1,3,5;4;9;1;1;1
258107821148;258107829894;8746;0,1,3,5;4;9;1;1;1
258107829894;258107829947;53;0,1,3,5;4;9;1;1;1
258107829947;258107830059;112;0,1,3,5;4;9;1;1;1
258107830059;258107830172;113;0,1,3,5;4;9;1;1;1
258107830172;258107830360;188;0,1,3,5;4;9;1;1;1
258107830360;258107831638;1278;0,1,3,5;4;9;1;1;1
258107831638;258107832189;551;0,1,3,5;4;9;1;1;1
258107832189;258107832417;228;0,1,3,5;4;9;1;1;1
258107832417;258107833008;591;0,1,3,5;4;9;1;1;1
258107833008;258107835205;2197;0,1,3,5;4;9;1;1;1
258107835205;258107835299;94;0,1,3,5;4;9;1;1;1
258107835299;258107836827;1528;0,1,3,5;4;9;1;1;1
258107836827;258107837392;565;0,1,3,5;4;9;1;1;1
258107837392;258107837845;453;0,1,3,5;4;9;1;1;1
258107837845;258107838483;638;0,1,3,5;4;9;1;1;1
258107838483;258107840008;1525;0,1,3,5;4;9;1;1;1
258107840008;258107840635;627;0,1,3,5;4;9;1;1;1
258107840635;258107840759;124;0,1,3,5;4;9;1;1;1
258107840759;258107840949;190;0,1,3,5;4;9;1;1;1
258107840949;258107841289;340;0,1,3,5;4;9;1;1;1
258107841289;258107841611;322;0,1,3,5;4;9;1;1;1
258107841611;258107842238;627;0,1,3,5;4;9;1;1;1
258107842238;258107845099;2861;0,1,3,5;4;9;1;1;1
258107845099;258107846491;1392;0,1,3,5;4;9;1;1;1
258107846491;258107846994;503;0,1,3,5;4;9;1;1;1
258107846994;258107847561;567;0,1,3,4,5;5;2,9;2;1;1
258107847561;258107848010;449;0,1,3,4,5;5;2,9;2;1;1
258107848010;258107848091;81;0,1,3,4,5;5;2,9;2;1;1
258107848091;258107848159;68;0,1,3,4,5;5;2,9;2;1;1
258107848159;258107848224;65;0,1,3,4,5;5;2,9;2;1;1
258107848224;258107848714;490;0,1,3,4,5;5;2,9;2;1;1
258107848714;258107848979;265;0,1,3,4,5;5;2,9;2;1;1
258107848979;258107849382;403;0,1,3,4,5;5;2,9;2;1;1
258107849382;258107849498;116;0,1,3,4,5;5;2,9;2;1;1
258107849498;258107849607;109;0,1,3,4,5;5;2,9;2;1;1
258107849607;258107852310;2703;0,1,3,4,5;5;2,9;2;1;1
258107852310;258107852534;224;0,1,3,4,5;5;2,9;2;1;1
258107852534;258107854021;1487;0,1,3,4,5;5;2,9;2;1;1
258107854021;258107854303;282;0,1,3,4,5;5;2,9;2;1;1
258107854303;258107856045;1742;0,1,3,4,5;5;2,9;2;1;1
258107856045;258107856204;159;0,1,3,4,5;5;2,9;2;1;1
258107856204;258107856259;55;0,1,3,4,5;5;2,9;2;1;1
258107856259;258107857882;1623;0,1,3,4,5;5;2,9;2;1;1
258107857882;258107858482;600;0,1,3,4,5;5;2,9;2;1;1
258107858482;258107858507;25;0,1,3,4,5;5;2,9;2;1;1
258107858507;258107858738;231;0,1,3,4,5;5;2,9;2;1;1
258107858738;258107859444;706;0,1,3,4,5;5;2,9;2;1;1
258107859444;258107860460;1016;0,1,3,4,5;5;2,9;2;1;1
258107860460;258107860617;157;0,1,3,4,5;5;2,9;2;1;1
258107860617;258107861195;578;0,1,3,4,5;5;2,9;2;1;1
258107861195;258107861307;112;0,1,3,4,5;5;2,9;2;1;1
258107861307;258107861449;142;0,1,3,4,5;5;2,9;2;1;1
258107861449;258107861697;248;0,1,3,4,5;5;2,9;2;1;1
258107861697;258107861830;133;0,1,3,4,5;5;2,9;2;1;1
258107861830;258107866516;4686;0,1,3,4,5;5;2,9;2;1;1
258107866516;258107867641;1125;0,1,3,4,5;5;2,9;2;1;1
258107867641;258107869476;1835;0,1,3,4,5;5;2,9;2;1;1
258107869476;258107869719;243;0,1,3,4,5;5;2,9;2;1;1
258107869719;258107870563;844;0,1,3,4,5;5;2,9;2;1;1
258107870563;258107871511;948;0,1,3,4,5;5;2,9;2;1;1
258107871511;258107871880;369;0,1,3,4,5;5;2,9;2;1;1
258107871880;258107874107;2227;0,1,3,4,5;5;2,9;2;1;1
258107874107;258107874156;49;0,1,3,4,5;5;2,9;2;1;1
258107874156;258107874243;87;0,1,3,4,5;5;2,9;2;1;1
258107874243;258107874306;63;0,1,3,4,5;5;2,9;2;1;1
258107874306;258107874520;214;0,1,3,4,5;5;2,9;2;1;1
258107874520;258107874694;174;0,1,3,4,5;5;2,9;2;1;1
258107874694;258107875685;991;0,1,3,4,5;5;2,9;2;1;1
258107875685;258107875842;157;0,1,3,4,5;5;2,9;2;1;1
258107875842;258107875925;83;0,1,3,4,5;5;2,9;2;1;1
258107875925;258107876102;177;0,1,3,4,5;5;2,9;2;1;1
258107876102;258107876169;67;0,1,3,4,5;5;2,9;2;1;1
258107876169;258107876364;195;0,1,3,4,5;5;2,9;2;1;1
258107876364;258107876901;537;0,1,3,4,5;5;2,9;2;1;1
258107876901;258107877001;100;0,1,3,4,5;5;2,9;2;1;1
258107877001;258107877050;49;0,1,3,4,5;5;2,9;2;1;1
258107877050;258107877250;200;0,1,3,4,5;5;2,9;2;1;1
258107877250;258107877433;183;0,1,3,4,5;5;2,9;2;1;1
258107877433;258107878254;821;0,1,3,4,5;5;2,9;2;1;1
258107878254;258107878763;509;0,1,3,4,5;5;2,9;2;1;1
258107878763;258107881347;2584;0,1,3,4,5;5;2,9;2;1;1
258107881347;258107881538;191;0,1,3,4,5;5;2,9;2;1;1
258107881538;258107881634;96;0,1,3,4,5;5;2,9;2;1;1
258107881634;258107881846;212;0,1,3,4,5;5;2,9;2;1;1
258107881846;258107882548;702;0,1,3,4,5;5;2,9;2;1;1
258107882548;258107884699;2151;0,1,3,4,5;5;2,9;2;1;1
258107884699;258107885567;868;0,1,3,4,5;5;2,9;2;1;1
258107885567;258107885625;58;0,1,3,4,5;5;2,9;2;1;1
258107885625;258107886046;421;0,1,3,4,5;5;2,9;2;1;1
258107886046;258107886142;96;0,1,3,4,5;5;2,9;2;1;1
258107886142;258107886259;117;0,1,3,4,5;5;2,9;2;1;1
258107886259;258107886707;448;0,1,3,4,5;5;2,9;2;1;1
258107886707;258107887401;694;0,1,3,4,5;5;2,9;2;1;1
258107887401;258107887447;46;0,1,3,4,5;5;2,9;2;1;1
258107887447;258107887636;189;0,1,3,4,5;5;2,9;2;1;1
258107887636;258107887682;46;0,1,3,4,5;5;2,9;2;1;1
258107887682;258107889347;1665;0,1,3,4,5;5;2,9;2;1;1
258107889347;258107889826;479;0,1,3,4,5;5;2,9;2;1;1
258107889826;258107893322;3496;0,1,3,4,5;5;2,9;2;1;1
258107893322;258107893745;423;0,1,3,4,5;5;2,9;2;1;1
258107893745;258107894117;372;0,1,3,4,5;5;2,9;2;1;1
258107894117;258107896461;2344;0,1,3,4,5;5;2,9;2;1;1
258107896461;258107897556;1095;0,1,3,4,5;5;2,9;2;1;1
258107897556;258107902304;4748;0,1,3,4,5;5;2,9;2;1;1
258107902304;258107902568;264;0,1,3,4,5;5;2,9;2;1;1
258107902568;258107903268;700;0,1,3,4,5;5;2,9;2;1;1
258107903268;258107903619;351;0,1,3,4,5;5;2,9;2;1;1
258107903619;258107903929;310;0,1,3,4,5;5;2,9;2;1;1
258107903929;258107904264;335;0,1,3,4,5;5;2,9;2;1;1
258107904264;258107904459;195;0,1,3,4,5;5;2,9;2;1;1
258107904459;258107904628;169;0,1,3,4,5;5;2,9;2;1;1
258107904628;258107904691;63;0,1,3,4,5;5;2,9;2;1;1
258107904691;258107904907;216;0,1,3,4,5;5;2,9;2;1;1
258107904907;258107905378;471;0,1,3,4,5;5;2,9;2;1;1
258107905378;258107905468;90;0,1,3,4,5;5;2,9;2;1;1
258107905468;258107906332;864;0,1,3,4,5;5;2,9;2;1;1
258107906332;258107906800;468;0,1,3,4,5;5;2,9;2;1;1
258107906800;258107907217;417;0,1,3,4,5;5;2,9;2;1;1
258107907217;258107907454;237;0,1,3,4,5;5;2,9;2;1;1
258107907454;258107908023;569;0,1,3,5;4;9;1;1;1
258107908023;258107908087;64;0,1,3,5;4;9;1;1;1
258107908087;258107908739;652;0,1,3,5;4;9;1;1;1
258107908739;258107911567;2828;0,1,3,5;4;9;1;1;1
258107911567;258107912124;557;0,1,3,5;4;9;1;1;1
258107912124;258107913299;1175;0,1,3,5;4;9;1;1;1
258107913299;258107918088;4789;0,1,3,5;4;9;1;1;1
258107918088;258107922751;4663;0,1,3,5;4;9;1;1;1
258107922751;258107923257;506;0,1,3,5;4;9;1;1;1
258107923257;258107925820;2563;0,1,3,5;4;9;1;1;1
258107925820;258107925862;42;0,1,3,5;4;9;1;1;1
258107925862;258107925894;32;0,1,3,5;4;9;1;1;1
258107925894;258107926162;268;0,1,3,5;4;9;1;1;1
258107926162;258107926199;37;0,1,3,5;4;9;1;1;1
258107926199;258107926237;38;0,1,3,5;4;9;1;1;1
258107926237;258107926881;644;0,1,3,5;4;9;1;1;1
258107926881;258107929536;2655;0,1,3,5;4;9;1;1;1
258107929536;258107937055;7519;0,1,3,5;4;9;1;1;1
258107937055;258107949555;12500;0,1,3,5;4;9;1;1;1
258107949555;258107960252;10697;0,1,3,5;4;9;1;1;1
258107960252;258107963874;3622;0,1,3,4,5;5;2,9;2;1;1
258107963874;258107964698;824;0,1,3,4,5;5;2,9;2;1;1
258107964698;258107967694;2996;0,1,3,4,5;5;2,9;2;1;1
258107967694;258107967746;52;0,1,3,4,5;5;2,9;2;1;1
258107967746;258107967816;70;0,1,3,4,5;5;2,9;2;1;1
258107967816;258107967917;101;0,1,3,4,5;5;2,9;2;1;1
258107967917;258107968056;139;0,1,3,4,5;5;2,9;2;1;1
258107968056;258107968140;84;0,1,3,4,5;5;2,9;2;1;1
258107968140;258107968210;70;0,1,3,4,5;5;2,9;2;1;1
258107968210;258107975692;7482;0,1,3,4,5;5;2,9;2;1;1
258107975692;258107976809;1117;0,1,3,4,5;5;2,9;2;1;1
258107976809;258107987468;10659;0,1,3,4,5;5;2,9;2;1;1
258107987468;258107989464;1996;0,1,3,4,5;5;2,9;2;1;1
258107989464;258107997630;8166;0,1,3,5;4;9;1;1;1
258107997630;258107998679;1049;0,1,3,5;4;9;1;1;1
258107998679;258108003444;4765;0,1,3,5;4;9;1;1;1
258108003444;258108004719;1275;0,1,3,5;4;9;1;1;1
258108004719;258108005032;313;0,1,3,5;4;9;1;1;1
258108005032;258108009866;4834;0,1,3,5;4;9;1;1;1
258108009866;258108009874;8;0,1,3,5;4;9;1;1;1
258108009874;258108009924;50;0,1,3,5;4;9;1;1;1
258108009924;258108009950;26;0,1,3,5;4;9;1;1;1
258108009950;258108012290;2340;0,1,3,5;4;9;1;1;1
258108012290;258108012637;347;0,1,3,5;4;9;1;1;1
258108012637;258108012811;174;0,1,3,5;4;9;1;1;1
258108012811;258108013440;629;0,1,3,5;4;9;1;1;1
258108013440;258108015283;1843;0,1,3,5;4;9;1;1;1
258108015283;258108015408;125;0,1,3,4,5;5;2,9;2;1;1
258108015408;258108015431;23;0,1,3,4,5;5;2,9;2;1;1
258108015431;258108015487;56;0,1,3,4,5;5;2,9;2;1;1
258108015487;258108015936;449;0,1,3,4,5;5;2,9;2;1;1
258108015936;258108017791;1855;0,1,3,5;4;9;1;1;1
258108017791;258108018004;213;0,1,3,5;4;9;1;1;1
258108018004;258108024957;6953;0,1,3,5;4;9;1;1;1
258108024957;258108026975;2018;0,1,3,5;4;9;1;1;1
258108026975;258108027675;700;0,1,3,5;4;9;1;1;1
258108027675;258108029426;1751;0,1,3,5;4;9;1;1;1
258108029426;258108030145;719;0,1,3,5;4;9;1;1;1
258108030145;258108034826;4681;0,1,3,5;4;9;1;1;1
258108034826;258108034895;69;0,1,3,5;4;9;1;1;1
258108034895;258108035774;879;0,1,3,5;4;9;1;1;1
258108035774;258108035787;13;0,1,3,5;4;9;1;1;1
258108035787;258108035808;21;0,1,3,5;4;9;1;1;1
258108035808;258108052158;16350;0,1,3,5;4;9;1;1;1
258108052158;258108062922;10764;0,1,3,5;4;9;1;1;1
258108062922;258108063353;431;0,1,3,5;4;9;1;1;1
258108063353;258108081122;17769;0,1,3,5;4;9;1;1;1
258108081122;258108083272;2150;0,1,3,4,5;5;2,9;2;1;1
258108083272;258108086118;2846;0,1,3,4,5;5;2,9;2;1;1
258108086118;258108090913;4795;0,1,3,4,5;5;2,9;2;1;1
258108090913;258108100022;9109;0,1,3,4,5;5;2,9;2;1;1
258108100022;258108100650;628;0,1,3,4,5;5;2,9;2;1;1
258108100650;258108101587;937;0,1,3,4,5;5;2,9;2;1;1
258108101587;258108102282;695;0,1,3,4,5;5;2,9;2;1;1
258108102282;258108108023;5741;0,1,3,4,5;5;2,9;2;1;1
258108108023;258108111684;3661;0,1,3,4,5;5;2,9;2;1;1
258108111684;258108111733;49;0,1,3,4,5;5;2,9;2;1;1
258108111733;258108112184;451;0,1,3,4,5;5;2,9;2;1;1
258108112184;258108112226;42;0,1,3,4,5;5;2,9;2;1;1
258108112226;258108112466;240;0,1,3,4,5;5;2,9;2;1;1
258108112466;258108113762;1296;0,1,3,4,5;5;2,9;2;1;1
258108113762;258108115969;2207;0,1,3,4,5;5;2,9;2;1;1
258108115969;258108123060;7091;0,1,3,4,5;5;2,9;2;1;1
258108123060;258108132978;9918;0,1,3,4,5;5;2,9;2;1;1
258108132978;258108133228;250;0,1,3,4,5;5;2,9;2;1;1
258108133228;258108134197;969;0,1,3,4,5;5;2,9;2;1;1
258108134197;258108136077;1880;0,1,3,4,5;5;2,9;2;1;1
258108136077;258108136575;498;0,1,3,4,5;5;2,9;2;1;1
258108136575;258108137546;971;0,1,3,4,5;5;2,9;2;1;1
258108137546;258108137754;208;0,1,3,4,5;5;2,9;2;1;1
258108137754;258108138248;494;0,1,3,4,5;5;2,9;2;1;1
258108138248;258108138965;717;0,1,3,4,5;5;2,9;2;1;1
258108138965;258108145170;6205;0,1,3,5;4;9;1;1;1
258108145170;258108154694;9524;0,1,3,5;4;9;1;1;1
258108154694;258108154729;35;0,1,3,5;4;9;1;1;1
258108154729;258108154943;214;0,1,3,5;4;9;1;1;1
258108154943;258108155068;125;0,1,3,5;4;9;1;1;1
258108155068;258108177609;22541;0,1,3,5;4;9;1;1;1
258108177609;258108180849;3240;0,1,3,5;4;9;1;1;1
258108180849;258108181164;315;0,1,3,5;4;9;1;1;1
258108181164;258108191103;9939;0,1,3,5;4;9;1;1;1
258108191103;258108212972;21869;0,1,3,4,5;5;2,9;2;1;1
258108212972;258108219614;6642;0,1,3,4,5;5;2,9;2;1;1
258108219614;258108223278;3664;0,1,3,5;4;9;1;1;1
258108223278;258108223327;49;0,1,3,5;4;9;1;1;1
258108223327;258108245866;22539;0,1,3,5;4;9;1;1;1
258108245866;258108247502;1636;0,1,3,4,5;5;2,9;2;1;1
258108247502;258108248060;558;0,1,3,4,5;5;2,9;2;1;1
258108248060;258108250834;2774;0,1,3,4,5;5;2,9;2;1;1
258108250834;258108253947;3113;0,1,3,5;4;9;1;1;1
258108253947;258108254241;294;0,1,3,4,5;5;2,9;2;1;1
258108254241;258108255457;1216;0,1,3,4,5;5;2,9;2;1;1
258108255457;258108255638;181;0,1,3,4,5;5;2,9;2;1;1
258108255638;258108257158;1520;0,1,3,4,5;5;2,9;2;1;1
258108257158;258108259763;2605;0,1,3,5;4;9;1;1;1
258108259763;258108260701;938;0,1,3,4,5;5;2,9;2;1;1
258108260701;258108261058;357;0,1,3,4,5;5;2,9;2;1;1
258108261058;258108262801;1743;0,1,3,4,5;5;2,9;2;1;1
258108262801;258108262887;86;0,1,3,4,5;5;2,9;2;1;1
258108262887;258108263059;172;0,1,3,4,5;5;2,9;2;1;1
258108263059;258108263094;35;0,1,3,4,5;5;2,9;2;1;1
258108263094;258108265416;2322;0,1,3,4,5;5;2,9;2;1;1
258108265416;258108265438;22;0,1,3,4,5;5;2,9;2;1;1
258108265438;258108265451;13;0,1,3,4,5;5;2,9;2;1;1
258108265451;258108265489;38;0,1,3,4,5;5;2,9;2;1;1
258108265489;258108265964;475;0,1,3,4,5;5;2,9;2;1;1
258108265964;258108267734;1770;0,1,3,4,5;5;2,9;2;1;1
258108267734;258108270659;2925;0,1,3,5;4;9;1;1;1
258108270659;258108271277;618;0,1,3,4,5;5;2,9;2;1;1
258108271277;258108293302;22025;0,1,3,5;4;9;1;1;1
258108293302;258108302427;9125;0,1,3,5;4;9;1;1;1
258108302427;258108302519;92;0,1,3,5;4;9;1;1;1
258108302519;258108302573;54;0,1,3,5;4;9;1;1;1
258108302573;258108302816;243;0,1,3,5;4;9;1;1;1
258108302816;258108303310;494;0,1,3,5;4;9;1;1;1
258108303310;258108312360;9050;0,1,3,5;4;9;1;1;1
258108312360;258108314858;2498;0,1,3,4,5;5;2,9;2;1;1
258108314858;258108317143;2285;0,1,3,4,5;5;2,9;2;1;1
258108317143;258108318442;1299;0,1,3,4,5;5;2,9;2;1;1
258108318442;258108321655;3213;0,1,3,4,5;5;2,9;2;1;1
258108321655;258108324942;3287;0,1,3,4,5;5;2,9;2;1;1
258108324942;258108324974;32;0,1,3,4,5;5;2,9;2;1;1
258108324974;258108336536;11562;0,1,3,4,5;5;2,9;2;1;1
258108336536;258108336782;246;0,1,3,4,5;5;2,9;2;1;1
258108336782;258108343858;7076;0,1,3,4,5;5;2,9;2;1;1
258108343858;258108346645;2787;0,1,3,4,5;5;2,9;2;1;1
258108346645;258108348027;1382;0,1,3,4,5;5;2,9;2;1;1
258108348027;258108350605;2578;0,1,3,4,5;5;2,9;2;1;1
258108350605;258108351428;823;0,1,3,4,5;5;2,9;2;1;1
258108351428;258108352018;590;0,1,3,4,5;5;2,9;2;1;1
258108352018;258108352552;534;0,1,3,4,5;5;2,9;2;1;1
258108352552;258108353018;466;0,1,3,4,5;5;2,9;2;1;1
258108353018;258108353295;277;0,1,3,4,5;5;2,9;2;1;1
258108353295;258108354562;1267;0,1,3,4,5;5;2,9;2;1;1
258108354562;258108355411;849;0,1,3,4,5;5;2,9;2;1;1
258108355411;258108355486;75;0,1,3,4,5;5;2,9;2;1;1
258108355486;258108356380;894;0,1,3,4,5;5;2,9;2;1;1
258108356380;258108356494;114;0,1,3,4,5;5;2,9;2;1;1
258108356494;258108362098;5604;0,1,3,5;4;9;1;1;1
258108362098;258108365834;3736;0,1,3,5;4;9;1;1;1
258108365834;258108366287;453;0,1,3,5;4;9;1;1;1
258108366287;258108370048;3761;0,1,3,5;4;9;1;1;1
258108370048;258108370056;8;0,1,3,5;4;9;1;1;1
258108370056;258108370106;50;0,1,3,5;4;9;1;1;1
258108370106;258108370115;9;0,1,3,5;4;9;1;1;1
258108370115;258108370166;51;0,1,3,5;4;9;1;1;1
258108370166;258108370193;27;0,1,3,5;4;9;1;1;1
258108370193;258108370247;54;0,1,3,5;4;9;1;1;1
258108370247;258108372506;2259;0,1,3,5;4;9;1;1;1
258108372506;258108372523;17;0,1,3,5;4;9;1;1;1
258108372523;258108372575;52;0,1,3,5;4;9;1;1;1
258108372575;258108372590;15;0,1,3,5;4;9;1;1;1
258108372590;258108373066;476;0,1,3,5;4;9;1;1;1
258108373066;258108373295;229;0,1,3,5;4;9;1;1;1
258108373295;258108373333;38;0,1,3,5;4;9;1;1;1
258108373333;258108408683;35350;0,1,3,5;4;9;1;1;1
258108408683;258108424219;15536;0,1,3,5;4;9;1;1;1
258108424219;258108452849;28630;0,1,3,4,5;5;2,9;2;1;1
258108452849;258108512065;59216;0,1,3,5;4;9;1;1;1
258108512065;258108513964;1899;0,1,3,4,5;5;2,9;2;1;1
258108513964;258108516558;2594;0,1,3,4,5;5;2,9;2;1;1
258108516558;258108523615;7057;0,1,3,4,5;5;2,9;2;1;1
258108523615;258108525040;1425;0,1,3,4,5;5;2,9;2;1;1
258108525040;258108527226;2186;0,1,3,4,5;5;2,9;2;1;1
258108527226;258108527299;73;0,1,3,4,5;5;2,9;2;1;1
258108527299;258108527433;134;0,1,3,4,5;5;2,9;2;1;1
258108527433;258108527538;105;0,1,3,4,5;5;2,9;2;1;1
258108527538;258108527629;91;0,1,3,4,5;5;2,9;2;1;1
258108527629;258108532893;5264;0,1,3,4,5;5;2,9;2;1;1
258108532893;258108536023;3130;0,1,3,4,5;5;2,9;2;1;1
258108536023;258108537967;1944;0,1,3,4,5;5;2,9;2;1;1
258108537967;258108540738;2771;0,1,3,4,5;5;2,9;2;1;1
258108540738;258108541723;985;0,1,3,4,5;5;2,9;2;1;1
258108541723;258108550016;8293;0,1,3,4,5;5;2,9;2;1;1
258108550016;258108560953;10937;0,1,3,4,5;5;2,9;2;1;1
258108560953;258108561891;938;0,1,3,4,5;5;2,9;2;1;1
258108561891;258108565115;3224;0,1,3,4,5;5;2,9;2;1;1
258108565115;258108565636;521;0,1,3,4,5;5;2,9;2;1;1
258108565636;258108566114;478;0,1,3,4,5;5;2,9;2;1;1
258108566114;258108566156;42;0,1,3,4,5;5;2,9;2;1;1
258108566156;258108567131;975;0,1,3,4,5;5;2,9;2;1;1
258108567131;258108568072;941;0,1,3,4,5;5;2,9;2;1;1
258108568072;258108569411;1339;0,1,3,4,5;5;2,9;2;1;1
258108569411;258108570423;1012;0,1,3,4,5;5;2,9;2;1;1
258108570423;258108571158;735;0,1,3,4,5;5;2,9;2;1;1
258108571158;258108576808;5650;0,1,3,5;4;9;1;1;1
258108576808;258108576859;51;0,1,3,5;4;9;1;1;1
258108576859;258108576884;25;0,1,3,5;4;9;1;1;1
258108576884;258108576956;72;0,1,3,5;4;9;1;1;1
258108576956;258108577060;104;0,1,3,5;4;9;1;1;1
258108577060;258108577424;364;0,1,3,5;4;9;1;1;1
258108577424;258108577469;45;0,1,3,5;4;9;1;1;1
258108577469;258108598396;20927;0,1,3,5;4;9;1;1;1
258108598396;258108620026;21630;0,1,3,5;4;9;1;1;1
258108620026;258108630057;10031;0,1,3,4,5;5;2,9;2;1;1
258108630057;258108638675;8618;0,1,3,4,5;5;2,9;2;1;1
258108638675;258108638679;4;0,1,3,4,5;5;2,9;2;1;1
258108638679;258108641419;2740;0,1,3,4,5;5;2,9;2;1;1
258108641419;258108646403;4984;0,1,3,4,5;5;2,9;2;1;1
258108646403;258108650522;4119;0,1,3,5;4;9;1;1;1
258108650522;258108650633;111;0,1,3,5;4;9;1;1;1
258108650633;258108672291;21658;0,1,3,5;4;9;1;1;1
258108672291;258108672427;136;0,1,3,5;4;9;1;1;1
258108672427;258108673093;666;0,1,3,4,5;5;2,9;2;1;1
258108673093;258108675478;2385;0,1,3,5;4;9;1;1;1
258108675478;258108675693;215;0,1,3,5;4;9;1;1;1
258108675693;258108700327;24634;0,1,3,5;4;9;1;1;1
258108700327;258108730430;30103;0,1,3,5;4;9;1;1;1
258108730430;258108731484;1054;0,1,3,5;4;9;1;1;1
258108731484;258108733080;1596;0,1,3,4,5;5;2,9;2;1;1
258108733080;258108734222;1142;0,1,3,4,5;5;2,9;2;1;1
258108734222;258108745944;11722;0,1,3,4,5;5;2,9;2;1;1
258108745944;258108748171;2227;0,1,3,4,5;5;2,9;2;1;1
258108748171;258108750047;1876;0,1,3,4,5;5;2,9;2;1;1
258108750047;258108756398;6351;0,1,3,4,5;5;2,9;2;1;1
258108756398;258108760732;4334;0,1,3,4,5;5;2,9;2;1;1
258108760732;258108765492;4760;0,1,3,4,5;5;2,9;2;1;1
258108765492;258108765884;392;0,1,3,4,5;5;2,9;2;1;1
258108765884;258108767210;1326;0,1,3,4,5;5;2,9;2;1;1
258108767210;258108768260;1050;0,1,3,4,5;5;2,9;2;1;1
258108768260;258108771094;2834;0,1,3,4,5;5;2,9;2;1;1
258108771094;258108771984;890;0,1,3,4,5;5;2,9;2;1;1
258108771984;258108776409;4425;0,1,3,5;4;9;1;1;1
258108776409;258108776502;93;0,1,3,5;4;9;1;1;1
258108776502;258108777365;863;0,1,3,5;4;9;1;1;1
258108777365;258108777995;630;0,1,3,4,5;5;2,9;2;1;1
258108777995;258108778038;43;0,1,3,4,5;5;2,9;2;1;1
258108778038;258108779713;1675;0,1,3,4,5;5;2,9;2;1;1
258108779713;258108781691;1978;0,1,3,4,5;5;2,9;2;1;1
258108781691;258108783367;1676;0,1,3,4,5;5;2,9;2;1;1
258108783367;258108783789;422;0,1,3,4,5;5;2,9;2;1;1
258108783789;258108784020;231;0,1,3,4,5;5;2,9;2;1;1
258108784020;258108840720;56700;0,1,3,5;4;9;1;1;1
258108840720;258108840930;210;0,1,3,5;4;9;1;1;1
258108840930;258108843280;2350;0,1,3,5;4;9;1;1;1
258108843280;258108869957;26677;0,1,3,4,5;5;2,9;2;1;1
258108869957;258108884662;14705;0,1,3,5;4;9;1;1;1
258108884662;258108895795;11133;0,1,3,5;4;9;1;1;1
258108895795;258108895883;88;0,1,3,5;4;9;1;1;1
258108895883;258108897767;1884;0,1,3,5;4;9;1;1;1
258108897767;258108898591;824;0,1,3,4,5;5;2,9;2;1;1
258108898591;258108935300;36709;0,1,3,5;4;9;1;1;1
258108935300;258108944814;9514;0,1,3,5;4;9;1;1;1
258108944814;258108945058;244;0,1,3,5;4;9;1;1;1
258108945058;258108975331;30273;0,1,3,5;4;9;1;1;1
258108975331;258108977274;1943;0,1,3,4,5;5;2,9;2;1;1
258108977274;258108983752;6478;0,1,3,4,5;5;2,9;2;1;1
258108983752;258108992332;8580;0,1,3,4,5;5;2,9;2;1;1
258108992332;258108997582;5250;0,1,3,4,5;5;2,9;2;1;1
258108997582;258109001695;4113;0,1,3,4,5;5;2,9;2;1;1
258109001695;258109001918;223;0,1,3,4,5;5;2,9;2;1;1
258109001918;258109004155;2237;0,1,3,4,5;5;2,9;2;1;1
258109004155;258109004235;80;0,1,3,4,5;5;2,9;2;1;1
258109004235;258109005086;851;0,1,3,4,5;5;2,9;2;1;1
258109005086;258109006989;1903;0,1,3,4,5;5;2,9;2;1;1
258109006989;258109007960;971;0,1,3,4,5;5;2,9;2;1;1
258109007960;258109008241;281;0,1,3,4,5;5;2,9;2;1;1
258109008241;258109008804;563;0,1,3,5;4;9;1;1;1
258109008804;258109009081;277;0,1,3,5;4;9;1;1;1
258109009081;258109009258;177;0,1,3,5;4;9;1;1;1
258109009258;258109009317;59;0,1,3,5;4;9;1;1;1
258109009317;258109009359;42;0,1,3,5;4;9;1;1;1
258109009359;258109009385;26;0,1,3,4,5;5;2,9;2;1;1
258109009385;258109009416;31;0,1,3,4,5;5;2,9;2;1;1
258109009416;258109010145;729;0,1,3,4,5;5;2,9;2;1;1
258109010145;258109010358;213;0,1,3,4,5;5;2,9;2;1;1
258109010358;258109013607;3249;0,1,3,4,5;5;2,9;2;1;1
258109013607;258109014214;607;0,1,3,5;4;9;1;1;1
258109014214;258109014931;717;0,1,3,4,5;5;2,9;2;1;1
258109014931;258109038512;23581;0,1,3,5;4;9;1;1;1
258109038512;258109041239;2727;0,1,3,5;4;9;1;1;1
258109041239;258109041464;225;0,1,3,5;4;9;1;1;1
258109041464;258109051091;9627;0,1,3,5;4;9;1;1;1
258109051091;258109080806;29715;0,1,3,5;4;9;1;1;1
258109080806;258109092395;11589;0,1,3,4,5;5;2,9;2;1;1
258109092395;258109107321;14926;0,1,3,4,5;5;2,9;2;1;1
258109107321;258109123961;16640;0,1,3,5;4;9;1;1;1
258109123961;258109127204;3243;0,1,3,5;4;9;1;1;1
258109127204;258109127258;54;0,1,3,5;4;9;1;1;1
258109127258;258109127432;174;0,1,3,5;4;9;1;1;1
258109127432;258109127712;280;0,1,3,5;4;9;1;1;1
258109127712;258109127764;52;0,1,3,5;4;9;1;1;1
258109127764;258109133700;5936;0,1,3,5;4;9;1;1;1
258109133700;258109136943;3243;0,1,3,4,5;5;2,9;2;1;1
258109136943;258109137299;356;0,1,3,4,5;5;2,9;2;1;1
258109137299;258109137908;609;0,1,3,4,5;5;2,9;2;1;1
258109137908;258109138713;805;0,1,3,4,5;5;2,9;2;1;1
258109138713;258109144370;5657;0,1,3,5;4;9;1;1;1
258109144370;258109144391;21;0,1,3,4,5;5;2,9;2;1;1
258109144391;258109145639;1248;0,1,3,4,5;5;2,9;2;1;1
258109145639;258109146826;1187;0,1,3,4,5;5;2,9;2;1;1
258109146826;258109149744;2918;0,1,3,4,5;5;2,9;2;1;1
258109149744;258109151904;2160;0,1,3,4,5;5;2,9;2;1;1
258109151904;258109152526;622;0,1,3,4,5;5;2,9;2;1;1
258109152526;258109155833;3307;0,1,3,4,5;5;2,9;2;1;1
258109155833;258109157572;1739;0,1,3,5;4;9;1;1;1
258109157572;258109158625;1053;0,1,3,4,5;5;2,9;2;1;1
258109158625;258109161300;2675;0,1,3,5;4;9;1;1;1
258109161300;258109162583;1283;0,1,3,4,5;5;2,9;2;1;1
258109162583;258109184727;22144;0,1,3,5;4;9;1;1;1
258109184727;258109189300;4573;0,1,3,5;4;9;1;1;1
258109189300;258109189759;459;0,1,3,5;4;9;1;1;1
258109189759;258109194998;5239;0,1,3,5;4;9;1;1;1
258109194998;258109195047;49;0,1,3,5;4;9;1;1;1
258109195047;258109200228;5181;0,1,3,5;4;9;1;1;1
258109200228;258109204111;3883;0,1,3,4,5;5;2,9;2;1;1
258109204111;258109204837;726;0,1,3,4,5;5;2,9;2;1;1
258109204837;258109204885;48;0,1,3,4,5;5;2,9;2;1;1
258109204885;258109205205;320;0,1,3,4,5;5;2,9;2;1;1
258109205205;258109206973;1768;0,1,3,4,5;5;2,9;2;1;1
258109206973;258109215403;8430;0,1,3,4,5;5;2,9;2;1;1
258109215403;258109215765;362;0,1,3,4,5;5;2,9;2;1;1
258109215765;258109222197;6432;0,1,3,4,5;5;2,9;2;1;1
258109222197;258109225197;3000;0,1,3,4,5;5;2,9;2;1;1
258109225197;258109227730;2533;0,1,3,4,5;5;2,9;2;1;1
258109227730;258109231098;3368;0,1,3,4,5;5;2,9;2;1;1
258109231098;258109232096;998;0,1,3,4,5;5;2,9;2;1;1
258109232096;258109234691;2595;0,1,3,4,5;5;2,9;2;1;1
258109234691;258109249761;15070;0,1,3,4,5;5;2,9;2;1;1
258109249761;258109251321;1560;0,1,3,4,5;5;2,9;2;1;1
258109251321;258109252629;1308;0,1,3,4,5;5;2,9;2;1;1
258109252629;258109253070;441;0,1,3,4,5;5;2,9;2;1;1
258109253070;258109254117;1047;0,1,3,4,5;5;2,9;2;1;1
258109254117;258109254654;537;0,1,3,4,5;5;2,9;2;1;1
258109254654;258109261708;7054;0,1,3,4,5;5;2,9;2;1;1
258109261708;258109261755;47;0,1,3,4,5;5;2,9;2;1;1
258109261755;258109262581;826;0,1,3,4,5;5;2,9;2;1;1
258109262581;258109263340;759;0,1,3,4,5;5;2,9;2;1;1
258109263340;258109298787;35447;0,1,3,5;4;9;1;1;1
258109298787;258109302398;3611;0,1,3,5;4;9;1;1;1
258109302398;258109302417;19;0,1,3,5;4;9;1;1;1
258109302417;258109302745;328;0,1,3,5;4;9;1;1;1
258109302745;258109302772;27;0,1,3,5;4;9;1;1;1
258109302772;258109311540;8768;0,1,3,5;4;9;1;1;1
258109311540;258109318138;6598;0,1,3,4,5;5;2,9;2;1;1
258109318138;258109320056;1918;0,1,3,4,5;5;2,9;2;1;1
258109320056;258109321322;1266;0,1,3,4,5;5;2,9;2;1;1
258109321322;258109333615;12293;0,1,3,4,5;5;2,9;2;1;1
258109333615;258109333991;376;0,1,3,4,5;5;2,9;2;1;1
258109333991;258109334416;425;0,1,3,4,5;5;2,9;2;1;1
258109334416;258109335572;1156;0,1,3,4,5;5;2,9;2;1;1
258109335572;258109336718;1146;0,1,3,4,5;5;2,9;2;1;1
258109336718;258109339246;2528;0,1,3,4,5;5;2,9;2;1;1
258109339246;258109341522;2276;0,1,3,4,5;5;2,9;2;1;1
258109341522;258109345558;4036;0,1,3,4,5;5;2,9;2;1;1
258109345558;258109345579;21;0,1,3,4,5;5;2,9;2;1;1
258109345579;258109345594;15;0,1,3,4,5;5;2,9;2;1;1
258109345594;258109345634;40;0,1,3,4,5;5;2,9;2;1;1
258109345634;258109345685;51;0,1,3,4,5;5;2,9;2;1;1
258109345685;258109345736;51;0,1,3,4,5;5;2,9;2;1;1
258109345736;258109345762;26;0,1,3,4,5;5;2,9;2;1;1
258109345762;258109345994;232;0,1,3,4,5;5;2,9;2;1;1
258109345994;258109348247;2253;0,1,3,4,5;5;2,9;2;1;1
258109348247;258109353580;5333;0,1,3,4,5;5;2,9;2;1;1
258109353580;258109357404;3824;0,1,3,4,5;5;2,9;2;1;1
258109357404;258109362799;5395;0,1,3,4,5;5;2,9;2;1;1
258109362799;258109363848;1049;0,1,3,4,5;5;2,9;2;1;1
258109363848;258109363859;11;0,1,3,4,5;5;2,9;2;1;1
258109363859;258109369665;5806;0,1,3,4,5;5;2,9;2;1;1
258109369665;258109370259;594;0,1,3,4,5;5;2,9;2;1;1
258109370259;258109370352;93;0,1,3,4,5;5;2,9;2;1;1
258109370352;258109370389;37;0,1,3,4,5;5;2,9;2;1;1
258109370389;258109371308;919;0,1,3,4,5;5;2,9;2;1;1
258109371308;258109388465;17157;0,1,3,5;4;9;1;1;1
258109388465;258109397921;9456;0,1,3,5;4;9;1;1;1
258109397921;258109398167;246;0,1,3,5;4;9;1;1;1
258109398167;258109398177;10;0,1,3,5;4;9;1;1;1
258109398177;258109398574;397;0,1,3,5;4;9;1;1;1
258109398574;258109398631;57;0,1,3,5;4;9;1;1;1
258109398631;258109398657;26;0,1,3,5;4;9;1;1;1
258109398657;258109399048;391;0,1,3,5;4;9;1;1;1
258109399048;258109426751;27703;0,1,3,5;4;9;1;1;1
258109426751;258109427864;1113;0,1,3,5;4;9;1;1;1
258109427864;258109429297;1433;0,1,3,4,5;5;2,9;2;1;1
258109429297;258109430000;703;0,1,3,4,5;5;2,9;2;1;1
258109430000;258109430358;358;0,1,3,4,5;5;2,9;2;1;1
258109430358;258109430633;275;0,1,3,4,5;5;2,9;2;1;1
258109430633;258109430670;37;0,1,3,4,5;5;2,9;2;1;1
258109430670;258109430705;35;0,1,3,4,5;5;2,9;2;1;1
258109430705;258109432726;2021;0,1,3,4,5;5;2,9;2;1;1
258109432726;258109442995;10269;0,1,3,4,5;5;2,9;2;1;1
258109442995;258109444946;1951;0,1,3,4,5;5;2,9;2;1;1
258109444946;258109449320;4374;0,1,3,4,5;5;2,9;2;1;1
258109449320;258109449632;312;0,1,3,4,5;5;2,9;2;1;1
258109449632;258109455828;6196;0,1,3,4,5;5;2,9;2;1;1
258109455828;258109457020;1192;0,1,3,4,5;5;2,9;2;1;1
258109457020;258109462693;5673;0,1,3,4,5;5;2,9;2;1;1
258109462693;258109467092;4399;0,1,3,4,5;5;2,9;2;1;1
258109467092;258109472171;5079;0,1,3,4,5;5;2,9;2;1;1
258109472171;258109473322;1151;0,1,3,4,5;5;2,9;2;1;1
258109473322;258109473920;598;0,1,3,4,5;5;2,9;2;1;1
258109473920;258109474421;501;0,1,3,4,5;5;2,9;2;1;1
258109474421;258109475593;1172;0,1,3,4,5;5;2,9;2;1;1
258109475593;258109477824;2231;0,1,3,4,5;5;2,9;2;1;1
258109477824;258109478131;307;0,1,3,4,5;5;2,9;2;1;1
258109478131;258109478549;418;0,1,3,4,5;5;2,9;2;1;1
258109478549;258109478944;395;0,1,3,4,5;5;2,9;2;1;1
258109478944;258109480327;1383;0,1,3,4,5;5;2,9;2;1;1
258109480327;258109480790;463;0,1,3,4,5;5;2,9;2;1;1
258109480790;258109481034;244;0,1,3,4,5;5;2,9;2;1;1
258109481034;258109481768;734;0,1,3,4,5;5;2,9;2;1;1
258109481768;258109497817;16049;0,1,3,5;4;9;1;1;1
258109497817;258109497852;35;0,1,3,5;4;9;1;1;1
258109497852;258109497912;60;0,1,3,5;4;9;1;1;1
258109497912;258109497967;55;0,1,3,5;4;9;1;1;1
258109497967;258109498096;129;0,1,3,5;4;9;1;1;1
258109498096;258109498268;172;0,1,3,5;4;9;1;1;1
258109498268;258109504377;6109;0,1,3,5;4;9;1;1;1
258109504377;258109536669;32292;0,1,3,5;4;9;1;1;1
258109536669;258109545929;9260;0,1,3,4,5;5;2,9;2;1;1
258109545929;258109546207;278;0,1,3,4,5;5;2,9;2;1;1
258109546207;258109546315;108;0,1,3,4,5;5;2,9;2;1;1
258109546315;258109546477;162;0,1,3,4,5;5;2,9;2;1;1
258109546477;258109546644;167;0,1,3,4,5;5;2,9;2;1;1
258109546644;258109546711;67;0,1,3,4,5;5;2,9;2;1;1
258109546711;258109546863;152;0,1,3,4,5;5;2,9;2;1;1
258109546863;258109547052;189;0,1,3,4,5;5;2,9;2;1;1
258109547052;258109549218;2166;0,1,3,4,5;5;2,9;2;1;1
258109549218;258109551183;1965;0,1,3,4,5;5;2,9;2;1;1
258109551183;258109551225;42;0,1,3,4,5;5;2,9;2;1;1
258109551225;258109551427;202;0,1,3,4,5;5;2,9;2;1;1
258109551427;258109551523;96;0,1,3,4,5;5;2,9;2;1;1
258109551523;258109551552;29;0,1,3,4,5;5;2,9;2;1;1
258109551552;258109551734;182;0,1,3,4,5;5;2,9;2;1;1
258109551734;258109551767;33;0,1,3,4,5;5;2,9;2;1;1
258109551767;258109551886;119;0,1,3,4,5;5;2,9;2;1;1
258109551886;258109559218;7332;0,1,3,4,5;5;2,9;2;1;1
258109559218;258109559534;316;0,1,3,4,5;5;2,9;2;1;1
258109559534;258109563155;3621;0,1,3,4,5;5;2,9;2;1;1
258109563155;258109564262;1107;0,1,3,5;4;9;1;1;1
258109564262;258109581623;17361;0,1,3,5;4;9;1;1;1
258109581623;258109582247;624;0,1,3,4,5;5;2,9;2;1;1
258109582247;258109612731;30484;0,1,3,5;4;9;1;1;1
258109612731;258109622015;9284;0,1,3,5;4;9;1;1;1
258109622015;258109622259;244;0,1,3,5;4;9;1;1;1
258109622259;258109643606;21347;0,1,3,5;4;9;1;1;1
258109643606;258109646899;3293;0,1,3,5;4;9;1;1;1
258109646899;258109647000;101;0,1,3,5;4;9;1;1;1
258109647000;258109647303;303;0,1,3,5;4;9;1;1;1
258109647303;258109647492;189;0,1,3,5;4;9;1;1;1
258109647492;258109678144;30652;0,1,3,5;4;9;1;1;1
258109678144;258109681112;2968;0,1,3,5;4;9;1;1;1
258109681112;258109681161;49;0,1,3,5;4;9;1;1;1
258109681161;258109682652;1491;0,1,3,5;4;9;1;1;1
258109682652;258109685548;2896;0,1,3,4,5;5;2,9;2;1;1
258109685548;258109689814;4266;0,1,3,4,5;5;2,9;2;1;1
258109689814;258109692640;2826;0,1,3,4,5;5;2,9;2;1;1
258109692640;258109694641;2001;0,1,3,4,5;5;2,9;2;1;1
258109694641;258109702013;7372;0,1,3,4,5;5;2,9;2;1;1
258109702013;258109705550;3537;0,1,3,4,5;5;2,9;2;1;1
258109705550;258109708460;2910;0,1,3,4,5;5;2,9;2;1;1
258109708460;258109711377;2917;0,1,3,4,5;5;2,9;2;1;1
258109711377;258109712177;800;0,1,3,4,5;5;2,9;2;1;1
258109712177;258109713419;1242;0,1,3,4,5;5;2,9;2;1;1
258109713419;258109714413;994;0,1,3,4,5;5;2,9;2;1;1
258109714413;258109715485;1072;0,1,3,4,5;5;2,9;2;1;1
258109715485;258109717855;2370;0,1,3,4,5;5;2,9;2;1;1
258109717855;258109719072;1217;0,1,3,4,5;5;2,9;2;1;1
258109719072;258109719908;836;0,1,3,4,5;5;2,9;2;1;1
258109719908;258109723100;3192;0,1,3,4,5;5;2,9;2;1;1
258109723100;258109724567;1467;0,1,3,4,5;5;2,9;2;1;1
258109724567;258109726013;1446;0,1,3,4,5;5;2,9;2;1;1
258109726013;258109726691;678;0,1,3,5;4;9;1;1;1
258109726691;258109726711;20;0,1,3,5;4;9;1;1;1
258109726711;258109726727;16;0,1,3,5;4;9;1;1;1
258109726727;258109726902;175;0,1,3,5;4;9;1;1;1
258109726902;258109727052;150;0,1,3,4,5;5;2,9;2;1;1
258109727052;258109727115;63;0,1,3,4,5;5;2,9;2;1;1
258109727115;258109727507;392;0,1,3,4,5;5;2,9;2;1;1
258109727507;258109756943;29436;0,1,3,5;4;9;1;1;1
258109756943;258109765247;8304;0,1,3,5;4;9;1;1;1
258109765247;258109766682;1435;0,1,3,5;4;9;1;1;1
258109766682;258109766690;8;0,1,3,5;4;9;1;1;1
258109766690;258109766743;53;0,1,3,5;4;9;1;1;1
258109766743;258109766770;27;0,1,3,5;4;9;1;1;1
258109766770;258109767312;542;0,1,3,5;4;9;1;1;1
258109767312;258109789815;22503;0,1,3,5;4;9;1;1;1
258109789815;258109795495;5680;0,1,3,4,5;5;2,9;2;1;1
258109795495;258109805076;9581;0,1,3,4,5;5;2,9;2;1;1
258109805076;258109815179;10103;0,1,3,4,5;5;2,9;2;1;1
258109815179;258109815206;27;0,1,3,4,5;5;2,9;2;1;1
258109815206;258109815285;79;0,1,3,4,5;5;2,9;2;1;1
258109815285;258109815832;547;0,1,3,4,5;5;2,9;2;1;1
258109815832;258109815867;35;0,1,3,4,5;5;2,9;2;1;1
258109815867;258109816265;398;0,1,3,4,5;5;2,9;2;1;1
258109816265;258109846524;30259;0,1,3,5;4;9;1;1;1
258109846524;258109848551;2027;0,1,3,5;4;9;1;1;1
258109848551;258109850620;2069;0,1,3,5;4;9;1;1;1
258109850620;258109867617;16997;0,1,3,5;4;9;1;1;1
258109867617;258109871519;3902;0,1,3,5;4;9;1;1;1
258109871519;258109874243;2724;0,1,3,4,5;5;2,9;2;1;1
258109874243;258109876559;2316;0,1,3,4,5;5;2,9;2;1;1
258109876559;258109888524;11965;0,1,3,4,5;5;2,9;2;1;1
258109888524;258109888575;51;0,1,3,4,5;5;2,9;2;1;1
258109888575;258109889167;592;0,1,3,4,5;5;2,9;2;1;1
258109889167;258109889184;17;0,1,3,4,5;5;2,9;2;1;1
258109889184;258109889240;56;0,1,3,4,5;5;2,9;2;1;1
258109889240;258109889294;54;0,1,3,4,5;5;2,9;2;1;1
258109889294;258109889307;13;0,1,3,4,5;5;2,9;2;1;1
258109889307;258109889337;30;0,1,3,4,5;5;2,9;2;1;1
258109889337;258109889351;14;0,1,3,4,5;5;2,9;2;1;1
258109889351;258109889779;428;0,1,3,4,5;5;2,9;2;1;1
258109889779;258109889810;31;0,1,3,4,5;5;2,9;2;1;1
258109889810;258109890345;535;0,1,3,4,5;5;2,9;2;1;1
258109890345;258109890450;105;0,1,3,4,5;5;2,9;2;1;1
258109890450;258109890579;129;0,1,3,4,5;5;2,9;2;1;1
258109890579;258109890590;11;0,1,3,4,5;5;2,9;2;1;1
258109890590;258109890649;59;0,1,3,4,5;5;2,9;2;1;1
258109890649;258109896218;5569;0,1,3,4,5;5;2,9;2;1;1
258109896218;258109898253;2035;0,1,3,4,5;5;2,9;2;1;1
258109898253;258109901145;2892;0,1,3,4,5;5;2,9;2;1;1
258109901145;258109902545;1400;0,1,3,4,5;5;2,9;2;1;1
258109902545;258109902682;137;0,1,3,4,5;5;2,9;2;1;1
258109902682;258109903242;560;0,1,3,4,5;5;2,9;2;1;1
258109903242;258109904449;1207;0,1,3,4,5;5;2,9;2;1;1
258109904449;258109906068;1619;0,1,3,4,5;5;2,9;2;1;1
258109906068;258109906279;211;0,1,3,4,5;5;2,9;2;1;1
258109906279;258109907336;1057;0,1,3,4,5;5;2,9;2;1;1
258109907336;258109908028;692;0,1,3,4,5;5;2,9;2;1;1
258109908028;258109911545;3517;0,1,3,4,5;5;2,9;2;1;1
258109911545;258109914144;2599;0,1,3,5;4;9;1;1;1
258109914144;258109914170;26;0,1,3,5;4;9;1;1;1
258109914170;258109915455;1285;0,1,3,5;4;9;1;1;1
258109915455;258109916670;1215;0,1,3,5;4;9;1;1;1
258109916670;258109916909;239;0,1,3,5;4;9;1;1;1
258109916909;258109920642;3733;0,1,3,5;4;9;1;1;1
258109920642;258109921022;380;0,1,3,5;4;9;1;1;1
258109921022;258109921095;73;0,1,3,5;4;9;1;1;1
258109921095;258109922906;1811;0,1,3,5;4;9;1;1;1
258109922906;258109923144;238;0,1,3,5;4;9;1;1;1
258109923144;258109924423;1279;0,1,3,5;4;9;1;1;1
258109924423;258109935372;10949;0,1,3,5;4;9;1;1;1
258109935372;258109937280;1908;0,1,3,5;4;9;1;1;1
258109937280;258109937724;444;0,1,3,5;4;9;1;1;1
258109937724;258109938221;497;0,1,3,5;4;9;1;1;1
258109938221;258109938625;404;0,1,3,5;4;9;1;1;1
258109938625;258109939188;563;0,1,3,5;4;9;1;1;1
258109939188;258109939759;571;0,1,3,5;4;9;1;1;1
258109939759;258109940211;452;0,1,3,5;4;9;1;1;1
258109940211;258109940832;621;0,1,3,5;4;9;1;1;1
258109940832;258109940946;114;0,1,3,5;4;9;1;1;1
258109940946;258109940981;35;0,1,3,5;4;9;1;1;1
258109940981;258109941207;226;0,1,3,5;4;9;1;1;1
258109941207;258109941288;81;0,1,3,5;4;9;1;1;1
258109941288;258109941603;315;0,1,3,5;4;9;1;1;1
258109941603;258109945561;3958;0,1,3,5;4;9;1;1;1
258109945561;258109945631;70;0,1,3,5;4;9;1;1;1
258109945631;258109945659;28;0,1,3,5;4;9;1;1;1
258109945659;258109945749;90;0,1,3,5;4;9;1;1;1
258109945749;258109946321;572;0,1,3,5;4;9;1;1;1
258109946321;258109952782;6461;0,1,3,5;4;9;1;1;1
258109952782;258109952796;14;0,1,3,5;4;9;1;1;1
258109952796;258109952817;21;0,1,3,5;4;9;1;1;1
258109952817;258109957089;4272;0,1,3,5;4;9;1;1;1
258109957089;258109957112;23;0,1,3,5;4;9;1;1;1
258109957112;258109957318;206;0,1,3,5;4;9;1;1;1
258109957318;258109957515;197;0,1,3,5;4;9;1;1;1
258109957515;258109957718;203;0,1,3,5;4;9;1;1;1
258109957718;258109957781;63;0,1,3,5;4;9;1;1;1
258109957781;258109957995;214;0,1,3,5;4;9;1;1;1
258109957995;258109958056;61;0,1,3,5;4;9;1;1;1
258109958056;258109960463;2407;0,1,3,5;4;9;1;1;1
258109960463;258109960476;13;0,1,3,5;4;9;1;1;1
258109960476;258109960500;24;0,1,3,5;4;9;1;1;1
258109960500;258109960545;45;0,1,3,5;4;9;1;1;1
258109960545;258109960561;16;0,1,3,5;4;9;1;1;1
258109960561;258109960632;71;0,1,3,5;4;9;1;1;1
258109960632;258109961989;1357;0,1,3,5;4;9;1;1;1
258109961989;258109962330;341;0,1,3,5;4;9;1;1;1
258109962330;258109964836;2506;0,1,3,5;4;9;1;1;1
258109964836;258109965385;549;0,1,3,5;4;9;1;1;1
258109965385;258109965964;579;0,1,3,5;4;9;1;1;1
258109965964;258109966031;67;0,1,3,5;4;9;1;1;1
258109966031;258109966048;17;0,1,3,5;4;9;1;1;1
258109966048;258109966146;98;0,1,3,5;4;9;1;1;1
258109966146;258109975035;8889;0,1,3,5;4;9;1;1;1
258109975035;258109985313;10278;0,1,3,4,5;5;2,9;2;1;1
258109985313;258109985490;177;0,1,3,4,5;5;2,9;2;1;1
258109985490;258109985942;452;0,1,3,4,5;5;2,9;2;1;1
258109985942;258109986839;897;0,1,3,4,5;5;2,9;2;1;1
258109986839;258109986911;72;0,1,3,4,5;5;2,9;2;1;1
258109986911;258109987360;449;0,1,3,4,5;5;2,9;2;1;1
258109987360;258109987570;210;0,1,3,4,5;5;2,9;2;1;1
258109987570;258109987662;92;0,1,3,4,5;5;2,9;2;1;1
258109987662;258109987717;55;0,1,3,4,5;5;2,9;2;1;1
258109987717;258109991488;3771;0,1,3,4,5;5;2,9;2;1;1
258109991488;258109991558;70;0,1,3,4,5;5;2,9;2;1;1
258109991558;258109991673;115;0,1,3,4,5;5;2,9;2;1;1
258109991673;258109991693;20;0,1,3,4,5;5;2,9;2;1;1
258109991693;258110006233;14540;0,1,3,4,5;5;2,9;2;1;1
258110006233;258110006779;546;0,1,3,5;4;9;1;1;1
258110006779;258110007544;765;0,1,3,5;4;9;1;1;1
258110007544;258110007646;102;0,1,3,5;4;9;1;1;1
258110007646;258110008107;461;0,1,3,5;4;9;1;1;1
258110008107;258110008819;712;0,1,3,5;4;9;1;1;1
258110008819;258110009187;368;0,1,3,5;4;9;1;1;1
258110009187;258110009936;749;0,1,3,5;4;9;1;1;1
258110009936;258110009982;46;0,1,3,5;4;9;1;1;1
258110009982;258110010156;174;0,1,3,5;4;9;1;1;1
258110010156;258110018244;8088;0,1,3,5;4;9;1;1;1
258110018244;258110018303;59;0,1,3,5;4;9;1;1;1
258110018303;258110018322;19;0,1,3,5;4;9;1;1;1
258110018322;258110018393;71;0,1,3,5;4;9;1;1;1
258110018393;258110018443;50;0,1,3,5;4;9;1;1;1
258110018443;258110021973;3530;0,1,3,5;4;9;1;1;1
258110021973;258110022006;33;0,1,3,5;4;9;1;1;1
258110022006;258110022027;21;0,1,3,5;4;9;1;1;1
258110022027;258110024403;2376;0,1,3,5;4;9;1;1;1
258110024403;258110025390;987;0,1,3,5;4;9;1;1;1
258110025390;258110026757;1367;0,1,3,5;4;9;1;1;1
258110026757;258110029180;2423;0,1,3,5;4;9;1;1;1
258110029180;258110029507;327;0,1,3,5;4;9;1;1;1
258110029507;258110029937;430;0,1,3,5;4;9;1;1;1
258110029937;258110030920;983;0,1,3,5;4;9;1;1;1
258110030920;258110031054;134;0,1,3,5;4;9;1;1;1
258110031054;258110032088;1034;0,1,3,5;4;9;1;1;1
258110032088;258110032620;532;0,1,3,5;4;9;1;1;1
258110032620;258110034098;1478;0,1,3,5;4;9;1;1;1
258110034098;258110034301;203;0,1,3,5;4;9;1;1;1
258110034301;258110034337;36;0,1,3,5;4;9;1;1;1
258110034337;258110036230;1893;0,1,3,5;4;9;1;1;1
258110036230;258110036289;59;0,1,3,5;4;9;1;1;1
258110036289;258110036298;9;0,1,3,5;4;9;1;1;1
258110036298;258110036347;49;0,1,3,5;4;9;1;1;1
258110036347;258110036460;113;0,1,3,5;4;9;1;1;1
258110036460;258110040896;4436;0,1,3,5;4;9;1;1;1
258110040896;258110042351;1455;0,1,3,4,5;5;2,9;2;1;1
258110042351;258110043558;1207;0,1,3,4,5;5;2,9;2;1;1
258110043558;258110043681;123;0,1,3,4,5;5;2,9;2;1;1
258110043681;258110044064;383;0,1,3,4,5;5;2,9;2;1;1
258110044064;258110045260;1196;0,1,3,4,5;5;2,9;2;1;1
258110045260;258110045520;260;0,1,3,4,5;5;2,9;2;1;1
258110045520;258110045565;45;0,1,3,4,5;5;2,9;2;1;1
258110045565;258110045823;258;0,1,3,4,5;5;2,9;2;1;1
258110045823;258110046101;278;0,1,3,4,5;5;2,9;2;1;1
258110046101;258110046271;170;0,1,3,4,5;5;2,9;2;1;1
258110046271;258110049995;3724;0,1,3,4,5;5;2,9;2;1;1
258110049995;258110053758;3763;0,1,3,4,5;5;2,9;2;1;1
258110053758;258110053781;23;0,1,3,4,5;5;2,9;2;1;1
258110053781;258110053858;77;0,1,3,4,5;5;2,9;2;1;1
258110053858;258110053905;47;0,1,3,4,5;5;2,9;2;1;1
258110053905;258110054211;306;0,1,3,4,5;5;2,9;2;1;1
258110054211;258110054446;235;0,1,3,4,5;5;2,9;2;1;1
258110054446;258110054766;320;0,1,3,4,5;5;2,9;2;1;1
258110054766;258110054833;67;0,1,3,4,5;5;2,9;2;1;1
258110054833;258110055391;558;0,1,3,4,5;5;2,9;2;1;1
258110055391;258110057814;2423;0,1,3,4,5;5;2,9;2;1;1
258110057814;258110057851;37;0,1,3,4,5;5;2,9;2;1;1
258110057851;258110057934;83;0,1,3,4,5;5;2,9;2;1;1
258110057934;258110057943;9;0,1,3,4,5;5;2,9;2;1;1
258110057943;258110058411;468;0,1,3,4,5;5;2,9;2;1;1
258110058411;258110058815;404;0,1,3,4,5;5;2,9;2;1;1
258110058815;258110060591;1776;0,1,3,4,5;5;2,9;2;1;1
258110060591;258110070832;10241;0,1,3,4,5;5;2,9;2;1;1
258110070832;258110072498;1666;0,1,3,4,5;5;2,9;2;1;1
258110072498;258110072924;426;0,1,3,4,5;5;2,9;2;1;1
258110072924;258110073160;236;0,1,3,4,5;5;2,9;2;1;1
258110073160;258110073466;306;0,1,3,4,5;5;2,9;2;1;1
258110073466;258110073515;49;0,1,3,4,5;5;2,9;2;1;1
258110073515;258110073735;220;0,1,3,4,5;5;2,9;2;1;1
258110073735;258110075015;1280;0,1,3,4,5;5;2,9;2;1;1
258110075015;258110075252;237;0,1,3,4,5;5;2,9;2;1;1
258110075252;258110075853;601;0,1,3,4,5;5;2,9;2;1;1
258110075853;258110077019;1166;0,1,3,4,5;5;2,9;2;1;1
258110077019;258110077065;46;0,1,3,4,5;5;2,9;2;1;1
258110077065;258110077084;19;0,1,3,4,5;5;2,9;2;1;1
258110077084;258110077161;77;0,1,3,4,5;5;2,9;2;1;1
258110077161;258110078676;1515;0,1,3,4,5;5;2,9;2;1;1
258110078676;258110079390;714;0,1,3,4,5;5;2,9;2;1;1
258110079390;258110079731;341;0,1,3,4,5;5;2,9;2;1;1
258110079731;258110079784;53;0,1,3,4,5;5;2,9;2;1;1
258110079784;258110080504;720;0,1,3,4,5;5;2,9;2;1;1
258110080504;258110081332;828;0,1,3,4,5;5;2,9;2;1;1
258110081332;258110082113;781;0,1,3,4,5;5;2,9;2;1;1
258110082113;258110083169;1056;0,1,3,4,5;5;2,9;2;1;1
258110083169;258110083297;128;0,1,3,4,5;5;2,9;2;1;1
258110083297;258110083521;224;0,1,3,4,5;5;2,9;2;1;1
258110083521;258110084100;579;0,1,3,4,5;5;2,9;2;1;1
258110084100;258110090220;6120;0,1,3,4,5;5;2,9;2;1;1
258110090220;258110090389;169;0,1,3,4,5;5;2,9;2;1;1
258110090389;258110090546;157;0,1,3,4,5;5;2,9;2;1;1
258110090546;258110090873;327;0,1,3,4,5;5;2,9;2;1;1
258110090873;258110091300;427;0,1,3,4,5;5;2,9;2;1;1
258110091300;258110091491;191;0,1,3,4,5;5;2,9;2;1;1
258110091491;258110094325;2834;0,1,3,4,5;5;2,9;2;1;1
258110094325;258110094657;332;0,1,3,4,5;5;2,9;2;1;1
258110094657;258110094713;56;0,1,3,4,5;5;2,9;2;1;1
258110094713;258110095252;539;0,1,3,4,5;5;2,9;2;1;1
258110095252;258110095341;89;0,1,3,4,5;5;2,9;2;1;1
258110095341;258110095416;75;0,1,3,4,5;5;2,9;2;1;1
258110095416;258110095720;304;0,1,3,4,5;5;2,9;2;1;1
258110095720;258110095919;199;0,1,3,4,5;5;2,9;2;1;1
258110095919;258110097480;1561;0,1,3,4,5;5;2,9;2;1;1
258110097480;258110098487;1007;0,1,3,4,5;5;2,9;2;1;1
258110098487;258110099387;900;0,1,3,4,5;5;2,9;2;1;1
258110099387;258110099792;405;0,1,3,4,5;5;2,9;2;1;1
258110099792;258110099867;75;0,1,3,4,5;5;2,9;2;1;1
258110099867;258110099879;12;0,1,3,4,5;5;2,9;2;1;1
258110099879;258110099989;110;0,1,3,4,5;5;2,9;2;1;1
258110099989;258110101554;1565;0,1,3,4,5;5;2,9;2;1;1
258110101554;258110102822;1268;0,1,3,4,5;5;2,9;2;1;1
258110102822;258110103221;399;0,1,3,4,5;5;2,9;2;1;1
258110103221;258110103470;249;0,1,3,5;4;9;1;1;1
258110103470;258110103544;74;0,1,3,5;4;9;1;1;1
258110103544;258110103856;312;0,1,3,5;4;9;1;1;1
258110103856;258110107286;3430;0,1,3,5;4;9;1;1;1
258110107286;258110107320;34;0,1,3,5;4;9;1;1;1
258110107320;258110107523;203;0,1,3,5;4;9;1;1;1
258110107523;258110108748;1225;0,1,3,5;4;9;1;1;1
258110108748;258110109394;646;0,1,3,5;4;9;1;1;1
258110109394;258110109475;81;0,1,3,5;4;9;1;1;1
258110109475;258110109483;8;0,1,3,5;4;9;1;1;1
258110109483;258110109513;30;0,1,3,5;4;9;1;1;1
258110109513;258110110028;515;0,1,3,5;4;9;1;1;1
258110110028;258110118774;8746;0,1,3,5;4;9;1;1;1
258110118774;258110118785;11;0,1,3,5;4;9;1;1;1
258110118785;258110118808;23;0,1,3,5;4;9;1;1;1
258110118808;258110118838;30;0,1,3,5;4;9;1;1;1
258110118838;258110118889;51;0,1,3,5;4;9;1;1;1
258110118889;258110118914;25;0,1,3,5;4;9;1;1;1
258110118914;258110119292;378;0,1,3,5;4;9;1;1;1
258110119292;258110119300;8;0,1,3,5;4;9;1;1;1
258110119300;258110119505;205;0,1,3,5;4;9;1;1;1
258110119505;258110119684;179;0,1,3,5;4;9;1;1;1
258110119684;258110120292;608;0,1,3,5;4;9;1;1;1
258110120292;258110120350;58;0,1,3,5;4;9;1;1;1
258110120350;258110124315;3965;0,1,3,5;4;9;1;1;1
258110124315;258110150612;26297;0,1,3,5;4;9;1;1;1
258110150612;258110150733;121;0,1,3,5;4;9;1;1;1
258110150733;258110151043;310;0,1,3,5;4;9;1;1;1
258110151043;258110151117;74;0,1,3,5;4;9;1;1;1
258110151117;258110151710;593;0,1,3,5;4;9;1;1;1
258110151710;258110163764;12054;0,1,3,5;4;9;1;1;1
258110163764;258110163856;92;0,1,3,5;4;9;1;1;1
258110163856;258110163879;23;0,1,3,5;4;9;1;1;1
258110163879;258110164017;138;0,1,3,5;4;9;1;1;1
258110164017;258110164304;287;0,1,3,5;4;9;1;1;1
258110164304;258110165228;924;0,1,3,5;4;9;1;1;1
258110165228;258110167132;1904;0,1,3,5;4;9;1;1;1
258110167132;258110168750;1618;0,1,3,5;4;9;1;1;1
258110168750;258110168815;65;0,1,3,5;4;9;1;1;1
258110168815;258110169337;522;0,1,3,5;4;9;1;1;1
258110169337;258110170953;1616;0,1,3,5;4;9;1;1;1
258110170953;258110171974;1021;0,1,3,5;4;9;1;1;1
258110171974;258110174671;2697;0,1,3,4,5;5;2,9;2;1;1
258110174671;258110177925;3254;0,1,3,4,5;5;2,9;2;1;1
258110177925;258110179187;1262;0,1,3,4,5;5;2,9;2;1;1
258110179187;258110179805;618;0,1,3,4,5;5;2,9;2;1;1
258110179805;258110179957;152;0,1,3,4,5;5;2,9;2;1;1
258110179957;258110179981;24;0,1,3,4,5;5;2,9;2;1;1
258110179981;258110180046;65;0,1,3,4,5;5;2,9;2;1;1
258110180046;258110180109;63;0,1,3,4,5;5;2,9;2;1;1
258110180109;258110180128;19;0,1,3,4,5;5;2,9;2;1;1
258110180128;258110180476;348;0,1,3,4,5;5;2,9;2;1;1
258110180476;258110180513;37;0,1,3,4,5;5;2,9;2;1;1
258110180513;258110188539;8026;0,1,3,4,5;5;2,9;2;1;1
258110188539;258110190962;2423;0,1,3,4,5;5;2,9;2;1;1
258110190962;258110194313;3351;0,1,3,4,5;5;2,9;2;1;1
258110194313;258110194978;665;0,1,3,4,5;5;2,9;2;1;1
258110194978;258110199048;4070;0,1,3,4,5;5;2,9;2;1;1
258110199048;258110203479;4431;0,1,3,4,5;5;2,9;2;1;1
258110203479;258110204114;635;0,1,3,4,5;5;2,9;2;1;1
258110204114;258110204497;383;0,1,3,4,5;5;2,9;2;1;1
258110204497;258110208678;4181;0,1,3,4,5;5;2,9;2;1;1
258110208678;258110220055;11377;0,1,3,4,5;5;2,9;2;1;1
258110220055;258110222853;2798;0,1,3,4,5;5;2,9;2;1;1
258110222853;258110223082;229;0,1,3,4,5;5;2,9;2;1;1
258110223082;258110224026;944;0,1,3,4,5;5;2,9;2;1;1
258110224026;258110226038;2012;0,1,3,4,5;5;2,9;2;1;1
258110226038;258110226383;345;0,1,3,4,5;5;2,9;2;1;1
258110226383;258110226935;552;0,1,3,4,5;5;2,9;2;1;1
258110226935;258110227030;95;0,1,3,4,5;5;2,9;2;1;1
258110227030;258110227683;653;0,1,3,4,5;5;2,9;2;1;1
258110227683;258110227834;151;0,1,3,4,5;5;2,9;2;1;1
258110227834;258110228430;596;0,1,3,4,5;5;2,9;2;1;1
258110228430;258110229059;629;0,1,3,4,5;5;2,9;2;1;1
258110229059;258110284252;55193;0,1,3,5;4;9;1;1;1
258110284252;258110290369;6117;0,1,3,4,5;5;2,9;2;1;1
258110290369;258110291189;820;0,1,3,4,5;5;2,9;2;1;1
258110291189;258110292929;1740;0,1,3,4,5;5;2,9;2;1;1
258110292929;258110296773;3844;0,1,3,4,5;5;2,9;2;1;1
258110296773;258110307182;10409;0,1,3,4,5;5;2,9;2;1;1
258110307182;258110312451;5269;0,1,3,4,5;5;2,9;2;1;1
258110312451;258110320801;8350;0,1,3,4,5;5;2,9;2;1;1
258110320801;258110320828;27;0,1,3,4,5;5;2,9;2;1;1
258110320828;258110321005;177;0,1,3,4,5;5;2,9;2;1;1
258110321005;258110321676;671;0,1,3,4,5;5;2,9;2;1;1
258110321676;258110322558;882;0,1,3,4,5;5;2,9;2;1;1
258110322558;258110323144;586;0,1,3,4,5;5;2,9;2;1;1
258110323144;258110325653;2509;0,1,3,4,5;5;2,9;2;1;1
258110325653;258110379110;53457;0,1,3,5;4;9;1;1;1
258110379110;258110407467;28357;0,1,3,4,5;5;2,9;2;1;1
258110407467;258110437727;30260;0,1,3,5;4;9;1;1;1
258110437727;258110438432;705;0,1,3,4,5;5;2,9;2;1;1
258110438432;258110440363;1931;0,1,3,5;4;9;1;1;1
258110440363;258110440596;233;0,1,3,5;4;9;1;1;1
258110440596;258110444828;4232;0,1,3,5;4;9;1;1;1
258110444828;258110447766;2938;0,1,3,5;4;9;1;1;1
258110447766;258110447914;148;0,1,3,5;4;9;1;1;1
258110447914;258110448163;249;0,1,3,5;4;9;1;1;1
258110448163;258110448190;27;0,1,3,5;4;9;1;1;1
258110448190;258110448336;146;0,1,3,5;4;9;1;1;1
258110448336;258110448576;240;0,1,3,5;4;9;1;1;1
258110448576;258110448826;250;0,1,3,5;4;9;1;1;1
258110448826;258110449616;790;0,1,3,5;4;9;1;1;1
258110449616;258110449775;159;0,1,3,5;4;9;1;1;1
258110449775;258110449840;65;0,1,3,5;4;9;1;1;1
258110449840;258110450037;197;0,1,3,5;4;9;1;1;1
258110450037;258110450281;244;0,1,3,5;4;9;1;1;1
258110450281;258110450520;239;0,1,3,5;4;9;1;1;1
258110450520;258110450597;77;0,1,3,5;4;9;1;1;1
258110450597;258110450647;50;0,1,3,5;4;9;1;1;1
258110450647;258110450707;60;0,1,3,5;4;9;1;1;1
258110450707;258110450711;4;0,1,3,5;4;9;1;1;1
258110450711;258110450936;225;0,1,3,5;4;9;1;1;1
258110450936;258110451101;165;0,1,3,5;4;9;1;1;1
258110451101;258110451176;75;0,1,3,5;4;9;1;1;1
258110451176;258110451229;53;0,1,3,5;4;9;1;1;1
258110451229;258110451691;462;0,1,3,5;4;9;1;1;1
258110451691;258110451984;293;0,1,3,5;4;9;1;1;1
258110451984;258110452549;565;0,1,3,5;4;9;1;1;1
258110452549;258110452856;307;0,1,3,5;4;9;1;1;1
258110452856;258110453522;666;0,1,3,5;4;9;1;1;1
258110453522;258110453564;42;0,1,3,5;4;9;1;1;1
258110453564;258110453817;253;0,1,3,5;4;9;1;1;1
258110453817;258110453963;146;0,1,3,5;4;9;1;1;1
258110453963;258110454070;107;0,1,3,5;4;9;1;1;1
258110454070;258110454186;116;0,1,3,5;4;9;1;1;1
258110454186;258110454194;8;0,1,3,5;4;9;1;1;1
258110454194;258110454251;57;0,1,3,5;4;9;1;1;1
258110454251;258110454331;80;0,1,3,5;4;9;1;1;1
258110454331;258110454372;41;0,1,3,5;4;9;1;1;1
258110454372;258110454404;32;0,1,3,5;4;9;1;1;1
258110454404;258110454422;18;0,1,3,5;4;9;1;1;1
258110454422;258110454447;25;0,1,3,5;4;9;1;1;1
258110454447;258110454469;22;0,1,3,5;4;9;1;1;1
258110454469;258110454668;199;0,1,3,5;4;9;1;1;1
258110454668;258110454674;6;0,1,3,5;4;9;1;1;1
258110454674;258110454791;117;0,1,3,5;4;9;1;1;1
258110454791;258110454867;76;0,1,3,5;4;9;1;1;1
258110454867;258110454912;45;0,1,3,5;4;9;1;1;1
258110454912;258110455189;277;0,1,3,5;4;9;1;1;1
258110455189;258110455249;60;0,1,3,5;4;9;1;1;1
258110455249;258110455560;311;0,1,3,5;4;9;1;1;1
258110455560;258110457261;1701;0,1,3,5;4;9;1;1;1
258110457261;258110457361;100;0,1,3,5;4;9;1;1;1
258110457361;258110457769;408;0,1,3,5;4;9;1;1;1
258110457769;258110457845;76;0,1,3,5;4;9;1;1;1
258110457845;258110457876;31;0,1,3,5;4;9;1;1;1
258110457876;258110458036;160;0,1,3,5;4;9;1;1;1
258110458036;258110458077;41;0,1,3,5;4;9;1;1;1
258110458077;258110458171;94;0,1,3,5;4;9;1;1;1
258110458171;258110458214;43;0,1,3,5;4;9;1;1;1
258110458214;258110458246;32;0,1,3,5;4;9;1;1;1
258110458246;258110458278;32;0,1,3,5;4;9;1;1;1
258110458278;258110458477;199;0,1,3,5;4;9;1;1;1
258110458477;258110458542;65;0,1,3,5;4;9;1;1;1
258110458542;258110458589;47;0,1,3,5;4;9;1;1;1
258110458589;258110459009;420;0,1,3,5;4;9;1;1;1
258110459009;258110459535;526;0,1,3,5;4;9;1;1;1
258110459535;258110459750;215;0,1,3,5;4;9;1;1;1
258110459750;258110460348;598;0,1,3,5;4;9;1;1;1
258110460348;258110460580;232;0,1,3,5;4;9;1;1;1
258110460580;258110460714;134;0,1,3,5;4;9;1;1;1
258110460714;258110460894;180;0,1,3,5;4;9;1;1;1
258110460894;258110460956;62;0,1,3,5;4;9;1;1;1
258110460956;258110461052;96;0,1,3,5;4;9;1;1;1
258110461052;258110461111;59;0,1,3,5;4;9;1;1;1
258110461111;258110461387;276;0,1,3,5;4;9;1;1;1
258110461387;258110461437;50;0,1,3,5;4;9;1;1;1
258110461437;258110461660;223;0,1,3,5;4;9;1;1;1
258110461660;258110461713;53;0,1,3,5;4;9;1;1;1
258110461713;258110461935;222;0,1,3,5;4;9;1;1;1
258110461935;258110462085;150;0,1,3,5;4;9;1;1;1
258110462085;258110462305;220;0,1,3,5;4;9;1;1;1
258110462305;258110462331;26;0,1,3,5;4;9;1;1;1
258110462331;258110462368;37;0,1,3,5;4;9;1;1;1
258110462368;258110462513;145;0,1,3,4,5;5;2,9;2;1;1
258110462513;258110462541;28;0,1,3,4,5;5;2,9;2;1;1
258110462541;258110462658;117;0,1,3,4,5;5;2,9;2;1;1
258110462658;258110462693;35;0,1,3,4,5;5;2,9;2;1;1
258110462693;258110462709;16;0,1,3,4,5;5;2,9;2;1;1
258110462709;258110462768;59;0,1,3,4,5;5;2,9;2;1;1
258110462768;258110462897;129;0,1,3,4,5;5;2,9;2;1;1
258110462897;258110462901;4;0,1,3,4,5;5;2,9;2;1;1
258110462901;258110463067;166;0,1,3,4,5;5;2,9;2;1;1
258110463067;258110463314;247;0,1,3,4,5;5;2,9;2;1;1
258110463314;258110463438;124;0,1,3,4,5;5;2,9;2;1;1
258110463438;258110463469;31;0,1,3,4,5;5;2,9;2;1;1
258110463469;258110467367;3898;0,1,3,4,5;5;2,9;2;1;1
258110467367;258110467764;397;0,1,3,5;4;9;1;1;1
258110467764;258110469248;1484;0,1,3,5;4;9;1;1;1
258110469248;258110471014;1766;0,1,3,4,5;5;2,9;2;1;1
258110471014;258110471353;339;0,1,3,5;4;9;1;1;1
258110471353;258110473626;2273;0,1,3,4,5;5;2,9;2;1;1
258110473626;258110479482;5856;0,1,3,5;4;9;1;1;1
258110479482;258110480703;1221;0,1,3,4,5;5;2,9;2;1;1
258110480703;258110480988;285;0,1,3,5;4;9;1;1;1
258110480988;258110481063;75;0,1,3,4,5;5;2,9;2;1;1
258110481063;258110481292;229;0,1,3,4,5;5;2,9;2;1;1
258110481292;258110482228;936;0,1,3,4,5;5;2,9;2;1;1
258110482228;258110482285;57;0,1,3,4,5;5;2,9;2;1;1
258110482285;258110482950;665;0,1,3,4,5;5;2,9;2;1;1
258110482950;258110487486;4536;0,1,3,5;4;9;1;1;1
258110487486;258110491633;4147;0,1,3,4,5;5;2,9;2;1;1
258110491633;258110492228;595;0,1,3,4,5;5;2,9;2;1;1
258110492228;258110494969;2741;0,1,3,4,5;5;2,9;2;1;1
258110494969;258110495852;883;0,1,3,4,5;5;2,9;2;1;1
258110495852;258110496189;337;0,1,3,4,5;5;2,9;2;1;1
258110496189;258110496723;534;0,1,3,5;4;9;1;1;1
258110496723;258110498221;1498;0,1,3,4,5;5;2,9;2;1;1
258110498221;258110499680;1459;0,1,3,5;4;9;1;1;1
258110499680;258110500341;661;0,1,3,4,5;5;2,9;2;1;1
258110500341;258110500442;101;0,1,3,5;4;9;1;1;1
258110500442;258110501345;903;0,1,3,4,5;5;2,9;2;1;1
258110501345;258110540237;38892;0,1,3,5;4;9;1;1;1
258110540237;258110542750;2513;0,1,3,4,5;5;2,9;2;1;1
258110542750;258110546555;3805;0,1,3,4,5;5;2,9;2;1;1
258110546555;258110550608;4053;0,1,3,4,5;5;2,9;2;1;1
258110550608;258110551886;1278;0,1,3,4,5;5;2,9;2;1;1
258110551886;258110551955;69;0,1,3,4,5;5;2,9;2;1;1
258110551955;258110552384;429;0,1,3,4,5;5;2,9;2;1;1
258110552384;258110552430;46;0,1,3,4,5;5;2,9;2;1;1
258110552430;258110552730;300;0,1,3,4,5;5;2,9;2;1;1
258110552730;258110552828;98;0,1,3,4,5;5;2,9;2;1;1
258110552828;258110552932;104;0,1,3,4,5;5;2,9;2;1;1
258110552932;258110553004;72;0,1,3,4,5;5;2,9;2;1;1
258110553004;258110553159;155;0,1,3,4,5;5;2,9;2;1;1
258110553159;258110553321;162;0,1,3,4,5;5;2,9;2;1;1
258110553321;258110553338;17;0,1,3,4,5;5;2,9;2;1;1
258110553338;258110553396;58;0,1,3,4,5;5;2,9;2;1;1
258110553396;258110553447;51;0,1,3,4,5;5;2,9;2;1;1
258110553447;258110553661;214;0,1,3,4,5;5;2,9;2;1;1
258110553661;258110553799;138;0,1,3,4,5;5;2,9;2;1;1
258110553799;258110553884;85;0,1,3,4,5;5;2,9;2;1;1
258110553884;258110553914;30;0,1,3,4,5;5;2,9;2;1;1
258110553914;258110554094;180;0,1,3,4,5;5;2,9;2;1;1
258110554094;258110554127;33;0,1,3,4,5;5;2,9;2;1;1
258110554127;258110556026;1899;0,1,3,4,5;5;2,9;2;1;1
258110556026;258110556100;74;0,1,3,4,5;5;2,9;2;1;1
258110556100;258110556197;97;0,1,3,4,5;5;2,9;2;1;1
258110556197;258110556238;41;0,1,3,4,5;5;2,9;2;1;1
258110556238;258110556257;19;0,1,3,4,5;5;2,9;2;1;1
258110556257;258110556383;126;0,1,3,4,5;5;2,9;2;1;1
258110556383;258110556444;61;0,1,3,4,5;5;2,9;2;1;1
258110556444;258110556465;21;0,1,3,4,5;5;2,9;2;1;1
258110556465;258110556596;131;0,1,3,4,5;5;2,9;2;1;1
258110556596;258110556700;104;0,1,3,4,5;5;2,9;2;1;1
258110556700;258110556741;41;0,1,3,4,5;5;2,9;2;1;1
258110556741;258110556815;74;0,1,3,4,5;5;2,9;2;1;1
258110556815;258110556843;28;0,1,3,4,5;5;2,9;2;1;1
258110556843;258110556864;21;0,1,3,4,5;5;2,9;2;1;1
258110556864;258110556901;37;0,1,3,4,5;5;2,9;2;1;1
258110556901;258110556953;52;0,1,3,4,5;5;2,9;2;1;1
258110556953;258110557085;132;0,1,3,4,5;5;2,9;2;1;1
258110557085;258110557119;34;0,1,3,4,5;5;2,9;2;1;1
258110557119;258110557144;25;0,1,3,4,5;5;2,9;2;1;1
258110557144;258110557264;120;0,1,3,4,5;5;2,9;2;1;1
258110557264;258110557411;147;0,1,3,4,5;5;2,9;2;1;1
258110557411;258110557488;77;0,1,3,4,5;5;2,9;2;1;1
258110557488;258110557695;207;0,1,3,4,5;5;2,9;2;1;1
258110557695;258110557704;9;0,1,3,4,5;5;2,9;2;1;1
258110557704;258110557875;171;0,1,3,4,5;5;2,9;2;1;1
258110557875;258110558073;198;0,1,3,4,5;5;2,9;2;1;1
258110558073;258110558311;238;0,1,3,4,5;5;2,9;2;1;1
258110558311;258110558473;162;0,1,3,4,5;5;2,9;2;1;1
258110558473;258110559077;604;0,1,3,4,5;5;2,9;2;1;1
258110559077;258110559470;393;0,1,3,4,5;5;2,9;2;1;1
258110559470;258110559585;115;0,1,3,4,5;5;2,9;2;1;1
258110559585;258110559618;33;0,1,3,4,5;5;2,9;2;1;1
258110559618;258110559675;57;0,1,3,4,5;5;2,9;2;1;1
258110559675;258110559810;135;0,1,3,4,5;5;2,9;2;1;1
258110559810;258110559823;13;0,1,3,4,5;5;2,9;2;1;1
258110559823;258110559846;23;0,1,3,4,5;5;2,9;2;1;1
258110559846;258110559919;73;0,1,3,4,5;5;2,9;2;1;1
258110559919;258110560050;131;0,1,3,4,5;5;2,9;2;1;1
258110560050;258110560073;23;0,1,3,4,5;5;2,9;2;1;1
258110560073;258110560110;37;0,1,3,4,5;5;2,9;2;1;1
258110560110;258110560166;56;0,1,3,4,5;5;2,9;2;1;1
258110560166;258110560299;133;0,1,3,4,5;5;2,9;2;1;1
258110560299;258110560573;274;0,1,3,4,5;5;2,9;2;1;1
258110560573;258110560623;50;0,1,3,4,5;5;2,9;2;1;1
258110560623;258110560667;44;0,1,3,4,5;5;2,9;2;1;1
258110560667;258110560671;4;0,1,3,4,5;5;2,9;2;1;1
258110560671;258110560701;30;0,1,3,4,5;5;2,9;2;1;1
258110560701;258110560779;78;0,1,3,4,5;5;2,9;2;1;1
258110560779;258110560817;38;0,1,3,4,5;5;2,9;2;1;1
258110560817;258110560825;8;0,1,3,4,5;5;2,9;2;1;1
258110560825;258110560905;80;0,1,3,4,5;5;2,9;2;1;1
258110560905;258110560997;92;0,1,3,4,5;5;2,9;2;1;1
258110560997;258110561001;4;0,1,3,4,5;5;2,9;2;1;1
258110561001;258110561076;75;0,1,3,4,5;5;2,9;2;1;1
258110561076;258110561106;30;0,1,3,4,5;5;2,9;2;1;1
258110561106;258110561201;95;0,1,3,4,5;5;2,9;2;1;1
258110561201;258110561275;74;0,1,3,4,5;5;2,9;2;1;1
258110561275;258110561331;56;0,1,3,4,5;5;2,9;2;1;1
258110561331;258110561395;64;0,1,3,4,5;5;2,9;2;1;1
258110561395;258110561408;13;0,1,3,4,5;5;2,9;2;1;1
258110561408;258110561416;8;0,1,3,4,5;5;2,9;2;1;1
258110561416;258110561564;148;0,1,3,4,5;5;2,9;2;1;1
258110561564;258110561747;183;0,1,3,4,5;5;2,9;2;1;1
258110561747;258110561893;146;0,1,3,4,5;5;2,9;2;1;1
258110561893;258110561908;15;0,1,3,4,5;5;2,9;2;1;1
258110561908;258110561952;44;0,1,3,4,5;5;2,9;2;1;1
258110561952;258110562463;511;0,1,3,4,5;5;2,9;2;1;1
258110562463;258110562566;103;0,1,3,4,5;5;2,9;2;1;1
258110562566;258110562669;103;0,1,3,4,5;5;2,9;2;1;1
258110562669;258110562734;65;0,1,3,4,5;5;2,9;2;1;1
258110562734;258110562818;84;0,1,3,4,5;5;2,9;2;1;1
258110562818;258110562932;114;0,1,3,4,5;5;2,9;2;1;1
258110562932;258110562972;40;0,1,3,4,5;5;2,9;2;1;1
258110562972;258110563014;42;0,1,3,4,5;5;2,9;2;1;1
258110563014;258110563090;76;0,1,3,4,5;5;2,9;2;1;1
258110563090;258110565419;2329;0,1,3,4,5;5;2,9;2;1;1
258110565419;258110565603;184;0,1,3,4,5;5;2,9;2;1;1
258110565603;258110565783;180;0,1,3,4,5;5;2,9;2;1;1
258110565783;258110565855;72;0,1,3,4,5;5;2,9;2;1;1
258110565855;258110565995;140;0,1,3,4,5;5;2,9;2;1;1
258110565995;258110566107;112;0,1,3,4,5;5;2,9;2;1;1
258110566107;258110566279;172;0,1,3,4,5;5;2,9;2;1;1
258110566279;258110566368;89;0,1,3,4,5;5;2,9;2;1;1
258110566368;258110566433;65;0,1,3,4,5;5;2,9;2;1;1
258110566433;258110566465;32;0,1,3,4,5;5;2,9;2;1;1
258110566465;258110566474;9;0,1,3,4,5;5;2,9;2;1;1
258110566474;258110566591;117;0,1,3,4,5;5;2,9;2;1;1
258110566591;258110566660;69;0,1,3,4,5;5;2,9;2;1;1
258110566660;258110566710;50;0,1,3,4,5;5;2,9;2;1;1
258110566710;258110566759;49;0,1,3,4,5;5;2,9;2;1;1
258110566759;258110566808;49;0,1,3,4,5;5;2,9;2;1;1
258110566808;258110566813;5;0,1,3,4,5;5;2,9;2;1;1
258110566813;258110566840;27;0,1,3,4,5;5;2,9;2;1;1
258110566840;258110566940;100;0,1,3,4,5;5;2,9;2;1;1
258110566940;258110566946;6;0,1,3,4,5;5;2,9;2;1;1
258110566946;258110567005;59;0,1,3,4,5;5;2,9;2;1;1
258110567005;258110567084;79;0,1,3,4,5;5;2,9;2;1;1
258110567084;258110567331;247;0,1,3,4,5;5;2,9;2;1;1
258110567331;258110567333;2;0,1,3,4,5;5;2,9;2;1;1
258110567333;258110567341;8;0,1,3,4,5;5;2,9;2;1;1
258110567341;258110567442;101;0,1,3,4,5;5;2,9;2;1;1
258110567442;258110567464;22;0,1,3,4,5;5;2,9;2;1;1
258110567464;258110567506;42;0,1,3,4,5;5;2,9;2;1;1
258110567506;258110567645;139;0,1,3,4,5;5;2,9;2;1;1
258110567645;258110567728;83;0,1,3,4,5;5;2,9;2;1;1
258110567728;258110567968;240;0,1,3,4,5;5;2,9;2;1;1
258110567968;258110568006;38;0,1,3,4,5;5;2,9;2;1;1
258110568006;258110568087;81;0,1,3,4,5;5;2,9;2;1;1
258110568087;258110568123;36;0,1,3,4,5;5;2,9;2;1;1
258110568123;258110568188;65;0,1,3,4,5;5;2,9;2;1;1
258110568188;258110568242;54;0,1,3,4,5;5;2,9;2;1;1
258110568242;258110568296;54;0,1,3,4,5;5;2,9;2;1;1
258110568296;258110568329;33;0,1,3,4,5;5;2,9;2;1;1
258110568329;258110568709;380;0,1,3,4,5;5;2,9;2;1;1
258110568709;258110568961;252;0,1,3,4,5;5;2,9;2;1;1
258110568961;258110569345;384;0,1,3,4,5;5;2,9;2;1;1
258110569345;258110569525;180;0,1,3,4,5;5;2,9;2;1;1
258110569525;258110569620;95;0,1,3,4,5;5;2,9;2;1;1
258110569620;258110569651;31;0,1,3,4,5;5;2,9;2;1;1
258110569651;258110569829;178;0,1,3,4,5;5;2,9;2;1;1
258110569829;258110569997;168;0,1,3,4,5;5;2,9;2;1;1
258110569997;258110570092;95;0,1,3,4,5;5;2,9;2;1;1
258110570092;258110570166;74;0,1,3,4,5;5;2,9;2;1;1
258110570166;258110570350;184;0,1,3,4,5;5;2,9;2;1;1
258110570350;258110570353;3;0,1,3,4,5;5;2,9;2;1;1
258110570353;258110570664;311;0,1,3,4,5;5;2,9;2;1;1
258110570664;258110570799;135;0,1,3,4,5;5;2,9;2;1;1
258110570799;258110570978;179;0,1,3,4,5;5;2,9;2;1;1
258110570978;258110571071;93;0,1,3,4,5;5;2,9;2;1;1
258110571071;258110571119;48;0,1,3,4,5;5;2,9;2;1;1
258110571119;258110571158;39;0,1,3,4,5;5;2,9;2;1;1
258110571158;258110571168;10;0,1,3,4,5;5;2,9;2;1;1
258110571168;258110571209;41;0,1,3,4,5;5;2,9;2;1;1
258110571209;258110571420;211;0,1,3,4,5;5;2,9;2;1;1
258110571420;258110572055;635;0,1,3,4,5;5;2,9;2;1;1
258110572055;258110572639;584;0,1,3,4,5;5;2,9;2;1;1
258110572639;258110573766;1127;0,1,3,4,5;5;2,9;2;1;1
258110573766;258110573819;53;0,1,3,4,5;5;2,9;2;1;1
258110573819;258110575212;1393;0,1,3,4,5;5;2,9;2;1;1
258110575212;258110575437;225;0,1,3,4,5;5;2,9;2;1;1
258110575437;258110576120;683;0,1,3,4,5;5;2,9;2;1;1
258110576120;258110576607;487;0,1,3,4,5;5;2,9;2;1;1
258110576607;258110576805;198;0,1,3,4,5;5;2,9;2;1;1
258110576805;258110576998;193;0,1,3,4,5;5;2,9;2;1;1
258110576998;258110577363;365;0,1,3,4,5;5;2,9;2;1;1
258110577363;258110578731;1368;0,1,3,4,5;5;2,9;2;1;1
258110578731;258110578884;153;0,1,3,4,5;5;2,9;2;1;1
258110578884;258110579207;323;0,1,3,4,5;5;2,9;2;1;1
258110579207;258110579488;281;0,1,3,4,5;5;2,9;2;1;1
258110579488;258110580700;1212;0,1,3,4,5;5;2,9;2;1;1
258110580700;258110580942;242;0,1,3,4,5;5;2,9;2;1;1
258110580942;258110581245;303;0,1,3,4,5;5;2,9;2;1;1
258110581245;258110581963;718;0,1,3,4,5;5;2,9;2;1;1
258110581963;258110582345;382;0,1,3,4,5;5;2,9;2;1;1
258110582345;258110582539;194;0,1,3,4,5;5;2,9;2;1;1
258110582539;258110582603;64;0,1,3,4,5;5;2,9;2;1;1
258110582603;258110583258;655;0,1,3,4,5;5;2,9;2;1;1
258110583258;258110583739;481;0,1,3,4,5;5;2,9;2;1;1
258110583739;258110583798;59;0,1,3,4,5;5;2,9;2;1;1
258110583798;258110583862;64;0,1,3,4,5;5;2,9;2;1;1
258110583862;258110583894;32;0,1,3,4,5;5;2,9;2;1;1
258110583894;258110583965;71;0,1,3,4,5;5;2,9;2;1;1
258110583965;258110584014;49;0,1,3,4,5;5;2,9;2;1;1
258110584014;258110584159;145;0,1,3,4,5;5;2,9;2;1;1
258110584159;258110584344;185;0,1,3,4,5;5;2,9;2;1;1
258110584344;258110584561;217;0,1,3,4,5;5;2,9;2;1;1
258110584561;258110584598;37;0,1,3,4,5;5;2,9;2;1;1
258110584598;258110584641;43;0,1,3,4,5;5;2,9;2;1;1
258110584641;258110584665;24;0,1,3,4,5;5;2,9;2;1;1
258110584665;258110584716;51;0,1,3,4,5;5;2,9;2;1;1
258110584716;258110585402;686;0,1,3,4,5;5;2,9;2;1;1
258110585402;258110586197;795;0,1,3,4,5;5;2,9;2;1;1
258110586197;258110586918;721;0,1,3,4,5;5;2,9;2;1;1
258110586918;258110587521;603;0,1,3,4,5;5;2,9;2;1;1
258110587521;258110587662;141;0,1,3,4,5;5;2,9;2;1;1
258110587662;258110587729;67;0,1,3,4,5;5;2,9;2;1;1
258110587729;258110587768;39;0,1,3,4,5;5;2,9;2;1;1
258110587768;258110590141;2373;0,1,3,4,5;5;2,9;2;1;1
258110590141;258110590434;293;0,1,3,4,5;5;2,9;2;1;1
258110590434;258110590439;5;0,1,3,4,5;5;2,9;2;1;1
258110590439;258110590502;63;0,1,3,4,5;5;2,9;2;1;1
258110590502;258110590601;99;0,1,3,4,5;5;2,9;2;1;1
258110590601;258110591716;1115;0,1,3,4,5;5;2,9;2;1;1
258110591716;258110591755;39;0,1,3,4,5;5;2,9;2;1;1
258110591755;258110591916;161;0,1,3,4,5;5;2,9;2;1;1
258110591916;258110592118;202;0,1,3,4,5;5;2,9;2;1;1
258110592118;258110593329;1211;0,1,3,4,5;5;2,9;2;1;1
258110593329;258110593496;167;0,1,3,4,5;5;2,9;2;1;1
258110593496;258110593500;4;0,1,3,4,5;5;2,9;2;1;1
258110593500;258110593692;192;0,1,3,4,5;5;2,9;2;1;1
258110593692;258110593822;130;0,1,3,4,5;5;2,9;2;1;1
258110593822;258110594096;274;0,1,3,4,5;5;2,9;2;1;1
258110594096;258110594146;50;0,1,3,4,5;5;2,9;2;1;1
258110594146;258110594281;135;0,1,3,4,5;5;2,9;2;1;1
258110594281;258110594298;17;0,1,3,4,5;5;2,9;2;1;1
258110594298;258110594323;25;0,1,3,4,5;5;2,9;2;1;1
258110594323;258110594351;28;0,1,3,4,5;5;2,9;2;1;1
258110594351;258110594523;172;0,1,3,4,5;5;2,9;2;1;1
258110594523;258110594658;135;0,1,3,4,5;5;2,9;2;1;1
258110594658;258110594756;98;0,1,3,4,5;5;2,9;2;1;1
258110594756;258110594792;36;0,1,3,4,5;5;2,9;2;1;1
258110594792;258110594902;110;0,1,3,4,5;5;2,9;2;1;1
258110594902;258110594989;87;0,1,3,4,5;5;2,9;2;1;1
258110594989;258110595024;35;0,1,3,4,5;5;2,9;2;1;1
258110595024;258110595112;88;0,1,3,4,5;5;2,9;2;1;1
258110595112;258110595154;42;0,1,3,4,5;5;2,9;2;1;1
258110595154;258110595171;17;0,1,3,4,5;5;2,9;2;1;1
258110595171;258110595202;31;0,1,3,4,5;5;2,9;2;1;1
258110595202;258110595365;163;0,1,3,4,5;5;2,9;2;1;1
258110595365;258110595376;11;0,1,3,4,5;5;2,9;2;1;1
258110595376;258110595486;110;0,1,3,4,5;5;2,9;2;1;1
258110595486;258110595571;85;0,1,3,4,5;5;2,9;2;1;1
258110595571;258110595626;55;0,1,3,4,5;5;2,9;2;1;1
258110595626;258110595665;39;0,1,3,4,5;5;2,9;2;1;1
258110595665;258110595834;169;0,1,3,4,5;5;2,9;2;1;1
258110595834;258110596008;174;0,1,3,5;4;9;1;1;1
258110596008;258110596101;93;0,1,3,5;4;9;1;1;1
258110596101;258110597658;1557;0,1,3,5;4;9;1;1;1
258110597658;258110597844;186;0,1,3,5;4;9;1;1;1
258110597844;258110597982;138;0,1,3,5;4;9;1;1;1
258110597982;258110598264;282;0,1,3,5;4;9;1;1;1
258110598264;258110598345;81;0,1,3,5;4;9;1;1;1
258110598345;258110599748;1403;0,1,3,5;4;9;1;1;1
258110599748;258110599861;113;0,1,3,5;4;9;1;1;1
258110599861;258110599990;129;0,1,3,5;4;9;1;1;1
258110599990;258110600116;126;0,1,3,5;4;9;1;1;1
258110600116;258110600222;106;0,1,3,5;4;9;1;1;1
258110600222;258110600270;48;0,1,3,5;4;9;1;1;1
258110600270;258110600305;35;0,1,3,5;4;9;1;1;1
258110600305;258110600329;24;0,1,3,5;4;9;1;1;1
258110600329;258110600403;74;0,1,3,5;4;9;1;1;1
258110600403;258110601769;1366;0,1,3,5;4;9;1;1;1
258110601769;258110601916;147;0,1,3,5;4;9;1;1;1
258110601916;258110602053;137;0,1,3,5;4;9;1;1;1
258110602053;258110602135;82;0,1,3,5;4;9;1;1;1
258110602135;258110603327;1192;0,1,3,5;4;9;1;1;1
258110603327;258110609793;6466;0,1,3,5;4;9;1;1;1
258110609793;258110609994;201;0,1,3,5;4;9;1;1;1
258110609994;258110610273;279;0,1,3,5;4;9;1;1;1
258110610273;258110610708;435;0,1,3,5;4;9;1;1;1
258110610708;258110611016;308;0,1,3,5;4;9;1;1;1
258110611016;258110611568;552;0,1,3,5;4;9;1;1;1
258110611568;258110614128;2560;0,1,3,5;4;9;1;1;1
258110614128;258110614209;81;0,1,3,5;4;9;1;1;1
258110614209;258110614300;91;0,1,3,5;4;9;1;1;1
258110614300;258110614382;82;0,1,3,5;4;9;1;1;1
258110614382;258110614424;42;0,1,3,5;4;9;1;1;1
258110614424;258110625709;11285;0,1,3,5;4;9;1;1;1
258110625709;258110625959;250;0,1,3,5;4;9;1;1;1
258110625959;258110626373;414;0,1,3,5;4;9;1;1;1
258110626373;258110626500;127;0,1,3,5;4;9;1;1;1
258110626500;258110626636;136;0,1,3,5;4;9;1;1;1
258110626636;258110626814;178;0,1,3,5;4;9;1;1;1
258110626814;258110627007;193;0,1,3,5;4;9;1;1;1
258110627007;258110627070;63;0,1,3,5;4;9;1;1;1
258110627070;258110627125;55;0,1,3,5;4;9;1;1;1
258110627125;258110627151;26;0,1,3,5;4;9;1;1;1
258110627151;258110627172;21;0,1,3,5;4;9;1;1;1
258110627172;258110627210;38;0,1,3,5;4;9;1;1;1
258110627210;258110627238;28;0,1,3,5;4;9;1;1;1
258110627238;258110628065;827;0,1,3,5;4;9;1;1;1
258110628065;258110628248;183;0,1,3,5;4;9;1;1;1
258110628248;258110628527;279;0,1,3,5;4;9;1;1;1
258110628527;258110632616;4089;0,1,3,5;4;9;1;1;1
258110632616;258110632815;199;0,1,3,5;4;9;1;1;1
258110632815;258110633428;613;0,1,3,5;4;9;1;1;1
258110633428;258110633662;234;0,1,3,5;4;9;1;1;1
258110633662;258110633699;37;0,1,3,5;4;9;1;1;1
258110633699;258110633833;134;0,1,3,5;4;9;1;1;1
258110633833;258110633953;120;0,1,3,5;4;9;1;1;1
258110633953;258110633991;38;0,1,3,5;4;9;1;1;1
258110633991;258110642497;8506;0,1,3,5;4;9;1;1;1
258110642497;258110642559;62;0,1,3,5;4;9;1;1;1
258110642559;258110643108;549;0,1,3,5;4;9;1;1;1
258110643108;258110643250;142;0,1,3,5;4;9;1;1;1
258110643250;258110643515;265;0,1,3,5;4;9;1;1;1
258110643515;258110643533;18;0,1,3,5;4;9;1;1;1
258110643533;258110643586;53;0,1,3,5;4;9;1;1;1
258110643586;258110644135;549;0,1,3,5;4;9;1;1;1
258110644135;258110644285;150;0,1,3,5;4;9;1;1;1
258110644285;258110644339;54;0,1,3,5;4;9;1;1;1
258110644339;258110644474;135;0,1,3,5;4;9;1;1;1
258110644474;258110644556;82;0,1,3,5;4;9;1;1;1
258110644556;258110645592;1036;0,1,3,5;4;9;1;1;1
258110645592;258110645859;267;0,1,3,5;4;9;1;1;1
258110645859;258110645945;86;0,1,3,5;4;9;1;1;1
258110645945;258110646066;121;0,1,3,5;4;9;1;1;1
258110646066;258110650231;4165;0,1,3,5;4;9;1;1;1
258110650231;258110654750;4519;0,1,3,4,5;5;2,9;2;1;1
258110654750;258110654810;60;0,1,3,4,5;5;2,9;2;1;1
258110654810;258110654958;148;0,1,3,4,5;5;2,9;2;1;1
258110654958;258110658932;3974;0,1,3,4,5;5;2,9;2;1;1
258110658932;258110659320;388;0,1,3,4,5;5;2,9;2;1;1
258110659320;258110659377;57;0,1,3,4,5;5;2,9;2;1;1
258110659377;258110659422;45;0,1,3,4,5;5;2,9;2;1;1
258110659422;258110659493;71;0,1,3,4,5;5;2,9;2;1;1
258110659493;258110659545;52;0,1,3,4,5;5;2,9;2;1;1
258110659545;258110659602;57;0,1,3,4,5;5;2,9;2;1;1
258110659602;258110659993;391;0,1,3,4,5;5;2,9;2;1;1
258110659993;258110665135;5142;0,1,3,4,5;5;2,9;2;1;1
258110665135;258110665483;348;0,1,3,4,5;5;2,9;2;1;1
258110665483;258110665581;98;0,1,3,4,5;5;2,9;2;1;1
258110665581;258110665728;147;0,1,3,4,5;5;2,9;2;1;1
258110665728;258110666807;1079;0,1,3,4,5;5;2,9;2;1;1
258110666807;258110668383;1576;0,1,3,4,5;5;2,9;2;1;1
258110668383;258110668612;229;0,1,3,4,5;5;2,9;2;1;1
258110668612;258110668721;109;0,1,3,4,5;5;2,9;2;1;1
258110668721;258110676962;8241;0,1,3,4,5;5;2,9;2;1;1
258110676962;258110677024;62;0,1,3,4,5;5;2,9;2;1;1
258110677024;258110677244;220;0,1,3,4,5;5;2,9;2;1;1
258110677244;258110677381;137;0,1,3,4,5;5;2,9;2;1;1
258110677381;258110677431;50;0,1,3,4,5;5;2,9;2;1;1
258110677431;258110677501;70;0,1,3,4,5;5;2,9;2;1;1
258110677501;258110679261;1760;0,1,3,4,5;5;2,9;2;1;1
258110679261;258110682705;3444;0,1,3,5;4;9;1;1;1
258110682705;258110682761;56;0,1,3,5;4;9;1;1;1
258110682761;258110682935;174;0,1,3,5;4;9;1;1;1
258110682935;258110683006;71;0,1,3,5;4;9;1;1;1
258110683006;258110683070;64;0,1,3,5;4;9;1;1;1
258110683070;258110683103;33;0,1,3,5;4;9;1;1;1
258110683103;258110684199;1096;0,1,3,5;4;9;1;1;1
258110684199;258110685276;1077;0,1,3,4,5;5;2,9;2;1;1
258110685276;258110686434;1158;0,1,3,5;4;9;1;1;1
258110686434;258110687308;874;0,1,3,4,5;5;2,9;2;1;1
258110687308;258110689544;2236;0,1,3,5;4;9;1;1;1
258110689544;258110691095;1551;0,1,3,4,5;5;2,9;2;1;1
258110691095;258110691814;719;0,1,3,5;4;9;1;1;1
258110691814;258110694340;2526;0,1,3,4,5;5;2,9;2;1;1
258110694340;258110694648;308;0,1,3,4,5;5;2,9;2;1;1
258110694648;258110695019;371;0,1,3,5;4;9;1;1;1
258110695019;258110695110;91;0,1,3,5;4;9;1;1;1
258110695110;258110695206;96;0,1,3,5;4;9;1;1;1
258110695206;258110695653;447;0,1,3,5;4;9;1;1;1
258110695653;258110697327;1674;0,1,3,4,5;5;2,9;2;1;1
258110697327;258110698129;802;0,1,3,5;4;9;1;1;1
258110698129;258110698344;215;0,1,3,4,5;5;2,9;2;1;1
258110698344;258110699393;1049;0,1,3,4,5;5;2,9;2;1;1
258110699393;258110699727;334;0,1,3,4,5;5;2,9;2;1;1
258110699727;258110709606;9879;0,1,3,5;4;9;1;1;1
258110709606;258110711565;1959;0,1,3,4,5;5;2,9;2;1;1
258110711565;258110712096;531;0,1,3,4,5;5;2,9;2;1;1
258110712096;258110712889;793;0,1,3,4,5;5;2,9;2;1;1
258110712889;258110712950;61;0,1,3,4,5;5;2,9;2;1;1
258110712950;258110713056;106;0,1,3,4,5;5;2,9;2;1;1
258110713056;258110715000;1944;0,1,3,4,5;5;2,9;2;1;1
258110715000;258110715618;618;0,1,3,5;4;9;1;1;1
258110715618;258110716247;629;0,1,3,4,5;5;2,9;2;1;1
258110716247;258110724527;8280;0,1,3,5;4;9;1;1;1
258110724527;258110724542;15;0,1,3,5;4;9;1;1;1
258110724542;258110724599;57;0,1,3,5;4;9;1;1;1
258110724599;258110724631;32;0,1,3,5;4;9;1;1;1
258110724631;258110724679;48;0,1,3,5;4;9;1;1;1
258110724679;258110724755;76;0,1,3,5;4;9;1;1;1
258110724755;258110724799;44;0,1,3,5;4;9;1;1;1
258110724799;258110724802;3;0,1,3,5;4;9;1;1;1
258110724802;258110724845;43;0,1,3,5;4;9;1;1;1
258110724845;258110724863;18;0,1,3,5;4;9;1;1;1
258110724863;258110724968;105;0,1,3,5;4;9;1;1;1
258110724968;258110754675;29707;0,1,3,5;4;9;1;1;1
258110754675;258110765669;10994;0,1,3,4,5;5;2,9;2;1;1
258110765669;258110766280;611;1,3,4,5;4;2,9;2;1;1
258110766280;258110766287;7;1,3,4,5,6;5;2,9;2;1;1
258110766287;258110766341;54;1,3,4,5,6;5;2,9;2;1;1
258110766341;258110766360;19;1,3,4,5,6;5;2,9;2;1;1
258110766360;258110766362;2;1,3,4,5,6;5;2,9;2;1;1
258110766362;258110766373;11;1,3,4,5,6;5;2,9;2;1;1
258110766373;258110766382;9;1,3,4,5,6;5;2,9;2;1;1
258110766382;258110766400;18;1,3,4,5,6;5;2,9;2;1;1
258110766400;258110766409;9;1,3,4,5,6;5;2,9;2;1;1
258110766409;258110766411;2;1,3,4,5,6;5;2,9;2;1;1
258110766411;258110766413;2;1,3,4,5,6;5;2,9;2;1;1
258110766413;258110766416;3;1,3,4,5,6;5;2,9;2;1;1
258110766416;258110766419;3;1,3,4,5,6;5;2,9;2;1;1
258110766419;258110766435;16;1,3,4,5,6;5;2,9;2;1;1
258110766435;258110766441;6;1,3,4,5,6;5;2,9;2;1;1
258110766441;258110766465;24;1,3,4,5,6;5;2,9;2;1;1
258110766465;258110766467;2;1,3,4,5,6;5;2,9;2;1;1
258110766467;258110766470;3;1,3,4,5,6;5;2,9;2;1;1
258110766470;258110766494;24;1,3,4,5,6;5;2,9;2;1;1
258110766494;258110766499;5;1,3,4,5,6;5;2,9;2;1;1
258110766499;258110766501;2;1,3,4,5,6;5;2,9;2;1;1
258110766501;258110766504;3;1,3,4,5,6;5;2,9;2;1;1
258110766504;258110766506;2;1,3,4,5,6;5;2,9;2;1;1
258110766506;258110766511;5;1,3,4,5,6;5;2,9;2;1;1
258110766511;258110766514;3;1,3,4,5,6;5;2,9;2;1;1
258110766514;258110766532;18;1,3,4,5,6;5;2,9;2;1;1
258110766532;258110766543;11;1,3,4,5,6;5;2,9;2;1;1
258110766543;258110766568;25;1,3,4,5,6;5;2,9;2;1;1
258110766568;258110766570;2;1,3,4,5,6;5;2,9;2;1;1
258110766570;258110766578;8;1,3,4,5,6;5;2,9;2;1;1
258110766578;258110766584;6;1,3,4,5,6;5;2,9;2;1;1
258110766584;258110766595;11;1,3,4,5,6;5;2,9;2;1;1
258110766595;258110766610;15;1,3,4,5,6;5;2,9;2;1;1
258110766610;258110766616;6;1,3,4,5,6;5;2,9;2;1;1
258110766616;258110766626;10;1,3,4,5,6;5;2,9;2;1;1
258110766626;258110766631;5;1,3,4,5,6;5;2,9;2;1;1
258110766631;258110766636;5;1,3,4,5,6;5;2,9;2;1;1
258110766636;258110766645;9;1,3,4,5,6;5;2,9;2;1;1
258110766645;258110766657;12;1,3,4,5,6;5;2,9;2;1;1
258110766657;258110766659;2;1,3,4,5,6;5;2,9;2;1;1
258110766659;258110766668;9;1,3,4,5,6;5;2,9;2;1;1
258110766668;258110766676;8;1,3,4,5,6;5;2,9;2;1;1
258110766676;258110766683;7;1,3,4,5,6;5;2,9;2;1;1
258110766683;258110766690;7;1,3,4,5,6;5;2,9;2;1;1
258110766690;258110766699;9;1,3,4,5,6;5;2,9;2;1;1
258110766699;258110766710;11;1,3,4,5,6;5;2,9;2;1;1
258110766710;258110766730;20;1,3,4,5,6;5;2,9;2;1;1
258110766730;258110766749;19;1,3,4,5,6;5;2,9;2;1;1
258110766749;258110766761;12;1,3,4,5,6;5;2,9;2;1;1
258110766761;258110766802;41;1,3,4,5,6;5;2,9;2;1;1
258110766802;258110766818;16;1,3,4,5,6;5;2,9;2;1;1
258110766818;258110766826;8;1,3,4,5,6;5;2,9;2;1;1
258110766826;258110766841;15;1,3,4,5,6;5;2,9;2;1;1
258110766841;258110766855;14;1,3,4,5,6;5;2,9;2;1;1
258110766855;258110766882;27;1,3,4,5,6;5;2,9;2;1;1
258110766882;258110766892;10;1,3,4,5,6;5;2,9;2;1;1
258110766892;258110766901;9;1,3,4,5,6;5;2,9;2;1;1
258110766901;258110766929;28;1,3,4,5,6;5;2,9;2;1;1
258110766929;258110766966;37;1,3,4,5,6;5;2,9;2;1;1
258110766966;258110766968;2;1,3,4,5,6;5;2,9;2;1;1
258110766968;258110766994;26;1,3,4,5,6;5;2,9;2;1;1
258110766994;258110767019;25;1,3,4,5,6;5;2,9;2;1;1
258110767019;258110767020;1;1,3,4,5,6;5;2,9;2;1;1
258110767020;258110767048;28;1,3,4,5,6;5;2,9;2;1;1
258110767048;258110767051;3;1,3,4,5,6;5;2,9;2;1;1
258110767051;258110767067;16;1,3,4,5,6;5;2,9;2;1;1
258110767067;258110767090;23;1,3,4,5,6;5;2,9;2;1;1
258110767090;258110767100;10;1,3,4,5,6;5;2,9;2;1;1
258110767100;258110767104;4;1,3,4,5,6;5;2,9;2;1;1
258110767104;258110767108;4;1,3,4,5,6;5;2,9;2;1;1
258110767108;258110767115;7;1,3,4,5,6;5;2,9;2;1;1
258110767115;258110767140;25;1,3,4,5,6;5;2,9;2;1;1
258110767140;258110767179;39;1,3,4,5,6;5;2,9;2;1;1
258110767179;258110767197;18;1,3,4,5,6;5;2,9;2;1;1
258110767197;258110767250;53;1,3,4,5,6;5;2,9;2;1;1
258110767250;258110767251;1;1,3,4,5,6;5;2,9;2;1;1
258110767251;258110767299;48;1,3,4,5,6;5;2,9;2;1;1
258110767299;258110767303;4;1,3,4,5,6;5;2,9;2;1;1
258110767303;258110767310;7;1,3,4,5,6;5;2,9;2;1;1
258110767310;258110767343;33;1,3,4,5,6;5;2,9;2;1;1
258110767343;258110767346;3;1,3,4,5,6;5;2,9;2;1;1
258110767346;258110767355;9;1,3,4,5,6;5;2,9;2;1;1
258110767355;258110767366;11;1,3,4,5,6;5;2,9;2;1;1
258110767366;258110767375;9;1,3,4,5,6;5;2,9;2;1;1
258110767375;258110767480;105;1,3,4,5,6;5;2,9;2;1;1
258110767480;258110767540;60;1,3,4,5,6;5;2,9;2;1;1
258110767540;258110767707;167;1,3,4,5,6;5;2,9;2;1;1
258110767707;258110767728;21;1,3,4,5,6;5;2,9;2;1;1
258110767728;258110767873;145;1,3,4,5,6;5;2,9;2;1;1
258110767873;258110767894;21;1,3,4,5,6;5;2,9;2;1;1
258110767894;258110767896;2;1,3,4,5,6;5;2,9;2;1;1
258110767896;258110768019;123;1,3,4,5,6;5;2,9;2;1;1
258110768019;258110768107;88;1,3,4,5,6;5;2,9;2;1;1
258110768107;258110781411;13304;1,3,4,5,6;5;2,9;2;1;1
258110781411;258110842298;60887;1,3,5,6;4;9;1;1;1
258110842298;258110844194;1896;1,3,4,5,6;5;2,9;2;1;1
258110844194;258110847259;3065;1,3,4,5,6;5;2,9;2;1;1
258110847259;258110847805;546;1,3,4,5,6;5;2,9;2;1;1
258110847805;258110850204;2399;1,3,4,5,6;5;2,9;2;1;1
258110850204;258110855162;4958;1,3,4,5,6;5;2,9;2;1;1
258110855162;258110857207;2045;1,3,4,5,6;5;2,9;2;1;1
258110857207;258110858394;1187;1,3,4,5,6;5;2,9;2;1;1
258110858394;258110860925;2531;1,3,4,5,6;5;2,9;2;1;1
258110860925;258110862610;1685;1,3,4,5,6;5;2,9;2;1;1
258110862610;258110864651;2041;1,3,4,5,6;5;2,9;2;1;1
258110864651;258110866376;1725;1,3,4,5,6;5;2,9;2;1;1
258110866376;258110867465;1089;1,3,4,5,6;5;2,9;2;1;1
258110867465;258110868052;587;1,3,4,5,6;5;2,9;2;1;1
258110868052;258110872545;4493;1,3,4,5,6;5;2,9;2;1;1
258110872545;258110874721;2176;1,3,4,5,6;5;2,9;2;1;1
258110874721;258110875937;1216;1,3,4,5,6;5;2,9;2;1;1
258110875937;258110876122;185;1,3,4,5,6;5;2,9;2;1;1
258110876122;258110881749;5627;1,3,4,5,6;5;2,9;2;1;1
258110881749;258110881780;31;1,3,4,5,6;5;2,9;2;1;1
258110881780;258110882096;316;1,3,4,5,6;5;2,9;2;1;1
258110882096;258110885354;3258;1,3,4,5,6;5;2,9;2;1;1
258110885354;258110885481;127;1,3,4,5,6;5;2,9;2;1;1
258110885481;258110885968;487;1,3,4,5,6;5;2,9;2;1;1
258110885968;258110889369;3401;1,3,4,5,6;5;2,9;2;1;1
258110889369;258110891484;2115;1,3,4,5,6;5;2,9;2;1;1
258110891484;258110892014;530;1,3,4,5,6;5;2,9;2;1;1
258110892014;258110893108;1094;1,3,4,5,6;5;2,9;2;1;1
258110893108;258110894151;1043;1,3,4,5,6;5;2,9;2;1;1
258110894151;258110894610;459;1,3,4,5,6;5;2,9;2;1;1
258110894610;258110894706;96;1,3,4,5,6;5;2,9;2;1;1
258110894706;258110894874;168;1,3,4,5,6;5;2,9;2;1;1
258110894874;258110895556;682;1,3,4,5,6;5;2,9;2;1;1
258110895556;258110896585;1029;1,3,4,5,6;5;2,9;2;1;1
258110896585;258110897128;543;1,3,4,5,6;5;2,9;2;1;1
258110897128;258110897290;162;1,3,4,5,6;5;2,9;2;1;1
258110897290;258110897782;492;1,3,4,5,6;5;2,9;2;1;1
258110897782;258110897803;21;1,3,5,6;4;9;1;1;1
258110897803;258110899914;2111;1,3,5,6;4;9;1;1;1
258110899914;258110900955;1041;1,3,5,6;4;9;1;1;1
258110900955;258110906675;5720;1,3,5,6;4;9;1;1;1
258110906675;258110906892;217;1,3,5,6;4;9;1;1;1
258110906892;258110907673;781;1,3,5,6;4;9;1;1;1
258110907673;258110909415;1742;1,3,5,6;4;9;1;1;1
258110909415;258110920667;11252;1,3,5,6;4;9;1;1;1
258110920667;258110920996;329;1,3,5,6;4;9;1;1;1
258110920996;258110921086;90;1,3,5,6;4;9;1;1;1
258110921086;258110923895;2809;1,3,5,6;4;9;1;1;1
258110923895;258110926799;2904;1,3,5,6;4;9;1;1;1
258110926799;258110932680;5881;1,3,5,6;4;9;1;1;1
258110932680;258110933733;1053;1,3,5,6;4;9;1;1;1
258110933733;258110936905;3172;1,3,5,6;4;9;1;1;1
258110936905;258110938177;1272;1,3,5,6;4;9;1;1;1
258110938177;258110939187;1010;1,3,5,6;4;9;1;1;1
258110939187;258110939900;713;1,3,5,6;4;9;1;1;1
258110939900;258110940026;126;1,3,5,6;4;9;1;1;1
258110940026;258110943430;3404;1,3,5,6;4;9;1;1;1
258110943430;258110944638;1208;1,3,5,6;4;9;1;1;1
258110944638;258110944713;75;0,1,3,5,6;5;9;1;1;1
258110944713;258110944853;140;0,1,3,5,6;5;9;1;1;1
258110944853;258110945131;278;0,1,3,5,6;5;9;1;1;1
258110945131;258110945226;95;0,1,3,5,6;5;9;1;1;1
258110945226;258110945576;350;0,1,3,5,6;5;9;1;1;1
258110945576;258110945764;188;0,1,3,5,6;5;9;1;1;1
258110945764;258110945831;67;0,1,3,5,6;5;9;1;1;1
258110945831;258110945846;15;0,1,3,5,6;5;9;1;1;1
258110945846;258110946099;253;0,1,3,5,6;5;9;1;1;1
258110946099;258110946334;235;0,1,3,5,6;5;9;1;1;1
258110946334;258110946545;211;0,1,3,5,6;5;9;1;1;1
258110946545;258110946583;38;0,1,3,5,6;5;9;1;1;1
258110946583;258110947001;418;0,1,3,5,6;5;9;1;1;1
258110947001;258110947406;405;0,1,3,5,6;5;9;1;1;1
258110947406;258110949791;2385;1,3,5,6;4;9;1;1;1
258110949791;258110949965;174;1,3,5,6;4;9;1;1;1
258110949965;258110949978;13;1,3,5,6;4;9;1;1;1
258110949978;258110950537;559;1,3,5,6;4;9;1;1;1
258110950537;258110950911;374;1,3,5,6;4;9;1;1;1
258110950911;258110951451;540;1,3,5,6;4;9;1;1;1
258110951451;258110952408;957;1,3,5,6;4;9;1;1;1
258110952408;258110957442;5034;1,3,4,5,6;5;2,9;2;1;1
258110957442;258110960179;2737;1,3,4,5,6;5;2,9;2;1;1
258110960179;258110963365;3186;1,3,4,5,6;5;2,9;2;1;1
258110963365;258110963802;437;1,3,4,5,6;5;2,9;2;1;1
258110963802;258110965046;1244;1,3,4,5,6;5;2,9;2;1;1
258110965046;258110969408;4362;1,3,4,5,6;5;2,9;2;1;1
258110969408;258110970333;925;1,3,4,5,6;5;2,9;2;1;1
258110970333;258110970653;320;1,3,4,5,6;5;2,9;2;1;1
258110970653;258110977714;7061;1,3,4,5,6;5;2,9;2;1;1
258110977714;258110980614;2900;1,3,4,5,6;5;2,9;2;1;1
258110980614;258110987097;6483;1,3,4,5,6;5;2,9;2;1;1
258110987097;258110990625;3528;1,3,4,5,6;5;2,9;2;1;1
258110990625;258110991816;1191;1,3,4,5,6;5;2,9;2;1;1
258110991816;258110994384;2568;1,3,4,5,6;5;2,9;2;1;1
258110994384;258110995315;931;1,3,4,5,6;5;2,9;2;1;1
258110995315;258110998794;3479;1,3,4,5,6;5;2,9;2;1;1
258110998794;258110999731;937;1,3,4,5,6;5;2,9;2;1;1
258110999731;258111002349;2618;1,3,4,5,6;5;2,9;2;1;1
258111002349;258111002634;285;1,3,4,5,6;5;2,9;2;1;1
258111002634;258111004848;2214;1,3,4,5,6;5;2,9;2;1;1
258111004848;258111006384;1536;1,3,4,5,6;5;2,9;2;1;1
258111006384;258111006618;234;1,3,4,5,6;5;2,9;2;1;1
258111006618;258111006680;62;0,1,3,4,5,6;6;2,9;2;1;1
258111006680;258111006691;11;0,1,3,4,5,6;6;2,9;2;1;1
258111006691;258111006715;24;0,1,3,4,5,6;6;2,9;2;1;1
258111006715;258111006744;29;0,1,3,4,5,6;6;2,9;2;1;1
258111006744;258111006935;191;0,1,3,4,5,6;6;2,9;2;1;1
258111006935;258111007032;97;0,1,3,4,5,6;6;2,9;2;1;1
258111007032;258111007083;51;0,1,3,4,5,6;6;2,9;2;1;1
258111007083;258111007107;24;0,1,3,4,5,6;6;2,9;2;1;1
258111007107;258111007211;104;0,1,3,4,5,6;6;2,9;2;1;1
258111007211;258111007252;41;0,1,3,4,5,6;6;2,9;2;1;1
258111007252;258111007280;28;1,3,4,5,6;5;2,9;2;1;1
258111007280;258111007524;244;1,3,4,5,6;5;2,9;2;1;1
258111007524;258111007791;267;1,3,4,5,6;5;2,9;2;1;1
258111007791;258111008011;220;1,3,4,5,6;5;2,9;2;1;1
258111008011;258111008439;428;1,3,4,5,6;5;2,9;2;1;1
258111008439;258111008955;516;1,3,4,5,6;5;2,9;2;1;1
258111008955;258111008990;35;1,3,4,5,6;5;2,9;2;1;1
258111008990;258111009294;304;1,3,4,5,6;5;2,9;2;1;1
258111009294;258111009877;583;1,3,4,5,6;5;2,9;2;1;1
258111009877;258111009899;22;0,1,3,4,5,6;6;2,9;2;1;1
258111009899;258111009936;37;0,1,3,4,5,6;6;2,9;2;1;1
258111009936;258111010088;152;0,1,3,4,5,6;6;2,9;2;1;1
258111010088;258111010126;38;0,1,3,4,5,6;6;2,9;2;1;1
258111010126;258111010135;9;1,3,4,5,6;5;2,9;2;1;1
258111010135;258111011896;1761;1,3,4,5,6;5;2,9;2;1;1
258111011896;258111012567;671;1,3,4,5,6;5;2,9;2;1;1
258111012567;258111012919;352;1,3,4,5,6;5;2,9;2;1;1
258111012919;258111013080;161;1,3,4,5,6;5;2,9;2;1;1
258111013080;258111013904;824;1,3,5,6;4;9;1;1;1
258111013904;258111014200;296;0,1,3,5,6;5;9;1;1;1
258111014200;258111014327;127;1,3,5,6;4;9;1;1;1
258111014327;258111014328;1;1,3,4,5,6;5;2,9;2;1;1
258111014328;258111014534;206;0,1,3,4,5,6;6;2,9;2;1;1
258111014534;258111015342;808;1,3,4,5,6;5;2,9;2;1;1
258111015342;258111021197;5855;1,3,5,6;4;9;1;1;1
258111021197;258111022473;1276;1,3,4,5,6;5;2,9;2;1;1
258111022473;258111026753;4280;1,3,5,6;4;9;1;1;1
258111026753;258111027370;617;1,3,5,6;4;9;1;1;1
258111027370;258111028067;697;1,3,4,5,6;5;2,9;2;1;1
258111028067;258111029194;1127;1,3,4,5,6;5;2,9;2;1;1
258111029194;258111029713;519;1,3,4,5,6;5;2,9;2;1;1
258111029713;258111029816;103;1,3,5,6;4;9;1;1;1
258111029816;258111030567;751;1,3,4,5,6;5;2,9;2;1;1
258111030567;258111030993;426;1,3,5,6;4;9;1;1;1
258111030993;258111031599;606;1,3,4,5,6;5;2,9;2;1;1
258111031599;258111033101;1502;1,3,5,6;4;9;1;1;1
258111033101;258111040047;6946;1,3,5,6;4;9;1;1;1
258111040047;258111043088;3041;1,3,5;3;9;1;1;1
258111043088;258111061874;18786;1,3,5;3;9;1;1;1
258111061874;258111068434;6560;1,3,5;3;9;1;1;1
258111068434;258111072210;3776;1,3,5;3;9;1;1;1
258111072210;258111072864;654;1,3,5;3;9;1;1;1
258111072864;258111075381;2517;1,3,4,5;4;2,9;2;1;1
258111075381;258111079214;3833;1,3,4,5;4;2,9;2;1;1
258111079214;258111081498;2284;1,3,4,5;4;2,9;2;1;1
258111081498;258111088108;6610;1,3,4,5;4;2,9;2;1;1
258111088108;258111088285;177;1,3,4,5;4;2,9;2;1;1
258111088285;258111089460;1175;1,3,4,5;4;2,9;2;1;1
258111089460;258111089850;390;1,3,4,5;4;2,9;2;1;1
258111089850;258111095953;6103;1,3,4,5;4;2,9;2;1;1
258111095953;258111097555;1602;1,3,4,5;4;2,9;2;1;1
258111097555;258111099680;2125;1,3,4,5;4;2,9;2;1;1
258111099680;258111099743;63;1,3,4,5;4;2,9;2;1;1
258111099743;258111103458;3715;1,3,4,5;4;2,9;2;1;1
258111103458;258111106555;3097;1,3,4,5;4;2,9;2;1;1
258111106555;258111106713;158;1,3,4,5;4;2,9;2;1;1
258111106713;258111107490;777;1,3,4,5;4;2,9;2;1;1
258111107490;258111108253;763;1,3,4,5;4;2,9;2;1;1
258111108253;258111110077;1824;1,3,4,5;4;2,9;2;1;1
258111110077;258111110388;311;1,3,4,5;4;2,9;2;1;1
258111110388;258111117334;6946;1,3,4,5;4;2,9;2;1;1
258111117334;258111120563;3229;1,3,4,5;4;2,9;2;1;1
258111120563;258111121651;1088;1,3,4,5;4;2,9;2;1;1
258111121651;258111122507;856;1,3,4,5;4;2,9;2;1;1
258111122507;258111123195;688;1,3,4,5;4;2,9;2;1;1
258111123195;258111140208;17013;1,3,5;3;9;1;1;1
258111140208;258111185656;45448;1,3,5;3;9;1;1;1
258111185656;258111185795;139;1,3,5;3;9;1;1;1
258111185795;258111189241;3446;1,3,4,5;4;2,9;2;1;1
258111189241;258111193172;3931;1,3,4,5;4;2,9;2;1;1
258111193172;258111196289;3117;1,3,4,5;4;2,9;2;1;1
258111196289;258111196305;16;0,1,3,4,5;5;2,9;2;1;1
258111196305;258111196323;18;0,1,3,4,5;5;2,9;2;1;1
258111196323;258111196358;35;0,1,3,4,5;5;2,9;2;1;1
258111196358;258111196398;40;0,1,3,4,5;5;2,9;2;1;1
258111196398;258111196654;256;0,1,3,4,5;5;2,9;2;1;1
258111196654;258111196685;31;0,1,3,4,5;5;2,9;2;1;1
258111196685;258111196802;117;0,1,3,4,5;5;2,9;2;1;1
258111196802;258111196858;56;0,1,3,4,5;5;2,9;2;1;1
258111196858;258111196894;36;0,1,3,4,5;5;2,9;2;1;1
258111196894;258111197037;143;1,3,4,5;4;2,9;2;1;1
258111197037;258111212547;15510;1,3,4,5;4;2,9;2;1;1
258111212547;258111212881;334;1,3,4,5;4;2,9;2;1;1
258111212881;258111214532;1651;1,3,4,5;4;2,9;2;1;1
258111214532;258111219560;5028;1,3,4,5;4;2,9;2;1;1
258111219560;258111221401;1841;1,3,4,5;4;2,9;2;1;1
258111221401;258111221655;254;1,3,4,5;4;2,9;2;1;1
258111221655;258111222428;773;1,3,4,5;4;2,9;2;1;1
258111222428;258111223658;1230;1,3,4,5;4;2,9;2;1;1
258111223658;258111223764;106;1,3,5;3;9;1;1;1
258111223764;258111224461;697;1,3,4,5;4;2,9;2;1;1
258111224461;258111225559;1098;1,3,4,5;4;2,9;2;1;1
258111225559;258111226203;644;1,3,4,5;4;2,9;2;1;1
258111226203;258111231209;5006;1,3,4,5;4;2,9;2;1;1
258111231209;258111231287;78;1,3,4,5;4;2,9;2;1;1
258111231287;258111261215;29928;1,3,5;3;9;1;1;1
258111261215;258111261501;286;1,3,5;3;9;1;1;1
258111261501;258111271109;9608;0,1,3,5;4;9;1;1;1
258111271109;258111271305;196;0,1,3,5;4;9;1;1;1
258111271305;258111271424;119;0,1,3,5;4;9;1;1;1
258111271424;258111271577;153;0,1,3,5;4;9;1;1;1
258111271577;258111277500;5923;0,1,3,5;4;9;1;1;1
258111277500;258111281826;4326;0,1,3,4,5;5;2,9;2;1;1
258111281826;258111283280;1454;0,1,3,4,5;5;2,9;2;1;1
258111283280;258111283328;48;0,1,3,4,5;5;2,9;2;1;1
258111283328;258111283902;574;0,1,3,4,5;5;2,9;2;1;1
258111283902;258111284980;1078;0,1,3,4,5;5;2,9;2;1;1
258111284980;258111287843;2863;0,1,3,4,5;5;2,9;2;1;1
258111287843;258111287932;89;0,1,3,4,5;5;2,9;2;1;1
258111287932;258111289583;1651;0,1,3,4,5;5;2,9;2;1;1
258111289583;258111289648;65;0,1,3,4,5;5;2,9;2;1;1
258111289648;258111289701;53;0,1,3,4,5;5;2,9;2;1;1
258111289701;258111290005;304;0,1,3,4,5;5;2,9;2;1;1
258111290005;258111290210;205;0,1,3,4,5;5;2,9;2;1;1
258111290210;258111290368;158;0,1,3,4,5;5;2,9;2;1;1
258111290368;258111290616;248;0,1,3,4,5;5;2,9;2;1;1
258111290616;258111290899;283;0,1,3,4,5;5;2,9;2;1;1
258111290899;258111291035;136;0,1,3,4,5;5;2,9;2;1;1
258111291035;258111291199;164;0,1,3,4,5;5;2,9;2;1;1
258111291199;258111291252;53;0,1,3,4,5;5;2,9;2;1;1
258111291252;258111291576;324;0,1,3,4,5;5;2,9;2;1;1
258111291576;258111293190;1614;0,1,3,4,5;5;2,9;2;1;1
258111293190;258111293210;20;0,1,3,4,5;5;2,9;2;1;1
258111293210;258111293442;232;0,1,3,4,5;5;2,9;2;1;1
258111293442;258111293594;152;0,1,3,4,5;5;2,9;2;1;1
258111293594;258111297420;3826;0,1,3,4,5;5;2,9;2;1;1
258111297420;258111298820;1400;0,1,3,4,5;5;2,9;2;1;1
258111298820;258111301922;3102;0,1,3,4,5;5;2,9;2;1;1
258111301922;258111305051;3129;0,1,3,4,5;5;2,9;2;1;1
258111305051;258111306906;1855;0,1,3,4,5;5;2,9;2;1;1
258111306906;258111311577;4671;0,1,3,4,5;5;2,9;2;1;1
258111311577;258111312120;543;0,1,3,4,5;5;2,9;2;1;1
258111312120;258111314788;2668;0,1,3,4,5;5;2,9;2;1;1
258111314788;258111331268;16480;0,1,3,4,5;5;2,9;2;1;1
258111331268;258111331404;136;0,1,3,4,5;5;2,9;2;1;1
258111331404;258111331497;93;0,1,3,4,5;5;2,9;2;1;1
258111331497;258111332465;968;0,1,3,4,5;5;2,9;2;1;1
258111332465;258111332805;340;0,1,3,4,5;5;2,9;2;1;1
258111332805;258111335569;2764;0,1,3,4,5;5;2,9;2;1;1
258111335569;258111336052;483;0,1,3,4,5;5;2,9;2;1;1
258111336052;258111337163;1111;0,1,3,4,5;5;2,9;2;1;1
258111337163;258111338306;1143;0,1,3,4,5;5;2,9;2;1;1
258111338306;258111340814;2508;0,1,3,5;4;9;1;1;1
258111340814;258111340971;157;0,1,3,5;4;9;1;1;1
258111340971;258111344682;3711;0,1,3,5;4;9;1;1;1
258111344682;258111363535;18853;1,3,5;3;9;1;1;1
258111363535;258111373587;10052;1,3,5;3;9;1;1;1
258111373587;258111376888;3301;1,3,5;3;9;1;1;1
258111376888;258111379080;2192;1,3,5;3;9;1;1;1
258111379080;258111379763;683;1,3,5;3;9;1;1;1
258111379763;258111380113;350;1,3,5;3;9;1;1;1
258111380113;258111382869;2756;1,3,5;3;9;1;1;1
258111382869;258111386422;3553;1,3,4,5;4;2,9;2;1;1
258111386422;258111386942;520;1,3,4,5;4;2,9;2;1;1
258111386942;258111386951;9;0,1,3,4,5;5;2,9;2;1;1
258111386951;258111387002;51;0,1,3,4,5;5;2,9;2;1;1
258111387002;258111387053;51;0,1,3,4,5;5;2,9;2;1;1
258111387053;258111387264;211;0,1,3,4,5;5;2,9;2;1;1
258111387264;258111387662;398;0,1,3,4,5;5;2,9;2;1;1
258111387662;258111387780;118;0,1,3,4,5;5;2,9;2;1;1
258111387780;258111387820;40;0,1,3,4,5;5;2,9;2;1;1
258111387820;258111387964;144;0,1,3,4,5;5;2,9;2;1;1
258111387964;258111388111;147;0,1,3,4,5;5;2,9;2;1;1
258111388111;258111390169;2058;1,3,4,5;4;2,9;2;1;1
258111390169;258111390173;4;0,1,3,4,5;5;2,9;2;1;1
258111390173;258111390205;32;0,1,3,4,5;5;2,9;2;1;1
258111390205;258111390450;245;0,1,3,4,5;5;2,9;2;1;1
258111390450;258111390513;63;0,1,3,4,5;5;2,9;2;1;1
258111390513;258111390563;50;0,1,3,4,5;5;2,9;2;1;1
258111390563;258111390575;12;0,1,3,4,5;5;2,9;2;1;1
258111390575;258111390580;5;0,1,3,4,5;5;2,9;2;1;1
258111390580;258111390599;19;0,1,3,4,5;5;2,9;2;1;1
258111390599;258111390627;28;0,1,3,4,5;5;2,9;2;1;1
258111390627;258111390651;24;0,1,3,4,5;5;2,9;2;1;1
258111390651;258111390822;171;0,1,3,4,5;5;2,9;2;1;1
258111390822;258111391064;242;0,1,3,4,5;5;2,9;2;1;1
258111391064;258111391274;210;0,1,3,4,5;5;2,9;2;1;1
258111391274;258111391382;108;0,1,3,4,5;5;2,9;2;1;1
258111391382;258111391491;109;0,1,3,4,5;5;2,9;2;1;1
258111391491;258111391662;171;0,1,3,4,5;5;2,9;2;1;1
258111391662;258111391723;61;0,1,3,4,5;5;2,9;2;1;1
258111391723;258111392504;781;0,1,3,4,5;5;2,9;2;1;1
258111392504;258111394675;2171;0,1,3,4,5;5;2,9;2;1;1
258111394675;258111394866;191;0,1,3,4,5;5;2,9;2;1;1
258111394866;258111395099;233;0,1,3,4,5;5;2,9;2;1;1
258111395099;258111400186;5087;0,1,3,4,5;5;2,9;2;1;1
258111400186;258111402115;1929;0,1,3,4,5;5;2,9;2;1;1
258111402115;258111402981;866;0,1,3,4,5;5;2,9;2;1;1
258111402981;258111414331;11350;0,1,3,4,5;5;2,9;2;1;1
258111414331;258111417100;2769;0,1,3,4,5;5;2,9;2;1;1
258111417100;258111417109;9;0,1,3,4,5;5;2,9;2;1;1
258111417109;258111422283;5174;0,1,3,4,5;5;2,9;2;1;1
258111422283;258111425743;3460;0,1,3,4,5;5;2,9;2;1;1
258111425743;258111425775;32;0,1,3,4,5;5;2,9;2;1;1
258111425775;258111425951;176;0,1,3,4,5;5;2,9;2;1;1
258111425951;258111425981;30;0,1,3,4,5;5;2,9;2;1;1
258111425981;258111426292;311;0,1,3,4,5;5;2,9;2;1;1
258111426292;258111429111;2819;0,1,3,4,5;5;2,9;2;1;1
258111429111;258111429896;785;0,1,3,4,5;5;2,9;2;1;1
258111429896;258111430150;254;0,1,3,4,5;5;2,9;2;1;1
258111430150;258111430787;637;0,1,3,4,5;5;2,9;2;1;1
258111430787;258111431867;1080;0,1,3,4,5;5;2,9;2;1;1
258111431867;258111433189;1322;0,1,3,4,5;5;2,9;2;1;1
258111433189;258111434331;1142;0,1,3,4,5;5;2,9;2;1;1
258111434331;258111434765;434;0,1,3,4,5;5;2,9;2;1;1
258111434765;258111441520;6755;0,1,3,4,5;5;2,9;2;1;1
258111441520;258111456182;14662;0,1,3,5;4;9;1;1;1
258111456182;258111456354;172;0,1,3,5;4;9;1;1;1
258111456354;258111466368;10014;0,1,3,5;4;9;1;1;1
258111466368;258111466571;203;0,1,3,5;4;9;1;1;1
258111466571;258111466683;112;0,1,3,5;4;9;1;1;1
258111466683;258111466845;162;0,1,3,5;4;9;1;1;1
258111466845;258111474788;7943;0,1,3,5;4;9;1;1;1
258111474788;258111478768;3980;0,1,3,4,5;5;2,9;2;1;1
258111478768;258111478882;114;0,1,3,4,5;5;2,9;2;1;1
258111478882;258111479061;179;0,1,3,4,5;5;2,9;2;1;1
258111479061;258111485529;6468;0,1,3,4,5;5;2,9;2;1;1
258111485529;258111501776;16247;0,1,3,4,5;5;2,9;2;1;1
258111501776;258111502050;274;0,1,3,5;4;9;1;1;1
258111502050;258111502228;178;0,1,3,5;4;9;1;1;1
258111502228;258111502512;284;0,1,3,5;4;9;1;1;1
258111502512;258111502578;66;0,1,3,5;4;9;1;1;1
258111502578;258111502611;33;0,1,3,5;4;9;1;1;1
258111502611;258111502645;34;0,1,3,5;4;9;1;1;1
258111502645;258111503943;1298;0,1,3,5;4;9;1;1;1
258111503943;258111510255;6312;1,3,5;3;9;1;1;1
258111510255;258111514208;3953;1,3,5;3;9;1;1;1
258111514208;258111516910;2702;1,3,5;3;9;1;1;1
258111516910;258111517091;181;0,1,3,5;4;9;1;1;1
258111517091;258111517129;38;1,3,5;3;9;1;1;1
258111517129;258111517260;131;0,1,3,5;4;9;1;1;1
258111517260;258111518910;1650;1,3,5;3;9;1;1;1
258111518910;258111520701;1791;1,3,4,5;4;2,9;2;1;1
258111520701;258111575438;54737;1,3,5;3;9;1;1;1
258111575438;258111584404;8966;1,3,5;3;9;1;1;1
258111584404;258111584648;244;0,1,3,5;4;9;1;1;1
258111584648;258111584731;83;1,3,5;3;9;1;1;1
258111584731;258111584978;247;0,1,3,5;4;9;1;1;1
258111584978;258111591607;6629;1,3,5;3;9;1;1;1
258111591607;258111594206;2599;1,3,4,5;4;2,9;2;1;1
258111594206;258111601595;7389;1,3,4,5;4;2,9;2;1;1
258111601595;258111602758;1163;1,3,4,5;4;2,9;2;1;1
258111602758;258111613811;11053;1,3,4,5;4;2,9;2;1;1
258111613811;258111614563;752;1,3,4,5;4;2,9;2;1;1
258111614563;258111614821;258;1,3,4,5;4;2,9;2;1;1
258111614821;258111618120;3299;1,3,4,5;4;2,9;2;1;1
258111618120;258111619859;1739;1,3,4,5;4;2,9;2;1;1
258111619859;258111623348;3489;1,3,4,5;4;2,9;2;1;1
258111623348;258111624336;988;1,3,4,5;4;2,9;2;1;1
258111624336;258111624490;154;1,3,4,5;4;2,9;2;1;1
258111624490;258111624667;177;0,1,3,4,5;5;2,9;2;1;1
258111624667;258111624706;39;1,3,4,5;4;2,9;2;1;1
258111624706;258111624835;129;0,1,3,4,5;5;2,9;2;1;1
258111624835;258111625171;336;1,3,4,5;4;2,9;2;1;1
258111625171;258111625416;245;1,3,4,5;4;2,9;2;1;1
258111625416;258111626103;687;1,3,4,5;4;2,9;2;1;1
258111626103;258111626525;422;1,3,4,5;4;2,9;2;1;1
258111626525;258111628131;1606;1,3,4,5;4;2,9;2;1;1
258111628131;258111633852;5721;1,3,4,5;4;2,9;2;1;1
258111633852;258111640415;6563;1,3,4,5;4;2,9;2;1;1
258111640415;258111640866;451;1,3,4,5;4;2,9;2;1;1
258111640866;258111641840;974;1,3,4,5;4;2,9;2;1;1
258111641840;258111643696;1856;1,3,4,5;4;2,9;2;1;1
258111643696;258111665459;21763;1,3,5;3;9;1;1;1
258111665459;258111668813;3354;1,3,5;3;9;1;1;1
258111668813;258111668919;106;0,1,3,5;4;9;1;1;1
258111668919;258111668925;6;0,1,3,5;4;9;1;1;1
258111668925;258111668974;49;0,1,3,5;4;9;1;1;1
258111668974;258111669007;33;0,1,3,5;4;9;1;1;1
258111669007;258111669085;78;0,1,3,5;4;9;1;1;1
258111669085;258111669218;133;0,1,3,5;4;9;1;1;1
258111669218;258111669397;179;0,1,3,5;4;9;1;1;1
258111669397;258111669627;230;0,1,3,5;4;9;1;1;1
258111669627;258111669665;38;0,1,3,5;4;9;1;1;1
258111669665;258111669702;37;0,1,3,5;4;9;1;1;1
258111669702;258111669867;165;0,1,3,5;4;9;1;1;1
258111669867;258111670077;210;0,1,3,5;4;9;1;1;1
258111670077;258111683503;13426;0,1,3,5;4;9;1;1;1
258111683503;258111683538;35;0,1,3,5;4;9;1;1;1
258111683538;258111683795;257;0,1,3,5;4;9;1;1;1
258111683795;258111691496;7701;0,1,3,5;4;9;1;1;1
258111691496;258111693984;2488;0,1,3,4,5;5;2,9;2;1;1
258111693984;258111698322;4338;0,1,3,4,5;5;2,9;2;1;1
258111698322;258111702836;4514;0,1,3,4,5;5;2,9;2;1;1
258111702836;258111702874;38;0,1,3,4,5;5;2,9;2;1;1
258111702874;258111703119;245;0,1,3,4,5;5;2,9;2;1;1
258111703119;258111703341;222;0,1,3,4,5;5;2,9;2;1;1
258111703341;258111707160;3819;0,1,3,4,5;5;2,9;2;1;1
258111707160;258111710466;3306;0,1,3,4,5;5;2,9;2;1;1
258111710466;258111710645;179;0,1,3,4,5;5;2,9;2;1;1
258111710645;258111710763;118;0,1,3,4,5;5;2,9;2;1;1
258111710763;258111710952;189;0,1,3,4,5;5;2,9;2;1;1
258111710952;258111711010;58;0,1,3,4,5;5;2,9;2;1;1
258111711010;258111711125;115;0,1,3,4,5;5;2,9;2;1;1
258111711125;258111711134;9;0,1,3,4,5;5;2,9;2;1;1
258111711134;258111711342;208;0,1,3,4,5;5;2,9;2;1;1
258111711342;258111711450;108;0,1,3,4,5;5;2,9;2;1;1
258111711450;258111711614;164;0,1,3,4,5;5;2,9;2;1;1
258111711614;258111711756;142;0,1,3,4,5;5;2,9;2;1;1
258111711756;258111711960;204;0,1,3,4,5;5;2,9;2;1;1
258111711960;258111712045;85;0,1,3,4,5;5;2,9;2;1;1
258111712045;258111712206;161;0,1,3,4,5;5;2,9;2;1;1
258111712206;258111715462;3256;0,1,3,4,5;5;2,9;2;1;1
258111715462;258111717949;2487;0,1,3,4,5;5;2,9;2;1;1
258111717949;258111718056;107;0,1,3,4,5;5;2,9;2;1;1
258111718056;258111718070;14;0,1,3,4,5;5;2,9;2;1;1
258111718070;258111718190;120;0,1,3,4,5;5;2,9;2;1;1
258111718190;258111718530;340;0,1,3,4,5;5;2,9;2;1;1
258111718530;258111719229;699;0,1,3,4,5;5;2,9;2;1;1
258111719229;258111723157;3928;0,1,3,4,5;5;2,9;2;1;1
258111723157;258111725022;1865;0,1,3,4,5;5;2,9;2;1;1
258111725022;258111725697;675;0,1,3,4,5;5;2,9;2;1;1
258111725697;258111731263;5566;0,1,3,4,5;5;2,9;2;1;1
258111731263;258111748264;17001;0,1,3,5;4;9;1;1;1
258111748264;258111749421;1157;0,1,3,5;4;9;1;1;1
258111749421;258111751239;1818;0,1,3,5;4;9;1;1;1
258111751239;258111759355;8116;0,1,3,5;4;9;1;1;1
258111759355;258111759748;393;0,1,3,5;4;9;1;1;1
258111759748;258111759973;225;0,1,3,5;4;9;1;1;1
258111759973;258111760008;35;0,1,3,5;4;9;1;1;1
258111760008;258111760030;22;0,1,3,5;4;9;1;1;1
258111760030;258111760064;34;0,1,3,5;4;9;1;1;1
258111760064;258111760086;22;0,1,3,5;4;9;1;1;1
258111760086;258111760291;205;0,1,3,5;4;9;1;1;1
258111760291;258111760436;145;0,1,3,5;4;9;1;1;1
258111760436;258111760483;47;0,1,3,5;4;9;1;1;1
258111760483;258111760565;82;0,1,3,5;4;9;1;1;1
258111760565;258111760641;76;0,1,3,5;4;9;1;1;1
258111760641;258111760947;306;0,1,3,5;4;9;1;1;1
258111760947;258111761036;89;0,1,3,5;4;9;1;1;1
258111761036;258111761075;39;0,1,3,5;4;9;1;1;1
258111761075;258111777565;16490;0,1,3,5;4;9;1;1;1
258111777565;258111777651;86;0,1,3,5;4;9;1;1;1
258111777651;258111777730;79;0,1,3,5;4;9;1;1;1
258111777730;258111786005;8275;0,1,3,5;4;9;1;1;1
258111786005;258111786067;62;0,1,3,5;4;9;1;1;1
258111786067;258111786162;95;0,1,3,5;4;9;1;1;1
258111786162;258111793293;7131;0,1,3,5;4;9;1;1;1
258111793293;258111793460;167;0,1,3,5;4;9;1;1;1
258111793460;258111795415;1955;0,1,3,4,5;5;2,9;2;1;1
258111795415;258111795494;79;0,1,3,4,5;5;2,9;2;1;1
258111795494;258111802380;6886;0,1,3,4,5;5;2,9;2;1;1
258111802380;258111802499;119;0,1,3,4,5;5;2,9;2;1;1
258111802499;258111802696;197;0,1,3,4,5;5;2,9;2;1;1
258111802696;258111802735;39;0,1,3,4,5;5;2,9;2;1;1
258111802735;258111802760;25;0,1,3,4,5;5;2,9;2;1;1
258111802760;258111802895;135;0,1,3,4,5;5;2,9;2;1;1
258111802895;258111803096;201;0,1,3,4,5;5;2,9;2;1;1
258111803096;258111803119;23;0,1,3,4,5;5;2,9;2;1;1
258111803119;258111803938;819;0,1,3,4,5;5;2,9;2;1;1
258111803938;258111815494;11556;0,1,3,4,5;5;2,9;2;1;1
258111815494;258111815557;63;0,1,3,4,5;5;2,9;2;1;1
258111815557;258111815627;70;0,1,3,4,5;5;2,9;2;1;1
258111815627;258111815763;136;0,1,3,4,5;5;2,9;2;1;1
258111815763;258111815793;30;0,1,3,4,5;5;2,9;2;1;1
258111815793;258111816211;418;1,3,4,5;4;2,9;2;1;1
258111816211;258111816837;626;1,3,4,5;4;2,9;2;1;1
258111816837;258111825873;9036;1,3,4,5;4;2,9;2;1;1
258111825873;258111825884;11;1,3,4,5;4;2,9;2;1;1
258111825884;258111828676;2792;1,3,4,5;4;2,9;2;1;1
258111828676;258111829303;627;1,3,4,5;4;2,9;2;1;1
258111829303;258111831281;1978;1,3,4,5;4;2,9;2;1;1
258111831281;258111831924;643;1,3,4,5;4;2,9;2;1;1
258111831924;258111832105;181;1,3,4,5;4;2,9;2;1;1
258111832105;258111832721;616;1,3,4,5;4;2,9;2;1;1
258111832721;258111833533;812;1,3,5;3;9;1;1;1
258111833533;258111844027;10494;1,3,5;3;9;1;1;1
258111844027;258111844077;50;0,1,3,5;4;9;1;1;1
258111844077;258111844087;10;0,1,3,5;4;9;1;1;1
258111844087;258111844112;25;0,1,3,5;4;9;1;1;1
258111844112;258111844150;38;0,1,3,5;4;9;1;1;1
258111844150;258111844372;222;0,1,3,5;4;9;1;1;1
258111844372;258111844533;161;0,1,3,5;4;9;1;1;1
258111844533;258111844570;37;0,1,3,5;4;9;1;1;1
258111844570;258111844675;105;0,1,3,5;4;9;1;1;1
258111844675;258111844715;40;0,1,3,5;4;9;1;1;1
258111844715;258111844739;24;0,1,3,5;4;9;1;1;1
258111844739;258111844751;12;0,1,3,5;4;9;1;1;1
258111844751;258111844973;222;0,1,3,5;4;9;1;1;1
258111844973;258111845105;132;0,1,3,5;4;9;1;1;1
258111845105;258111876235;31130;1,3,5;3;9;1;1;1
258111876235;258111879575;3340;1,3,4,5;4;2,9;2;1;1
258111879575;258111881393;1818;1,3,4,5;4;2,9;2;1;1
258111881393;258111888047;6654;1,3,4,5;4;2,9;2;1;1
258111888047;258111890895;2848;0,1,3,4,5;5;2,9;2;1;1
258111890895;258111891220;325;0,1,3,4,5;5;2,9;2;1;1
258111891220;258111896275;5055;1,3,4,5;4;2,9;2;1;1
258111896275;258111896546;271;1,3,4,5;4;2,9;2;1;1
258111896546;258111898887;2341;1,3,4,5;4;2,9;2;1;1
258111898887;258111900042;1155;1,3,4,5;4;2,9;2;1;1
258111900042;258111900249;207;0,1,3,4,5;5;2,9;2;1;1
258111900249;258111900286;37;1,3,4,5;4;2,9;2;1;1
258111900286;258111900466;180;0,1,3,4,5;5;2,9;2;1;1
258111900466;258111904899;4433;1,3,4,5;4;2,9;2;1;1
258111904899;258111908714;3815;1,3,4,5;4;2,9;2;1;1
258111908714;258111908827;113;1,3,4,5;4;2,9;2;1;1
258111908827;258111909030;203;1,3,4,5;4;2,9;2;1;1
258111909030;258111910950;1920;1,3,4,5;4;2,9;2;1;1
258111910950;258111978608;67658;1,3,5;3;9;1;1;1
258111978608;258112005764;27156;1,3,4,5;4;2,9;2;1;1
258112005764;258112070973;65209;1,3,5;3;9;1;1;1
258112070973;258112073268;2295;1,3,4,5;4;2,9;2;1;1
258112073268;258112082938;9670;1,3,4,5;4;2,9;2;1;1
258112082938;258112083536;598;1,3,4,5;4;2,9;2;1;1
258112083536;258112089980;6444;1,3,4,5;4;2,9;2;1;1
258112089980;258112095912;5932;1,3,4,5;4;2,9;2;1;1
258112095912;258112096485;573;1,3,4,5;4;2,9;2;1;1
258112096485;258112097852;1367;1,3,4,5;4;2,9;2;1;1
258112097852;258112100630;2778;1,3,4,5;4;2,9;2;1;1
258112100630;258112101267;637;1,3,4,5;4;2,9;2;1;1
258112101267;258112106030;4763;1,3,4,5;4;2,9;2;1;1
258112106030;258112111533;5503;1,3,4,5;4;2,9;2;1;1
258112111533;258112112131;598;1,3,4,5;4;2,9;2;1;1
258112112131;258112119581;7450;1,3,4,5;4;2,9;2;1;1
258112119581;258112120680;1099;1,3,4,5;4;2,9;2;1;1
258112120680;258112121630;950;1,3,4,5;4;2,9;2;1;1
258112121630;258112122435;805;1,3,4,5;4;2,9;2;1;1
258112122435;258112122961;526;1,3,4,5;4;2,9;2;1;1
258112122961;258112125705;2744;1,3,5;3;9;1;1;1
258112125705;258112126230;525;1,3,4,5;4;2,9;2;1;1
258112126230;258112127044;814;1,3,4,5;4;2,9;2;1;1
258112127044;258112127199;155;1,3,4,5;4;2,9;2;1;1
258112127199;258112128867;1668;1,3,4,5;4;2,9;2;1;1
258112128867;258112128973;106;1,3,4,5;4;2,9;2;1;1
258112128973;258112129760;787;1,3,5;3;9;1;1;1
258112129760;258112130510;750;1,3,4,5;4;2,9;2;1;1
258112130510;258112167062;36552;1,3,5;3;9;1;1;1
258112167062;258112168121;1059;1,3,4,5;4;2,9;2;1;1
258112168121;258112170134;2013;1,3,5;3;9;1;1;1
258112170134;258112170940;806;1,3,4,5;4;2,9;2;1;1
258112170940;258112172536;1596;1,3,4,5;4;2,9;2;1;1
258112172536;258112172987;451;1,3,4,5;4;2,9;2;1;1
258112172987;258112175641;2654;1,3,5;3;9;1;1;1
258112175641;258112176231;590;1,3,4,5;4;2,9;2;1;1
258112176231;258112177106;875;1,3,4,5;4;2,9;2;1;1
258112177106;258112178415;1309;1,3,4,5;4;2,9;2;1;1
258112178415;258112178727;312;1,3,4,5;4;2,9;2;1;1
258112178727;258112179749;1022;1,3,4,5;4;2,9;2;1;1
258112179749;258112180605;856;1,3,5;3;9;1;1;1
258112180605;258112183057;2452;1,3,4,5;4;2,9;2;1;1
258112183057;258112184403;1346;1,3,4,5;4;2,9;2;1;1
258112184403;258112185113;710;1,3,4,5;4;2,9;2;1;1
258112185113;258112185525;412;1,3,4,5;4;2,9;2;1;1
258112185525;258112185777;252;1,3,4,5;4;2,9;2;1;1
258112185777;258112189177;3400;1,3,4,5;4;2,9;2;1;1
258112189177;258112190159;982;1,3,4,5;4;2,9;2;1;1
258112190159;258112192101;1942;1,3,4,5;4;2,9;2;1;1
258112192101;258112192729;628;1,3,4,5;4;2,9;2;1;1
258112192729;258112193749;1020;1,3,4,5;4;2,9;2;1;1
258112193749;258112194840;1091;1,3,4,5;4;2,9;2;1;1
258112194840;258112198582;3742;1,3,4,5;4;2,9;2;1;1
258112198582;258112199756;1174;1,3,4,5;4;2,9;2;1;1
258112199756;258112200409;653;1,3,4,5;4;2,9;2;1;1
258112200409;258112200489;80;1,3,4,5;4;2,9;2;1;1
258112200489;258112203807;3318;1,3,5;3;9;1;1;1
258112203807;258112204356;549;1,3,4,5;4;2,9;2;1;1
258112204356;258112242912;38556;1,3,5;3;9;1;1;1
258112242912;258112247126;4214;1,3,4,5;4;2,9;2;1;1
258112247126;258112273166;26040;1,3,5;3;9;1;1;1
258112273166;258112273509;343;1,3,5;3;9;1;1;1
258112273509;258112277163;3654;1,3,5;3;9;1;1;1
258112277163;258112277376;213;0,1,3,5;4;9;1;1;1
258112277376;258112277725;349;1,3,5;3;9;1;1;1
258112277725;258112277762;37;0,1,3,5;4;9;1;1;1
258112277762;258112277798;36;0,1,3,5;4;9;1;1;1
258112277798;258112277833;35;0,1,3,5;4;9;1;1;1
258112277833;258112277870;37;0,1,3,5;4;9;1;1;1
258112277870;258112277999;129;0,1,3,5;4;9;1;1;1
258112277999;258112278118;119;0,1,3,5;4;9;1;1;1
258112278118;258112278286;168;0,1,3,5;4;9;1;1;1
258112278286;258112278404;118;0,1,3,5;4;9;1;1;1
258112278404;258112278525;121;0,1,3,5;4;9;1;1;1
258112278525;258112278561;36;1,3,5;3;9;1;1;1
258112278561;258112278695;134;0,1,3,5;4;9;1;1;1
258112278695;258112290574;11879;1,3,5;3;9;1;1;1
258112290574;258112291195;621;1,3,4,5;4;2,9;2;1;1
258112291195;258112320782;29587;1,3,5;3;9;1;1;1
258112320782;258112324638;3856;1,3,5;3;9;1;1;1
258112324638;258112324757;119;0,1,3,5;4;9;1;1;1
258112324757;258112324796;39;0,1,3,5;4;9;1;1;1
258112324796;258112324954;158;0,1,3,5;4;9;1;1;1
258112324954;258112325209;255;0,1,3,5;4;9;1;1;1
258112325209;258112327526;2317;0,1,3,5;4;9;1;1;1
258112327526;258112327891;365;0,1,3,5;4;9;1;1;1
258112327891;258112328707;816;0,1,3,5;4;9;1;1;1
258112328707;258112329103;396;0,1,3,5;4;9;1;1;1
258112329103;258112329529;426;0,1,3,5;4;9;1;1;1
258112329529;258112331751;2222;1,3,5;3;9;1;1;1
258112331751;258112331968;217;0,1,3,5;4;9;1;1;1
258112331968;258112332009;41;1,3,5;3;9;1;1;1
258112332009;258112332234;225;0,1,3,5;4;9;1;1;1
258112332234;258112338812;6578;1,3,5;3;9;1;1;1
258112338812;258112359941;21129;1,3,5;3;9;1;1;1
258112359941;258112360497;556;1,3,4,5;4;2,9;2;1;1
258112360497;258112363149;2652;1,3,5;3;9;1;1;1
258112363149;258112406171;43022;1,3,5;3;9;1;1;1
258112406171;258112407081;910;1,3,5;3;9;1;1;1
258112407081;258112407924;843;1,3,4,5;4;2,9;2;1;1
258112407924;258112416503;8579;1,3,5;3;9;1;1;1
258112416503;258112416517;14;0,1,3,5;4;9;1;1;1
258112416517;258112416566;49;0,1,3,5;4;9;1;1;1
258112416566;258112416574;8;0,1,3,5;4;9;1;1;1
258112416574;258112416599;25;0,1,3,5;4;9;1;1;1
258112416599;258112416793;194;0,1,3,5;4;9;1;1;1
258112416793;258112416836;43;0,1,3,5;4;9;1;1;1
258112416836;258112416936;100;0,1,3,5;4;9;1;1;1
258112416936;258112416996;60;0,1,3,5;4;9;1;1;1
258112416996;258112417075;79;0,1,3,5;4;9;1;1;1
258112417075;258112438533;21458;1,3,5;3;9;1;1;1
258112438533;258112438766;233;0,1,3,5;4;9;1;1;1
258112438766;258112438797;31;0,1,3,5;4;9;1;1;1
258112438797;258112438811;14;0,1,3,5;4;9;1;1;1
258112438811;258112440174;1363;0,1,3,5;4;9;1;1;1
258112440174;258112467340;27166;0,1,3,5;4;9;1;1;1
258112467340;258112473374;6034;0,1,3,5;4;9;1;1;1
258112473374;258112481182;7808;0,1,3,5;4;9;1;1;1
258112481182;258112482207;1025;0,1,3,4,5;5;2,9;2;1;1
258112482207;258112485145;2938;0,1,3,5;4;9;1;1;1
258112485145;258112486060;915;0,1,3,4,5;5;2,9;2;1;1
258112486060;258112486177;117;0,1,3,5;4;9;1;1;1
258112486177;258112487382;1205;0,1,3,4,5;5;2,9;2;1;1
258112487382;258112487683;301;0,1,3,5;4;9;1;1;1
258112487683;258112489272;1589;0,1,3,4,5;5;2,9;2;1;1
258112489272;258112492402;3130;0,1,3,5;4;9;1;1;1
258112492402;258112493780;1378;0,1,3,4,5;5;2,9;2;1;1
258112493780;258112497269;3489;0,1,3,5;4;9;1;1;1
258112497269;258112498927;1658;0,1,3,4,5;5;2,9;2;1;1
258112498927;258112510857;11930;0,1,3,5;4;9;1;1;1
258112510857;258112521184;10327;0,1,3,5;4;9;1;1;1
258112521184;258112521387;203;0,1,3,5;4;9;1;1;1
258112521387;258112521441;54;0,1,3,5;4;9;1;1;1
258112521441;258112521616;175;0,1,3,5;4;9;1;1;1
258112521616;258112525723;4107;0,1,3,5;4;9;1;1;1
258112525723;258112525909;186;0,1,3,5;4;9;1;1;1
258112525909;258112526033;124;0,1,3,5;4;9;1;1;1
258112526033;258112526073;40;0,1,3,5;4;9;1;1;1
258112526073;258112526108;35;0,1,3,5;4;9;1;1;1
258112526108;258112543610;17502;0,1,3,5;4;9;1;1;1
258112543610;258112550907;7297;0,1,3,5;4;9;1;1;1
258112550907;258112558507;7600;1,3,5;3;9;1;1;1
258112558507;258112560375;1868;1,3,4,5;4;2,9;2;1;1
258112560375;258112563723;3348;1,3,4,5;4;2,9;2;1;1
258112563723;258112564178;455;1,3,4,5;4;2,9;2;1;1
258112564178;258112564486;308;1,3,4,5;4;2,9;2;1;1
258112564486;258112568470;3984;1,3,4,5;4;2,9;2;1;1
258112568470;258112573361;4891;1,3,4,5;4;2,9;2;1;1
258112573361;258112573640;279;1,3,4,5;4;2,9;2;1;1
258112573640;258112573855;215;0,1,3,4,5;5;2,9;2;1;1
258112573855;258112573978;123;1,3,4,5;4;2,9;2;1;1
258112573978;258112574145;167;0,1,3,4,5;5;2,9;2;1;1
258112574145;258112575430;1285;1,3,4,5;4;2,9;2;1;1
258112575430;258112576336;906;1,3,4,5;4;2,9;2;1;1
258112576336;258112581372;5036;1,3,4,5;4;2,9;2;1;1
258112581372;258112582244;872;1,3,4,5;4;2,9;2;1;1
258112582244;258112582269;25;0,1,3,4,5;5;2,9;2;1;1
258112582269;258112582465;196;0,1,3,4,5;5;2,9;2;1;1
258112582465;258112582589;124;0,1,3,4,5;5;2,9;2;1;1
258112582589;258112582620;31;0,1,3,4,5;5;2,9;2;1;1
258112582620;258112582652;32;0,1,3,4,5;5;2,9;2;1;1
258112582652;258112582705;53;0,1,3,4,5;5;2,9;2;1;1
258112582705;258112582877;172;0,1,3,4,5;5;2,9;2;1;1
258112582877;258112582917;40;0,1,3,4,5;5;2,9;2;1;1
258112582917;258112583076;159;0,1,3,4,5;5;2,9;2;1;1
258112583076;258112584707;1631;1,3,4,5;4;2,9;2;1;1
258112584707;258112585334;627;1,3,4,5;4;2,9;2;1;1
258112585334;258112585781;447;0,1,3,4,5;5;2,9;2;1;1
258112585781;258112586182;401;0,1,3,4,5;5;2,9;2;1;1
258112586182;258112586186;4;0,1,3,4,5;5;2,9;2;1;1
258112586186;258112593955;7769;0,1,3,4,5;5;2,9;2;1;1
258112593955;258112594673;718;0,1,3,4,5;5;2,9;2;1;1
258112594673;258112611126;16453;0,1,3,4,5;5;2,9;2;1;1
258112611126;258112611397;271;0,1,3,4,5;5;2,9;2;1;1
258112611397;258112612357;960;0,1,3,4,5;5;2,9;2;1;1
258112612357;258112612618;261;0,1,3,4,5;5;2,9;2;1;1
258112612618;258112613318;700;0,1,3,4,5;5;2,9;2;1;1
258112613318;258112613818;500;0,1,3,4,5;5;2,9;2;1;1
258112613818;258112614593;775;0,1,3,4,5;5;2,9;2;1;1
258112614593;258112615924;1331;0,1,3,4,5;5;2,9;2;1;1
258112615924;258112616733;809;0,1,3,4,5;5;2,9;2;1;1
258112616733;258112617165;432;0,1,3,4,5;5;2,9;2;1;1
258112617165;258112630127;12962;0,1,3,5;4;9;1;1;1
258112630127;258112638762;8635;0,1,3,5;4;9;1;1;1
258112638762;258112638789;27;0,1,3,5;4;9;1;1;1
258112638789;258112638843;54;0,1,3,5;4;9;1;1;1
258112638843;258112639044;201;0,1,3,5;4;9;1;1;1
258112639044;258112639077;33;0,1,3,5;4;9;1;1;1
258112639077;258112639169;92;0,1,3,5;4;9;1;1;1
258112639169;258112639256;87;0,1,3,5;4;9;1;1;1
258112639256;258112639410;154;0,1,3,5;4;9;1;1;1
258112639410;258112641662;2252;0,1,3,5;4;9;1;1;1
258112641662;258112644437;2775;0,1,3,5;4;9;1;1;1
258112644437;258112644528;91;0,1,3,5;4;9;1;1;1
258112644528;258112644613;85;0,1,3,5;4;9;1;1;1
258112644613;258112644706;93;0,1,3,5;4;9;1;1;1
258112644706;258112644784;78;0,1,3,5;4;9;1;1;1
258112644784;258112644820;36;0,1,3,5;4;9;1;1;1
258112644820;258112644967;147;0,1,3,5;4;9;1;1;1
258112644967;258112645087;120;0,1,3,5;4;9;1;1;1
258112645087;258112662972;17885;0,1,3,5;4;9;1;1;1
258112662972;258112663092;120;0,1,3,5;4;9;1;1;1
258112663092;258112663408;316;0,1,3,5;4;9;1;1;1
258112663408;258112663651;243;0,1,3,5;4;9;1;1;1
258112663651;258112664616;965;0,1,3,5;4;9;1;1;1
258112664616;258112664655;39;0,1,3,5;4;9;1;1;1
258112664655;258112667844;3189;0,1,3,5;4;9;1;1;1
258112667844;258112668038;194;0,1,3,5;4;9;1;1;1
258112668038;258112669722;1684;0,1,3,5;4;9;1;1;1
258112669722;258112669911;189;0,1,3,5;4;9;1;1;1
258112669911;258112670058;147;0,1,3,5;4;9;1;1;1
258112670058;258112676449;6391;0,1,3,5;4;9;1;1;1
258112676449;258112679694;3245;0,1,3,5;4;9;1;1;1
258112679694;258112679796;102;0,1,3,5;4;9;1;1;1
258112679796;258112679847;51;0,1,3,5;4;9;1;1;1
258112679847;258112681440;1593;0,1,3,5;4;9;1;1;1
258112681440;258112689720;8280;0,1,3,5;4;9;1;1;1
258112689720;258112689801;81;1,3,5;3;9;1;1;1
258112689801;258112695302;5501;1,3,5;3;9;1;1;1
258112695302;258112697479;2177;0,1,3,5;4;9;1;1;1
258112697479;258112699201;1722;0,1,3,5;4;9;1;1;1
258112699201;258112699859;658;0,1,3,4,5;5;2,9;2;1;1
258112699859;258112708860;9001;0,1,3,5;4;9;1;1;1
258112708860;258112708912;52;0,1,3,5;4;9;1;1;1
258112708912;258112708938;26;0,1,3,5;4;9;1;1;1
258112708938;258112708995;57;0,1,3,5;4;9;1;1;1
258112708995;258112709003;8;0,1,3,5;4;9;1;1;1
258112709003;258112709054;51;0,1,3,5;4;9;1;1;1
258112709054;258112709081;27;0,1,3,5;4;9;1;1;1
258112709081;258112709405;324;0,1,3,5;4;9;1;1;1
258112709405;258112709592;187;0,1,3,5;4;9;1;1;1
258112709592;258112709651;59;0,1,3,5;4;9;1;1;1
258112709651;258112709753;102;0,1,3,5;4;9;1;1;1
258112709753;258112709804;51;0,1,3,5;4;9;1;1;1
258112709804;258112709983;179;0,1,3,5;4;9;1;1;1
258112709983;258112710028;45;0,1,3,5;4;9;1;1;1
258112710028;258112741317;31289;0,1,3,5;4;9;1;1;1
258112741317;258112750376;9059;0,1,3,5;4;9;1;1;1
258112750376;258112751658;1282;0,1,3,5;4;9;1;1;1
258112751658;258112751982;324;0,1,3,5;4;9;1;1;1
258112751982;258112752035;53;0,1,3,5;4;9;1;1;1
258112752035;258112752063;28;0,1,3,5;4;9;1;1;1
258112752063;258112752119;56;0,1,3,5;4;9;1;1;1
258112752119;258112752130;11;0,1,3,5;4;9;1;1;1
258112752130;258112752153;23;0,1,3,5;4;9;1;1;1
258112752153;258112752341;188;0,1,3,5;4;9;1;1;1
258112752341;258112752496;155;0,1,3,5;4;9;1;1;1
258112752496;258112752537;41;0,1,3,5;4;9;1;1;1
258112752537;258112752695;158;0,1,3,5;4;9;1;1;1
258112752695;258112752737;42;0,1,3,5;4;9;1;1;1
258112752737;258112752837;100;0,1,3,5;4;9;1;1;1
258112752837;258112752928;91;0,1,3,5;4;9;1;1;1
258112752928;258112753095;167;0,1,3,5;4;9;1;1;1
258112753095;258112757806;4711;0,1,3,5;4;9;1;1;1
258112757806;258112757829;23;0,1,3,5;4;9;1;1;1
258112757829;258112757882;53;0,1,3,5;4;9;1;1;1
258112757882;258112760574;2692;0,1,3,5;4;9;1;1;1
258112760574;258112760593;19;0,1,3,5;4;9;1;1;1
258112760593;258112761002;409;0,1,3,5;4;9;1;1;1
258112761002;258112761057;55;0,1,3,5;4;9;1;1;1
258112761057;258112763688;2631;0,1,3,5;4;9;1;1;1
258112763688;258112764017;329;0,1,3,5;4;9;1;1;1
258112764017;258112764070;53;0,1,3,5;4;9;1;1;1
258112764070;258112764366;296;0,1,3,5;4;9;1;1;1
258112764366;258112766933;2567;0,1,3,5;4;9;1;1;1
258112766933;258112767031;98;0,1,3,5;4;9;1;1;1
258112767031;258112767150;119;0,1,3,5;4;9;1;1;1
258112767150;258112770316;3166;0,1,3,5;4;9;1;1;1
258112770316;258112772517;2201;0,1,3,4,5;5;2,9;2;1;1
258112772517;258112773510;993;0,1,3,4,5;5;2,9;2;1;1
258112773510;258112774850;1340;0,1,3,4,5;5;2,9;2;1;1
258112774850;258112775411;561;0,1,3,4,5;5;2,9;2;1;1
258112775411;258112776850;1439;0,1,3,4,5;5;2,9;2;1;1
258112776850;258112777704;854;0,1,3,5;4;9;1;1;1
258112777704;258112778148;444;0,1,3,4,5;5;2,9;2;1;1
258112778148;258112779376;1228;0,1,3,4,5;5;2,9;2;1;1
258112779376;258112780235;859;0,1,3,4,5;5;2,9;2;1;1
258112780235;258112780765;530;0,1,3,5;4;9;1;1;1
258112780765;258112781680;915;0,1,3,4,5;5;2,9;2;1;1
258112781680;258112785439;3759;0,1,3,5;4;9;1;1;1
258112785439;258112788106;2667;0,1,3,4,5;5;2,9;2;1;1
258112788106;258112789106;1000;0,1,3,4,5;5;2,9;2;1;1
258112789106;258112789722;616;0,1,3,4,5;5;2,9;2;1;1
258112789722;258112790503;781;0,1,3,4,5;5;2,9;2;1;1
258112790503;258112790594;91;0,1,3,4,5;5;2,9;2;1;1
258112790594;258112791305;711;0,1,3,4,5;5;2,9;2;1;1
258112791305;258112791884;579;0,1,3,4,5;5;2,9;2;1;1
258112791884;258112799503;7619;0,1,3,4,5;5;2,9;2;1;1
258112799503;258112801437;1934;0,1,3,5;4;9;1;1;1
258112801437;258112801509;72;0,1,3,5;4;9;1;1;1
258112801509;258112801610;101;0,1,3,5;4;9;1;1;1
258112801610;258112801676;66;0,1,3,5;4;9;1;1;1
258112801676;258112803058;1382;0,1,3,5;4;9;1;1;1
258112803058;258112803575;517;0,1,3,4,5;5;2,9;2;1;1
258112803575;258112803908;333;0,1,3,4,5;5;2,9;2;1;1
258112803908;258112804818;910;0,1,3,4,5;5;2,9;2;1;1
258112804818;258112805595;777;0,1,3,4,5;5;2,9;2;1;1
258112805595;258112806024;429;0,1,3,4,5;5;2,9;2;1;1
258112806024;258112806547;523;0,1,3,4,5;5;2,9;2;1;1
258112806547;258112807064;517;0,1,3,4,5;5;2,9;2;1;1
258112807064;258112808126;1062;0,1,3,4,5;5;2,9;2;1;1
258112808126;258112808253;127;0,1,3,4,5;5;2,9;2;1;1
258112808253;258112808687;434;0,1,3,4,5;5;2,9;2;1;1
258112808687;258112809091;404;0,1,3,4,5;5;2,9;2;1;1
258112809091;258112810271;1180;0,1,3,4,5;5;2,9;2;1;1
258112810271;258112822433;12162;0,1,3,5;4;9;1;1;1
258112822433;258112822563;130;0,1,3,5;4;9;1;1;1
258112822563;258112822687;124;0,1,3,5;4;9;1;1;1
258112822687;258112823122;435;0,1,3,5;4;9;1;1;1
258112823122;258112823170;48;0,1,3,5;4;9;1;1;1
258112823170;258112830441;7271;0,1,3,5;4;9;1;1;1
258112830441;258112830580;139;0,1,3,5;4;9;1;1;1
258112830580;258112830641;61;0,1,3,5;4;9;1;1;1
258112830641;258112830908;267;0,1,3,5;4;9;1;1;1
258112830908;258112830994;86;0,1,3,5;4;9;1;1;1
258112830994;258112831026;32;0,1,3,5;4;9;1;1;1
258112831026;258112831052;26;0,1,3,5;4;9;1;1;1
258112831052;258112854953;23901;0,1,3,5;4;9;1;1;1
258112854953;258112855062;109;0,1,3,5;4;9;1;1;1
258112855062;258112855107;45;0,1,3,5;4;9;1;1;1
258112855107;258112858277;3170;0,1,3,5;4;9;1;1;1
258112858277;258112862776;4499;0,1,3,4,5;5;2,9;2;1;1
258112862776;258112862840;64;0,1,3,4,5;5;2,9;2;1;1
258112862840;258112862999;159;0,1,3,4,5;5;2,9;2;1;1
258112862999;258112863147;148;0,1,3,4,5;5;2,9;2;1;1
258112863147;258112863249;102;0,1,3,4,5;5;2,9;2;1;1
258112863249;258112869008;5759;1,3,4,5;4;2,9;2;1;1
258112869008;258112872246;3238;1,3,4,5;4;2,9;2;1;1
258112872246;258112872705;459;0,1,3,4,5;5;2,9;2;1;1
258112872705;258112872899;194;1,3,4,5;4;2,9;2;1;1
258112872899;258112872928;29;0,1,3,4,5;5;2,9;2;1;1
258112872928;258112872955;27;0,1,3,4,5;5;2,9;2;1;1
258112872955;258112872970;15;0,1,3,4,5;5;2,9;2;1;1
258112872970;258112873216;246;0,1,3,4,5;5;2,9;2;1;1
258112873216;258112873246;30;0,1,3,4,5;5;2,9;2;1;1
258112873246;258112873279;33;0,1,3,4,5;5;2,9;2;1;1
258112873279;258112873321;42;0,1,3,4,5;5;2,9;2;1;1
258112873321;258112873445;124;1,3,4,5;4;2,9;2;1;1
258112873445;258112873488;43;0,1,3,4,5;5;2,9;2;1;1
258112873488;258112873672;184;0,1,3,4,5;5;2,9;2;1;1
258112873672;258112873842;170;0,1,3,4,5;5;2,9;2;1;1
258112873842;258112882724;8882;1,3,4,5;4;2,9;2;1;1
258112882724;258112882848;124;0,1,3,4,5;5;2,9;2;1;1
258112882848;258112883020;172;0,1,3,4,5;5;2,9;2;1;1
258112883020;258112883225;205;0,1,3,4,5;5;2,9;2;1;1
258112883225;258112883634;409;0,1,3,4,5;5;2,9;2;1;1
258112883634;258112888963;5329;0,1,3,4,5;5;2,9;2;1;1
258112888963;258112898736;9773;0,1,3,5;4;9;1;1;1
258112898736;258112898794;58;0,1,3,5;4;9;1;1;1
258112898794;258112899058;264;0,1,3,5;4;9;1;1;1
258112899058;258112899187;129;0,1,3,5;4;9;1;1;1
258112899187;258112899533;346;0,1,3,5;4;9;1;1;1
258112899533;258112899607;74;0,1,3,5;4;9;1;1;1
258112899607;258112899657;50;0,1,3,5;4;9;1;1;1
258112899657;258112899708;51;0,1,3,5;4;9;1;1;1
258112899708;258112900787;1079;0,1,3,5;4;9;1;1;1
258112900787;258112900975;188;0,1,3,5;4;9;1;1;1
258112900975;258112904303;3328;0,1,3,5;4;9;1;1;1
258112904303;258112904686;383;0,1,3,4,5;5;2,9;2;1;1
258112904686;258112904781;95;0,1,3,4,5;5;2,9;2;1;1
258112904781;258112904937;156;0,1,3,4,5;5;2,9;2;1;1
258112904937;258112905126;189;0,1,3,5;4;9;1;1;1
258112905126;258112906230;1104;0,1,3,5;4;9;1;1;1
258112906230;258112908885;2655;0,1,3,5;4;9;1;1;1
258112908885;258112909009;124;0,1,3,5;4;9;1;1;1
258112909009;258112909224;215;0,1,3,5;4;9;1;1;1
258112909224;258112909477;253;0,1,3,5;4;9;1;1;1
258112909477;258112956509;47032;0,1,3,5;4;9;1;1;1
258112956509;258112966045;9536;0,1,3,5;4;9;1;1;1
258112966045;258112966093;48;0,1,3,5;4;9;1;1;1
258112966093;258112966290;197;0,1,3,5;4;9;1;1;1
258112966290;258112966432;142;0,1,3,5;4;9;1;1;1
258112966432;258112967393;961;0,1,3,5;4;9;1;1;1
258112967393;258112969506;2113;0,1,3,5;4;9;1;1;1
258112969506;258112969687;181;0,1,3,5;4;9;1;1;1
258112969687;258112969770;83;0,1,3,5;4;9;1;1;1
258112969770;258112969820;50;0,1,3,5;4;9;1;1;1
258112969820;258112969876;56;0,1,3,5;4;9;1;1;1
258112969876;258112970808;932;0,1,3,5;4;9;1;1;1
258112970808;258112972619;1811;0,1,3,5;4;9;1;1;1
258112972619;258112975364;2745;0,1,3,4,5;5;2,9;2;1;1
258112975364;258112976463;1099;0,1,3,4,5;5;2,9;2;1;1
258112976463;258112978525;2062;0,1,3,4,5;5;2,9;2;1;1
258112978525;258112981480;2955;0,1,3,4,5;5;2,9;2;1;1
258112981480;258112990813;9333;0,1,3,4,5;5;2,9;2;1;1
258112990813;258112992500;1687;0,1,3,4,5;5;2,9;2;1;1
258112992500;258112993702;1202;0,1,3,4,5;5;2,9;2;1;1
258112993702;258112995416;1714;0,1,3,4,5;5;2,9;2;1;1
258112995416;258112995816;400;0,1,3,4,5;5;2,9;2;1;1
258112995816;258112997215;1399;0,1,3,4,5;5;2,9;2;1;1
258112997215;258112997347;132;0,1,3,4,5;5;2,9;2;1;1
258112997347;258112997455;108;0,1,3,4,5;5;2,9;2;1;1
258112997455;258113003879;6424;0,1,3,4,5;5;2,9;2;1;1
258113003879;258113004277;398;0,1,3,4,5;5;2,9;2;1;1
258113004277;258113004619;342;0,1,3,4,5;5;2,9;2;1;1
258113004619;258113005687;1068;0,1,3,4,5;5;2,9;2;1;1
258113005687;258113005979;292;0,1,3,4,5;5;2,9;2;1;1
258113005979;258113007013;1034;0,1,3,4,5;5;2,9;2;1;1
258113007013;258113007391;378;0,1,3,4,5;5;2,9;2;1;1
258113007391;258113007544;153;0,1,3,4,5;5;2,9;2;1;1
258113007544;258113007576;32;0,1,3,4,5;5;2,9;2;1;1
258113007576;258113007595;19;0,1,3,4,5;5;2,9;2;1;1
258113007595;258113007745;150;0,1,3,4,5;5;2,9;2;1;1
258113007745;258113007911;166;0,1,3,4,5;5;2,9;2;1;1
258113007911;258113008096;185;0,1,3,4,5;5;2,9;2;1;1
258113008096;258113008352;256;0,1,3,4,5;5;2,9;2;1;1
258113008352;258113008500;148;0,1,3,4,5;5;2,9;2;1;1
258113008500;258113008602;102;0,1,3,4,5;5;2,9;2;1;1
258113008602;258113010637;2035;0,1,3,4,5;5;2,9;2;1;1
258113010637;258113011005;368;0,1,3,4,5;5;2,9;2;1;1
258113011005;258113011118;113;0,1,3,4,5;5;2,9;2;1;1
258113011118;258113012055;937;1,3,4,5;4;2,9;2;1;1
258113012055;258113012119;64;1,3,4,5;4;2,9;2;1;1
258113012119;258113014026;1907;1,3,4,5;4;2,9;2;1;1
258113014026;258113015529;1503;1,3,4,5;4;2,9;2;1;1
258113015529;258113016397;868;1,3,4,5;4;2,9;2;1;1
258113016397;258113016481;84;1,3,4,5;4;2,9;2;1;1
258113016481;258113017460;979;1,3,4,5;4;2,9;2;1;1
258113017460;258113018122;662;1,3,4,5;4;2,9;2;1;1
258113018122;258113018834;712;1,3,4,5;4;2,9;2;1;1
258113018834;258113019492;658;1,3,4,5;4;2,9;2;1;1
258113019492;258113022680;3188;1,3,4,5;4;2,9;2;1;1
258113022680;258113022766;86;1,3,4,5;4;2,9;2;1;1
258113022766;258113023216;450;1,3,4,5;4;2,9;2;1;1
258113023216;258113023356;140;1,3,4,5;4;2,9;2;1;1
258113023356;258113025066;1710;1,3,5;3;9;1;1;1
258113025066;258113036849;11783;1,3,5;3;9;1;1;1
258113036849;258113057956;21107;1,3,5;3;9;1;1;1
258113057956;258113060001;2045;0,1,3,5;4;9;1;1;1
258113060001;258113060051;50;0,1,3,5;4;9;1;1;1
258113060051;258113060078;27;0,1,3,5;4;9;1;1;1
258113060078;258113060132;54;0,1,3,5;4;9;1;1;1
258113060132;258113060183;51;0,1,3,5;4;9;1;1;1
258113060183;258113060191;8;0,1,3,5;4;9;1;1;1
258113060191;258113060244;53;0,1,3,5;4;9;1;1;1
258113060244;258113060294;50;0,1,3,5;4;9;1;1;1
258113060294;258113062137;1843;0,1,3,5;4;9;1;1;1
258113062137;258113063185;1048;0,1,3,5;4;9;1;1;1
258113063185;258113075332;12147;0,1,3,5;4;9;1;1;1
258113075332;258113080817;5485;0,1,3,5;4;9;1;1;1
258113080817;258113090965;10148;0,1,3,4,5;5;2,9;2;1;1
258113090965;258113092206;1241;0,1,3,4,5;5;2,9;2;1;1
258113092206;258113092270;64;0,1,3,4,5;5;2,9;2;1;1
258113092270;258113092605;335;0,1,3,4,5;5;2,9;2;1;1
258113092605;258113092630;25;0,1,3,4,5;5;2,9;2;1;1
258113092630;258113092663;33;0,1,3,4,5;5;2,9;2;1;1
258113092663;258113092679;16;0,1,3,4,5;5;2,9;2;1;1
258113092679;258113092693;14;0,1,3,4,5;5;2,9;2;1;1
258113092693;258113092841;148;0,1,3,4,5;5;2,9;2;1;1
258113092841;258113092882;41;0,1,3,4,5;5;2,9;2;1;1
258113092882;258113092888;6;0,1,3,4,5;5;2,9;2;1;1
258113092888;258113092916;28;0,1,3,4,5;5;2,9;2;1;1
258113092916;258113092957;41;0,1,3,4,5;5;2,9;2;1;1
258113092957;258113093011;54;0,1,3,4,5;5;2,9;2;1;1
258113093011;258113093022;11;0,1,3,4,5;5;2,9;2;1;1
258113093022;258113093047;25;0,1,3,4,5;5;2,9;2;1;1
258113093047;258113093173;126;0,1,3,4,5;5;2,9;2;1;1
258113093173;258113093248;75;0,1,3,4,5;5;2,9;2;1;1
258113093248;258113093508;260;0,1,3,4,5;5;2,9;2;1;1
258113093508;258113098557;5049;0,1,3,4,5;5;2,9;2;1;1
258113098557;258113098629;72;0,1,3,4,5;5;2,9;2;1;1
258113098629;258113099474;845;0,1,3,4,5;5;2,9;2;1;1
258113099474;258113099542;68;0,1,3,4,5;5;2,9;2;1;1
258113099542;258113099651;109;0,1,3,4,5;5;2,9;2;1;1
258113099651;258113099827;176;0,1,3,4,5;5;2,9;2;1;1
258113099827;258113099881;54;0,1,3,4,5;5;2,9;2;1;1
258113099881;258113099921;40;0,1,3,4,5;5;2,9;2;1;1
258113099921;258113099992;71;0,1,3,4,5;5;2,9;2;1;1
258113099992;258113100042;50;0,1,3,4,5;5;2,9;2;1;1
258113100042;258113101063;1021;0,1,3,4,5;5;2,9;2;1;1
258113101063;258113101278;215;0,1,3,4,5;5;2,9;2;1;1
258113101278;258113102247;969;0,1,3,4,5;5;2,9;2;1;1
258113102247;258113102585;338;0,1,3,4,5;5;2,9;2;1;1
258113102585;258113103053;468;0,1,3,4,5;5;2,9;2;1;1
258113103053;258113103105;52;0,1,3,4,5;5;2,9;2;1;1
258113103105;258113104655;1550;0,1,3,4,5;5;2,9;2;1;1
258113104655;258113105000;345;0,1,3,4,5;5;2,9;2;1;1
258113105000;258113105147;147;0,1,3,4,5;5;2,9;2;1;1
258113105147;258113111340;6193;0,1,3,4,5;5;2,9;2;1;1
258113111340;258113111635;295;0,1,3,5;4;9;1;1;1
258113111635;258113111684;49;0,1,3,5;4;9;1;1;1
258113111684;258113111736;52;0,1,3,5;4;9;1;1;1
258113111736;258113111770;34;0,1,3,5;4;9;1;1;1
258113111770;258113111792;22;0,1,3,5;4;9;1;1;1
258113111792;258113112844;1052;0,1,3,5;4;9;1;1;1
258113112844;258113112906;62;0,1,3,5;4;9;1;1;1
258113112906;258113115231;2325;0,1,3,5;4;9;1;1;1
258113115231;258113115239;8;0,1,3,5;4;9;1;1;1
258113115239;258113115752;513;0,1,3,5;4;9;1;1;1
258113115752;258113115776;24;0,1,3,5;4;9;1;1;1
258113115776;258113115896;120;0,1,3,5;4;9;1;1;1
258113115896;258113116226;330;0,1,3,5;4;9;1;1;1
258113116226;258113116362;136;0,1,3,5;4;9;1;1;1
258113116362;258113116418;56;0,1,3,5;4;9;1;1;1
258113116418;258113117603;1185;0,1,3,5;4;9;1;1;1
258113117603;258113117676;73;0,1,3,5;4;9;1;1;1
258113117676;258113118128;452;0,1,3,5;4;9;1;1;1
258113118128;258113118285;157;0,1,3,5;4;9;1;1;1
258113118285;258113118358;73;0,1,3,5;4;9;1;1;1
258113118358;258113118451;93;0,1,3,5;4;9;1;1;1
258113118451;258113118609;158;0,1,3,5;4;9;1;1;1
258113118609;258113118688;79;0,1,3,5;4;9;1;1;1
258113118688;258113119039;351;0,1,3,5;4;9;1;1;1
258113119039;258113122590;3551;0,1,3,5;4;9;1;1;1
258113122590;258113122933;343;0,1,3,5;4;9;1;1;1
258113122933;258113122982;49;0,1,3,5;4;9;1;1;1
258113122982;258113123033;51;0,1,3,5;4;9;1;1;1
258113123033;258113123041;8;0,1,3,5;4;9;1;1;1
258113123041;258113123047;6;0,1,3,5;4;9;1;1;1
258113123047;258113123106;59;0,1,3,5;4;9;1;1;1
258113123106;258113123174;68;0,1,3,5;4;9;1;1;1
258113123174;258113123343;169;0,1,3,5;4;9;1;1;1
258113123343;258113123490;147;0,1,3,5;4;9;1;1;1
258113123490;258113123653;163;0,1,3,5;4;9;1;1;1
258113123653;258113123682;29;0,1,3,5;4;9;1;1;1
258113123682;258113125526;1844;0,1,3,5;4;9;1;1;1
258113125526;258113125585;59;0,1,3,5;4;9;1;1;1
258113125585;258113125659;74;0,1,3,5;4;9;1;1;1
258113125659;258113126034;375;0,1,3,5;4;9;1;1;1
258113126034;258113126378;344;0,1,3,4,5;5;2,9;2;1;1
258113126378;258113126662;284;0,1,3,4,5;5;2,9;2;1;1
258113126662;258113127080;418;0,1,3,5;4;9;1;1;1
258113127080;258113127236;156;0,1,3,5;4;9;1;1;1
258113127236;258113127256;20;0,1,3,5;4;9;1;1;1
258113127256;258113127435;179;0,1,3,5;4;9;1;1;1
258113127435;258113128527;1092;0,1,3,5;4;9;1;1;1
258113128527;258113129486;959;0,1,3,5;4;9;1;1;1
258113129486;258113130756;1270;0,1,3,5;4;9;1;1;1
258113130756;258113131262;506;0,1,3,5;4;9;1;1;1
258113131262;258113131295;33;0,1,3,5;4;9;1;1;1
258113131295;258113131554;259;0,1,3,5;4;9;1;1;1
258113131554;258113131692;138;0,1,3,5;4;9;1;1;1
258113131692;258113131763;71;0,1,3,5;4;9;1;1;1
258113131763;258113132532;769;0,1,3,5;4;9;1;1;1
258113132532;258113132779;247;0,1,3,5;4;9;1;1;1
258113132779;258113135621;2842;0,1,3,5;4;9;1;1;1
258113135621;258113136962;1341;0,1,3,5;4;9;1;1;1
258113136962;258113137287;325;0,1,3,5;4;9;1;1;1
258113137287;258113139888;2601;0,1,3,5;4;9;1;1;1
258113139888;258113144705;4817;0,1,3,5;4;9;1;1;1
258113144705;258113144991;286;0,1,3,5;4;9;1;1;1
258113144991;258113147407;2416;0,1,3,5;4;9;1;1;1
258113147407;258113148069;662;0,1,3,5;4;9;1;1;1
258113148069;258113148381;312;0,1,3,5;4;9;1;1;1
258113148381;258113148398;17;0,1,3,5;4;9;1;1;1
258113148398;258113148476;78;0,1,3,5;4;9;1;1;1
258113148476;258113148547;71;0,1,3,5;4;9;1;1;1
258113148547;258113148600;53;0,1,3,5;4;9;1;1;1
258113148600;258113156007;7407;0,1,3,5;4;9;1;1;1
258113156007;258113156062;55;0,1,3,5;4;9;1;1;1
258113156062;258113156171;109;0,1,3,5;4;9;1;1;1
258113156171;258113156376;205;0,1,3,5;4;9;1;1;1
258113156376;258113156387;11;0,1,3,5;4;9;1;1;1
258113156387;258113159489;3102;0,1,3,5;4;9;1;1;1
258113159489;258113159585;96;0,1,3,5;4;9;1;1;1
258113159585;258113159624;39;0,1,3,5;4;9;1;1;1
258113159624;258113159696;72;0,1,3,5;4;9;1;1;1
258113159696;258113159804;108;0,1,3,5;4;9;1;1;1
258113159804;258113159909;105;0,1,3,5;4;9;1;1;1
258113159909;258113160021;112;0,1,3,5;4;9;1;1;1
258113160021;258113160118;97;0,1,3,5;4;9;1;1;1
258113160118;258113161825;1707;0,1,3,5;4;9;1;1;1
258113161825;258113162020;195;0,1,3,5;4;9;1;1;1
258113162020;258113162814;794;0,1,3,5;4;9;1;1;1
258113162814;258113164574;1760;0,1,3,5;4;9;1;1;1
258113164574;258113164875;301;0,1,3,5;4;9;1;1;1
258113164875;258113164894;19;0,1,3,5;4;9;1;1;1
258113164894;258113164924;30;0,1,3,5;4;9;1;1;1
258113164924;258113165086;162;0,1,3,5;4;9;1;1;1
258113165086;258113166613;1527;0,1,3,5;4;9;1;1;1
258113166613;258113166682;69;0,1,3,5;4;9;1;1;1
258113166682;258113166709;27;0,1,3,5;4;9;1;1;1
258113166709;258113166961;252;0,1,3,5;4;9;1;1;1
258113166961;258113167057;96;0,1,3,5;4;9;1;1;1
258113167057;258113167381;324;0,1,3,5;4;9;1;1;1
258113167381;258113168756;1375;0,1,3,5;4;9;1;1;1
258113168756;258113168953;197;0,1,3,5;4;9;1;1;1
258113168953;258113169012;59;0,1,3,5;4;9;1;1;1
258113169012;258113169126;114;0,1,3,5;4;9;1;1;1
258113169126;258113169157;31;0,1,3,5;4;9;1;1;1
258113169157;258113172444;3287;0,1,3,5;4;9;1;1;1
258113172444;258113172648;204;0,1,3,5;4;9;1;1;1
258113172648;258113173126;478;0,1,3,5;4;9;1;1;1
258113173126;258113173298;172;0,1,3,5;4;9;1;1;1
258113173298;258113173490;192;0,1,3,5;4;9;1;1;1
258113173490;258113175610;2120;0,1,3,5;4;9;1;1;1
258113175610;258113177033;1423;0,1,3,5;4;9;1;1;1
258113177033;258113177233;200;0,1,3,5;4;9;1;1;1
258113177233;258113177458;225;0,1,3,5;4;9;1;1;1
258113177458;258113178271;813;0,1,3,5;4;9;1;1;1
258113178271;258113178484;213;0,1,3,5;4;9;1;1;1
258113178484;258113178734;250;0,1,3,5;4;9;1;1;1
258113178734;258113178868;134;0,1,3,5;4;9;1;1;1
258113178868;258113178904;36;0,1,3,5;4;9;1;1;1
258113178904;258113178943;39;0,1,3,5;4;9;1;1;1
258113178943;258113179095;152;0,1,3,5;4;9;1;1;1
258113179095;258113182867;3772;0,1,3,5;4;9;1;1;1
258113182867;258113184800;1933;0,1,3,5;4;9;1;1;1
258113184800;258113184844;44;0,1,3,5;4;9;1;1;1
258113184844;258113184873;29;0,1,3,5;4;9;1;1;1
258113184873;258113184888;15;0,1,3,5;4;9;1;1;1
258113184888;258113186172;1284;0,1,3,5;4;9;1;1;1
258113186172;258113189868;3696;0,1,3,5;4;9;1;1;1
258113189868;258113190831;963;0,1,3,5;4;9;1;1;1
258113190831;258113191116;285;0,1,3,5;4;9;1;1;1
258113191116;258113193007;1891;0,1,3,5;4;9;1;1;1
258113193007;258113193078;71;0,1,3,5;4;9;1;1;1
258113193078;258113193179;101;0,1,3,5;4;9;1;1;1
258113193179;258113194162;983;0,1,3,5;4;9;1;1;1
258113194162;258113194513;351;0,1,3,5;4;9;1;1;1
258113194513;258113195567;1054;0,1,3,5;4;9;1;1;1
258113195567;258113195709;142;0,1,3,5;4;9;1;1;1
258113195709;258113195778;69;0,1,3,5;4;9;1;1;1
258113195778;258113198151;2373;0,1,3,5;4;9;1;1;1
258113198151;258113198311;160;0,1,3,5;4;9;1;1;1
258113198311;258113198512;201;0,1,3,5;4;9;1;1;1
258113198512;258113199867;1355;0,1,3,5;4;9;1;1;1
258113199867;258113200032;165;0,1,3,5;4;9;1;1;1
258113200032;258113201530;1498;0,1,3,5;4;9;1;1;1
258113201530;258113202164;634;0,1,3,4,5;5;2,9;2;1;1
258113202164;258113202220;56;0,1,3,5;4;9;1;1;1
258113202220;258113202719;499;0,1,3,5;4;9;1;1;1
258113202719;258113205085;2366;0,1,3,5;4;9;1;1;1
258113205085;258113205134;49;0,1,3,5;4;9;1;1;1
258113205134;258113205319;185;0,1,3,5;4;9;1;1;1
258113205319;258113205431;112;0,1,3,5;4;9;1;1;1
258113205431;258113205482;51;0,1,3,5;4;9;1;1;1
258113205482;258113205792;310;0,1,3,5;4;9;1;1;1
258113205792;258113205871;79;0,1,3,5;4;9;1;1;1
258113205871;258113205914;43;0,1,3,5;4;9;1;1;1
258113205914;258113206898;984;0,1,3,5;4;9;1;1;1
258113206898;258113207039;141;0,1,3,5;4;9;1;1;1
258113207039;258113207448;409;0,1,3,5;4;9;1;1;1
258113207448;258113208670;1222;0,1,3,5;4;9;1;1;1
258113208670;258113209550;880;0,1,3,5;4;9;1;1;1
258113209550;258113209606;56;0,1,3,5;4;9;1;1;1
258113209606;258113209659;53;0,1,3,5;4;9;1;1;1
258113209659;258113209767;108;0,1,3,5;4;9;1;1;1
258113209767;258113209815;48;0,1,3,5;4;9;1;1;1
258113209815;258113210400;585;0,1,3,5;4;9;1;1;1
258113210400;258113210934;534;0,1,3,5;4;9;1;1;1
258113210934;258113210983;49;0,1,3,5;4;9;1;1;1
258113210983;258113211063;80;0,1,3,5;4;9;1;1;1
258113211063;258113211071;8;0,1,3,5;4;9;1;1;1
258113211071;258113211191;120;0,1,3,5;4;9;1;1;1
258113211191;258113211206;15;0,1,3,5;4;9;1;1;1
258113211206;258113216214;5008;0,1,3,5;4;9;1;1;1
258113216214;258113217709;1495;0,1,3,5;4;9;1;1;1
258113217709;258113221867;4158;0,1,3,5;4;9;1;1;1
258113221867;258113222170;303;0,1,3,5;4;9;1;1;1
258113222170;258113222340;170;0,1,3,5;4;9;1;1;1
258113222340;258113222436;96;0,1,3,5;4;9;1;1;1
258113222436;258113222494;58;0,1,3,5;4;9;1;1;1
258113222494;258113222546;52;0,1,3,5;4;9;1;1;1
258113222546;258113222602;56;0,1,3,5;4;9;1;1;1
258113222602;258113222608;6;0,1,3,5;4;9;1;1;1
258113222608;258113223264;656;0,1,3,5;4;9;1;1;1
258113223264;258113223309;45;0,1,3,5;4;9;1;1;1
258113223309;258113224497;1188;0,1,3,5;4;9;1;1;1
258113224497;258113224756;259;0,1,3,5;4;9;1;1;1
258113224756;258113224887;131;0,1,3,5;4;9;1;1;1
258113224887;258113225071;184;0,1,3,5;4;9;1;1;1
258113225071;258113227353;2282;0,1,3,5;4;9;1;1;1
258113227353;258113227381;28;0,1,3,5;4;9;1;1;1
258113227381;258113227785;404;0,1,3,5;4;9;1;1;1
258113227785;258113227991;206;0,1,3,5;4;9;1;1;1
258113227991;258113228222;231;0,1,3,5;4;9;1;1;1
258113228222;258113228474;252;0,1,3,5;4;9;1;1;1
258113228474;258113228874;400;0,1,3,5;4;9;1;1;1
258113228874;258113229102;228;0,1,3,5;4;9;1;1;1
258113229102;258113229228;126;0,1,3,5;4;9;1;1;1
258113229228;258113229419;191;0,1,3,5;4;9;1;1;1
258113229419;258113230995;1576;0,1,3,5;4;9;1;1;1
258113230995;258113231931;936;0,1,3,5;4;9;1;1;1
258113231931;258113232082;151;0,1,3,5;4;9;1;1;1
258113232082;258113232223;141;0,1,3,5;4;9;1;1;1
258113232223;258113234152;1929;0,1,3,5;4;9;1;1;1
258113234152;258113234947;795;0,1,3,5;4;9;1;1;1
258113234947;258113235386;439;0,1,3,5;4;9;1;1;1
258113235386;258113236983;1597;0,1,3,5;4;9;1;1;1
258113236983;258113238866;1883;0,1,3,5;4;9;1;1;1
258113238866;258113239716;850;0,1,3,5;4;9;1;1;1
258113239716;258113241144;1428;0,1,3,5;4;9;1;1;1
258113241144;258113243966;2822;0,1,3,5;4;9;1;1;1
258113243966;258113245712;1746;0,1,3,5;4;9;1;1;1
258113245712;258113245890;178;0,1,3,5;4;9;1;1;1
258113245890;258113245918;28;0,1,3,5;4;9;1;1;1
258113245918;258113248935;3017;0,1,3,5;4;9;1;1;1
258113248935;258113251788;2853;0,1,3,5;4;9;1;1;1
258113251788;258113252430;642;0,1,3,4,5;5;2,9;2;1;1
258113252430;258113252625;195;0,1,3,5;4;9;1;1;1
258113252625;258113252647;22;0,1,3,5;4;9;1;1;1
258113252647;258113252697;50;0,1,3,5;4;9;1;1;1
258113252697;258113259487;6790;0,1,3,5;4;9;1;1;1
258113259487;258113259514;27;0,1,3,5;4;9;1;1;1
258113259514;258113260538;1024;0,1,3,5;4;9;1;1;1
258113260538;258113261144;606;0,1,3,5;4;9;1;1;1
258113261144;258113261324;180;0,1,3,5;4;9;1;1;1
258113261324;258113261614;290;0,1,3,5;4;9;1;1;1
258113261614;258113261683;69;0,1,3,5;4;9;1;1;1
258113261683;258113263853;2170;0,1,3,5;4;9;1;1;1
258113263853;258113264042;189;0,1,3,5;4;9;1;1;1
258113264042;258113264052;10;0,1,3,5;4;9;1;1;1
258113264052;258113264092;40;0,1,3,5;4;9;1;1;1
258113264092;258113264353;261;0,1,3,5;4;9;1;1;1
258113264353;258113264467;114;0,1,3,5;4;9;1;1;1
258113264467;258113264800;333;0,1,3,5;4;9;1;1;1
258113264800;258113264873;73;0,1,3,5;4;9;1;1;1
258113264873;258113264965;92;0,1,3,5;4;9;1;1;1
258113264965;258113265173;208;0,1,3,5;4;9;1;1;1
258113265173;258113265302;129;0,1,3,5;4;9;1;1;1
258113265302;258113265377;75;0,1,3,5;4;9;1;1;1
258113265377;258113265545;168;0,1,3,5;4;9;1;1;1
258113265545;258113269210;3665;0,1,3,5;4;9;1;1;1
258113269210;258113271616;2406;0,1,3,5;4;9;1;1;1
258113271616;258113271679;63;0,1,3,5;4;9;1;1;1
258113271679;258113271947;268;0,1,3,5;4;9;1;1;1
258113271947;258113273600;1653;0,1,3,5;4;9;1;1;1
258113273600;258113274355;755;0,1,3,5;4;9;1;1;1
258113274355;258113275078;723;0,1,3,5;4;9;1;1;1
258113275078;258113275879;801;0,1,3,5;4;9;1;1;1
258113275879;258113276045;166;0,1,3,5;4;9;1;1;1
258113276045;258113276220;175;0,1,3,5;4;9;1;1;1
258113276220;258113276362;142;0,1,3,5;4;9;1;1;1
258113276362;258113276485;123;0,1,3,5;4;9;1;1;1
258113276485;258113276486;1;0,1,3,5;4;9;1;1;1
258113276486;258113276540;54;0,1,3,5;4;9;1;1;1
258113276540;258113276597;57;0,1,3,5;4;9;1;1;1
258113276597;258113276697;100;0,1,3,5;4;9;1;1;1
258113276697;258113276733;36;0,1,3,5;4;9;1;1;1
258113276733;258113277856;1123;0,1,3,5;4;9;1;1;1
258113277856;258113277947;91;0,1,3,5;4;9;1;1;1
258113277947;258113278124;177;0,1,3,5;4;9;1;1;1
258113278124;258113278746;622;0,1,3,5;4;9;1;1;1
258113278746;258113279184;438;0,1,3,5;4;9;1;1;1
258113279184;258113282862;3678;0,1,3,5;4;9;1;1;1
258113282862;258113283415;553;0,1,3,5;4;9;1;1;1
258113283415;258113285652;2237;0,1,3,5;4;9;1;1;1
258113285652;258113290776;5124;0,1,3,5;4;9;1;1;1
258113290776;258113290817;41;0,1,3,5;4;9;1;1;1
258113290817;258113290842;25;0,1,3,5;4;9;1;1;1
258113290842;258113290885;43;0,1,3,5;4;9;1;1;1
258113290885;258113290909;24;0,1,3,5;4;9;1;1;1
258113290909;258113291300;391;0,1,3,5;4;9;1;1;1
258113291300;258113291656;356;0,1,3,5;4;9;1;1;1
258113291656;258113291973;317;0,1,3,5;4;9;1;1;1
258113291973;258113293691;1718;0,1,3,5;4;9;1;1;1
258113293691;258113293935;244;0,1,3,5;4;9;1;1;1
258113293935;258113293995;60;0,1,3,5;4;9;1;1;1
258113293995;258113295616;1621;0,1,3,5;4;9;1;1;1
258113295616;258113299437;3821;0,1,3,5;4;9;1;1;1
258113299437;258113299792;355;0,1,3,5;4;9;1;1;1
258113299792;258113300172;380;0,1,3,5;4;9;1;1;1
258113300172;258113300532;360;0,1,3,5;4;9;1;1;1
258113300532;258113301346;814;0,1,3,5;4;9;1;1;1
258113301346;258113301868;522;0,1,3,5;4;9;1;1;1
258113301868;258113301993;125;0,1,3,5;4;9;1;1;1
258113301993;258113302024;31;0,1,3,5;4;9;1;1;1
258113302024;258113302226;202;0,1,3,5;4;9;1;1;1
258113302226;258113302266;40;0,1,3,5;4;9;1;1;1
258113302266;258113302294;28;0,1,3,5;4;9;1;1;1
258113302294;258113302480;186;0,1,3,5;4;9;1;1;1
258113302480;258113302546;66;0,1,3,5;4;9;1;1;1
258113302546;258113302674;128;0,1,3,5;4;9;1;1;1
258113302674;258113302965;291;0,1,3,5;4;9;1;1;1
258113302965;258113303152;187;0,1,3,5;4;9;1;1;1
258113303152;258113305554;2402;0,1,3,5;4;9;1;1;1
258113305554;258113305761;207;0,1,3,5;4;9;1;1;1
258113305761;258113305848;87;0,1,3,5;4;9;1;1;1
258113305848;258113305964;116;0,1,3,5;4;9;1;1;1
258113305964;258113306820;856;0,1,3,5;4;9;1;1;1
258113306820;258113306960;140;0,1,3,5;4;9;1;1;1
258113306960;258113307060;100;0,1,3,5;4;9;1;1;1
258113307060;258113307096;36;0,1,3,5;4;9;1;1;1
258113307096;258113307501;405;0,1,3,5;4;9;1;1;1
258113307501;258113311604;4103;0,1,3,5;4;9;1;1;1
258113311604;258113311919;315;0,1,3,5;4;9;1;1;1
258113311919;258113313442;1523;0,1,3,5;4;9;1;1;1
258113313442;258113314296;854;0,1,3,5;4;9;1;1;1
258113314296;258113314429;133;0,1,3,5;4;9;1;1;1
258113314429;258113314879;450;0,1,3,5;4;9;1;1;1
258113314879;258113316393;1514;0,1,3,5;4;9;1;1;1
258113316393;258113322580;6187;0,1,3,5;4;9;1;1;1
258113322580;258113323551;971;0,1,3,5;4;9;1;1;1
258113323551;258113327562;4011;0,1,3,5;4;9;1;1;1
258113327562;258113331728;4166;0,1,3,5;4;9;1;1;1
258113331728;258113332367;639;0,1,3,4,5;5;2,9;2;1;1
258113332367;258113339129;6762;0,1,3,5;4;9;1;1;1
258113339129;258113339135;6;0,1,3,5;4;9;1;1;1
258113339135;258113341879;2744;0,1,3,5;4;9;1;1;1
258113341879;258113342024;145;0,1,3,5;4;9;1;1;1
258113342024;258113343334;1310;0,1,3,5;4;9;1;1;1
258113343334;258113343515;181;0,1,3,5;4;9;1;1;1
258113343515;258113343892;377;0,1,3,5;4;9;1;1;1
258113343892;258113344098;206;0,1,3,5;4;9;1;1;1
258113344098;258113344290;192;0,1,3,5;4;9;1;1;1
258113344290;258113344424;134;0,1,3,5;4;9;1;1;1
258113344424;258113344558;134;0,1,3,5;4;9;1;1;1
258113344558;258113344677;119;0,1,3,5;4;9;1;1;1
258113344677;258113354833;10156;0,1,3,5;4;9;1;1;1
258113354833;258113362546;7713;0,1,3,5;4;9;1;1;1
258113362546;258113362621;75;0,1,3,5;4;9;1;1;1
258113362621;258113362778;157;0,1,3,5;4;9;1;1;1
258113362778;258113362818;40;0,1,3,5;4;9;1;1;1
258113362818;258113362896;78;0,1,3,5;4;9;1;1;1
258113362896;258113363035;139;0,1,3,5;4;9;1;1;1
258113363035;258113365668;2633;0,1,3,5;4;9;1;1;1
258113365668;258113365731;63;0,1,3,5;4;9;1;1;1
258113365731;258113366127;396;0,1,3,4,5;5;2,9;2;1;1
258113366127;258113366182;55;0,1,3,4,5;5;2,9;2;1;1
258113366182;258113366372;190;0,1,3,4,5;5;2,9;2;1;1
258113366372;258113366399;27;0,1,3,5;4;9;1;1;1
258113366399;258113366495;96;0,1,3,5;4;9;1;1;1
258113366495;258113366674;179;0,1,3,5;4;9;1;1;1
258113366674;258113368797;2123;0,1,3,5;4;9;1;1;1
258113368797;258113368845;48;0,1,3,5;4;9;1;1;1
258113368845;258113368906;61;0,1,3,5;4;9;1;1;1
258113368906;258113372872;3966;0,1,3,5;4;9;1;1;1
258113372872;258113373945;1073;0,1,3,5;4;9;1;1;1
258113373945;258113374099;154;0,1,3,5;4;9;1;1;1
258113374099;258113374275;176;0,1,3,5;4;9;1;1;1
258113374275;258113375656;1381;0,1,3,5;4;9;1;1;1
258113375656;258113375693;37;0,1,3,5;4;9;1;1;1
258113375693;258113375769;76;0,1,3,5;4;9;1;1;1
258113375769;258113382782;7013;0,1,3,5;4;9;1;1;1
258113382782;258113385711;2929;0,1,3,5;4;9;1;1;1
258113385711;258113385779;68;0,1,3,5;4;9;1;1;1
258113385779;258113385880;101;0,1,3,5;4;9;1;1;1
258113385880;258113388434;2554;0,1,3,5;4;9;1;1;1
258113388434;258113388593;159;0,1,3,5;4;9;1;1;1
258113388593;258113388619;26;0,1,3,5;4;9;1;1;1
258113388619;258113390560;1941;0,1,3,5;4;9;1;1;1
258113390560;258113398259;7699;0,1,3,5;4;9;1;1;1
258113398259;258113399608;1349;0,1,3,5;4;9;1;1;1
258113399608;258113399988;380;0,1,3,5;4;9;1;1;1
258113399988;258113400122;134;0,1,3,5;4;9;1;1;1
258113400122;258113400218;96;0,1,3,5;4;9;1;1;1
258113400218;258113400448;230;0,1,3,5;4;9;1;1;1
258113400448;258113400518;70;0,1,3,5;4;9;1;1;1
258113400518;258113400555;37;0,1,3,5;4;9;1;1;1
258113400555;258113400628;73;0,1,3,5;4;9;1;1;1
258113400628;258113408192;7564;0,1,3,5;4;9;1;1;1
258113408192;258113409056;864;0,1,3,5;4;9;1;1;1
258113409056;258113409139;83;0,1,3,5;4;9;1;1;1
258113409139;258113409330;191;0,1,3,5;4;9;1;1;1
258113409330;258113418912;9582;0,1,3,5;4;9;1;1;1
258113418912;258113419955;1043;0,1,3,5;4;9;1;1;1
258113419955;258113419987;32;0,1,3,5;4;9;1;1;1
258113419987;258113420059;72;0,1,3,5;4;9;1;1;1
258113420059;258113420117;58;0,1,3,5;4;9;1;1;1
258113420117;258113420155;38;0,1,3,5;4;9;1;1;1
258113420155;258113421124;969;0,1,3,5;4;9;1;1;1
258113421124;258113422401;1277;0,1,3,5;4;9;1;1;1
258113422401;258113422598;197;0,1,3,5;4;9;1;1;1
258113422598;258113422692;94;0,1,3,5;4;9;1;1;1
258113422692;258113422902;210;0,1,3,5;4;9;1;1;1
258113422902;258113424827;1925;0,1,3,5;4;9;1;1;1
258113424827;258113424847;20;0,1,3,5;4;9;1;1;1
258113424847;258113424867;20;0,1,3,5;4;9;1;1;1
258113424867;258113425025;158;0,1,3,5;4;9;1;1;1
258113425025;258113425237;212;0,1,3,5;4;9;1;1;1
258113425237;258113425372;135;0,1,3,5;4;9;1;1;1
258113425372;258113425733;361;0,1,3,5;4;9;1;1;1
258113425733;258113425856;123;0,1,3,5;4;9;1;1;1
258113425856;258113425899;43;0,1,3,5;4;9;1;1;1
258113425899;258113425942;43;0,1,3,5;4;9;1;1;1
258113425942;258113426055;113;0,1,3,5;4;9;1;1;1
258113426055;258113426307;252;0,1,3,5;4;9;1;1;1
258113426307;258113428159;1852;0,1,3,5;4;9;1;1;1
258113428159;258113428483;324;0,1,3,5;4;9;1;1;1
258113428483;258113428742;259;0,1,3,5;4;9;1;1;1
258113428742;258113428846;104;0,1,3,5;4;9;1;1;1
258113428846;258113428980;134;0,1,3,5;4;9;1;1;1
258113428980;258113429402;422;0,1,3,5;4;9;1;1;1
258113429402;258113438021;8619;0,1,3,5;4;9;1;1;1
258113438021;258113439009;988;0,1,3,5;4;9;1;1;1
258113439009;258113442381;3372;0,1,3,5;4;9;1;1;1
258113442381;258113470489;28108;0,1,3,5;4;9;1;1;1
258113470489;258113470547;58;0,1,3,5;4;9;1;1;1
258113470547;258113470675;128;0,1,3,5;4;9;1;1;1
258113470675;258113471057;382;0,1,3,5;4;9;1;1;1
258113471057;258113471177;120;0,1,3,5;4;9;1;1;1
258113471177;258113471223;46;0,1,3,5;4;9;1;1;1
258113471223;258113472129;906;1,3,5;3;9;1;1;1
258113472129;258113473057;928;1,3,4,5;4;2,9;2;1;1
258113473057;258113474477;1420;1,3,5;3;9;1;1;1
258113474477;258113480144;5667;1,3,5;3;9;1;1;1
258113480144;258113541220;61076;1,3,5;3;9;1;1;1
258113541220;258113544419;3199;1,3,4,5;4;2,9;2;1;1
258113544419;258113548514;4095;1,3,5;3;9;1;1;1
258113548514;258113549435;921;1,3,5;3;9;1;1;1
258113549435;258113550020;585;1,3,4,5;4;2,9;2;1;1
258113550020;258113550702;682;1,3,4,5;4;2,9;2;1;1
258113550702;258113551276;574;1,3,4,5;4;2,9;2;1;1
258113551276;258113551671;395;1,3,4,5;4;2,9;2;1;1
258113551671;258113551751;80;1,3,4,5;4;2,9;2;1;1
258113551751;258113552384;633;1,3,4,5;4;2,9;2;1;1
258113552384;258113554988;2604;1,3,4,5;4;2,9;2;1;1
258113554988;258113555835;847;1,3,4,5;4;2,9;2;1;1
258113555835;258113557364;1529;1,3,5;3;9;1;1;1
258113557364;258113557602;238;1,3,4,5;4;2,9;2;1;1
258113557602;258113558501;899;1,3,4,5;4;2,9;2;1;1
258113558501;258113559231;730;1,3,5;3;9;1;1;1
258113559231;258113559802;571;1,3,4,5;4;2,9;2;1;1
258113559802;258113559873;71;1,3,4,5;4;2,9;2;1;1
258113559873;258113559993;120;1,3,4,5;4;2,9;2;1;1
258113559993;258113562674;2681;1,3,4,5;4;2,9;2;1;1
258113562674;258113563390;716;1,3,4,5;4;2,9;2;1;1
258113563390;258113564178;788;1,3,4,5;4;2,9;2;1;1
258113564178;258113564664;486;1,3,5;3;9;1;1;1
258113564664;258113565432;768;1,3,4,5;4;2,9;2;1;1
258113565432;258113569601;4169;1,3,5;3;9;1;1;1
258113569601;258113570017;416;1,3,4,5;4;2,9;2;1;1
258113570017;258113571076;1059;1,3,4,5;4;2,9;2;1;1
258113571076;258113571781;705;1,3,4,5;4;2,9;2;1;1
258113571781;258113602109;30328;1,3,5;3;9;1;1;1
258113602109;258113610779;8670;1,3,5;3;9;1;1;1
258113610779;258113619992;9213;1,3,5;3;9;1;1;1
258113619992;258113621933;1941;1,3,4,5;4;2,9;2;1;1
258113621933;258113628457;6524;1,3,4,5;4;2,9;2;1;1
258113628457;258113628633;176;1,3,4,5;4;2,9;2;1;1
258113628633;258113640827;12194;1,3,4,5;4;2,9;2;1;1
258113640827;258113641283;456;1,3,4,5;4;2,9;2;1;1
258113641283;258113643559;2276;1,3,4,5;4;2,9;2;1;1
258113643559;258113647473;3914;1,3,4,5;4;2,9;2;1;1
258113647473;258113649620;2147;1,3,4,5;4;2,9;2;1;1
258113649620;258113651356;1736;1,3,4,5;4;2,9;2;1;1
258113651356;258113651783;427;1,3,4,5;4;2,9;2;1;1
258113651783;258113658811;7028;1,3,4,5;4;2,9;2;1;1
258113658811;258113664018;5207;1,3,4,5;4;2,9;2;1;1
258113664018;258113666523;2505;1,3,4,5;4;2,9;2;1;1
258113666523;258113666743;220;1,3,4,5;4;2,9;2;1;1
258113666743;258113666887;144;1,3,4,5;4;2,9;2;1;1
258113666887;258113667070;183;1,3,4,5;4;2,9;2;1;1
258113667070;258113667274;204;1,3,4,5;4;2,9;2;1;1
258113667274;258113669227;1953;1,3,4,5;4;2,9;2;1;1
258113669227;258113670389;1162;1,3,4,5;4;2,9;2;1;1
258113670389;258113672323;1934;1,3,4,5;4;2,9;2;1;1
258113672323;258113672493;170;1,3,4,5;4;2,9;2;1;1
258113672493;258113702018;29525;1,3,5;3;9;1;1;1
258113702018;258113704954;2936;1,3,5;3;9;1;1;1
258113704954;258113728123;23169;1,3,5;3;9;1;1;1
258113728123;258113739646;11523;1,3,4,5;4;2,9;2;1;1
258113739646;258113743030;3384;1,3,4,5;4;2,9;2;1;1
258113743030;258113756786;13756;1,3,4,5;4;2,9;2;1;1
258113756786;258113792518;35732;1,3,5;3;9;1;1;1
258113792518;258113793524;1006;1,3,4,5;4;2,9;2;1;1
258113793524;258113793976;452;1,3,4,5;4;2,9;2;1;1
258113793976;258113795085;1109;1,3,4,5;4;2,9;2;1;1
258113795085;258113796658;1573;1,3,5;3;9;1;1;1
258113796658;258113797875;1217;1,3,4,5;4;2,9;2;1;1
258113797875;258113797878;3;1,3,5;3;9;1;1;1
258113797878;258113799496;1618;1,3,4,5;4;2,9;2;1;1
258113799496;258113799922;426;1,3,5;3;9;1;1;1
258113799922;258113804755;4833;1,3,4,5;4;2,9;2;1;1
258113804755;258113805524;769;1,3,4,5;4;2,9;2;1;1
258113805524;258113807589;2065;1,3,4,5;4;2,9;2;1;1
258113807589;258113810119;2530;1,3,5;3;9;1;1;1
258113810119;258113812856;2737;1,3,5;3;9;1;1;1
258113812856;258113841523;28667;1,3,5;3;9;1;1;1
258113841523;258113842064;541;1,3,4,5;4;2,9;2;1;1
258113842064;258113846419;4355;1,3,5;3;9;1;1;1
258113846419;258113855105;8686;1,3,5;3;9;1;1;1
258113855105;258113871998;16893;1,3,5;3;9;1;1;1
258113871998;258113873323;1325;1,3,4,5;4;2,9;2;1;1
258113873323;258113876533;3210;1,3,5;3;9;1;1;1
258113876533;258113879096;2563;1,3,4,5;4;2,9;2;1;1
258113879096;258113879280;184;1,3,5;3;9;1;1;1
258113879280;258113881884;2604;1,3,4,5;4;2,9;2;1;1
258113881884;258113882747;863;1,3,4,5;4;2,9;2;1;1
258113882747;258113884205;1458;1,3,4,5;4;2,9;2;1;1
258113884205;258113884290;85;1,3,4,5;4;2,9;2;1;1
258113884290;258113884865;575;1,3,5;3;9;1;1;1
258113884865;258113885365;500;1,3,4,5;4;2,9;2;1;1
258113885365;258113886269;904;1,3,4,5;4;2,9;2;1;1
258113886269;258113886776;507;1,3,5;3;9;1;1;1
258113886776;258113888160;1384;1,3,4,5;4;2,9;2;1;1
258113888160;258113889739;1579;1,3,4,5;4;2,9;2;1;1
258113889739;258113890072;333;1,3,4,5;4;2,9;2;1;1
258113890072;258113891874;1802;1,3,5;3;9;1;1;1
258113891874;258113892401;527;1,3,4,5;4;2,9;2;1;1
258113892401;258113899466;7065;1,3,4,5;4;2,9;2;1;1
258113899466;258113899701;235;1,3,4,5;4;2,9;2;1;1
258113899701;258113901312;1611;1,3,5;3;9;1;1;1
258113901312;258113902714;1402;1,3,4,5;4;2,9;2;1;1
258113902714;258113933746;31032;1,3,5;3;9;1;1;1
258113933746;258113943230;9484;1,3,5;3;9;1;1;1
258113943230;258113944464;1234;1,3,5;3;9;1;1;1
258113944464;258113944540;76;1,3,5;3;9;1;1;1
258113944540;258113946337;1797;1,3,5;3;9;1;1;1
258113946337;258113946392;55;1,3,5;3;9;1;1;1
258113946392;258113946570;178;1,3,5;3;9;1;1;1
258113946570;258113955275;8705;1,3,5;3;9;1;1;1
258113955275;258113955741;466;1,3,4,5;4;2,9;2;1;1
258113955741;258113956446;705;1,3,4,5;4;2,9;2;1;1
258113956446;258113961075;4629;1,3,4,5;4;2,9;2;1;1
258113961075;258113961390;315;1,3,4,5;4;2,9;2;1;1
258113961390;258113962300;910;1,3,4,5;4;2,9;2;1;1
258113962300;258113962356;56;1,3,4,5;4;2,9;2;1;1
258113962356;258113963237;881;1,3,4,5;4;2,9;2;1;1
258113963237;258113964142;905;1,3,4,5;4;2,9;2;1;1
258113964142;258113967901;3759;1,3,4,5;4;2,9;2;1;1
258113967901;258113988976;21075;1,3,4,5;4;2,9;2;1;1
258113988976;258113989329;353;1,3,4,5;4;2,9;2;1;1
258113989329;258113989917;588;1,3,4,5;4;2,9;2;1;1
258113989917;258113994610;4693;1,3,4,5;4;2,9;2;1;1
258113994610;258113998803;4193;1,3,4,5;4;2,9;2;1;1
258113998803;258113999377;574;1,3,4,5;4;2,9;2;1;1
258113999377;258114002157;2780;1,3,4,5;4;2,9;2;1;1
258114002157;258114018014;15857;1,3,5;3;9;1;1;1
258114018014;258114026738;8724;1,3,5;3;9;1;1;1
258114026738;258114059916;33178;1,3,5;3;9;1;1;1
258114059916;258114061744;1828;1,3,4,5;4;2,9;2;1;1
258114061744;258114062611;867;1,3,4,5;4;2,9;2;1;1
258114062611;258114063188;577;1,3,4,5;4;2,9;2;1;1
258114063188;258114065451;2263;1,3,5;3;9;1;1;1
258114065451;258114067114;1663;1,3,4,5;4;2,9;2;1;1
258114067114;258114069052;1938;1,3,5;3;9;1;1;1
258114069052;258114071058;2006;1,3,4,5;4;2,9;2;1;1
258114071058;258114071573;515;1,3,5;3;9;1;1;1
258114071573;258114073995;2422;1,3,4,5;4;2,9;2;1;1
258114073995;258114076421;2426;1,3,4,5;4;2,9;2;1;1
258114076421;258114076528;107;1,3,4,5;4;2,9;2;1;1
258114076528;258114077243;715;1,3,4,5;4;2,9;2;1;1
258114077243;258114078353;1110;1,3,5;3;9;1;1;1
258114078353;258114079302;949;1,3,4,5;4;2,9;2;1;1
258114079302;258114081369;2067;1,3,4,5;4;2,9;2;1;1
258114081369;258114082558;1189;1,3,4,5;4;2,9;2;1;1
258114082558;258114083808;1250;1,3,4,5;4;2,9;2;1;1
258114083808;258114085555;1747;1,3,4,5;4;2,9;2;1;1
258114085555;258114085563;8;1,3,4,5;4;2,9;2;1;1
258114085563;258114086185;622;1,3,4,5;4;2,9;2;1;1
258114086185;258114089857;3672;1,3,4,5;4;2,9;2;1;1
258114089857;258114090657;800;1,3,5;3;9;1;1;1
258114090657;258114093260;2603;1,3,4,5;4;2,9;2;1;1
258114093260;258114093725;465;1,3,5;3;9;1;1;1
258114093725;258114095622;1897;1,3,4,5;4;2,9;2;1;1
258114095622;258114096052;430;1,3,4,5;4;2,9;2;1;1
258114096052;258114096531;479;1,3,4,5;4;2,9;2;1;1
258114096531;258114097589;1058;1,3,4,5;4;2,9;2;1;1
258114097589;258114098072;483;1,3,4,5;4;2,9;2;1;1
258114098072;258114145136;47064;1,3,5;3;9;1;1;1
258114145136;258114148211;3075;1,3,5;3;9;1;1;1
258114148211;258114153219;5008;1,3,4,5;4;2,9;2;1;1
258114153219;258114153855;636;1,3,4,5;4;2,9;2;1;1
258114153855;258114156768;2913;1,3,4,5;4;2,9;2;1;1
258114156768;258114161237;4469;1,3,4,5;4;2,9;2;1;1
258114161237;258114166428;5191;1,3,4,5;4;2,9;2;1;1
258114166428;258114169818;3390;1,3,4,5;4;2,9;2;1;1
258114169818;258114174802;4984;1,3,4,5;4;2,9;2;1;1
258114174802;258114179986;5184;1,3,4,5;4;2,9;2;1;1
258114179986;258114181542;1556;1,3,4,5;4;2,9;2;1;1
258114181542;258114184484;2942;1,3,4,5;4;2,9;2;1;1
258114184484;258114185012;528;1,3,4,5;4;2,9;2;1;1
258114185012;258114187148;2136;1,3,4,5;4;2,9;2;1;1
258114187148;258114187562;414;1,3,4,5;4;2,9;2;1;1
258114187562;258114189767;2205;1,3,4,5;4;2,9;2;1;1
258114189767;258114190932;1165;1,3,4,5;4;2,9;2;1;1
258114190932;258114191436;504;1,3,4,5;4;2,9;2;1;1
258114191436;258114192188;752;1,3,4,5;4;2,9;2;1;1
258114192188;258114193636;1448;1,3,5;3;9;1;1;1
258114193636;258114204521;10885;1,3,5;3;9;1;1;1
258114204521;258114213445;8924;1,3,5;3;9;1;1;1
258114213445;258114237479;24034;1,3,5;3;9;1;1;1
258114237479;258114237785;306;1,3,5;3;9;1;1;1
258114237785;258114238427;642;1,3,4,5;4;2,9;2;1;1
258114238427;258114246355;7928;1,3,5;3;9;1;1;1
258114246355;258114288517;42162;1,3,5;3;9;1;1;1
258114288517;258114289147;630;1,3,4,5;4;2,9;2;1;1
258114289147;258114325230;36083;1,3,5;3;9;1;1;1
258114325230;258114328218;2988;1,3,5;3;9;1;1;1
258114328218;258114361934;33716;1,3,5;3;9;1;1;1
258114361934;258114367947;6013;1,3,4,5;4;2,9;2;1;1
258114367947;258114369357;1410;1,3,4,5;4;2,9;2;1;1
258114369357;258114374502;5145;1,3,4,5;4;2,9;2;1;1
258114374502;258114377367;2865;1,3,4,5;4;2,9;2;1;1
258114377367;258114379834;2467;1,3,4,5;4;2,9;2;1;1
258114379834;258114380493;659;1,3,4,5;4;2,9;2;1;1
258114380493;258114383018;2525;1,3,4,5;4;2,9;2;1;1
258114383018;258114386431;3413;1,3,4,5;4;2,9;2;1;1
258114386431;258114399552;13121;1,3,4,5;4;2,9;2;1;1
258114399552;258114401823;2271;1,3,4,5;4;2,9;2;1;1
258114401823;258114405141;3318;1,3,4,5;4;2,9;2;1;1
258114405141;258114405584;443;1,3,4,5;4;2,9;2;1;1
258114405584;258114406717;1133;1,3,4,5;4;2,9;2;1;1
258114406717;258114407648;931;1,3,4,5;4;2,9;2;1;1
258114407648;258114408723;1075;1,3,4,5;4;2,9;2;1;1
258114408723;258114409645;922;1,3,4,5;4;2,9;2;1;1
258114409645;258114410668;1023;1,3,4,5;4;2,9;2;1;1
258114410668;258114410824;156;1,3,4,5;4;2,9;2;1;1
258114410824;258114411127;303;1,3,4,5;4;2,9;2;1;1
258114411127;258114411820;693;1,3,4,5;4;2,9;2;1;1
258114411820;258114413761;1941;1,3,5;3;9;1;1;1
258114413761;258114454538;40777;1,3,5;3;9;1;1;1
258114454538;258114455169;631;1,3,4,5;4;2,9;2;1;1
258114455169;258114458671;3502;1,3,5;3;9;1;1;1
258114458671;258114467377;8706;1,3,5;3;9;1;1;1
258114467377;258114494321;26944;1,3,5;3;9;1;1;1
258114494321;258114496396;2075;1,3,4,5;4;2,9;2;1;1
258114496396;258114498673;2277;1,3,5;3;9;1;1;1
258114498673;258114501091;2418;1,3,5;3;9;1;1;1
258114501091;258114504146;3055;1,3,4,5;4;2,9;2;1;1
258114504146;258114507435;3289;1,3,5;3;9;1;1;1
258114507435;258114507972;537;1,3,5;3;9;1;1;1
258114507972;258114509072;1100;1,3,4,5;4;2,9;2;1;1
258114509072;258114509509;437;1,3,5;3;9;1;1;1
258114509509;258114510502;993;1,3,4,5;4;2,9;2;1;1
258114510502;258114511421;919;1,3,4,5;4;2,9;2;1;1
258114511421;258114513854;2433;1,3,4,5;4;2,9;2;1;1
258114513854;258114513863;9;1,3,4,5;4;2,9;2;1;1
258114513863;258114514623;760;1,3,4,5;4;2,9;2;1;1
258114514623;258114514630;7;1,3,4,5;4;2,9;2;1;1
258114514630;258114519905;5275;1,3,4,5;4;2,9;2;1;1
258114519905;258114519923;18;1,3,4,5;4;2,9;2;1;1
258114519923;258114521411;1488;1,3,4,5;4;2,9;2;1;1
258114521411;258114523915;2504;1,3,5;3;9;1;1;1
258114523915;258114524564;649;1,3,4,5;4;2,9;2;1;1
258114524564;258114525441;877;1,3,5;3;9;1;1;1
258114525441;258114525981;540;1,3,4,5;4;2,9;2;1;1
258114525981;258114570979;44998;1,3,5;3;9;1;1;1
258114570979;258114573845;2866;1,3,4,5;4;2,9;2;1;1
258114573845;258114581706;7861;1,3,4,5;4;2,9;2;1;1
258114581706;258114581865;159;1,3,4,5;4;2,9;2;1;1
258114581865;258114582282;417;1,3,4,5;4;2,9;2;1;1
258114582282;258114582745;463;1,3,4,5;4;2,9;2;1;1
258114582745;258114590751;8006;1,3,4,5;4;2,9;2;1;1
258114590751;258114594269;3518;1,3,4,5;4;2,9;2;1;1
258114594269;258114596243;1974;1,3,4,5;4;2,9;2;1;1
258114596243;258114597822;1579;1,3,4,5;4;2,9;2;1;1
258114597822;258114600061;2239;1,3,4,5;4;2,9;2;1;1
258114600061;258114600356;295;1,3,4,5;4;2,9;2;1;1
258114600356;258114603898;3542;1,3,4,5;4;2,9;2;1;1
258114603898;258114604890;992;1,3,4,5;4;2,9;2;1;1
258114604890;258114605901;1011;1,3,4,5;4;2,9;2;1;1
258114605901;258114609162;3261;1,3,4,5;4;2,9;2;1;1
258114609162;258114613011;3849;1,3,4,5;4;2,9;2;1;1
258114613011;258114613645;634;1,3,4,5;4;2,9;2;1;1
258114613645;258114613865;220;1,3,4,5;4;2,9;2;1;1
258114613865;258114615944;2079;1,3,4,5;4;2,9;2;1;1
258114615944;258114618107;2163;1,3,4,5;4;2,9;2;1;1
258114618107;258114618716;609;1,3,4,5;4;2,9;2;1;1
258114618716;258114654632;35916;1,3,5;3;9;1;1;1
258114654632;258114663305;8673;1,3,5;3;9;1;1;1
258114663305;258114674766;11461;1,3,5;3;9;1;1;1
258114674766;258114676797;2031;1,3,4,5;4;2,9;2;1;1
258114676797;258114679664;2867;1,3,4,5;4;2,9;2;1;1
258114679664;258114684586;4922;1,3,4,5;4;2,9;2;1;1
258114684586;258114685479;893;1,3,4,5;4;2,9;2;1;1
258114685479;258114693156;7677;1,3,4,5;4;2,9;2;1;1
258114693156;258114697162;4006;1,3,4,5;4;2,9;2;1;1
258114697162;258114698561;1399;1,3,4,5;4;2,9;2;1;1
258114698561;258114700874;2313;1,3,4,5;4;2,9;2;1;1
258114700874;258114703505;2631;1,3,4,5;4;2,9;2;1;1
258114703505;258114703673;168;1,3,4,5;4;2,9;2;1;1
258114703673;258114705847;2174;1,3,4,5;4;2,9;2;1;1
258114705847;258114706359;512;1,3,4,5;4;2,9;2;1;1
258114706359;258114712433;6074;1,3,4,5;4;2,9;2;1;1
258114712433;258114713405;972;1,3,4,5;4;2,9;2;1;1
258114713405;258114714745;1340;1,3,4,5;4;2,9;2;1;1
258114714745;258114716336;1591;1,3,4,5;4;2,9;2;1;1
258114716336;258114718691;2355;1,3,4,5;4;2,9;2;1;1
258114718691;258114722411;3720;1,3,4,5;4;2,9;2;1;1
258114722411;258114723107;696;1,3,4,5;4;2,9;2;1;1
258114723107;258114723726;619;1,3,4,5;4;2,9;2;1;1
258114723726;258114724342;616;1,3,4,5;4;2,9;2;1;1
258114724342;258114725118;776;1,3,4,5;4;2,9;2;1;1
258114725118;258114726369;1251;1,3,4,5;4;2,9;2;1;1
258114726369;258114778435;52066;1,3,5;3;9;1;1;1
258114778435;258114781048;2613;1,3,5;3;9;1;1;1
258114781048;258114791065;10017;1,3,5;3;9;1;1;1
258114791065;258114791692;627;1,3,4,5;4;2,9;2;1;1
258114791692;258114797055;5363;1,3,5;3;9;1;1;1
258114797055;258114805802;8747;1,3,5;3;9;1;1;1
258114805802;258114823181;17379;1,3,5;3;9;1;1;1
258114823181;258114824470;1289;1,3,4,5;4;2,9;2;1;1
258114824470;258114827679;3209;1,3,5;3;9;1;1;1
258114827679;258114830034;2355;1,3,4,5;4;2,9;2;1;1
258114830034;258114830917;883;1,3,4,5;4;2,9;2;1;1
258114830917;258114832134;1217;1,3,4,5;4;2,9;2;1;1
258114832134;258114832166;32;1,3,5;3;9;1;1;1
258114832166;258114833492;1326;1,3,4,5;4;2,9;2;1;1
258114833492;258114834336;844;1,3,4,5;4;2,9;2;1;1
258114834336;258114836004;1668;1,3,4,5;4;2,9;2;1;1
258114836004;258114837322;1318;1,3,5;3;9;1;1;1
258114837322;258114839491;2169;1,3,4,5;4;2,9;2;1;1
258114839491;258114840750;1259;1,3,4,5;4;2,9;2;1;1
258114840750;258114846039;5289;1,3,4,5;4;2,9;2;1;1
258114846039;258114847370;1331;1,3,4,5;4;2,9;2;1;1
258114847370;258114848743;1373;1,3,4,5;4;2,9;2;1;1
258114848743;258114852172;3429;1,3,4,5;4;2,9;2;1;1
258114852172;258114854717;2545;1,3,4,5;4;2,9;2;1;1
258114854717;258114856146;1429;1,3,4,5;4;2,9;2;1;1
258114856146;258114857225;1079;1,3,4,5;4;2,9;2;1;1
258114857225;258114898267;41042;1,3,5;3;9;1;1;1
258114898267;258114900603;2336;1,3,4,5;4;2,9;2;1;1
258114900603;258114913974;13371;1,3,4,5;4;2,9;2;1;1
258114913974;258114917563;3589;1,3,4,5;4;2,9;2;1;1
258114917563;258114919641;2078;1,3,4,5;4;2,9;2;1;1
258114919641;258114919958;317;1,3,4,5;4;2,9;2;1;1
258114919958;258114920760;802;1,3,4,5;4;2,9;2;1;1
258114920760;258114922035;1275;1,3,4,5;4;2,9;2;1;1
258114922035;258114924049;2014;1,3,4,5;4;2,9;2;1;1
258114924049;258114924698;649;1,3,4,5;4;2,9;2;1;1
258114924698;258114928820;4122;1,3,4,5;4;2,9;2;1;1
258114928820;258114929512;692;1,3,4,5;4;2,9;2;1;1
258114929512;258114929568;56;1,3,4,5;4;2,9;2;1;1
258114929568;258114930401;833;1,3,5;3;9;1;1;1
258114930401;258114932908;2507;1,3,5;3;9;1;1;1
258114932908;258114945461;12553;1,3,4,5;4;2,9;2;1;1
258114945461;258114945636;175;1,3,4,5;4;2,9;2;1;1
258114945636;258114946265;629;1,3,4,5;4;2,9;2;1;1
258114946265;258114946876;611;1,3,4,5;4;2,9;2;1;1
258114946876;258114947402;526;1,3,4,5;4;2,9;2;1;1
258114947402;258114948400;998;1,3,4,5;4;2,9;2;1;1
258114948400;258114948573;173;1,3,4,5;4;2,9;2;1;1
258114948573;258114984187;35614;1,3,5;3;9;1;1;1
258114984187;258114996592;12405;1,3,5;3;9;1;1;1
258114996592;258115021086;24494;1,3,5;3;9;1;1;1
258115021086;258115021633;547;1,3,4,5;4;2,9;2;1;1
258115021633;258115031002;9369;1,3,5;3;9;1;1;1
258115031002;258115039591;8589;1,3,5;3;9;1;1;1
258115039591;258115060396;20805;1,3,5;3;9;1;1;1
258115060396;258115061550;1154;1,3,4,5;4;2,9;2;1;1
258115061550;258115065676;4126;1,3,5;3;9;1;1;1
258115065676;258115066495;819;1,3,4,5;4;2,9;2;1;1
258115066495;258115068753;2258;1,3,4,5;4;2,9;2;1;1
258115068753;258115069709;956;1,3,4,5;4;2,9;2;1;1
258115069709;258115070688;979;1,3,5;3;9;1;1;1
258115070688;258115070797;109;1,3,4,5;4;2,9;2;1;1
258115070797;258115073749;2952;1,3,4,5;4;2,9;2;1;1
258115073749;258115073842;93;1,3,4,5;4;2,9;2;1;1
258115073842;258115074581;739;1,3,4,5;4;2,9;2;1;1
258115074581;258115076470;1889;1,3,4,5;4;2,9;2;1;1
258115076470;258115076627;157;1,3,4,5;4;2,9;2;1;1
258115076627;258115077251;624;1,3,4,5;4;2,9;2;1;1
258115077251;258115078829;1578;1,3,4,5;4;2,9;2;1;1
258115078829;258115079735;906;1,3,5;3;9;1;1;1
258115079735;258115080724;989;1,3,5;3;9;1;1;1
258115080724;258115081876;1152;1,3,4,5;4;2,9;2;1;1
258115081876;258115082250;374;1,3,4,5;4;2,9;2;1;1
258115082250;258115083904;1654;1,3,4,5;4;2,9;2;1;1
258115083904;258115084282;378;1,3,4,5;4;2,9;2;1;1
258115084282;258115085282;1000;1,3,4,5;4;2,9;2;1;1
258115085282;258115086869;1587;1,3,4,5;4;2,9;2;1;1
258115086869;258115087571;702;1,3,4,5;4;2,9;2;1;1
258115087571;258115090061;2490;1,3,4,5;4;2,9;2;1;1
258115090061;258115090329;268;1,3,4,5;4;2,9;2;1;1
258115090329;258115091729;1400;1,3,4,5;4;2,9;2;1;1
258115091729;258115092717;988;1,3,4,5;4;2,9;2;1;1
258115092717;258115093024;307;1,3,4,5;4;2,9;2;1;1
258115093024;258115093743;719;1,3,4,5;4;2,9;2;1;1
258115093743;258115096647;2904;1,3,5;3;9;1;1;1
258115096647;258115097525;878;1,3,4,5;4;2,9;2;1;1
258115097525;258115098430;905;1,3,5;3;9;1;1;1
258115098430;258115098976;546;1,3,4,5;4;2,9;2;1;1
258115098976;258115137422;38446;1,3,5;3;9;1;1;1
258115137422;258115144228;6806;1,3,5;3;9;1;1;1
258115144228;258115145298;1070;1,3,4,5;4;2,9;2;1;1
258115145298;258115146698;1400;1,3,4,5;4;2,9;2;1;1
258115146698;258115147619;921;1,3,4,5;4;2,9;2;1;1
258115147619;258115154395;6776;1,3,4,5;4;2,9;2;1;1
258115154395;258115162864;8469;1,3,4,5;4;2,9;2;1;1
258115162864;258115169109;6245;1,3,4,5;4;2,9;2;1;1
258115169109;258115172526;3417;1,3,4,5;4;2,9;2;1;1
258115172526;258115172995;469;1,3,4,5;4;2,9;2;1;1
258115172995;258115173296;301;1,3,4,5;4;2,9;2;1;1
258115173296;258115174086;790;1,3,4,5;4;2,9;2;1;1
258115174086;258115175058;972;1,3,4,5;4;2,9;2;1;1
258115175058;258115176098;1040;1,3,4,5;4;2,9;2;1;1
258115176098;258115176440;342;1,3,4,5;4;2,9;2;1;1
258115176440;258115178740;2300;1,3,4,5;4;2,9;2;1;1
258115178740;258115181033;2293;1,3,4,5;4;2,9;2;1;1
258115181033;258115182146;1113;1,3,4,5;4;2,9;2;1;1
258115182146;258115182506;360;1,3,4,5;4;2,9;2;1;1
258115182506;258115187814;5308;1,3,4,5;4;2,9;2;1;1
258115187814;258115188182;368;1,3,4,5;4;2,9;2;1;1
258115188182;258115193454;5272;1,3,4,5;4;2,9;2;1;1
258115193454;258115193918;464;1,3,4,5;4;2,9;2;1;1
258115193918;258115195056;1138;1,3,4,5;4;2,9;2;1;1
258115195056;258115214086;19030;1,3,5;3;9;1;1;1
258115214086;258115216915;2829;1,3,5;3;9;1;1;1
258115216915;258115217281;366;1,3,5;3;9;1;1;1
258115217281;258115217474;193;1,3,5;3;9;1;1;1
258115217474;258115219908;2434;1,3,5;3;9;1;1;1
258115219908;258115221412;1504;1,3,5;3;9;1;1;1
258115221412;258115242618;21206;1,3,5;3;9;1;1;1
258115242618;258115245272;2654;1,3,5;3;9;1;1;1
258115245272;258115264596;19324;1,3,5;3;9;1;1;1
258115264596;258115269601;5005;1,3,4,5;4;2,9;2;1;1
258115269601;258115270917;1316;1,3,4,5;4;2,9;2;1;1
258115270917;258115282487;11570;1,3,4,5;4;2,9;2;1;1
258115282487;258115284126;1639;1,3,4,5;4;2,9;2;1;1
258115284126;258115285348;1222;1,3,4,5;4;2,9;2;1;1
258115285348;258115289934;4586;1,3,4,5;4;2,9;2;1;1
258115289934;258115290297;363;1,3,4,5;4;2,9;2;1;1
258115290297;258115293263;2966;1,3,4,5;4;2,9;2;1;1
258115293263;258115294260;997;1,3,4,5;4;2,9;2;1;1
258115294260;258115296793;2533;1,3,4,5;4;2,9;2;1;1
258115296793;258115299435;2642;1,3,4,5;4;2,9;2;1;1
258115299435;258115301563;2128;1,3,4,5;4;2,9;2;1;1
258115301563;258115302268;705;1,3,4,5;4;2,9;2;1;1
258115302268;258115302854;586;1,3,4,5;4;2,9;2;1;1
258115302854;258115303097;243;1,3,4,5;4;2,9;2;1;1
258115303097;258115306664;3567;1,3,4,5;4;2,9;2;1;1
258115306664;258115306774;110;1,3,4,5;4;2,9;2;1;1
258115306774;258115320302;13528;1,3,4,5;4;2,9;2;1;1
258115320302;258115320546;244;1,3,4,5;4;2,9;2;1;1
258115320546;258115321692;1146;1,3,4,5;4;2,9;2;1;1
258115321692;258115323139;1447;1,3,4,5;4;2,9;2;1;1
258115323139;258115326603;3464;1,3,5;3;9;1;1;1
258115326603;258115335476;8873;1,3,5;3;9;1;1;1
258115335476;258115360150;24674;1,3,5;3;9;1;1;1
258115360150;258115360711;561;1,3,4,5;4;2,9;2;1;1
258115360711;258115362629;1918;1,3,5;3;9;1;1;1
258115362629;258115371507;8878;1,3,5;3;9;1;1;1
258115371507;258115397996;26489;1,3,5;3;9;1;1;1
258115397996;258115399079;1083;1,3,4,5;4;2,9;2;1;1
258115399079;258115400036;957;1,3,5;3;9;1;1;1
258115400036;258115401294;1258;1,3,4,5;4;2,9;2;1;1
258115401294;258115403559;2265;1,3,5;3;9;1;1;1
258115403559;258115405344;1785;1,3,5;3;9;1;1;1
258115405344;258115405817;473;1,3,4,5;4;2,9;2;1;1
258115405817;258115406490;673;1,3,4,5;4;2,9;2;1;1
258115406490;258115408811;2321;1,3,4,5;4;2,9;2;1;1
258115408811;258115409173;362;1,3,4,5;4;2,9;2;1;1
258115409173;258115409689;516;1,3,5;3;9;1;1;1
258115409689;258115410235;546;1,3,4,5;4;2,9;2;1;1
258115410235;258115411136;901;1,3,4,5;4;2,9;2;1;1
258115411136;258115411818;682;1,3,4,5;4;2,9;2;1;1
258115411818;258115412474;656;1,3,5;3;9;1;1;1
258115412474;258115415440;2966;1,3,5;3;9;1;1;1
258115415440;258115418061;2621;1,3,5;3;9;1;1;1
258115418061;258115419004;943;1,3,4,5;4;2,9;2;1;1
258115419004;258115420553;1549;1,3,5;3;9;1;1;1
258115420553;258115421574;1021;1,3,4,5;4;2,9;2;1;1
258115421574;258115422269;695;1,3,4,5;4;2,9;2;1;1
258115422269;258115422818;549;1,3,4,5;4;2,9;2;1;1
258115422818;258115431885;9067;1,3,5;3;9;1;1;1
258115431885;258115433923;2038;1,3,4,5;4;2,9;2;1;1
258115433923;258115436229;2306;1,3,4,5;4;2,9;2;1;1
258115436229;258115437415;1186;1,3,4,5;4;2,9;2;1;1
258115437415;258115437940;525;1,3,4,5;4;2,9;2;1;1
258115437940;258115438150;210;1,3,4,5;4;2,9;2;1;1
258115438150;258115438728;578;1,3,4,5;4;2,9;2;1;1
258115438728;258115439621;893;1,3,4,5;4;2,9;2;1;1
258115439621;258115439743;122;1,3,4,5;4;2,9;2;1;1
258115439743;258115440710;967;1,3,4,5;4;2,9;2;1;1
258115440710;258115441244;534;1,3,4,5;4;2,9;2;1;1
258115441244;258115441535;291;1,3,4,5;4;2,9;2;1;1
258115441535;258115442179;644;1,3,5;3;9;1;1;1
258115442179;258115442326;147;1,3,4,5;4;2,9;2;1;1
258115442326;258115443246;920;1,3,4,5;4;2,9;2;1;1
258115443246;258115443391;145;1,3,4,5;4;2,9;2;1;1
258115443391;258115443535;144;1,3,4,5;4;2,9;2;1;1
258115443535;258115452666;9131;1,3,5;3;9;1;1;1
258115452666;258115454295;1629;1,3,5;3;9;1;1;1
258115454295;258115456365;2070;1,3,5;3;9;1;1;1
258115456365;258115464757;8392;1,3,5;3;9;1;1;1
258115464757;258115465761;1004;1,3,5;3;9;1;1;1
258115465761;258115465917;156;1,3,5;3;9;1;1;1
258115465917;258115466153;236;1,3,5;3;9;1;1;1
258115466153;258115467749;1596;1,3,5;3;9;1;1;1
258115467749;258115475829;8080;1,3,5;3;9;1;1;1
258115475829;258115476180;351;1,3,5;3;9;1;1;1
258115476180;258115477803;1623;1,3,5;3;9;1;1;1
258115477803;258115481076;3273;1,3,4,5;4;2,9;2;1;1
258115481076;258115481213;137;1,3,4,5;4;2,9;2;1;1
258115481213;258115482839;1626;1,3,4,5;4;2,9;2;1;1
258115482839;258115483590;751;1,3,4,5;4;2,9;2;1;1
258115483590;258115483865;275;1,3,4,5;4;2,9;2;1;1
258115483865;258115484086;221;1,3,4,5;4;2,9;2;1;1
258115484086;258115484242;156;1,3,4,5;4;2,9;2;1;1
258115484242;258115487785;3543;1,3,4,5;4;2,9;2;1;1
258115487785;258115493034;5249;1,3,4,5;4;2,9;2;1;1
258115493034;258115495621;2587;1,3,4,5;4;2,9;2;1;1
258115495621;258115503228;7607;1,3,4,5;4;2,9;2;1;1
258115503228;258115503790;562;1,3,4,5;4;2,9;2;1;1
258115503790;258115508686;4896;1,3,4,5;4;2,9;2;1;1
258115508686;258115509255;569;1,3,4,5;4;2,9;2;1;1
258115509255;258115516461;7206;1,3,4,5;4;2,9;2;1;1
258115516461;258115517075;614;1,3,4,5;4;2,9;2;1;1
258115517075;258115518865;1790;1,3,4,5;4;2,9;2;1;1
258115518865;258115519325;460;1,3,4,5;4;2,9;2;1;1
258115519325;258115520485;1160;1,3,4,5;4;2,9;2;1;1
258115520485;258115521585;1100;1,3,4,5;4;2,9;2;1;1
258115521585;258115522145;560;1,3,4,5;4;2,9;2;1;1
258115522145;258115523259;1114;1,3,4,5;4;2,9;2;1;1
258115523259;258115524028;769;1,3,4,5;4;2,9;2;1;1
258115524028;258115524706;678;1,3,4,5;4;2,9;2;1;1
258115524706;258115530450;5744;1,3,4,5;4;2,9;2;1;1
258115530450;258115530536;86;1,3,4,5;4;2,9;2;1;1
258115530536;258115531263;727;1,3,4,5;4;2,9;2;1;1
258115531263;258115533658;2395;1,3,5;3;9;1;1;1
258115533658;258115564333;30675;1,3,5;3;9;1;1;1
258115564333;258115566090;1757;1,3,5;3;9;1;1;1
258115566090;258115573436;7346;1,3,5;3;9;1;1;1
258115573436;258115574443;1007;1,3,5;3;9;1;1;1
258115574443;258115575055;612;1,3,5;3;9;1;1;1
258115575055;258115582862;7807;1,3,5;3;9;1;1;1
258115582862;258115629905;47043;1,3,5;3;9;1;1;1
258115629905;258115634595;4690;1,3,4,5;4;2,9;2;1;1
258115634595;258115642513;7918;1,3,5;3;9;1;1;1
258115642513;258115642784;271;1,3,5;3;9;1;1;1
258115642784;258115651733;8949;1,3,5;3;9;1;1;1
258115651733;258115652304;571;1,3,5;3;9;1;1;1
258115652304;258115652582;278;1,3,5;3;9;1;1;1
258115652582;258115661079;8497;1,3,5;3;9;1;1;1
258115661079;258115686507;25428;1,3,5;3;9;1;1;1
258115686507;258115687128;621;1,3,4,5;4;2,9;2;1;1
258115687128;258115702231;15103;1,3,5;3;9;1;1;1
258115702231;258115707419;5188;1,3,5;3;9;1;1;1
258115707419;258115765983;58564;1,3,5;3;9;1;1;1
258115765983;258115766598;615;1,3,4,5;4;2,9;2;1;1
258115766598;258115771370;4772;1,3,5;3;9;1;1;1
258115771370;258115780082;8712;1,3,5;3;9;1;1;1
258115780082;258115809593;29511;1,3,5;3;9;1;1;1
258115809593;258115812793;3200;1,3,5;3;9;1;1;1
258115812793;258115816850;4057;1,3,4,5;4;2,9;2;1;1
258115816850;258115818929;2079;1,3,5;3;9;1;1;1
258115818929;258115851544;32615;1,3,5;3;9;1;1;1
258115851544;258115854335;2791;1,3,5;3;9;1;1;1
258115854335;258115891413;37078;1,3,5;3;9;1;1;1
258115891413;258115895241;3828;1,3,5;3;9;1;1;1
258115895241;258115896013;772;1,3,5;3;9;1;1;1
258115896013;258115896248;235;1,3,5;3;9;1;1;1
258115896248;258115896430;182;1,3,5;3;9;1;1;1
258115896430;258115898011;1581;1,3,4,5;4;2,9;2;1;1
258115898011;258115899101;1090;1,3,5;3;9;1;1;1
258115899101;258115899489;388;1,3,5;3;9;1;1;1
258115899489;258115899938;449;1,3,4,5;4;2,9;2;1;1
258115899938;258115901263;1325;1,3,4,5;4;2,9;2;1;1
258115901263;258115901656;393;1,3,4,5;4;2,9;2;1;1
258115901656;258115902333;677;1,3,4,5;4;2,9;2;1;1
258115902333;258115902444;111;1,3,5;3;9;1;1;1
258115902444;258115903192;748;1,3,5;3;9;1;1;1
258115903192;258115903530;338;1,3,5;3;9;1;1;1
258115903530;258115903554;24;1,3,5;3;9;1;1;1
258115903554;258115904830;1276;1,3,4,5;4;2,9;2;1;1
258115904830;258115906038;1208;1,3,5;3;9;1;1;1
258115906038;258115906230;192;1,3,4,5;4;2,9;2;1;1
258115906230;258115906480;250;1,3,4,5;4;2,9;2;1;1
258115906480;258115907204;724;1,3,4,5;4;2,9;2;1;1
258115907204;258115907887;683;1,3,5;3;9;1;1;1
258115907887;258115910070;2183;1,3,5;3;9;1;1;1
258115910070;258115910181;111;1,3,5;3;9;1;1;1
258115910181;258115911874;1693;1,3,4,5;4;2,9;2;1;1
258115911874;258115912970;1096;1,3,4,5;4;2,9;2;1;1
258115912970;258115913746;776;1,3,5;3;9;1;1;1
258115913746;258115914733;987;1,3,4,5;4;2,9;2;1;1
258115914733;258115915913;1180;1,3,4,5;4;2,9;2;1;1
258115915913;258115918314;2401;1,3,4,5;4;2,9;2;1;1
258115918314;258115918480;166;1,3,4,5;4;2,9;2;1;1
258115918480;258115919045;565;1,3,4,5;4;2,9;2;1;1
258115919045;258115919270;225;1,3,4,5;4;2,9;2;1;1
258115919270;258115922115;2845;1,3,4,5;4;2,9;2;1;1
258115922115;258115922459;344;1,3,5;3;9;1;1;1
258115922459;258115923007;548;1,3,4,5;4;2,9;2;1;1
258115923007;258115923958;951;1,3,4,5;4;2,9;2;1;1
258115923958;258115926318;2360;1,3,4,5;4;2,9;2;1;1
258115926318;258115926616;298;1,3,4,5;4;2,9;2;1;1
258115926616;258115928968;2352;1,3,4,5;4;2,9;2;1;1
258115928968;258115929613;645;1,3,4,5;4;2,9;2;1;1
258115929613;258115933641;4028;1,3,4,5;4;2,9;2;1;1
258115933641;258115936485;2844;1,3,5;3;9;1;1;1
258115936485;258115936586;101;1,3,4,5;4;2,9;2;1;1
258115936586;258115937723;1137;1,3,4,5;4;2,9;2;1;1
258115937723;258115938176;453;1,3,4,5;4;2,9;2;1;1
258115938176;258115944357;6181;1,3,5;3;9;1;1;1
258115944357;258115944658;301;1,3,4,5;4;2,9;2;1;1
258115944658;258115946037;1379;1,3,4,5;4;2,9;2;1;1
258115946037;258115947271;1234;1,3,5;3;9;1;1;1
258115947271;258115983190;35919;1,3,5;3;9;1;1;1
258115983190;258115986029;2839;1,3,4,5;4;2,9;2;1;1
258115986029;258115991089;5060;1,3,4,5;4;2,9;2;1;1
258115991089;258115994610;3521;1,3,4,5;4;2,9;2;1;1
258115994610;258115998562;3952;1,3,4,5;4;2,9;2;1;1
258115998562;258116000487;1925;1,3,4,5;4;2,9;2;1;1
258116000487;258116005960;5473;1,3,4,5;4;2,9;2;1;1
258116005960;258116008285;2325;1,3,4,5;4;2,9;2;1;1
258116008285;258116012213;3928;1,3,4,5;4;2,9;2;1;1
258116012213;258116012989;776;1,3,4,5;4;2,9;2;1;1
258116012989;258116015353;2364;1,3,4,5;4;2,9;2;1;1
258116015353;258116023154;7801;1,3,4,5;4;2,9;2;1;1
258116023154;258116025130;1976;1,3,4,5;4;2,9;2;1;1
258116025130;258116025737;607;1,3,4,5;4;2,9;2;1;1
258116025737;258116028507;2770;1,3,4,5;4;2,9;2;1;1
258116028507;258116029334;827;1,3,4,5;4;2,9;2;1;1
258116029334;258116029821;487;1,3,4,5;4;2,9;2;1;1
258116029821;258116030321;500;1,3,4,5;4;2,9;2;1;1
258116030321;258116030929;608;1,3,4,5;4;2,9;2;1;1
258116030929;258116031599;670;1,3,4,5;4;2,9;2;1;1
258116031599;258116032841;1242;1,3,4,5;4;2,9;2;1;1
258116032841;258116035113;2272;1,3,4,5;4;2,9;2;1;1
258116035113;258116043664;8551;1,3,4,5;4;2,9;2;1;1
258116043664;258116044250;586;1,3,4,5;4;2,9;2;1;1
258116044250;258116079157;34907;1,3,5;3;9;1;1;1
258116079157;258116080299;1142;1,3,5;3;9;1;1;1
258116080299;258116082213;1914;1,3,5;3;9;1;1;1
258116082213;258116084611;2398;1,3,5;3;9;1;1;1
258116084611;258116089806;5195;1,3,5;3;9;1;1;1
258116089806;258116089947;141;1,3,5;3;9;1;1;1
258116089947;258116090770;823;1,3,5;3;9;1;1;1
258116090770;258116091223;453;1,3,5;3;9;1;1;1
258116091223;258116091633;410;1,3,5;3;9;1;1;1
258116091633;258116092935;1302;1,3,5;3;9;1;1;1
258116092935;258116097979;5044;1,3,5;3;9;1;1;1
258116097979;258116100347;2368;1,3,4,5;4;2,9;2;1;1
258116100347;258116111635;11288;1,3,4,5;4;2,9;2;1;1
258116111635;258116112016;381;1,3,4,5;4;2,9;2;1;1
258116112016;258116114017;2001;1,3,4,5;4;2,9;2;1;1
258116114017;258116118257;4240;1,3,4,5;4;2,9;2;1;1
258116118257;258116119651;1394;1,3,4,5;4;2,9;2;1;1
258116119651;258116120616;965;1,3,4,5;4;2,9;2;1;1
258116120616;258116124877;4261;1,3,4,5;4;2,9;2;1;1
258116124877;258116125085;208;1,3,4,5;4;2,9;2;1;1
258116125085;258116126357;1272;1,3,4,5;4;2,9;2;1;1
258116126357;258116128314;1957;1,3,4,5;4;2,9;2;1;1
258116128314;258116128389;75;1,3,4,5;4;2,9;2;1;1
258116128389;258116130042;1653;1,3,4,5;4;2,9;2;1;1
258116130042;258116130191;149;1,3,4,5;4;2,9;2;1;1
258116130191;258116135024;4833;1,3,4,5;4;2,9;2;1;1
258116135024;258116136753;1729;1,3,4,5;4;2,9;2;1;1
258116136753;258116142589;5836;1,3,4,5;4;2,9;2;1;1
258116142589;258116144665;2076;1,3,4,5;4;2,9;2;1;1
258116144665;258116145327;662;1,3,4,5;4;2,9;2;1;1
258116145327;258116145369;42;1,3,4,5;4;2,9;2;1;1
258116145369;258116145521;152;1,3,4,5;4;2,9;2;1;1
258116145521;258116146093;572;1,3,4,5;4;2,9;2;1;1
258116146093;258116146352;259;1,3,4,5;4;2,9;2;1;1
258116146352;258116146750;398;1,3,4,5;4;2,9;2;1;1
258116146750;258116146999;249;1,3,4,5;4;2,9;2;1;1
258116146999;258116147183;184;1,3,4,5;4;2,9;2;1;1
258116147183;258116148087;904;1,3,4,5;4;2,9;2;1;1
258116148087;258116152184;4097;1,3,5;3;9;1;1;1
258116152184;258116153291;1107;1,3,5;3;9;1;1;1
258116153291;258116167231;13940;1,3,5;3;9;1;1;1
258116167231;258116175532;8301;1,3,5;3;9;1;1;1
258116175532;258116208650;33118;1,3,5;3;9;1;1;1
258116208650;258116210762;2112;1,3,4,5;4;2,9;2;1;1
258116210762;258116223053;12291;1,3,4,5;4;2,9;2;1;1
258116223053;258116223409;356;1,3,4,5;4;2,9;2;1;1
258116223409;258116229018;5609;1,3,4,5;4;2,9;2;1;1
258116229018;258116230325;1307;1,3,4,5;4;2,9;2;1;1
258116230325;258116238058;7733;1,3,4,5;4;2,9;2;1;1
258116238058;258116239916;1858;1,3,4,5;4;2,9;2;1;1
258116239916;258116245067;5151;1,3,4,5;4;2,9;2;1;1
258116245067;258116246022;955;1,3,4,5;4;2,9;2;1;1
258116246022;258116246709;687;1,3,4,5;4;2,9;2;1;1
258116246709;258116247152;443;1,3,4,5;4;2,9;2;1;1
258116247152;258116247445;293;1,3,4,5;4;2,9;2;1;1
258116247445;258116247661;216;1,3,4,5;4;2,9;2;1;1
258116247661;258116248393;732;1,3,5;3;9;1;1;1
258116248393;258116249736;1343;1,3,4,5;4;2,9;2;1;1
258116249736;258116249983;247;1,3,4,5;4;2,9;2;1;1
258116249983;258116251550;1567;1,3,4,5;4;2,9;2;1;1
258116251550;258116252007;457;1,3,4,5;4;2,9;2;1;1
258116252007;258116252927;920;1,3,4,5;4;2,9;2;1;1
258116252927;258116274111;21184;1,3,5;3;9;1;1;1
258116274111;258116276745;2634;1,3,5;3;9;1;1;1
258116276745;258116320766;44021;1,3,5;3;9;1;1;1
258116320766;258116329549;8783;1,3,5;3;9;1;1;1
258116329549;258116356447;26898;1,3,5;3;9;1;1;1
258116356447;258116358623;2176;1,3,4,5;4;2,9;2;1;1
258116358623;258116358774;151;1,3,5;3;9;1;1;1
258116358774;258116359799;1025;1,3,4,5;4;2,9;2;1;1
258116359799;258116362496;2697;1,3,5;3;9;1;1;1
258116362496;258116362938;442;1,3,5;3;9;1;1;1
258116362938;258116364755;1817;1,3,4,5;4;2,9;2;1;1
258116364755;258116365381;626;1,3,4,5;4;2,9;2;1;1
258116365381;258116366591;1210;1,3,4,5;4;2,9;2;1;1
258116366591;258116367371;780;1,3,4,5;4;2,9;2;1;1
258116367371;258116368218;847;1,3,4,5;4;2,9;2;1;1
258116368218;258116368261;43;1,3,4,5;4;2,9;2;1;1
258116368261;258116368745;484;1,3,4,5;4;2,9;2;1;1
258116368745;258116369693;948;1,3,4,5;4;2,9;2;1;1
258116369693;258116370332;639;1,3,5;3;9;1;1;1
258116370332;258116372544;2212;1,3,4,5;4;2,9;2;1;1
258116372544;258116374921;2377;1,3,4,5;4;2,9;2;1;1
258116374921;258116376291;1370;1,3,4,5;4;2,9;2;1;1
258116376291;258116377126;835;1,3,4,5;4;2,9;2;1;1
258116377126;258116377464;338;1,3,4,5;4;2,9;2;1;1
258116377464;258116381634;4170;1,3,5;3;9;1;1;1
258116381634;258116383093;1459;1,3,4,5;4;2,9;2;1;1
258116383093;258116384933;1840;1,3,4,5;4;2,9;2;1;1
258116384933;258116385039;106;1,3,4,5;4;2,9;2;1;1
258116385039;258116385992;953;1,3,4,5;4;2,9;2;1;1
258116385992;258116386627;635;1,3,4,5;4;2,9;2;1;1
258116386627;258116386887;260;1,3,5;3;9;1;1;1
258116386887;258116387536;649;1,3,4,5;4;2,9;2;1;1
258116387536;258116398424;10888;1,3,5;3;9;1;1;1
258116398424;258116399143;719;1,3,4,5;4;2,9;2;1;1
258116399143;258116400006;863;1,3,4,5;4;2,9;2;1;1
258116400006;258116400316;310;1,3,4,5;4;2,9;2;1;1
258116400316;258116400396;80;1,3,4,5;4;2,9;2;1;1
258116400396;258116401092;696;1,3,4,5;4;2,9;2;1;1
258116401092;258116401236;144;1,3,4,5;4;2,9;2;1;1
258116401236;258116401674;438;1,3,4,5;4;2,9;2;1;1
258116401674;258116401788;114;1,3,4,5;4;2,9;2;1;1
258116401788;258116402655;867;1,3,4,5;4;2,9;2;1;1
258116402655;258116433573;30918;1,3,5;3;9;1;1;1
258116433573;258116436308;2735;1,3,5;3;9;1;1;1
258116436308;258116453743;17435;1,3,5;3;9;1;1;1
258116453743;258116457536;3793;1,3,4,5;4;2,9;2;1;1
258116457536;258116468682;11146;1,3,4,5;4;2,9;2;1;1
258116468682;258116476688;8006;1,3,4,5;4;2,9;2;1;1
258116476688;258116478783;2095;1,3,4,5;4;2,9;2;1;1
258116478783;258116479383;600;1,3,4,5;4;2,9;2;1;1
258116479383;258116483774;4391;1,3,4,5;4;2,9;2;1;1
258116483774;258116484994;1220;1,3,4,5;4;2,9;2;1;1
258116484994;258116485388;394;1,3,4,5;4;2,9;2;1;1
258116485388;258116485975;587;1,3,4,5;4;2,9;2;1;1
258116485975;258116487607;1632;1,3,4,5;4;2,9;2;1;1
258116487607;258116487886;279;1,3,4,5;4;2,9;2;1;1
258116487886;258116488104;218;1,3,4,5;4;2,9;2;1;1
258116488104;258116488981;877;1,3,4,5;4;2,9;2;1;1
258116488981;258116489252;271;1,3,4,5;4;2,9;2;1;1
258116489252;258116489571;319;1,3,4,5;4;2,9;2;1;1
258116489571;258116490840;1269;1,3,4,5;4;2,9;2;1;1
258116490840;258116491088;248;1,3,4,5;4;2,9;2;1;1
258116491088;258116491337;249;1,3,4,5;4;2,9;2;1;1
258116491337;258116492266;929;1,3,4,5;4;2,9;2;1;1
258116492266;258116493139;873;1,3,4,5;4;2,9;2;1;1
258116493139;258116493240;101;1,3,4,5;4;2,9;2;1;1
258116493240;258116493944;704;1,3,4,5;4;2,9;2;1;1
258116493944;258116494381;437;1,3,4,5;4;2,9;2;1;1
258116494381;258116494869;488;1,3,4,5;4;2,9;2;1;1
258116494869;258116495634;765;1,3,5;3;9;1;1;1
258116495634;258116496178;544;1,3,4,5;4;2,9;2;1;1
258116496178;258116498590;2412;1,3,5;3;9;1;1;1
258116498590;258116499559;969;1,3,5;3;9;1;1;1
258116499559;258116499939;380;1,3,5;3;9;1;1;1
258116499939;258116538155;38216;1,3,5;3;9;1;1;1
258116538155;258116546808;8653;1,3,5;3;9;1;1;1
258116546808;258116561832;15024;1,3,5;3;9;1;1;1
258116561832;258116563638;1806;1,3,4,5;4;2,9;2;1;1
258116563638;258116569250;5612;1,3,4,5;4;2,9;2;1;1
258116569250;258116577230;7980;1,3,4,5;4;2,9;2;1;1
258116577230;258116578054;824;1,3,4,5;4;2,9;2;1;1
258116578054;258116580482;2428;1,3,4,5;4;2,9;2;1;1
258116580482;258116580625;143;1,3,4,5;4;2,9;2;1;1
258116580625;258116580703;78;1,3,4,5;4;2,9;2;1;1
258116580703;258116581896;1193;1,3,4,5;4;2,9;2;1;1
258116581896;258116584911;3015;1,3,4,5;4;2,9;2;1;1
258116584911;258116595345;10434;1,3,4,5;4;2,9;2;1;1
258116595345;258116595424;79;1,3,4,5;4;2,9;2;1;1
258116595424;258116595753;329;1,3,4,5;4;2,9;2;1;1
258116595753;258116596019;266;1,3,4,5;4;2,9;2;1;1
258116596019;258116596569;550;1,3,4,5;4;2,9;2;1;1
258116596569;258116597253;684;1,3,4,5;4;2,9;2;1;1
258116597253;258116598029;776;1,3,4,5;4;2,9;2;1;1
258116598029;258116599573;1544;1,3,4,5;4;2,9;2;1;1
258116599573;258116601786;2213;1,3,4,5;4;2,9;2;1;1
258116601786;258116610803;9017;1,3,4,5;4;2,9;2;1;1
258116610803;258116614903;4100;1,3,5;3;9;1;1;1
258116614903;258116617782;2879;1,3,5;3;9;1;1;1
258116617782;258116659890;42108;1,3,5;3;9;1;1;1
258116659890;258116669593;9703;1,3,5;3;9;1;1;1
258116669593;258116681581;11988;1,3,5;3;9;1;1;1
258116681581;258116690185;8604;1,3,4,5;4;2,9;2;1;1
258116690185;258116691825;1640;1,3,4,5;4;2,9;2;1;1
258116691825;258116696474;4649;1,3,4,5;4;2,9;2;1;1
258116696474;258116701302;4828;1,3,4,5;4;2,9;2;1;1
258116701302;258116706367;5065;1,3,4,5;4;2,9;2;1;1
258116706367;258116706378;11;1,3,4,5;4;2,9;2;1;1
258116706378;258116706921;543;1,3,4,5;4;2,9;2;1;1
258116706921;258116712104;5183;1,3,4,5;4;2,9;2;1;1
258116712104;258116713874;1770;1,3,4,5;4;2,9;2;1;1
258116713874;258116714508;634;1,3,4,5;4;2,9;2;1;1
258116714508;258116715092;584;1,3,4,5;4;2,9;2;1;1
258116715092;258116716107;1015;1,3,4,5;4;2,9;2;1;1
258116716107;258116719361;3254;1,3,4,5;4;2,9;2;1;1
258116719361;258116721374;2013;1,3,4,5;4;2,9;2;1;1
258116721374;258116721526;152;1,3,4,5;4;2,9;2;1;1
258116721526;258116723396;1870;1,3,4,5;4;2,9;2;1;1
258116723396;258116724255;859;1,3,4,5;4;2,9;2;1;1
258116724255;258116724468;213;1,3,4,5;4;2,9;2;1;1
258116724468;258116726566;2098;1,3,4,5;4;2,9;2;1;1
258116726566;258116774260;47694;1,3,5;3;9;1;1;1
258116774260;258116775408;1148;1,3,4,5;4;2,9;2;1;1
258116775408;258116824630;49222;1,3,5;3;9;1;1;1
258116824630;258116825510;880;1,3,4,5;4;2,9;2;1;1
258116825510;258116872684;47174;1,3,5;3;9;1;1;1
258116872684;258116877319;4635;1,3,5;3;9;1;1;1
258116877319;258116878101;782;1,3,5;3;9;1;1;1
258116878101;258116884304;6203;1,3,5;3;9;1;1;1
258116884304;258116884377;73;1,3,5;3;9;1;1;1
258116884377;258116884663;286;1,3,5;3;9;1;1;1
258116884663;258116884697;34;1,3,5;3;9;1;1;1
258116884697;258116885717;1020;1,3,5;3;9;1;1;1
258116885717;258116894513;8796;1,3,5;3;9;1;1;1
258116894513;258116897117;2604;1,3,5;3;9;1;1;1
258116897117;258116902524;5407;1,3,5;3;9;1;1;1
258116902524;258116902599;75;1,3,4,5;4;2,9;2;1;1
258116902599;258116903131;532;1,3,4,5;4;2,9;2;1;1
258116903131;258116904197;1066;1,3,5;3;9;1;1;1
258116904197;258116915943;11746;1,3,5;3;9;1;1;1
258116915943;258116917166;1223;1,3,5;3;9;1;1;1
258116917166;258116917731;565;1,3,5;3;9;1;1;1
258116917731;258116917749;18;1,3,5;3;9;1;1;1
258116917749;258116949049;31300;1,3,5;3;9;1;1;1
258116949049;258116949610;561;1,3,4,5;4;2,9;2;1;1
258116949610;258116986167;36557;1,3,5;3;9;1;1;1
258116986167;258116987712;1545;1,3,4,5;4;2,9;2;1;1
258116987712;258116988516;804;1,3,5;3;9;1;1;1
258116988516;258116989799;1283;1,3,4,5;4;2,9;2;1;1
258116989799;258116992399;2600;1,3,5;3;9;1;1;1
258116992399;258116993419;1020;1,3,5;3;9;1;1;1
258116993419;258116993819;400;1,3,4,5;4;2,9;2;1;1
258116993819;258116995577;1758;1,3,4,5;4;2,9;2;1;1
258116995577;258116996627;1050;1,3,4,5;4;2,9;2;1;1
258116996627;258116997141;514;1,3,4,5;4;2,9;2;1;1
258116997141;258116997535;394;1,3,4,5;4;2,9;2;1;1
258116997535;258116998278;743;1,3,4,5;4;2,9;2;1;1
258116998278;258116998753;475;1,3,4,5;4;2,9;2;1;1
258116998753;258116999593;840;1,3,5;3;9;1;1;1
258116999593;258117001024;1431;1,3,4,5;4;2,9;2;1;1
258117001024;258117001196;172;1,3,4,5;4;2,9;2;1;1
258117001196;258117007924;6728;1,3,5;3;9;1;1;1
258117007924;258117009607;1683;1,3,4,5;4;2,9;2;1;1
258117009607;258117010548;941;1,3,5;3;9;1;1;1
258117010548;258117011170;622;1,3,4,5;4;2,9;2;1;1
258117011170;258117018769;7599;1,3,5;3;9;1;1;1
258117018769;258117028179;9410;1,3,5;3;9;1;1;1
258117028179;258117059003;30824;1,3,5;3;9;1;1;1
258117059003;258117059540;537;1,3,4,5;4;2,9;2;1;1
258117059540;258117059886;346;1,3,4,5;4;2,9;2;1;1
258117059886;258117060296;410;1,3,4,5;4;2,9;2;1;1
258117060296;258117063678;3382;1,3,4,5;4;2,9;2;1;1
258117063678;258117072483;8805;1,3,4,5;4;2,9;2;1;1
258117072483;258117073498;1015;1,3,4,5;4;2,9;2;1;1
258117073498;258117078589;5091;1,3,4,5;4;2,9;2;1;1
258117078589;258117083298;4709;1,3,4,5;4;2,9;2;1;1
258117083298;258117084982;1684;1,3,4,5;4;2,9;2;1;1
258117084982;258117085776;794;1,3,4,5;4;2,9;2;1;1
258117085776;258117091427;5651;1,3,4,5;4;2,9;2;1;1
258117091427;258117092691;1264;1,3,4,5;4;2,9;2;1;1
258117092691;258117101320;8629;1,3,4,5;4;2,9;2;1;1
258117101320;258117102363;1043;1,3,4,5;4;2,9;2;1;1
258117102363;258117103924;1561;1,3,4,5;4;2,9;2;1;1
258117103924;258117104641;717;1,3,4,5;4;2,9;2;1;1
258117104641;258117108406;3765;1,3,4,5;4;2,9;2;1;1
258117108406;258117111597;3191;1,3,4,5;4;2,9;2;1;1
258117111597;258117111607;10;1,3,4,5;4;2,9;2;1;1
258117111607;258117111832;225;1,3,4,5;4;2,9;2;1;1
258117111832;258117113086;1254;1,3,4,5;4;2,9;2;1;1
258117113086;258117113213;127;1,3,4,5;4;2,9;2;1;1
258117113213;258117113927;714;1,3,4,5;4;2,9;2;1;1
258117113927;258117148430;34503;1,3,5;3;9;1;1;1
258117148430;258117151487;3057;1,3,5;3;9;1;1;1
258117151487;258117158760;7273;1,3,5;3;9;1;1;1
258117158760;258117162637;3877;1,3,4,5;4;2,9;2;1;1
258117162637;258117164598;1961;1,3,4,5;4;2,9;2;1;1
258117164598;258117168530;3932;1,3,4,5;4;2,9;2;1;1
258117168530;258117174454;5924;1,3,4,5;4;2,9;2;1;1
258117174454;258117178966;4512;1,3,4,5;4;2,9;2;1;1
258117178966;258117180890;1924;1,3,4,5;4;2,9;2;1;1
258117180890;258117187820;6930;1,3,4,5;4;2,9;2;1;1
258117187820;258117188297;477;1,3,4,5;4;2,9;2;1;1
258117188297;258117190689;2392;1,3,4,5;4;2,9;2;1;1
258117190689;258117192167;1478;1,3,4,5;4;2,9;2;1;1
258117192167;258117196120;3953;1,3,4,5;4;2,9;2;1;1
258117196120;258117196754;634;1,3,4,5;4;2,9;2;1;1
258117196754;258117197941;1187;1,3,4,5;4;2,9;2;1;1
258117197941;258117199394;1453;1,3,4,5;4;2,9;2;1;1
258117199394;258117199801;407;1,3,4,5;4;2,9;2;1;1
258117199801;258117206656;6855;1,3,4,5;4;2,9;2;1;1
258117206656;258117210389;3733;1,3,4,5;4;2,9;2;1;1
258117210389;258117210553;164;1,3,4,5;4;2,9;2;1;1
258117210553;258117210824;271;1,3,4,5;4;2,9;2;1;1
258117210824;258117210982;158;1,3,4,5;4;2,9;2;1;1
258117210982;258117211707;725;1,3,4,5;4;2,9;2;1;1
258117211707;258117230306;18599;1,3,5;3;9;1;1;1
258117230306;258117239745;9439;1,3,5;3;9;1;1;1
258117239745;258117257893;18148;1,3,5;3;9;1;1;1
258117257893;258117258505;612;1,3,4,5;4;2,9;2;1;1
258117258505;258117268927;10422;1,3,5;3;9;1;1;1
258117268927;258117277988;9061;1,3,5;3;9;1;1;1
258117277988;258117290763;12775;1,3,5;3;9;1;1;1
258117290763;258117292084;1321;1,3,4,5;4;2,9;2;1;1
258117292084;258117300465;8381;1,3,5;3;9;1;1;1
258117300465;258117301522;1057;1,3,5;3;9;1;1;1
258117301522;258117302218;696;1,3,5;3;9;1;1;1
258117302218;258117303332;1114;1,3,5;3;9;1;1;1
258117303332;258117311377;8045;1,3,5;3;9;1;1;1
258117311377;258117311770;393;1,3,5;3;9;1;1;1
258117311770;258117330745;18975;1,3,5;3;9;1;1;1
258117330745;258117332227;1482;1,3,5;3;9;1;1;1
258117332227;258117340394;8167;1,3,5;3;9;1;1;1
258117340394;258117340798;404;1,3,5;3;9;1;1;1
258117340798;258117370601;29803;1,3,5;3;9;1;1;1
258117370601;258117371252;651;1,3,4,5;4;2,9;2;1;1
258117371252;258117419147;47895;1,3,5;3;9;1;1;1
258117419147;258117419716;569;1,3,4,5;4;2,9;2;1;1
258117419716;258117456995;37279;1,3,5;3;9;1;1;1
258117456995;258117457558;563;1,3,4,5;4;2,9;2;1;1
258117457558;258117492998;35440;1,3,5;3;9;1;1;1
258117492998;258117493728;730;1,3,4,5;4;2,9;2;1;1
258117493728;258117618787;125059;1,3,5;3;9;1;1;1
258117618787;258117620564;1777;1,3,4,5;4;2,9;2;1;1
258117620564;258117620798;234;1,3,5;3;9;1;1;1
258117620798;258117622790;1992;1,3,4,5;4;2,9;2;1;1
258117622790;258117623620;830;1,3,5;3;9;1;1;1
258117623620;258117624884;1264;1,3,4,5;4;2,9;2;1;1
258117624884;258117626279;1395;1,3,5;3;9;1;1;1
258117626279;258117629096;2817;1,3,4,5;4;2,9;2;1;1
258117629096;258117631446;2350;1,3,5;3;9;1;1;1
258117631446;258117632000;554;1,3,4,5;4;2,9;2;1;1
258117632000;258117634928;2928;1,3,4,5;4;2,9;2;1;1
258117634928;258117635176;248;1,3,4,5;4;2,9;2;1;1
258117635176;258117635507;331;1,3,4,5;4;2,9;2;1;1
258117635507;258117637380;1873;1,3,4,5;4;2,9;2;1;1
258117637380;258117639211;1831;1,3,4,5;4;2,9;2;1;1
258117639211;258117648826;9615;1,3,4,5;4;2,9;2;1;1
258117648826;258117649581;755;1,3,4,5;4;2,9;2;1;1
258117649581;258117650024;443;1,3,4,5;4;2,9;2;1;1
258117650024;258117653296;3272;1,3,5;3;9;1;1;1
258117653296;258117653939;643;1,3,4,5;4;2,9;2;1;1
258117653939;258117713111;59172;1,3,5;3;9;1;1;1
258117713111;258117716630;3519;1,3,4,5;4;2,9;2;1;1
258117716630;258117763139;46509;1,3,5;3;9;1;1;1
258117763139;258117772057;8918;1,3,5;3;9;1;1;1
258117772057;258117793820;21763;1,3,5;3;9;1;1;1
258117793820;258117795203;1383;1,3,4,5;4;2,9;2;1;1
258117795203;258117796596;1393;1,3,4,5;4;2,9;2;1;1
258117796596;258117797370;774;1,3,4,5;4;2,9;2;1;1
258117797370;258117798080;710;1,3,4,5;4;2,9;2;1;1
258117798080;258117799148;1068;1,3,4,5;4;2,9;2;1;1
258117799148;258117800267;1119;1,3,5;3;9;1;1;1
258117800267;258117801105;838;1,3,4,5;4;2,9;2;1;1
258117801105;258117802793;1688;1,3,4,5;4;2,9;2;1;1
258117802793;258117803373;580;1,3,4,5;4;2,9;2;1;1
258117803373;258117806860;3487;1,3,5;3;9;1;1;1
258117806860;258117815186;8326;1,3,5;3;9;1;1;1
258117815186;258117860911;45725;1,3,5;3;9;1;1;1
258117860911;258117863772;2861;1,3,5;3;9;1;1;1
258117863772;258117891450;27678;1,3,5;3;9;1;1;1
258117891450;258117892708;1258;1,3,4,5;4;2,9;2;1;1
258117892708;258117893777;1069;1,3,4,5;4;2,9;2;1;1
258117893777;258117897629;3852;1,3,4,5;4;2,9;2;1;1
258117897629;258117899918;2289;1,3,4,5;4;2,9;2;1;1
258117899918;258117901426;1508;1,3,4,5;4;2,9;2;1;1
258117901426;258117901559;133;1,3,4,5;4;2,9;2;1;1
258117901559;258117904444;2885;1,3,4,5;4;2,9;2;1;1
258117904444;258117905189;745;1,3,4,5;4;2,9;2;1;1
258117905189;258117908876;3687;1,3,4,5;4;2,9;2;1;1
258117908876;258117909534;658;1,3,4,5;4;2,9;2;1;1
258117909534;258117915928;6394;1,3,4,5;4;2,9;2;1;1
258117915928;258117918154;2226;1,3,4,5;4;2,9;2;1;1
258117918154;258117925422;7268;1,3,4,5;4;2,9;2;1;1
258117925422;258117954338;28916;1,3,5;3;9;1;1;1
258117954338;258117955173;835;1,3,5;3;9;1;1;1
258117955173;258117963917;8744;1,3,5;3;9;1;1;1
258117963917;258117964568;651;1,3,5;3;9;1;1;1
258117964568;258117975617;11049;1,3,5;3;9;1;1;1
258117975617;258117978601;2984;1,3,5;3;9;1;1;1
258117978601;258118017801;39200;1,3,5;3;9;1;1;1
258118017801;258118018724;923;1,3,5;3;9;1;1;1
258118018724;258118024182;5458;1,3,5;3;9;1;1;1
258118024182;258118029097;4915;1,3,5;3;9;1;1;1
258118029097;258118035963;6866;1,3,5;3;9;1;1;1
258118035963;258118036160;197;1,3,5;3;9;1;1;1
258118036160;258118037061;901;1,3,5;3;9;1;1;1
258118037061;258118045648;8587;1,3,5;3;9;1;1;1
258118045648;258118108616;62968;1,3,5;3;9;1;1;1
258118108616;258118111395;2779;1,3,5;3;9;1;1;1
258118111395;258118147618;36223;1,3,5;3;9;1;1;1
258118147618;258118156477;8859;1,3,5;3;9;1;1;1
258118156477;258118216618;60141;1,3,5;3;9;1;1;1
258118216618;258118223856;7238;1,3,5;3;9;1;1;1
258118223856;258118224457;601;1,3,5;3;9;1;1;1
258118224457;258118226240;1783;1,3,5;3;9;1;1;1
258118226240;258118227158;918;1,3,5;3;9;1;1;1
258118227158;258118233850;6692;1,3,5;3;9;1;1;1
258118233850;258118262685;28835;1,3,5;3;9;1;1;1
258118262685;258118271891;9206;1,3,5;3;9;1;1;1
258118271891;258118288783;16892;1,3,5;3;9;1;1;1
258118288783;258118291513;2730;1,3,5;3;9;1;1;1
258118291513;258118363664;72151;1,3,5;3;9;1;1;1
258118363664;258118372587;8923;1,3,5;3;9;1;1;1
258118372587;258118420280;47693;1,3,5;3;9;1;1;1
258118420280;258118428972;8692;1,3,5;3;9;1;1;1
258118428972;258118469723;40751;1,3,5;3;9;1;1;1
258118469723;258118479113;9390;1,3,5;3;9;1;1;1
258118479113;258118482435;3322;1,3,5;3;9;1;1;1
258118482435;258118482731;296;1,3,5;3;9;1;1;1
258118482731;258118492063;9332;1,3,5;3;9;1;1;1
258118492063;258118492670;607;1,3,5;3;9;1;1;1
258118492670;258118496308;3638;1,3,5;3;9;1;1;1
258118496308;258118499247;2939;1,3,5;3;9;1;1;1
258118499247;258118534757;35510;1,3,5;3;9;1;1;1
258118534757;258118543294;8537;1,3,5;3;9;1;1;1
258118543294;258118587619;44325;1,3,5;3;9;1;1;1
258118587619;258118596256;8637;1,3,5;3;9;1;1;1
258118596256;258118618128;21872;1,3,5;3;9;1;1;1
258118618128;258118621461;3333;1,3,5;3;9;1;1;1
258118621461;258118660250;38789;1,3,5;3;9;1;1;1
258118660250;258118660923;673;1,3,5;3;9;1;1;1
258118660923;258118670120;9197;1,3,5;3;9;1;1;1
258118670120;258118671176;1056;1,3,5;3;9;1;1;1
258118671176;258118671998;822;1,3,5;3;9;1;1;1
258118671998;258118677126;5128;1,3,5;3;9;1;1;1
258118677126;258118679734;2608;1,3,5;3;9;1;1;1
258118679734;258118686408;6674;1,3,5;3;9;1;1;1
258118686408;258118708091;21683;1,3,5;3;9;1;1;1
258118708091;258118710977;2886;1,3,5;3;9;1;1;1
258118710977;258118748314;37337;1,3,5;3;9;1;1;1
258118748314;258118757581;9267;1,3,5;3;9;1;1;1
258118757581;258118788575;30994;1,3,5;3;9;1;1;1
258118788575;258118793161;4586;1,3,5;3;9;1;1;1
258118793161;258118793838;677;1,3,5;3;9;1;1;1
258118793838;258118796350;2512;1,3,5;3;9;1;1;1
258118796350;258118838420;42070;1,3,5;3;9;1;1;1
258118838420;258118847617;9197;1,3,5;3;9;1;1;1
258118847617;258118881773;34156;1,3,5;3;9;1;1;1
258118881773;258118890323;8550;1,3,5;3;9;1;1;1
258118890323;258118917526;27203;1,3,5;3;9;1;1;1
258118917526;258118920334;2808;1,3,5;3;9;1;1;1
258118920334;258118957440;37106;1,3,5;3;9;1;1;1
258118957440;258118966273;8833;1,3,5;3;9;1;1;1
258118966273;258118999129;32856;1,3,5;3;9;1;1;1
258118999129;258119000533;1404;1,3,5;3;9;1;1;1
258119000533;258119002487;1954;1,3,5;3;9;1;1;1
258119002487;258119003847;1360;1,3,5;3;9;1;1;1
258119003847;258119018655;14808;1,3,5;3;9;1;1;1
258119018655;258119023019;4364;1,3,5;3;9;1;1;1
258119023019;258119095033;72014;1,3,5;3;9;1;1;1
258119095033;258119103914;8881;1,3,5;3;9;1;1;1
258119103914;258119135636;31722;1,3,5;3;9;1;1;1
258119135636;258119144391;8755;1,3,5;3;9;1;1;1
258119144391;258119184875;40484;1,3,5;3;9;1;1;1
258119184875;258119188634;3759;1,3,5;3;9;1;1;1
258119188634;258119188813;179;1,3,5;3;9;1;1;1
258119188813;258119193092;4279;1,3,5;3;9;1;1;1
258119193092;258119193644;552;1,3,5;3;9;1;1;1
258119193644;258119194132;488;1,3,5;3;9;1;1;1
258119194132;258119195898;1766;1,3,5;3;9;1;1;1
258119195898;258119196457;559;1,3,5;3;9;1;1;1
258119196457;258119197781;1324;1,3,5;3;9;1;1;1
258119197781;258119205038;7257;1,3,5;3;9;1;1;1
258119205038;258119234939;29901;1,3,5;3;9;1;1;1
258119234939;258119243282;8343;1,3,5;3;9;1;1;1
258119243282;258119292236;48954;1,3,5;3;9;1;1;1
258119292236;258119301683;9447;1,3,5;3;9;1;1;1
258119301683;258119338580;36897;1,3,5;3;9;1;1;1
258119338580;258119341480;2900;1,3,5;3;9;1;1;1
258119341480;258119379385;37905;1,3,5;3;9;1;1;1
258119379385;258119388425;9040;1,3,5;3;9;1;1;1
258119388425;258119390963;2538;1,3,5;3;9;1;1;1
258119390963;258119393225;2262;1,3,5;3;9;1;1;1
258119393225;258119394281;1056;1,3,5;3;9;1;1;1
258119394281;258119396202;1921;1,3,5;3;9;1;1;1
258119396202;258119430824;34622;1,3,5;3;9;1;1;1
258119430824;258119432987;2163;1,3,5;3;9;1;1;1
258119432987;258119439728;6741;1,3,5;3;9;1;1;1
258119439728;258119440102;374;1,3,5;3;9;1;1;1
258119440102;258119467146;27044;1,3,5;3;9;1;1;1
258119467146;258119470116;2970;1,3,5;3;9;1;1;1
258119470116;258119518677;48561;1,3,5;3;9;1;1;1
258119518677;258119527236;8559;1,3,5;3;9;1;1;1
258119527236;258119560734;33498;1,3,5;3;9;1;1;1
258119560734;258119570222;9488;1,3,5;3;9;1;1;1
258119570222;258119598669;28447;1,3,5;3;9;1;1;1
258119598669;258119606108;7439;1,3,5;3;9;1;1;1
258119606108;258119607420;1312;1,3,5;3;9;1;1;1
258119607420;258119616304;8884;1,3,5;3;9;1;1;1
258119616304;258119793826;177522;1,3,5;3;9;1;1;1
258119793826;258119799486;5660;1,3,5;3;9;1;1;1
258119799486;258119801670;2184;1,3,5;3;9;1;1;1
258119801670;258119802937;1267;1,3,5;3;9;1;1;1
258119802937;258119857678;54741;1,3,5;3;9;1;1;1
258119857678;258119858198;520;1,3,5;3;9;1;1;1
258119858198;258119858818;620;1,3,5;3;9;1;1;1
258119858818;258119860522;1704;1,3,5;3;9;1;1;1
258119860522;258119861408;886;1,3,5;3;9;1;1;1
258119861408;258119861531;123;1,3,5;3;9;1;1;1
258119861531;258119899491;37960;1,3,5;3;9;1;1;1
258119899491;258119900213;722;1,3,5;3;9;1;1;1
258119900213;258119908083;7870;1,3,5;3;9;1;1;1
258119908083;258119909035;952;1,3,5;3;9;1;1;1
258119909035;258119937578;28543;1,3,5;3;9;1;1;1
258119937578;258119940469;2891;1,3,5;3;9;1;1;1
258119940469;258119941779;1310;1,3,5;3;9;1;1;1
258119941779;258119942263;484;1,3,5;3;9;1;1;1
258119942263;258119950863;8600;1,3,5;3;9;1;1;1
258119950863;258119951524;661;1,3,5;3;9;1;1;1
258119951524;258119979629;28105;1,3,5;3;9;1;1;1
258119979629;258119989109;9480;1,3,5;3;9;1;1;1
258119989109;258120010695;21586;1,3,5;3;9;1;1;1
258120010695;258120017714;7019;1,3,4,5;4;2,9;2;1;1
258120017714;258120018012;298;1,3,4,5;4;2,9;2;1;1
258120018012;258120020287;2275;1,3,5;3;9;1;1;1
258120020287;258120027214;6927;1,3,5;3;9;1;1;1
258120027214;258120027816;602;1,3,5;3;9;1;1;1
258120027816;258120102938;75122;1,3,5;3;9;1;1;1
258120102938;258120103596;658;1,3,4,5;4;2,9;2;1;1
258120103596;258120143986;40390;1,3,5;3;9;1;1;1
258120143986;258120144621;635;1,3,4,5;4;2,9;2;1;1
258120144621;258120190169;45548;1,3,5;3;9;1;1;1
258120190169;258120191068;899;1,3,4,5;4;2,9;2;1;1
258120191068;258120196439;5371;1,3,5;3;9;1;1;1
258120196439;258120199383;2944;1,3,5;3;9;1;1;1
258120199383;258120206270;6887;1,3,5;3;9;1;1;1
258120206270;258120209277;3007;1,3,5;3;9;1;1;1
258120209277;258120241464;32187;1,3,5;3;9;1;1;1
258120241464;258120242023;559;1,3,4,5;4;2,9;2;1;1
258120242023;258120248039;6016;1,3,5;3;9;1;1;1
258120248039;258120256355;8316;1,3,5;3;9;1;1;1
258120256355;258120257864;1509;1,3,5;3;9;1;1;1
258120257864;258120266795;8931;1,3,5;3;9;1;1;1
258120266795;258120267323;528;1,3,5;3;9;1;1;1
258120267323;258120269523;2200;1,3,5;3;9;1;1;1
258120269523;258120270597;1074;1,3,5;3;9;1;1;1
258120270597;258120272707;2110;1,3,5;3;9;1;1;1
258120272707;258120308113;35406;1,3,5;3;9;1;1;1
258120308113;258120316932;8819;1,3,5;3;9;1;1;1
258120316932;258120334833;17901;1,3,5;3;9;1;1;1
258120334833;258120344053;9220;1,3,5;3;9;1;1;1
258120344053;258120359150;15097;1,3,5;3;9;1;1;1
258120359150;258120360757;1607;1,3,4,5;4;2,9;2;1;1
258120360757;258120377599;16842;1,3,5;3;9;1;1;1
258120377599;258120386400;8801;1,3,5;3;9;1;1;1
258120386400;258120417032;30632;1,3,5;3;9;1;1;1
258120417032;258120417663;631;1,3,4,5;4;2,9;2;1;1
258120417663;258120498244;80581;1,3,5;3;9;1;1;1
258120498244;258120499238;994;1,3,5;3;9;1;1;1
258120499238;258120503218;3980;1,3,5;3;9;1;1;1
258120503218;258120504074;856;1,3,5;3;9;1;1;1
258120504074;258120504588;514;1,3,5;3;9;1;1;1
258120504588;258120504995;407;1,3,5;3;9;1;1;1
258120504995;258120507216;2221;1,3,5;3;9;1;1;1
258120507216;258120513428;6212;1,3,5;3;9;1;1;1
258120513428;258120545797;32369;1,3,5;3;9;1;1;1
258120545797;258120548511;2714;1,3,5;3;9;1;1;1
258120548511;258120599322;50811;1,3,5;3;9;1;1;1
258120599322;258120608481;9159;1,3,5;3;9;1;1;1
258120608481;258120608669;188;1,3,5;3;9;1;1;1
258120608669;258120618802;10133;1,3,5;3;9;1;1;1
258120618802;258120621480;2678;1,3,5;3;9;1;1;1
258120621480;258120630934;9454;1,3,5;3;9;1;1;1
258120630934;258120634146;3212;1,3,5;3;9;1;1;1
258120634146;258120643000;8854;1,3,5;3;9;1;1;1
258120643000;258120652821;9821;1,3,5;3;9;1;1;1
258120652821;258120653432;611;1,3,4,5;4;2,9;2;1;1
258120653432;258120676861;23429;1,3,5;3;9;1;1;1
258120676861;258120679808;2947;1,3,5;3;9;1;1;1
258120679808;258120709758;29950;1,3,5;3;9;1;1;1
258120709758;258120711369;1611;1,3,4,5;4;2,9;2;1;1
258120711369;258120721763;10394;1,3,5;3;9;1;1;1
258120721763;258120724751;2988;1,3,5;3;9;1;1;1
258120724751;258120756385;31634;1,3,5;3;9;1;1;1
258120756385;258120761368;4983;1,3,4,5;4;2,9;2;1;1
258120761368;258120800179;38811;1,3,5;3;9;1;1;1
258120800179;258120800381;202;1,3,5;3;9;1;1;1
258120800381;258120805374;4993;1,3,5;3;9;1;1;1
258120805374;258120808655;3281;1,3,4,5;4;2,9;2;1;1
258120808655;258120809685;1030;1,3,4,5;4;2,9;2;1;1
258120809685;258120815139;5454;1,3,5;3;9;1;1;1
258120815139;258120828016;12877;1,3,5;3;9;1;1;1
258120828016;258120837181;9165;1,3,5;3;9;1;1;1
258120837181;258120858953;21772;1,3,5;3;9;1;1;1
258120858953;258120867921;8968;1,3,5;3;9;1;1;1
258120867921;258120936632;68711;1,3,5;3;9;1;1;1
258120936632;258120939354;2722;1,3,5;3;9;1;1;1
258120939354;258120976636;37282;1,3,5;3;9;1;1;1
258120976636;258120979611;2975;1,3,5;3;9;1;1;1
258120979611;258121008612;29001;1,3,5;3;9;1;1;1
258121008612;258121009332;720;1,3,4,5;4;2,9;2;1;1
258121009332;258121027946;18614;1,3,5;3;9;1;1;1
258121027946;258121037670;9724;1,3,5;3;9;1;1;1
258121037670;258121047799;10129;1,3,5;3;9;1;1;1
258121047799;258121056434;8635;1,3,5;3;9;1;1;1
258121056434;258121061114;4680;1,3,5;3;9;1;1;1
258121061114;258121063959;2845;1,3,5;3;9;1;1;1
258121063959;258121086883;22924;1,3,5;3;9;1;1;1
258121086883;258121091298;4415;1,3,4,5;4;2,9;2;1;1
258121091298;258121091752;454;1,3,4,5;4;2,9;2;1;1
258121091752;258121092267;515;1,3,5;3;9;1;1;1
258121092267;258121092865;598;1,3,4,5;4;2,9;2;1;1
258121092865;258121099650;6785;1,3,5;3;9;1;1;1
258121099650;258121124219;24569;1,3,5;3;9;1;1;1
258121124219;258121124806;587;1,3,4,5;4;2,9;2;1;1
258121124806;258121128895;4089;1,3,5;3;9;1;1;1
258121128895;258121137405;8510;1,3,5;3;9;1;1;1
258121137405;258121174482;37077;1,3,5;3;9;1;1;1
258121174482;258121175031;549;1,3,4,5;4;2,9;2;1;1
258121175031;258121204766;29735;1,3,5;3;9;1;1;1
258121204766;258121213536;8770;1,3,5;3;9;1;1;1
258121213536;258121234019;20483;1,3,5;3;9;1;1;1
258121234019;258121234646;627;1,3,4,5;4;2,9;2;1;1
258121234646;258121241888;7242;1,3,5;3;9;1;1;1
258121241888;258121251253;9365;1,3,5;3;9;1;1;1
258121251253;258121281247;29994;1,3,5;3;9;1;1;1
258121281247;258121284278;3031;1,3,5;3;9;1;1;1
258121284278;258121291181;6903;1,3,5;3;9;1;1;1
258121291181;258121293929;2748;1,3,5;3;9;1;1;1
258121293929;258121330451;36522;1,3,5;3;9;1;1;1
258121330451;258121331616;1165;1,3,4,5;4;2,9;2;1;1
258121331616;258121353767;22151;1,3,5;3;9;1;1;1
258121353767;258121358759;4992;1,3,5;3;9;1;1;1
258121358759;258121359391;632;1,3,5;3;9;1;1;1
258121359391;258121360942;1551;1,3,5;3;9;1;1;1
258121360942;258121362492;1550;1,3,5;3;9;1;1;1
258121362492;258121364805;2313;1,3,5;3;9;1;1;1
258121364805;258121365768;963;1,3,5;3;9;1;1;1
258121365768;258121366836;1068;1,3,5;3;9;1;1;1
258121366836;258121366873;37;1,3,5;3;9;1;1;1
258121366873;258121376599;9726;1,3,5;3;9;1;1;1
258121376599;258121377659;1060;1,3,5;3;9;1;1;1
258121377659;258121381085;3426;1,3,5;3;9;1;1;1
258121381085;258121382823;1738;1,3,5;3;9;1;1;1
258121382823;258121389299;6476;1,3,5;3;9;1;1;1
258121389299;258121390210;911;1,3,4,5;4;2,9;2;1;1
258121390210;258121391517;1307;1,3,5;3;9;1;1;1
258121391517;258121432787;41270;1,3,5;3;9;1;1;1
258121432787;258121433738;951;1,3,5;3;9;1;1;1
258121433738;258121441483;7745;1,3,4,5;4;2,9;2;1;1
258121441483;258121469762;28279;1,3,4,5;4;2,9;2;1;1
258121469762;258121473223;3461;1,3,5;3;9;1;1;1
258121473223;258121481703;8480;1,3,5;3;9;1;1;1
258121481703;258121497755;16052;1,3,5;3;9;1;1;1
258121497755;258121498380;625;1,3,4,5;4;2,9;2;1;1
258121498380;258121552157;53777;1,3,5;3;9;1;1;1
258121552157;258121561231;9074;1,3,5;3;9;1;1;1
258121561231;258121562523;1292;1,3,5;3;9;1;1;1
258121562523;258121572446;9923;1,3,5;3;9;1;1;1
258121572446;258121600848;28402;1,3,5;3;9;1;1;1
258121600848;258121601879;1031;1,3,4,5;4;2,9;2;1;1
258121601879;258121602845;966;1,3,4,5;4;2,9;2;1;1
258121602845;258121604546;1701;1,3,5;3;9;1;1;1
258121604546;258121605098;552;1,3,5;3;9;1;1;1
258121605098;258121608292;3194;1,3,5;3;9;1;1;1
258121608292;258121644392;36100;1,3,5;3;9;1;1;1
258121644392;258121645046;654;1,3,4,5;4;2,9;2;1;1
258121645046;258121682813;37767;1,3,5;3;9;1;1;1
258121682813;258121686123;3310;1,3,5;3;9;1;1;1
258121686123;258121694055;7932;1,3,5;3;9;1;1;1
258121694055;258121695187;1132;1,3,4,5;4;2,9;2;1;1
258121695187;258121722627;27440;1,3,5;3;9;1;1;1
258121722627;258121732134;9507;1,3,5;3;9;1;1;1
258121732134;258121760039;27905;1,3,5;3;9;1;1;1
258121760039;258121760825;786;1,3,5;3;9;1;1;1
258121760825;258121763809;2984;1,3,5;3;9;1;1;1
258121763809;258121764373;564;1,3,4,5;4;2,9;2;1;1
258121764373;258121768874;4501;1,3,5;3;9;1;1;1
258121768874;258121775947;7073;1,3,5;3;9;1;1;1
258121775947;258121787950;12003;1,3,5;3;9;1;1;1
258121787950;258121796498;8548;1,3,5;3;9;1;1;1
258121796498;258121811376;14878;1,3,5;3;9;1;1;1
258121811376;258121812051;675;1,3,4,5;4;2,9;2;1;1
258121812051;258121824093;12042;1,3,5;3;9;1;1;1
258121824093;258121824826;733;1,3,5;3;9;1;1;1
258121824826;258121826971;2145;1,3,5;3;9;1;1;1
258121826971;258121833605;6634;1,3,5;3;9;1;1;1
258121833605;258121835841;2236;1,3,5;3;9;1;1;1
258121835841;258121844260;8419;1,3,5;3;9;1;1;1
258121844260;258121871060;26800;1,3,5;3;9;1;1;1
258121871060;258121881146;10086;1,3,5;3;9;1;1;1
258121881146;258121899318;18172;1,3,5;3;9;1;1;1
258121899318;258121900151;833;1,3,4,5;4;2,9;2;1;1
258121900151;258121954070;53919;1,3,5;3;9;1;1;1
258121954070;258121954756;686;1,3,4,5;4;2,9;2;1;1
258121954756;258121982331;27575;1,3,5;3;9;1;1;1
258121982331;258121984858;2527;1,3,5;3;9;1;1;1
258121984858;258121985367;509;1,3,5;3;9;1;1;1
258121985367;258121986224;857;1,3,5;3;9;1;1;1
258121986224;258121988312;2088;1,3,5;3;9;1;1;1
258121988312;258121989234;922;1,3,5;3;9;1;1;1
258121989234;258122070243;81009;1,3,5;3;9;1;1;1
258122070243;258122073401;3158;1,3,5;3;9;1;1;1
258122073401;258122073417;16;1,3,4,5;4;2,9;2;1;1
258122073417;258122074528;1111;1,3,4,5;4;2,9;2;1;1
258122074528;258122077827;3299;1,3,5;3;9;1;1;1
258122077827;258122078423;596;1,3,4,5;4;2,9;2;1;1
258122078423;258122078504;81;1,3,5;3;9;1;1;1
258122078504;258122079340;836;1,3,4,5;4;2,9;2;1;1
258122079340;258122111509;32169;1,3,5;3;9;1;1;1
258122111509;258122120140;8631;1,3,5;3;9;1;1;1
258122120140;258122122442;2302;1,3,5;3;9;1;1;1
258122122442;258122131606;9164;1,3,5;3;9;1;1;1
258122131606;258122134136;2530;1,3,5;3;9;1;1;1
258122134136;258122135059;923;1,3,4,5;4;2,9;2;1;1
258122135059;258122169517;34458;1,3,5;3;9;1;1;1
258122169517;258122172328;2811;1,3,5;3;9;1;1;1
258122172328;258122184408;12080;1,3,5;3;9;1;1;1
258122184408;258122187491;3083;1,3,4,5;4;2,9;2;1;1
258122187491;258122196082;8591;1,3,4,5;4;2,9;2;1;1
258122196082;258122213418;17336;1,3,4,5;4;2,9;2;1;1
258122213418;258122233244;19826;1,3,5;3;9;1;1;1
258122233244;258122236752;3508;1,3,5;3;9;1;1;1
258122236752;258122237390;638;1,3,4,5;4;2,9;2;1;1
258122237390;258122242727;5337;1,3,5;3;9;1;1;1
258122242727;258122277339;34612;1,3,5;3;9;1;1;1
258122277339;258122280053;2714;1,3,5;3;9;1;1;1
258122280053;258122310496;30443;1,3,5;3;9;1;1;1
258122310496;258122313119;2623;1,3,5;3;9;1;1;1
258122313119;258122319958;6839;1,3,5;3;9;1;1;1
258122319958;258122320526;568;1,3,4,5;4;2,9;2;1;1
258122320526;258122341649;21123;1,3,5;3;9;1;1;1
258122341649;258122350439;8790;1,3,5;3;9;1;1;1
258122350439;258122382242;31803;1,3,5;3;9;1;1;1
258122382242;258122383447;1205;1,3,4,5;4;2,9;2;1;1
258122383447;258122432005;48558;1,3,5;3;9;1;1;1
258122432005;258122440766;8761;1,3,5;3;9;1;1;1
258122440766;258122458614;17848;1,3,5;3;9;1;1;1
258122458614;258122459247;633;1,3,4,5;4;2,9;2;1;1
258122459247;258122472664;13417;1,3,5;3;9;1;1;1
258122472664;258122474917;2253;1,3,5;3;9;1;1;1
258122474917;258122481305;6388;1,3,5;3;9;1;1;1
258122481305;258122482969;1664;1,3,5;3;9;1;1;1
258122482969;258122483864;895;1,3,5;3;9;1;1;1
258122483864;258122485108;1244;1,3,5;3;9;1;1;1
258122485108;258122493227;8119;1,3,5;3;9;1;1;1
258122493227;258122494302;1075;1,3,5;3;9;1;1;1
258122494302;258122501496;7194;1,3,5;3;9;1;1;1
258122501496;258122503427;1931;1,3,5;3;9;1;1;1
258122503427;258122525581;22154;1,3,5;3;9;1;1;1
258122525581;258122526228;647;1,3,4,5;4;2,9;2;1;1
258122526228;258122533895;7667;1,3,5;3;9;1;1;1
258122533895;258122536028;2133;1,3,5;3;9;1;1;1
258122536028;258122537285;1257;1,3,5;3;9;1;1;1
258122537285;258122538887;1602;1,3,5;3;9;1;1;1
258122538887;258122553190;14303;1,3,5;3;9;1;1;1
258122553190;258122553727;537;1,3,4,5;4;2,9;2;1;1
258122553727;258122572433;18706;1,3,5;3;9;1;1;1
258122572433;258122581219;8786;1,3,5;3;9;1;1;1
258122581219;258122601573;20354;1,3,5;3;9;1;1;1
258122601573;258122604604;3031;1,3,5;3;9;1;1;1
258122604604;258122609784;5180;1,3,5;3;9;1;1;1
258122609784;258122610703;919;1,3,4,5;4;2,9;2;1;1
258122610703;258122659482;48779;1,3,5;3;9;1;1;1
258122659482;258122660102;620;1,3,4,5;4;2,9;2;1;1
258122660102;258122666672;6570;1,3,5;3;9;1;1;1
258122666672;258122675250;8578;1,3,5;3;9;1;1;1
258122675250;258122707397;32147;1,3,5;3;9;1;1;1
258122707397;258122710462;3065;1,3,5;3;9;1;1;1
258122710462;258122722326;11864;1,3,5;3;9;1;1;1
258122722326;258122722873;547;1,3,4,5;4;2,9;2;1;1
258122722873;258122768999;46126;1,3,5;3;9;1;1;1
258122768999;258122769800;801;1,3,4,5;4;2,9;2;1;1
258122769800;258122779171;9371;1,3,5;3;9;1;1;1
258122779171;258122788752;9581;1,3,5;3;9;1;1;1
258122788752;258122809195;20443;1,3,5;3;9;1;1;1
258122809195;258122817559;8364;1,3,5;3;9;1;1;1
258122817559;258122821196;3637;1,3,5;3;9;1;1;1
258122821196;258122824802;3606;1,3,5;3;9;1;1;1
258122824802;258122824833;31;1,3,5;3;9;1;1;1
258122824833;258122827748;2915;1,3,5;3;9;1;1;1
258122827748;258122832071;4323;1,3,5;3;9;1;1;1
258122832071;258122841529;9458;1,3,5;3;9;1;1;1
258122841529;258122857597;16068;1,3,5;3;9;1;1;1
258122857597;258122858492;895;1,3,4,5;4;2,9;2;1;1
258122858492;258122882389;23897;1,3,5;3;9;1;1;1
258122882389;258122891088;8699;1,3,5;3;9;1;1;1
258122891088;258122905612;14524;1,3,5;3;9;1;1;1
258122905612;258122906249;637;1,3,4,5;4;2,9;2;1;1
258122906249;258122911810;5561;1,3,5;3;9;1;1;1
258122911810;258122914443;2633;1,3,5;3;9;1;1;1
258122914443;258122986243;71800;1,3,5;3;9;1;1;1
258122986243;258122987297;1054;1,3,4,5;4;2,9;2;1;1
258122987297;258123009716;22419;1,3,5;3;9;1;1;1
258123009716;258123010276;560;1,3,4,5;4;2,9;2;1;1
258123010276;258123061226;50950;1,3,5;3;9;1;1;1
258123061226;258123069777;8551;1,3,5;3;9;1;1;1
258123069777;258123100702;30925;1,3,5;3;9;1;1;1
258123100702;258123102637;1935;1,3,5;3;9;1;1;1
258123102637;258123103915;1278;1,3,5;3;9;1;1;1
258123103915;258123105873;1958;1,3,5;3;9;1;1;1
258123105873;258123117454;11581;1,3,5;3;9;1;1;1
258123117454;258123118006;552;1,3,4,5;4;2,9;2;1;1
258123118006;258123173216;55210;1,3,5;3;9;1;1;1
258123173216;258123182488;9272;1,3,5;3;9;1;1;1
258123182488;258123185108;2620;1,3,5;3;9;1;1;1
258123185108;258123194138;9030;1,3,5;3;9;1;1;1
258123194138;258123195766;1628;1,3,5;3;9;1;1;1
258123195766;258123199106;3340;1,3,5;3;9;1;1;1
258123199106;258123199680;574;1,3,5;3;9;1;1;1
258123199680;258123203452;3772;1,3,5;3;9;1;1;1
258123203452;258123203601;149;1,3,5;3;9;1;1;1
258123203601;258123204846;1245;1,3,5;3;9;1;1;1
258123204846;258123207040;2194;1,3,5;3;9;1;1;1
258123207040;258123207621;581;1,3,5;3;9;1;1;1
258123207621;258123208375;754;1,3,5;3;9;1;1;1
258123208375;258123209849;1474;1,3,5;3;9;1;1;1
258123209849;258123210415;566;1,3,5;3;9;1;1;1
258123210415;258123211206;791;1,3,4,5;4;2,9;2;1;1
258123211206;258123246744;35538;1,3,5;3;9;1;1;1
258123246744;258123255983;9239;1,3,5;3;9;1;1;1
258123255983;258123285537;29554;1,3,5;3;9;1;1;1
258123285537;258123294446;8909;1,3,5;3;9;1;1;1
258123294446;258123322682;28236;1,3,5;3;9;1;1;1
258123322682;258123324783;2101;1,3,5;3;9;1;1;1
258123324783;258123326044;1261;1,3,5;3;9;1;1;1
258123326044;258123328027;1983;1,3,5;3;9;1;1;1
258123328027;258123363294;35267;1,3,5;3;9;1;1;1
258123363294;258123371895;8601;1,3,5;3;9;1;1;1
258123371895;258123372420;525;1,3,5;3;9;1;1;1
258123372420;258123373215;795;1,3,4,5;4;2,9;2;1;1
258123373215;258123402899;29684;1,3,5;3;9;1;1;1
258123402899;258123411665;8766;1,3,5;3;9;1;1;1
258123411665;258123421950;10285;1,3,5;3;9;1;1;1
258123421950;258123422701;751;1,3,4,5;4;2,9;2;1;1
258123422701;258123433833;11132;1,3,5;3;9;1;1;1
258123433833;258123442422;8589;1,3,5;3;9;1;1;1
258123442422;258123476164;33742;1,3,5;3;9;1;1;1
258123476164;258123480945;4781;1,3,4,5;4;2,9;2;1;1
258123480945;258123522498;41553;1,3,5;3;9;1;1;1
258123522498;258123526092;3594;1,3,4,5;4;2,9;2;1;1
258123526092;258123528823;2731;1,3,4,5;4;2,9;2;1;1
258123528823;258123557193;28370;1,3,4,5;4;2,9;2;1;1
258123557193;258123567789;10596;1,3,5;3;9;1;1;1
258123567789;258123568137;348;1,3,5;3;9;1;1;1
258123568137;258123570429;2292;1,3,5;3;9;1;1;1
258123570429;258123578281;7852;1,3,5;3;9;1;1;1
258123578281;258123597756;19475;1,3,5;3;9;1;1;1
258123597756;258123598305;549;1,3,4,5;4;2,9;2;1;1
258123598305;258123606772;8467;1,3,5;3;9;1;1;1
258123606772;258123608942;2170;1,3,5;3;9;1;1;1
258123608942;258123610424;1482;1,3,5;3;9;1;1;1
258123610424;258123612051;1627;1,3,5;3;9;1;1;1
258123612051;258123616793;4742;1,3,5;3;9;1;1;1
258123616793;258123626669;9876;1,3,5;3;9;1;1;1
258123626669;258123658007;31338;1,3,5;3;9;1;1;1
258123658007;258123666532;8525;1,3,5;3;9;1;1;1
258123666532;258123696799;30267;1,3,5;3;9;1;1;1
258123696799;258123698178;1379;1,3,5;3;9;1;1;1
258123698178;258123706206;8028;1,3,5;3;9;1;1;1
258123706206;258123706898;692;1,3,5;3;9;1;1;1
258123706898;258123707836;938;1,3,5;3;9;1;1;1
258123707836;258123711151;3315;1,3,5;3;9;1;1;1
258123711151;258123713168;2017;1,3,4,5;4;2,9;2;1;1
258123713168;258123714801;1633;1,3,5;3;9;1;1;1
258123714801;258123739287;24486;1,3,5;3;9;1;1;1
258123739287;258123739860;573;1,3,4,5;4;2,9;2;1;1
258123739860;258123813477;73617;1,3,5;3;9;1;1;1
258123813477;258123814034;557;1,3,4,5;4;2,9;2;1;1
258123814034;258123831093;17059;1,3,5;3;9;1;1;1
258123831093;258123840429;9336;1,3,5;3;9;1;1;1
258123840429;258123890797;50368;1,3,5;3;9;1;1;1
258123890797;258123891344;547;1,3,4,5;4;2,9;2;1;1
258123891344;258123929171;37827;1,3,5;3;9;1;1;1
258123929171;258123937993;8822;1,3,5;3;9;1;1;1
258123937993;258123953835;15842;1,3,5;3;9;1;1;1
258123953835;258123955239;1404;1,3,4,5;4;2,9;2;1;1
258123955239;258123968267;13028;1,3,5;3;9;1;1;1
258123968267;258123970746;2479;1,3,5;3;9;1;1;1
258123970746;258123971056;310;1,3,5;3;9;1;1;1
258123971056;258123974116;3060;1,3,5;3;9;1;1;1
258123974116;258123982551;8435;1,3,5;3;9;1;1;1
258123982551;258123985227;2676;1,3,5;3;9;1;1;1
258123985227;258124022998;37771;1,3,5;3;9;1;1;1
258124022998;258124023701;703;1,3,5;3;9;1;1;1
258124023701;258124032058;8357;1,3,5;3;9;1;1;1
258124032058;258124039233;7175;1,3,5;3;9;1;1;1
258124039233;258124042809;3576;1,3,5;3;9;1;1;1
258124042809;258124043390;581;1,3,4,5;4;2,9;2;1;1
258124043390;258124096515;53125;1,3,5;3;9;1;1;1
258124096515;258124097173;658;1,3,4,5;4;2,9;2;1;1
258124097173;258124198446;101273;1,3,5;3;9;1;1;1
258124198446;258124199076;630;1,3,4,5;4;2,9;2;1;1
258124199076;258124248709;49633;1,3,5;3;9;1;1;1
258124248709;258124249353;644;1,3,4,5;4;2,9;2;1;1
258124249353;258124333372;84019;1,3,5;3;9;1;1;1
258124333372;258124333998;626;1,3,4,5;4;2,9;2;1;1
258124333998;258124356489;22491;1,3,5;3;9;1;1;1
258124356489;258124365388;8899;1,3,5;3;9;1;1;1
258124365388;258124380222;14834;1,3,5;3;9;1;1;1
258124380222;258124380844;622;1,3,4,5;4;2,9;2;1;1
258124380844;258124412167;31323;1,3,5;3;9;1;1;1
258124412167;258124413063;896;1,3,5;3;9;1;1;1
258124413063;258124421103;8040;1,3,5;3;9;1;1;1
258124421103;258124421490;387;1,3,5;3;9;1;1;1
258124421490;258124487175;65685;1,3,5;3;9;1;1;1
258124487175;258124496736;9561;1,3,5;3;9;1;1;1
258124496736;258124515836;19100;1,3,5;3;9;1;1;1
258124515836;258124516444;608;1,3,4,5;4;2,9;2;1;1
258124516444;258124527268;10824;1,3,5;3;9;1;1;1
258124527268;258124530346;3078;1,3,5;3;9;1;1;1
258124530346;258124543507;13161;1,3,5;3;9;1;1;1
258124543507;258124544142;635;1,3,5;3;9;1;1;1
258124544142;258124552842;8700;1,3,5;3;9;1;1;1
258124552842;258124553305;463;1,3,5;3;9;1;1;1
258124553305;258124558974;5669;1,3,5;3;9;1;1;1
258124558974;258124601688;42714;1,3,4,5;4;2,9;2;1;1
258124601688;258124604953;3265;1,3,4,5;4;2,9;2;1;1
258124604953;258124610208;5255;1,3,4,5;4;2,9;2;1;1
258124610208;258124640907;30699;1,3,5;3;9;1;1;1
258124640907;258124643901;2994;1,3,5;3;9;1;1;1
258124643901;258124670264;26363;1,3,5;3;9;1;1;1
258124670264;258124670906;642;1,3,4,5;4;2,9;2;1;1
258124670906;258124677628;6722;1,3,5;3;9;1;1;1
258124677628;258124687334;9706;1,3,5;3;9;1;1;1
258124687334;258124721650;34316;1,3,5;3;9;1;1;1
258124721650;258124724499;2849;1,3,5;3;9;1;1;1
258124724499;258124731537;7038;1,3,5;3;9;1;1;1
258124731537;258124740416;8879;1,3,5;3;9;1;1;1
258124740416;258124745076;4660;1,3,5;3;9;1;1;1
258124745076;258124745731;655;1,3,4,5;4;2,9;2;1;1
258124745731;258124751586;5855;1,3,5;3;9;1;1;1
258124751586;258124759814;8228;1,3,5;3;9;1;1;1
258124759814;258124789194;29380;1,3,5;3;9;1;1;1
258124789194;258124789823;629;1,3,4,5;4;2,9;2;1;1
258124789823;258124823248;33425;1,3,5;3;9;1;1;1
258124823248;258124826183;2935;1,3,5;3;9;1;1;1
258124826183;258124846518;20335;1,3,5;3;9;1;1;1
258124846518;258124847644;1126;1,3,4,5;4;2,9;2;1;1
258124847644;258124861610;13966;1,3,5;3;9;1;1;1
258124861610;258124871074;9464;1,3,5;3;9;1;1;1
258124871074;258124894174;23100;1,3,5;3;9;1;1;1
258124894174;258124894313;139;1,3,5;3;9;1;1;1
258124894313;258124902866;8553;1,3,5;3;9;1;1;1
258124902866;258124903923;1057;1,3,5;3;9;1;1;1
258124903923;258124938920;34997;1,3,5;3;9;1;1;1
258124938920;258124939616;696;1,3,4,5;4;2,9;2;1;1
258124939616;258124956686;17070;1,3,5;3;9;1;1;1
258124956686;258124965735;9049;1,3,5;3;9;1;1;1
258124965735;258125013593;47858;1,3,5;3;9;1;1;1
258125013593;258125014152;559;1,3,4,5;4;2,9;2;1;1
258125014152;258125021826;7674;1,3,5;3;9;1;1;1
258125021826;258125024602;2776;1,3,5;3;9;1;1;1
258125024602;258125032507;7905;1,3,5;3;9;1;1;1
258125032507;258125035439;2932;1,3,5;3;9;1;1;1
258125035439;258125044047;8608;1,3,5;3;9;1;1;1
258125044047;258125052404;8357;1,3,5;3;9;1;1;1
258125052404;258125084938;32534;1,3,5;3;9;1;1;1
258125084938;258125087972;3034;1,3,5;3;9;1;1;1
258125087972;258125088615;643;1,3,4,5;4;2,9;2;1;1
258125088615;258125094208;5593;1,3,5;3;9;1;1;1
258125094208;258125135375;41167;1,3,5;3;9;1;1;1
258125135375;258125144292;8917;1,3,5;3;9;1;1;1
258125144292;258125172938;28646;1,3,5;3;9;1;1;1
258125172938;258125175640;2702;1,3,5;3;9;1;1;1
258125175640;258125178321;2681;1,3,5;3;9;1;1;1
258125178321;258125178973;652;1,3,4,5;4;2,9;2;1;1
258125178973;258125246141;67168;1,3,5;3;9;1;1;1
258125246141;258125247311;1170;1,3,5;3;9;1;1;1
258125247311;258125248612;1301;1,3,4,5;4;2,9;2;1;1
258125248612;258125254730;6118;1,3,5;3;9;1;1;1
258125254730;258125301891;47161;1,3,5;3;9;1;1;1
258125301891;258125302488;597;1,3,4,5;4;2,9;2;1;1
258125302488;258125309914;7426;1,3,5;3;9;1;1;1
258125309914;258125318719;8805;1,3,5;3;9;1;1;1
258125318719;258125350687;31968;1,3,5;3;9;1;1;1
258125350687;258125351236;549;1,3,4,5;4;2,9;2;1;1
258125351236;258125352195;959;1,3,5;3;9;1;1;1
258125352195;258125354843;2648;1,3,5;3;9;1;1;1
258125354843;258125364982;10139;1,3,5;3;9;1;1;1
258125364982;258125366976;1994;1,3,5;3;9;1;1;1
258125366976;258125368870;1894;1,3,5;3;9;1;1;1
258125368870;258125369447;577;1,3,5;3;9;1;1;1
258125369447;258125370383;936;1,3,5;3;9;1;1;1
258125370383;258125372205;1822;1,3,5;3;9;1;1;1
258125372205;258125400446;28241;1,3,5;3;9;1;1;1
258125400446;258125407966;7520;1,3,4,5;4;2,9;2;1;1
258125407966;258125423196;15230;1,3,5;3;9;1;1;1
258125423196;258125431955;8759;1,3,5;3;9;1;1;1
258125431955;258125454256;22301;1,3,5;3;9;1;1;1
258125454256;258125454889;633;1,3,4,5;4;2,9;2;1;1
258125454889;258125465620;10731;1,3,5;3;9;1;1;1
258125465620;258125474537;8917;1,3,5;3;9;1;1;1
258125474537;258125502280;27743;1,3,5;3;9;1;1;1
258125502280;258125508895;6615;1,3,5;3;9;1;1;1
258125508895;258125509454;559;1,3,4,5;4;2,9;2;1;1
258125509454;258125511723;2269;1,3,5;3;9;1;1;1
258125511723;258125555142;43419;1,3,5;3;9;1;1;1
258125555142;258125558074;2932;1,3,5;3;9;1;1;1
258125558074;258125604711;46637;1,3,5;3;9;1;1;1
258125604711;258125613278;8567;1,3,5;3;9;1;1;1
258125613278;258125625963;12685;1,3,5;3;9;1;1;1
258125625963;258125626520;557;1,3,4,5;4;2,9;2;1;1
258125626520;258125647482;20962;1,3,5;3;9;1;1;1
258125647482;258125656214;8732;1,3,5;3;9;1;1;1
258125656214;258125656845;631;1,3,5;3;9;1;1;1
258125656845;258125665525;8680;1,3,5;3;9;1;1;1
258125665525;258125696272;30747;1,3,5;3;9;1;1;1
258125696272;258125697421;1149;1,3,4,5;4;2,9;2;1;1
258125697421;258125732710;35289;1,3,5;3;9;1;1;1
258125732710;258125735457;2747;1,3,5;3;9;1;1;1
258125735457;258125760680;25223;1,3,5;3;9;1;1;1
258125760680;258125761101;421;1,3,4,5;4;2,9;2;1;1
258125761101;258125761390;289;1,3,4,5;4;2,9;2;1;1
258125761390;258125761753;363;1,3,4,5;4;2,9;2;1;1
258125761753;258125777698;15945;1,3,5;3;9;1;1;1
258125777698;258125782380;4682;1,3,5;3;9;1;1;1
258125782380;258125783925;1545;1,3,5;3;9;1;1;1
258125783925;258125786019;2094;1,3,5;3;9;1;1;1
258125786019;258125808771;22752;1,3,5;3;9;1;1;1
258125808771;258125810498;1727;1,3,5;3;9;1;1;1
258125810498;258125811130;632;1,3,4,5;4;2,9;2;1;1
258125811130;258125817954;6824;1,3,5;3;9;1;1;1
258125817954;258125818064;110;1,3,5;3;9;1;1;1
258125818064;258125826827;8763;1,3,5;3;9;1;1;1
258125826827;258125851995;25168;1,3,5;3;9;1;1;1
258125851995;258125861283;9288;1,3,5;3;9;1;1;1
258125861283;258125882018;20735;1,3,5;3;9;1;1;1
258125882018;258125883513;1495;1,3,4,5;4;2,9;2;1;1
258125883513;258125885278;1765;1,3,5;3;9;1;1;1
258125885278;258125885920;642;1,3,4,5;4;2,9;2;1;1
258125885920;258125893671;7751;1,3,5;3;9;1;1;1
258125893671;258125900656;6985;1,3,5;3;9;1;1;1
258125900656;258125901168;512;1,3,5;3;9;1;1;1
258125901168;258125902654;1486;1,3,5;3;9;1;1;1
258125902654;258125903643;989;1,3,5;3;9;1;1;1
258125903643;258125910443;6800;1,3,5;3;9;1;1;1
258125910443;258125933327;22884;1,3,5;3;9;1;1;1
258125933327;258125933870;543;1,3,4,5;4;2,9;2;1;1
258125933870;258125951168;17298;1,3,5;3;9;1;1;1
258125951168;258125960024;8856;1,3,5;3;9;1;1;1
258125960024;258125981550;21526;1,3,5;3;9;1;1;1
258125981550;258125984510;2960;1,3,5;3;9;1;1;1
258125984510;258126021082;36572;1,3,5;3;9;1;1;1
258126021082;258126029605;8523;1,3,5;3;9;1;1;1
258126029605;258126030812;1207;1,3,5;3;9;1;1;1
258126030812;258126031757;945;1,3,4,5;4;2,9;2;1;1
258126031757;258126077876;46119;1,3,5;3;9;1;1;1
258126077876;258126078693;817;1,3,4,5;4;2,9;2;1;1
258126078693;258126098431;19738;1,3,5;3;9;1;1;1
258126098431;258126101082;2651;1,3,5;3;9;1;1;1
258126101082;258126135244;34162;1,3,5;3;9;1;1;1
258126135244;258126135757;513;1,3,4,5;4;2,9;2;1;1
258126135757;258126182065;46308;1,3,5;3;9;1;1;1
258126182065;258126182787;722;1,3,5;3;9;1;1;1
258126182787;258126188972;6185;1,3,5;3;9;1;1;1
258126188972;258126191170;2198;1,3,5;3;9;1;1;1
258126191170;258126192356;1186;1,3,5;3;9;1;1;1
258126192356;258126192966;610;1,3,5;3;9;1;1;1
258126192966;258126198455;5489;1,3,5;3;9;1;1;1
258126198455;258126199555;1100;1,3,5;3;9;1;1;1
258126199555;258126201679;2124;1,3,5;3;9;1;1;1
258126201679;258126208327;6648;1,3,5;3;9;1;1;1
258126208327;258126210414;2087;1,3,5;3;9;1;1;1
258126210414;258126212576;2162;1,3,5;3;9;1;1;1
258126212576;258126214044;1468;1,3,5;3;9;1;1;1
258126214044;258126216337;2293;1,3,5;3;9;1;1;1
258126216337;258126230572;14235;1,3,5;3;9;1;1;1
258126230572;258126231191;619;1,3,4,5;4;2,9;2;1;1
258126231191;258126242071;10880;1,3,5;3;9;1;1;1
258126242071;258126244713;2642;1,3,5;3;9;1;1;1
258126244713;258126272057;27344;1,3,5;3;9;1;1;1
258126272057;258126272601;544;1,3,4,5;4;2,9;2;1;1
258126272601;258126280446;7845;1,3,5;3;9;1;1;1
258126280446;258126288984;8538;1,3,5;3;9;1;1;1
258126288984;258126319951;30967;1,3,5;3;9;1;1;1
258126319951;258126328246;8295;1,3,5;3;9;1;1;1
258126328246;258126348920;20674;1,3,5;3;9;1;1;1
258126348920;258126349616;696;1,3,4,5;4;2,9;2;1;1
258126349616;258126389386;39770;1,3,5;3;9;1;1;1
258126389386;258126393081;3695;1,3,5;3;9;1;1;1
258126393081;258126395489;2408;1,3,5;3;9;1;1;1
258126395489;258126396191;702;1,3,5;3;9;1;1;1
258126396191;258126399134;2943;1,3,5;3;9;1;1;1
258126399134;258126400484;1350;1,3,5;3;9;1;1;1
258126400484;258126421680;21196;1,3,5;3;9;1;1;1
258126421680;258126431247;9567;1,3,5;3;9;1;1;1
258126431247;258126472866;41619;1,3,5;3;9;1;1;1
258126472866;258126473335;469;1,3,4,5;4;2,9;2;1;1
258126473335;258126515054;41719;1,3,5;3;9;1;1;1
258126515054;258126524696;9642;1,3,5;3;9;1;1;1
258126524696;258126524834;138;1,3,4,5;4;2,9;2;1;1
258126524834;258126525193;359;1,3,4,5;4;2,9;2;1;1
258126525193;258126551193;26000;1,3,5;3;9;1;1;1
258126551193;258126551992;799;1,3,5;3;9;1;1;1
258126551992;258126554518;2526;1,3,5;3;9;1;1;1
258126554518;258126561127;6609;1,3,5;3;9;1;1;1
258126561127;258126566566;5439;1,3,5;3;9;1;1;1
258126566566;258126567043;477;1,3,4,5;4;2,9;2;1;1
258126567043;258126595474;28431;1,3,5;3;9;1;1;1
258126595474;258126604445;8971;1,3,5;3;9;1;1;1
258126604445;258126606854;2409;1,3,5;3;9;1;1;1
258126606854;258126607395;541;1,3,4,5;4;2,9;2;1;1
258126607395;258126656124;48729;1,3,5;3;9;1;1;1
258126656124;258126657887;1763;1,3,5;3;9;1;1;1
258126657887;258126658883;996;1,3,5;3;9;1;1;1
258126658883;258126660740;1857;1,3,5;3;9;1;1;1
258126660740;258126678190;17450;1,3,5;3;9;1;1;1
258126678190;258126680333;2143;1,3,5;3;9;1;1;1
258126680333;258126688583;8250;1,3,5;3;9;1;1;1
258126688583;258126689251;668;1,3,5;3;9;1;1;1
258126689251;258126701367;12116;1,3,5;3;9;1;1;1
258126701367;258126710659;9292;1,3,5;3;9;1;1;1
258126710659;258126720032;9373;1,3,5;3;9;1;1;1
258126720032;258126720562;530;1,3,4,5;4;2,9;2;1;1
258126720562;258126745276;24714;1,3,5;3;9;1;1;1
258126745276;258126748258;2982;1,3,5;3;9;1;1;1
258126748258;258126789629;41371;1,3,5;3;9;1;1;1
258126789629;258126790118;489;1,3,4,5;4;2,9;2;1;1
258126790118;258126790352;234;1,3,5;3;9;1;1;1
258126790352;258126801431;11079;1,3,5;3;9;1;1;1
258126801431;258126822959;21528;1,3,5;3;9;1;1;1
258126822959;258126826989;4030;1,3,5;3;9;1;1;1
258126826989;258126831049;4060;1,3,4,5;4;2,9;2;1;1
258126831049;258126831445;396;1,3,5;3;9;1;1;1
258126831445;258126832767;1322;1,3,5;3;9;1;1;1
258126832767;258126840104;7337;1,3,5;3;9;1;1;1
258126840104;258126864547;24443;1,3,5;3;9;1;1;1
258126864547;258126873784;9237;1,3,5;3;9;1;1;1
258126873784;258126917802;44018;1,3,5;3;9;1;1;1
258126917802;258126918274;472;1,3,4,5;4;2,9;2;1;1
258126918274;258126924994;6720;1,3,5;3;9;1;1;1
258126924994;258126928490;3496;1,3,5;3;9;1;1;1
258126928490;258126980695;52205;1,3,5;3;9;1;1;1
258126980695;258126983739;3044;1,3,5;3;9;1;1;1
258126983739;258126997327;13588;1,3,5;3;9;1;1;1
258126997327;258127006889;9562;1,3,5;3;9;1;1;1
258127006889;258127041834;34945;1,3,5;3;9;1;1;1
258127041834;258127045383;3549;1,3,5;3;9;1;1;1
258127045383;258127055421;10038;1,3,5;3;9;1;1;1
258127055421;258127059697;4276;1,3,4,5;4;2,9;2;1;1
258127059697;258127081840;22143;1,3,5;3;9;1;1;1
258127081840;258127090215;8375;1,3,5;3;9;1;1;1
258127090215;258127091236;1021;1,3,5;3;9;1;1;1
258127091236;258127100862;9626;1,3,5;3;9;1;1;1
258127100862;258127163603;62741;1,3,5;3;9;1;1;1
258127163603;258127164634;1031;1,3,4,5;4;2,9;2;1;1
258127164634;258127194475;29841;1,3,5;3;9;1;1;1
258127194475;258127194781;306;1,3,5;3;9;1;1;1
258127194781;258127197252;2471;1,3,5;3;9;1;1;1
258127197252;258127203769;6517;1,3,5;3;9;1;1;1
258127203769;258127205510;1741;1,3,5;3;9;1;1;1
258127205510;258127215097;9587;1,3,5;3;9;1;1;1
258127215097;258127226887;11790;1,3,5;3;9;1;1;1
258127226887;258127227368;481;1,3,4,5;4;2,9;2;1;1
258127227368;258127247022;19654;1,3,5;3;9;1;1;1
258127247022;258127255729;8707;1,3,5;3;9;1;1;1
258127255729;258127324509;68780;1,3,5;3;9;1;1;1
258127324509;258127327507;2998;1,3,5;3;9;1;1;1
258127327507;258127335032;7525;1,3,5;3;9;1;1;1
258127335032;258127336902;1870;1,3,5;3;9;1;1;1
258127336902;258127337938;1036;1,3,5;3;9;1;1;1
258127337938;258127339867;1929;1,3,5;3;9;1;1;1
258127339867;258127340885;1018;1,3,5;3;9;1;1;1
258127340885;258127341376;491;1,3,4,5;4;2,9;2;1;1
258127341376;258127344234;2858;1,3,5;3;9;1;1;1
258127344234;258127344724;490;1,3,4,5;4;2,9;2;1;1
258127344724;258127345214;490;1,3,5;3;9;1;1;1
258127345214;258127345807;593;1,3,4,5;4;2,9;2;1;1
258127345807;258127379497;33690;1,3,5;3;9;1;1;1
258127379497;258127379965;468;1,3,4,5;4;2,9;2;1;1
258127379965;258127384597;4632;1,3,5;3;9;1;1;1
258127384597;258127393341;8744;1,3,5;3;9;1;1;1
258127393341;258127418879;25538;1,3,5;3;9;1;1;1
258127418879;258127419461;582;1,3,4,5;4;2,9;2;1;1
258127419461;258127442090;22629;1,3,5;3;9;1;1;1
258127442090;258127444885;2795;1,3,5;3;9;1;1;1
258127444885;258127481258;36373;1,3,5;3;9;1;1;1
258127481258;258127481533;275;1,3,5;3;9;1;1;1
258127481533;258127489867;8334;1,3,5;3;9;1;1;1
258127489867;258127496726;6859;1,3,5;3;9;1;1;1
258127496726;258127541362;44636;1,3,5;3;9;1;1;1
258127541362;258127541842;480;1,3,4,5;4;2,9;2;1;1
258127541842;258127585124;43282;1,3,5;3;9;1;1;1
258127585124;258127585734;610;1,3,4,5;4;2,9;2;1;1
258127585734;258127617887;32153;1,3,5;3;9;1;1;1
258127617887;258127627230;9343;1,3,5;3;9;1;1;1
258127627230;258127640028;12798;1,3,5;3;9;1;1;1
258127640028;258127640659;631;1,3,4,5;4;2,9;2;1;1
258127640659;258127649941;9282;1,3,5;3;9;1;1;1
258127649941;258127660077;10136;1,3,5;3;9;1;1;1
258127660077;258127660221;144;1,3,5;3;9;1;1;1
258127660221;258127661205;984;1,3,5;3;9;1;1;1
258127661205;258127663964;2759;1,3,5;3;9;1;1;1
258127663964;258127664137;173;1,3,5;3;9;1;1;1
258127664137;258127665051;914;1,3,5;3;9;1;1;1
258127665051;258127665212;161;1,3,5;3;9;1;1;1
258127665212;258127668394;3182;1,3,5;3;9;1;1;1
258127668394;258127669256;862;1,3,5;3;9;1;1;1
258127669256;258127692981;23725;1,3,5;3;9;1;1;1
258127692981;258127695776;2795;1,3,5;3;9;1;1;1
258127695776;258127704779;9003;1,3,5;3;9;1;1;1
258127704779;258127705310;531;1,3,4,5;4;2,9;2;1;1
258127705310;258127731810;26500;1,3,5;3;9;1;1;1
258127731810;258127738227;6417;1,3,5;3;9;1;1;1
258127738227;258127740297;2070;1,3,5;3;9;1;1;1
258127740297;258127741831;1534;1,3,5;3;9;1;1;1
258127741831;258127744189;2358;1,3,5;3;9;1;1;1
258127744189;258127744678;489;1,3,4,5;4;2,9;2;1;1
258127744678;258127747263;2585;1,3,5;3;9;1;1;1
258127747263;258127748891;1628;1,3,5;3;9;1;1;1
258127748891;258127789028;40137;1,3,5;3;9;1;1;1
258127789028;258127798527;9499;1,3,5;3;9;1;1;1
258127798527;258127799840;1313;1,3,5;3;9;1;1;1
258127799840;258127809427;9587;1,3,5;3;9;1;1;1
258127809427;258127845507;36080;1,3,5;3;9;1;1;1
258127845507;258127848161;2654;1,3,5;3;9;1;1;1
258127848161;258127854745;6584;1,3,5;3;9;1;1;1
258127854745;258127855209;464;1,3,4,5;4;2,9;2;1;1
258127855209;258127887398;32189;1,3,5;3;9;1;1;1
258127887398;258127890049;2651;1,3,5;3;9;1;1;1
258127890049;258127897779;7730;1,3,5;3;9;1;1;1
258127897779;258127907310;9531;1,3,5;3;9;1;1;1
258127907310;258127922448;15138;1,3,5;3;9;1;1;1
258127922448;258127923005;557;1,3,4,5;4;2,9;2;1;1
258127923005;258127967625;44620;1,3,5;3;9;1;1;1
258127967625;258127968092;467;1,3,4,5;4;2,9;2;1;1
258127968092;258128046564;78472;1,3,5;3;9;1;1;1
258128046564;258128047587;1023;1,3,4,5;4;2,9;2;1;1
258128047587;258128131656;84069;1,3,5;3;9;1;1;1
258128131656;258128132153;497;1,3,4,5;4;2,9;2;1;1
258128132153;258128197196;65043;1,3,5;3;9;1;1;1
258128197196;258128197660;464;1,3,4,5;4;2,9;2;1;1
258128197660;258128232723;35063;1,3,5;3;9;1;1;1
258128232723;258128233325;602;1,3,4,5;4;2,9;2;1;1
258128233325;258128244229;10904;1,3,5;3;9;1;1;1
258128244229;258128247536;3307;1,3,5;3;9;1;1;1
258128247536;258128247958;422;1,3,5;3;9;1;1;1
258128247958;258128251142;3184;1,3,5;3;9;1;1;1
258128251142;258128313131;61989;1,3,5;3;9;1;1;1
258128313131;258128313852;721;1,3,4,5;4;2,9;2;1;1
258128313852;258128333820;19968;1,3,5;3;9;1;1;1
258128333820;258128342382;8562;1,3,5;3;9;1;1;1
258128342382;258128380097;37715;1,3,5;3;9;1;1;1
258128380097;258128383247;3150;1,3,5;3;9;1;1;1
258128383247;258128383711;464;1,3,4,5;4;2,9;2;1;1
258128383711;258128388452;4741;1,3,5;3;9;1;1;1
258128388452;258128391430;2978;1,3,5;3;9;1;1;1
258128391430;258128393127;1697;1,3,5;3;9;1;1;1
258128393127;258128400477;7350;1,3,5;3;9;1;1;1
258128400477;258128400901;424;1,3,5;3;9;1;1;1
258128400901;258128402887;1986;1,3,5;3;9;1;1;1
258128402887;258128403230;343;1,3,5;3;9;1;1;1
258128403230;258128404956;1726;1,3,5;3;9;1;1;1
258128404956;258128406057;1101;1,3,5;3;9;1;1;1
258128406057;258128408221;2164;1,3,5;3;9;1;1;1
258128408221;258128410944;2723;1,3,5;3;9;1;1;1
258128410944;258128444376;33432;1,3,5;3;9;1;1;1
258128444376;258128445106;730;1,3,5;3;9;1;1;1
258128445106;258128447450;2344;1,3,5;3;9;1;1;1
258128447450;258128448575;1125;1,3,5;3;9;1;1;1
258128448575;258128463921;15346;1,3,5;3;9;1;1;1
258128463921;258128464396;475;1,3,4,5;4;2,9;2;1;1
258128464396;258128554319;89923;1,3,5;3;9;1;1;1
258128554319;258128554381;62;1,3,5;3;9;1;1;1
258128554381;258128555025;644;1,3,4,5;4;2,9;2;1;1
258128555025;258128557019;1994;1,3,5;3;9;1;1;1
258128557019;258128600656;43637;1,3,5;3;9;1;1;1
258128600656;258128609603;8947;1,3,5;3;9;1;1;1
258128609603;258128611764;2161;1,3,5;3;9;1;1;1
258128611764;258128614030;2266;1,3,5;3;9;1;1;1
258128614030;258128614834;804;1,3,4,5;4;2,9;2;1;1
258128614834;258128620970;6136;1,3,5;3;9;1;1;1
258128620970;258128623975;3005;1,3,5;3;9;1;1;1
258128623975;258128632723;8748;1,3,5;3;9;1;1;1
258128632723;258128669026;36303;1,3,5;3;9;1;1;1
258128669026;258128671787;2761;1,3,5;3;9;1;1;1
258128671787;258128692270;20483;1,3,5;3;9;1;1;1
258128692270;258128692897;627;1,3,4,5;4;2,9;2;1;1
258128692897;258128752449;59552;1,3,5;3;9;1;1;1
258128752449;258128755141;2692;1,3,5;3;9;1;1;1
258128755141;258128756067;926;1,3,5;3;9;1;1;1
258128756067;258128756384;317;1,3,5;3;9;1;1;1
258128756384;258128765889;9505;1,3,5;3;9;1;1;1
258128765889;258128771599;5710;1,3,5;3;9;1;1;1
258128771599;258128773411;1812;1,3,5;3;9;1;1;1
258128773411;258128773878;467;1,3,4,5;4;2,9;2;1;1
258128773878;258128804538;30660;1,3,5;3;9;1;1;1
258128804538;258128812672;8134;1,3,5;3;9;1;1;1
258128812672;258128814145;1473;1,3,5;3;9;1;1;1
258128814145;258128815987;1842;1,3,5;3;9;1;1;1
258128815987;258128822058;6071;1,3,5;3;9;1;1;1
258128822058;258128824457;2399;1,3,5;3;9;1;1;1
258128824457;258128829920;5463;1,3,5;3;9;1;1;1
258128829920;258128830549;629;1,3,4,5;4;2,9;2;1;1
258128830549;258128859636;29087;1,3,5;3;9;1;1;1
258128859636;258128862309;2673;1,3,5;3;9;1;1;1
258128862309;258128875316;13007;1,3,5;3;9;1;1;1
258128875316;258128875815;499;1,3,4,5;4;2,9;2;1;1
258128875815;258128953867;78052;1,3,5;3;9;1;1;1
258128953867;258128954342;475;1,3,4,5;4;2,9;2;1;1
258128954342;258128957121;2779;1,3,5;3;9;1;1;1
258128957121;258128958960;1839;1,3,5;3;9;1;1;1
258128958960;258128960337;1377;1,3,5;3;9;1;1;1
258128960337;258128961789;1452;1,3,5;3;9;1;1;1
258128961789;258128966958;5169;1,3,5;3;9;1;1;1
258128966958;258128976188;9230;1,3,5;3;9;1;1;1
258128976188;258129006700;30512;1,3,5;3;9;1;1;1
258129006700;258129015844;9144;1,3,5;3;9;1;1;1
258129015844;258129016396;552;1,3,4,5;4;2,9;2;1;1
258129016396;258129016491;95;1,3,5;3;9;1;1;1
258129016491;258129016681;190;1,3,5;3;9;1;1;1
258129016681;258129019962;3281;1,3,5;3;9;1;1;1
258129019962;258129064240;44278;1,3,5;3;9;1;1;1
258129064240;258129064704;464;1,3,4,5;4;2,9;2;1;1
258129064704;258129078685;13981;1,3,5;3;9;1;1;1
258129078685;258129081435;2750;1,3,5;3;9;1;1;1
258129081435;258129096856;15421;1,3,5;3;9;1;1;1
258129096856;258129097368;512;1,3,4,5;4;2,9;2;1;1
258129097368;258129118236;20868;1,3,5;3;9;1;1;1
258129118236;258129121053;2817;1,3,5;3;9;1;1;1
258129121053;258129159165;38112;1,3,5;3;9;1;1;1
258129159165;258129159851;686;1,3,5;3;9;1;1;1
258129159851;258129161779;1928;1,3,5;3;9;1;1;1
258129161779;258129167723;5944;1,3,5;3;9;1;1;1
258129167723;258129170273;2550;1,3,5;3;9;1;1;1
258129170273;258129170671;398;1,3,5;3;9;1;1;1
258129170671;258129173290;2619;1,3,5;3;9;1;1;1
258129173290;258129173742;452;1,3,4,5;4;2,9;2;1;1
258129173742;258129213192;39450;1,3,5;3;9;1;1;1
258129213192;258129213645;453;1,3,4,5;4;2,9;2;1;1
258129213645;258129231286;17641;1,3,5;3;9;1;1;1
258129231286;258129240005;8719;1,3,5;3;9;1;1;1
258129240005;258129242671;2666;1,3,5;3;9;1;1;1
258129242671;258129252067;9396;1,3,5;3;9;1;1;1
258129252067;258129277187;25120;1,3,5;3;9;1;1;1
258129277187;258129277753;566;1,3,4,5;4;2,9;2;1;1
258129277753;258129298683;20930;1,3,5;3;9;1;1;1
258129298683;258129307569;8886;1,3,5;3;9;1;1;1
258129307569;258129311566;3997;1,3,5;3;9;1;1;1
258129311566;258129313130;1564;1,3,5;3;9;1;1;1
258129313130;258129313274;144;1,3,5;3;9;1;1;1
258129313274;258129321229;7955;1,3,5;3;9;1;1;1
258129321229;258129322377;1148;1,3,5;3;9;1;1;1
258129322377;258129323751;1374;1,3,5;3;9;1;1;1
258129323751;258129349977;26226;1,3,5;3;9;1;1;1
258129349977;258129354035;4058;1,3,4,5;4;2,9;2;1;1
258129354035;258129369385;15350;1,3,5;3;9;1;1;1
258129369385;258129378056;8671;1,3,5;3;9;1;1;1
258129378056;258129381452;3396;1,3,5;3;9;1;1;1
258129381452;258129391446;9994;1,3,5;3;9;1;1;1
258129391446;258129411668;20222;1,3,5;3;9;1;1;1
258129411668;258129421557;9889;1,3,5;3;9;1;1;1
258129421557;258129451592;30035;1,3,5;3;9;1;1;1
258129451592;258129460338;8746;1,3,5;3;9;1;1;1
258129460338;258129493137;32799;1,3,5;3;9;1;1;1
258129493137;258129493441;304;1,3,5;3;9;1;1;1
258129493441;258129503016;9575;1,3,5;3;9;1;1;1
258129503016;258129503481;465;1,3,5;3;9;1;1;1
258129503481;258129507069;3588;1,3,5;3;9;1;1;1
258129507069;258129507572;503;1,3,4,5;4;2,9;2;1;1
258129507572;258129526388;18816;1,3,5;3;9;1;1;1
258129526388;258129535675;9287;1,3,5;3;9;1;1;1
258129535675;258129567577;31902;1,3,5;3;9;1;1;1
258129567577;258129576423;8846;1,3,5;3;9;1;1;1
258129576423;258129595636;19213;1,3,5;3;9;1;1;1
258129595636;258129604199;8563;1,3,5;3;9;1;1;1
258129604199;258129612083;7884;1,3,5;3;9;1;1;1
258129612083;258129613070;987;1,3,4,5;4;2,9;2;1;1
258129613070;258129634986;21916;1,3,5;3;9;1;1;1
258129634986;258129635316;330;1,3,5;3;9;1;1;1
258129635316;258129643946;8630;1,3,5;3;9;1;1;1
258129643946;258129644330;384;1,3,5;3;9;1;1;1
258129644330;258129711919;67589;1,3,5;3;9;1;1;1
258129711919;258129712904;985;1,3,4,5;4;9;1;1;1
258129712904;258129716400;3496;1,3,5;3;9;1;1;1
258129716400;258129716951;551;1,3,4,5;4;2,9;2;1;1
258129716951;258129725692;8741;1,3,5;3;9;1;1;1
258129725692;258129782346;56654;1,3,5;3;9;1;1;1
258129782346;258129782884;538;1,3,5;3;9;1;1;1
258129782884;258129795631;12747;1,3,5;3;9;1;1;1
258129795631;258129799042;3411;1,3,5;3;9;1;1;1
258129799042;258129799855;813;1,3,5;3;9;1;1;1
258129799855;258129803466;3611;1,3,5;3;9;1;1;1
258129803466;258129815112;11646;1,3,5;3;9;1;1;1
258129815112;258129830457;15345;1,3,5;3;9;1;1;1
258129830457;258129848001;17544;1,3,5;3;9;1;1;1
258129848001;258129851314;3313;1,3,5;3;9;1;1;1
258129851314;258129860412;9098;1,3,5;3;9;1;1;1
258129860412;258129862144;1732;1,3,5;3;9;1;1;1
258129862144;258129872008;9864;1,3,5;3;9;1;1;1
258129872008;258129872883;875;1,3,5;3;9;1;1;1
258129872883;258129887445;14562;1,3,5;3;9;1;1;1
258129887445;258129888258;813;1,3,5;3;9;1;1;1
258129888258;258129891001;2743;1,3,5;3;9;1;1;1
258129891001;258129891804;803;1,3,5;3;9;1;1;1
258129891804;258129928737;36933;1,3,5;3;9;1;1;1
258129928737;258129934781;6044;1,3,5;3;9;1;1;1
258129934781;258129944500;9719;1,3,5;3;9;1;1;1
258129944500;258129953910;9410;1,3,5;3;9;1;1;1
258129953910;258129957167;3257;1,3,5;3;9;1;1;1
258129957167;258129957481;314;1,3,5;3;9;1;1;1
258129957481;258129958906;1425;1,3,5;3;9;1;1;1
258129958906;258129962821;3915;1,3,5;3;9;1;1;1
258129962821;258129963645;824;1,3,5;3;9;1;1;1
258129963645;258129964787;1142;1,3,5;3;9;1;1;1
258129964787;258129965417;630;1,3,4,5;4;2,9;2;1;1
258129965417;258129967051;1634;1,3,5;3;9;1;1;1
258129967051;258129969442;2391;1,3,5;3;9;1;1;1
258129969442;258129974018;4576;1,3,5;3;9;1;1;1
258129974018;258129974950;932;1,3,5;3;9;1;1;1
258129974950;258129976852;1902;1,3,5;3;9;1;1;1
258129976852;258129977677;825;1,3,5;3;9;1;1;1
258129977677;258129980433;2756;1,3,5;3;9;1;1;1
258129980433;258129981236;803;1,3,5;3;9;1;1;1
258129981236;258129987752;6516;1,3,5;3;9;1;1;1
258129987752;258129990802;3050;1,3,5;3;9;1;1;1
258129990802;258129999992;9190;1,3,5;3;9;1;1;1
258129999992;258130002152;2160;1,3,5;3;9;1;1;1
258130002152;258130009028;6876;1,3,5;3;9;1;1;1
258130009028;258130009989;961;1,3,5;3;9;1;1;1
258130009989;258130014082;4093;1,3,5;3;9;1;1;1
258130014082;258130014321;239;1,3,5;3;9;1;1;1
258130014321;258130014992;671;1,3,5;3;9;1;1;1
258130014992;258130015229;237;1,3,5;3;9;1;1;1
258130015229;258130032323;17094;1,3,5;3;9;1;1;1
258130032323;258130033219;896;1,3,5;3;9;1;1;1
258130033219;258130038938;5719;1,3,5;3;9;1;1;1
258130038938;258130039481;543;1,3,4,5;4;2,9;2;1;1
258130039481;258130042081;2600;1,3,5;3;9;1;1;1
258130042081;258130047344;5263;1,3,5;3;9;1;1;1
258130047344;258130049542;2198;1,3,5;3;9;1;1;1
258130049542;258130049652;110;1,3,5;3;9;1;1;1
258130049652;258130050454;802;1,3,5;3;9;1;1;1
258130050454;258130051725;1271;1,3,5;3;9;1;1;1
258130051725;258130053709;1984;1,3,5;3;9;1;1;1
258130053709;258130054513;804;1,3,5;3;9;1;1;1
258130054513;258130058651;4138;1,3,5;3;9;1;1;1
258130058651;258130060505;1854;1,3,5;3;9;1;1;1
258130060505;258130064896;4391;1,3,5;3;9;1;1;1
258130064896;258130066073;1177;1,3,5;3;9;1;1;1
258130066073;258130066678;605;1,3,5;3;9;1;1;1
258130066678;258130066777;99;1,3,5;3;9;1;1;1
258130066777;258130070255;3478;1,3,5;3;9;1;1;1
258130070255;258130077715;7460;1,3,5;3;9;1;1;1
258130077715;258130078658;943;1,3,5;3;9;1;1;1
258130078658;258130078912;254;1,3,5;3;9;1;1;1
258130078912;258130087758;8846;1,3,5;3;9;1;1;1
258130087758;258130088584;826;1,3,5;3;9;1;1;1
258130088584;258130088654;70;1,3,5;3;9;1;1;1
258130088654;258130089722;1068;1,3,5;3;9;1;1;1
258130089722;258130096459;6737;1,3,5;3;9;1;1;1
258130096459;258130104607;8148;1,3,5;3;9;1;1;1
258130104607;258130114535;9928;1,3,5;3;9;1;1;1
258130114535;258130114933;398;1,3,5;3;9;1;1;1
258130114933;258130115755;822;1,3,5;3;9;1;1;1
258130115755;258130117751;1996;1,3,5;3;9;1;1;1
258130117751;258130118237;486;1,3,4,5;4;2,9;2;1;1
258130118237;258130124688;6451;1,3,5;3;9;1;1;1
258130124688;258130125005;317;1,3,5;3;9;1;1;1
258130125005;258130125402;397;1,3,5;3;9;1;1;1
258130125402;258130127805;2403;1,3,5;3;9;1;1;1
258130127805;258130128868;1063;1,3,5;3;9;1;1;1
258130128868;258130132920;4052;1,3,5;3;9;1;1;1
258130132920;258130134164;1244;1,3,5;3;9;1;1;1
258130134164;258130149904;15740;1,3,5;3;9;1;1;1
258130149904;258130158455;8551;1,3,5;3;9;1;1;1
258130158455;258130160127;1672;1,3,5;3;9;1;1;1
258130160127;258130162304;2177;1,3,5;3;9;1;1;1
258130162304;258130165145;2841;1,3,5;3;9;1;1;1
258130165145;258130165671;526;1,3,5;3;9;1;1;1
258130165671;258130165907;236;1,3,5;3;9;1;1;1
258130165907;258130166249;342;1,3,5;3;9;1;1;1
258130166249;258130171449;5200;1,3,5;3;9;1;1;1
258130171449;258130179209;7760;1,3,5;3;9;1;1;1
258130179209;258130180388;1179;1,3,5;3;9;1;1;1
258130180388;258130182599;2211;1,3,5;3;9;1;1;1
258130182599;258130185423;2824;1,3,5;3;9;1;1;1
258130185423;258130187111;1688;1,3,5;3;9;1;1;1
258130187111;258130187987;876;1,3,5;3;9;1;1;1
258130187987;258130190120;2133;1,3,5;3;9;1;1;1
258130190120;258130207238;17118;1,3,5;3;9;1;1;1
258130207238;258130207767;529;1,3,5;3;9;1;1;1
258130207767;258130207994;227;1,3,5;3;9;1;1;1
258130207994;258130208828;834;1,3,5;3;9;1;1;1
258130208828;258130211962;3134;1,3,5;3;9;1;1;1
258130211962;258130212878;916;1,3,5;3;9;1;1;1
258130212878;258130212894;16;1,3,5;3;9;1;1;1
258130212894;258130214479;1585;1,3,5;3;9;1;1;1
258130214479;258130215520;1041;1,3,5;3;9;1;1;1
258130215520;258130224064;8544;1,3,5;3;9;1;1;1
258130224064;258130230968;6904;1,3,5;3;9;1;1;1
258130230968;258130232050;1082;1,3,5;3;9;1;1;1
258130232050;258130246075;14025;1,3,5;3;9;1;1;1
258130246075;258130247313;1238;1,3,5;3;9;1;1;1
258130247313;258130251359;4046;1,3,5;3;9;1;1;1
258130251359;258130256654;5295;1,3,5;3;9;1;1;1
258130256654;258130257288;634;1,3,4,5;4;2,9;2;1;1
258130257288;258130259370;2082;1,3,5;3;9;1;1;1
258130259370;258130260851;1481;1,3,5;3;9;1;1;1
258130260851;258130261941;1090;1,3,5;3;9;1;1;1
258130261941;258130263095;1154;1,3,5;3;9;1;1;1
258130263095;258130263652;557;1,3,5;3;9;1;1;1
258130263652;258130264207;555;1,3,5;3;9;1;1;1
258130264207;258130266594;2387;1,3,5;3;9;1;1;1
258130266594;258130267507;913;1,3,5;3;9;1;1;1
258130267507;258130272440;4933;1,3,5;3;9;1;1;1
258130272440;258130277054;4614;1,3,5;3;9;1;1;1
258130277054;258130278529;1475;1,3,5;3;9;1;1;1
258130278529;258130279940;1411;1,3,5;3;9;1;1;1
258130279940;258130282248;2308;1,3,5;3;9;1;1;1
258130282248;258130288967;6719;1,3,5;3;9;1;1;1
258130288967;258130293776;4809;1,3,5;3;9;1;1;1
258130293776;258130294893;1117;1,3,5;3;9;1;1;1
258130294893;258130299266;4373;1,3,5;3;9;1;1;1
258130299266;258130300988;1722;1,3,5;3;9;1;1;1
258130300988;258130308042;7054;1,3,5;3;9;1;1;1
258130308042;258130311219;3177;1,3,5;3;9;1;1;1
258130311219;258130311668;449;1,3,5;3;9;1;1;1
258130311668;258130313433;1765;1,3,5;3;9;1;1;1
258130313433;258130315150;1717;1,3,5;3;9;1;1;1
258130315150;258130323807;8657;1,3,5;3;9;1;1;1
258130323807;258130331721;7914;1,3,5;3;9;1;1;1
258130331721;258130332502;781;1,3,5;3;9;1;1;1
258130332502;258130332676;174;1,3,5;3;9;1;1;1
258130332676;258130339977;7301;1,3,5;3;9;1;1;1
258130339977;258130340638;661;1,3,4,5;4;2,9;2;1;1
258130340638;258130343327;2689;1,3,5;3;9;1;1;1
258130343327;258130344436;1109;1,3,5;3;9;1;1;1
258130344436;258130348185;3749;1,3,5;3;9;1;1;1
258130348185;258130348481;296;1,3,5;3;9;1;1;1
258130348481;258130349094;613;1,3,5;3;9;1;1;1
258130349094;258130349796;702;1,3,5;3;9;1;1;1
258130349796;258130354577;4781;1,3,5;3;9;1;1;1
258130354577;258130355820;1243;1,3,5;3;9;1;1;1
258130355820;258130360703;4883;1,3,5;3;9;1;1;1
258130360703;258130364015;3312;1,3,5;3;9;1;1;1
258130364015;258130371497;7482;1,3,5;3;9;1;1;1
258130371497;258130373992;2495;1,3,5;3;9;1;1;1
258130373992;258130381635;7643;1,3,5;3;9;1;1;1
258130381635;258130382898;1263;1,3,5;3;9;1;1;1
258130382898;258130383395;497;1,3,5;3;9;1;1;1
258130383395;258130385179;1784;1,3,5;3;9;1;1;1
258130385179;258130386928;1749;1,3,5;3;9;1;1;1
258130386928;258130387850;922;1,3,5;3;9;1;1;1
258130387850;258130388789;939;1,3,5;3;9;1;1;1
258130388789;258130397506;8717;1,3,5;3;9;1;1;1
258130397506;258130398330;824;1,3,5;3;9;1;1;1
258130398330;258130399057;727;1,3,5;3;9;1;1;1
258130399057;258130402752;3695;1,3,5;3;9;1;1;1
258130402752;258130403029;277;1,3,5;3;9;1;1;1
258130403029;258130404095;1066;1,3,5;3;9;1;1;1
258130404095;258130407146;3051;1,3,5;3;9;1;1;1
258130407146;258130410544;3398;1,3,5;3;9;1;1;1
258130410544;258130411520;976;1,3,5;3;9;1;1;1
258130411520;258130415389;3869;1,3,5;3;9;1;1;1
258130415389;258130416228;839;1,3,5;3;9;1;1;1
258130416228;258130419396;3168;1,3,5;3;9;1;1;1
258130419396;258130420371;975;1,3,5;3;9;1;1;1
258130420371;258130444813;24442;1,3,5;3;9;1;1;1
258130444813;258130445452;639;1,3,4,5;4;2,9;2;1;1
258130445452;258130450728;5276;1,3,5;3;9;1;1;1
258130450728;258130451645;917;1,3,5;3;9;1;1;1
258130451645;258130456326;4681;1,3,5;3;9;1;1;1
258130456326;258130456714;388;1,3,5;3;9;1;1;1
258130456714;258130457263;549;1,3,5;3;9;1;1;1
258130457263;258130457917;654;1,3,5;3;9;1;1;1
258130457917;258130469112;11195;1,3,5;3;9;1;1;1
258130469112;258130471269;2157;1,3,5;3;9;1;1;1
258130471269;258130488323;17054;1,3,5;3;9;1;1;1
258130488323;258130491260;2937;1,3,5;3;9;1;1;1
258130491260;258130492068;808;1,3,5;3;9;1;1;1
258130492068;258130499969;7901;1,3,5;3;9;1;1;1
258130499969;258130500516;547;1,3,4,5;4;2,9;2;1;1
258130500516;258130505281;4765;1,3,5;3;9;1;1;1
258130505281;258130508786;3505;1,3,5;3;9;1;1;1
258130508786;258130509494;708;1,3,5;3;9;1;1;1
258130509494;258130512189;2695;1,3,5;3;9;1;1;1
258130512189;258130513501;1312;1,3,5;3;9;1;1;1
258130513501;258130514358;857;1,3,5;3;9;1;1;1
258130514358;258130515345;987;1,3,5;3;9;1;1;1
258130515345;258130515350;5;1,3,5;3;9;1;1;1
258130515350;258130519549;4199;1,3,5;3;9;1;1;1
258130519549;258130541131;21582;1,3,5;3;9;1;1;1
258130541131;258130541696;565;1,3,4,5;4;2,9;2;1;1
258130541696;258130548209;6513;1,3,5;3;9;1;1;1
258130548209;258130548313;104;1,3,5;3;9;1;1;1
258130548313;258130549684;1371;1,3,5;3;9;1;1;1
258130549684;258130550551;867;1,3,5;3;9;1;1;1
258130550551;258130551810;1259;1,3,5;3;9;1;1;1
258130551810;258130552789;979;1,3,5;3;9;1;1;1
258130552789;258130553006;217;1,3,5;3;9;1;1;1
258130553006;258130554230;1224;1,3,5;3;9;1;1;1
258130554230;258130554599;369;1,3,5;3;9;1;1;1
258130554599;258130560108;5509;1,3,5;3;9;1;1;1
258130560108;258130562420;2312;1,3,5;3;9;1;1;1
258130562420;258130562871;451;1,3,5;3;9;1;1;1
258130562871;258130563805;934;1,3,5;3;9;1;1;1
258130563805;258130566609;2804;1,3,5;3;9;1;1;1
258130566609;258130570716;4107;1,3,5;3;9;1;1;1
258130570716;258130573948;3232;1,3,5;3;9;1;1;1
258130573948;258130574187;239;1,3,5;3;9;1;1;1
258130574187;258130576202;2015;1,3,5;3;9;1;1;1
258130576202;258130576842;640;1,3,5;3;9;1;1;1
258130576842;258130577724;882;1,3,5;3;9;1;1;1
258130577724;258130578242;518;1,3,5;3;9;1;1;1
258130578242;258130579369;1127;1,3,5;3;9;1;1;1
258130579369;258130579691;322;1,3,5;3;9;1;1;1
258130579691;258130579847;156;1,3,5;3;9;1;1;1
258130579847;258130581478;1631;1,3,5;3;9;1;1;1
258130581478;258130585021;3543;1,3,5;3;9;1;1;1
258130585021;258130586048;1027;1,3,5;3;9;1;1;1
258130586048;258130586451;403;1,3,5;3;9;1;1;1
258130586451;258130586723;272;1,3,5;3;9;1;1;1
258130586723;258130589327;2604;1,3,5;3;9;1;1;1
258130589327;258130590452;1125;1,3,5;3;9;1;1;1
258130590452;258130593033;2581;1,3,5;3;9;1;1;1
258130593033;258130596629;3596;1,3,5;3;9;1;1;1
258130596629;258130602102;5473;1,3,5;3;9;1;1;1
258130602102;258130603538;1436;1,3,5;3;9;1;1;1
258130603538;258130604290;752;1,3,5;3;9;1;1;1
258130604290;258130610847;6557;1,3,5;3;9;1;1;1
258130610847;258130612066;1219;1,3,5;3;9;1;1;1
258130612066;258130614936;2870;1,3,5;3;9;1;1;1
258130614936;258130616338;1402;1,3,5;3;9;1;1;1
258130616338;258130616847;509;1,3,5;3;9;1;1;1
258130616847;258130618116;1269;1,3,5;3;9;1;1;1
258130618116;258130618615;499;1,3,5;3;9;1;1;1
258130618615;258130619076;461;1,3,4,5;4;2,9;2;1;1
258130619076;258130619576;500;1,3,4,5;4;2,9;2;1;1
258130619576;258130621072;1496;1,3,5;3;9;1;1;1
258130621072;258130622503;1431;1,3,5;3;9;1;1;1
258130622503;258130623309;806;1,3,5;3;9;1;1;1
258130623309;258130626378;3069;1,3,5;3;9;1;1;1
258130626378;258130628003;1625;1,3,5;3;9;1;1;1
258130628003;258130631383;3380;1,3,5;3;9;1;1;1
258130631383;258130640859;9476;1,3,5;3;9;1;1;1
258130640859;258130664364;23505;1,3,5;3;9;1;1;1
258130664364;258130664647;283;1,3,5;3;9;1;1;1
258130664647;258130666713;2066;1,3,5;3;9;1;1;1
258130666713;258130667538;825;1,3,5;3;9;1;1;1
258130667538;258130676356;8818;1,3,5;3;9;1;1;1
258130676356;258130677259;903;1,3,5;3;9;1;1;1
258130677259;258130684635;7376;1,3,5;3;9;1;1;1
258130684635;258130701152;16517;1,3,5;3;9;1;1;1
258130701152;258130701683;531;1,3,4,5;4;2,9;2;1;1
258130701683;258130715176;13493;1,3,5;3;9;1;1;1
258130715176;258130719859;4683;1,3,5;3;9;1;1;1
258130719859;258130726040;6181;1,3,5;3;9;1;1;1
258130726040;258130730539;4499;1,3,5;3;9;1;1;1
258130730539;258130732504;1965;1,3,5;3;9;1;1;1
258130732504;258130732732;228;1,3,5;3;9;1;1;1
258130732732;258130733508;776;1,3,5;3;9;1;1;1
258130733508;258130733590;82;1,3,5;3;9;1;1;1
258130733590;258130733680;90;1,3,5;3;9;1;1;1
258130733680;258130733865;185;1,3,5;3;9;1;1;1
258130733865;258130736318;2453;1,3,5;3;9;1;1;1
258130736318;258130737123;805;1,3,5;3;9;1;1;1
258130737123;258130737430;307;1,3,5;3;9;1;1;1
258130737430;258130737566;136;1,3,5;3;9;1;1;1
258130737566;258130738251;685;1,3,5;3;9;1;1;1
258130738251;258130738382;131;1,3,5;3;9;1;1;1
258130738382;258130738912;530;1,3,5;3;9;1;1;1
258130738912;258130739312;400;1,3,5;3;9;1;1;1
258130739312;258130739520;208;1,3,5;3;9;1;1;1
258130739520;258130742949;3429;1,3,5;3;9;1;1;1
258130742949;258130745570;2621;1,3,5;3;9;1;1;1
258130745570;258130746456;886;1,3,5;3;9;1;1;1
258130746456;258130748819;2363;1,3,5;3;9;1;1;1
258130748819;258130752693;3874;1,3,5;3;9;1;1;1
258130752693;258130753253;560;1,3,5;3;9;1;1;1
258130753253;258130753401;148;1,3,5;3;9;1;1;1
258130753401;258130754247;846;1,3,5;3;9;1;1;1
258130754247;258130755157;910;1,3,5;3;9;1;1;1
258130755157;258130755414;257;1,3,5;3;9;1;1;1
258130755414;258130755586;172;1,3,5;3;9;1;1;1
258130755586;258130756535;949;1,3,5;3;9;1;1;1
258130756535;258130758541;2006;1,3,5;3;9;1;1;1
258130758541;258130765609;7068;1,3,5;3;9;1;1;1
258130765609;258130772746;7137;1,3,5;3;9;1;1;1
258130772746;258130773864;1118;1,3,5;3;9;1;1;1
258130773864;258130780231;6367;1,3,5;3;9;1;1;1
258130780231;258130780495;264;1,3,5;3;9;1;1;1
258130780495;258130781407;912;1,3,5;3;9;1;1;1
258130781407;258130786447;5040;1,3,5;3;9;1;1;1
258130786447;258130787008;561;1,3,4,5;4;2,9;2;1;1
258130787008;258130788561;1553;1,3,5;3;9;1;1;1
258130788561;258130788796;235;1,3,5;3;9;1;1;1
258130788796;258130788905;109;1,3,5;3;9;1;1;1
258130788905;258130789833;928;1,3,5;3;9;1;1;1
258130789833;258130791532;1699;1,3,5;3;9;1;1;1
258130791532;258130792555;1023;1,3,5;3;9;1;1;1
258130792555;258130797890;5335;1,3,5;3;9;1;1;1
258130797890;258130798882;992;1,3,5;3;9;1;1;1
258130798882;258130802318;3436;1,3,5;3;9;1;1;1
258130802318;258130802508;190;1,3,5;3;9;1;1;1
258130802508;258130803609;1101;1,3,5;3;9;1;1;1
258130803609;258130829062;25453;1,3,5;3;9;1;1;1
258130829062;258130829481;419;1,3,5;3;9;1;1;1
258130829481;258130829657;176;1,3,5;3;9;1;1;1
258130829657;258130830206;549;1,3,4,5;4;2,9;2;1;1
258130830206;258130831028;822;1,3,5;3;9;1;1;1
258130831028;258130832042;1014;1,3,5;3;9;1;1;1
258130832042;258130832222;180;1,3,5;3;9;1;1;1
258130832222;258130834481;2259;1,3,5;3;9;1;1;1
258130834481;258130838061;3580;1,3,5;3;9;1;1;1
258130838061;258130838084;23;1,3,5;3;9;1;1;1
258130838084;258130838293;209;1,3,5;3;9;1;1;1
258130838293;258130838997;704;1,3,5;3;9;1;1;1
258130838997;258130839437;440;1,3,5;3;9;1;1;1
258130839437;258130840715;1278;1,3,5;3;9;1;1;1
258130840715;258130840757;42;1,3,5;3;9;1;1;1
258130840757;258130843372;2615;1,3,5;3;9;1;1;1
258130843372;258130843863;491;1,3,5;3;9;1;1;1
258130843863;258130844596;733;1,3,5;3;9;1;1;1
258130844596;258130844895;299;1,3,5;3;9;1;1;1
258130844895;258130845619;724;1,3,5;3;9;1;1;1
258130845619;258130847357;1738;1,3,5;3;9;1;1;1
258130847357;258130851202;3845;1,3,5;3;9;1;1;1
258130851202;258130851657;455;1,3,5;3;9;1;1;1
258130851657;258130856828;5171;1,3,5;3;9;1;1;1
258130856828;258130857329;501;1,3,5;3;9;1;1;1
258130857329;258130860653;3324;1,3,5;3;9;1;1;1
258130860653;258130861257;604;1,3,5;3;9;1;1;1
258130861257;258130865576;4319;1,3,5;3;9;1;1;1
258130865576;258130865940;364;1,3,5;3;9;1;1;1
258130865940;258130866680;740;1,3,5;3;9;1;1;1
258130866680;258130867220;540;1,3,4,5;4;2,9;2;1;1
258130867220;258130867461;241;1,3,5;3;9;1;1;1
258130867461;258130867508;47;1,3,5;3;9;1;1;1
258130867508;258130868612;1104;1,3,5;3;9;1;1;1
258130868612;258130870386;1774;1,3,5;3;9;1;1;1
258130870386;258130872247;1861;1,3,5;3;9;1;1;1
258130872247;258130873016;769;1,3,5;3;9;1;1;1
258130873016;258130876483;3467;1,3,5;3;9;1;1;1
258130876483;258130880824;4341;1,3,5;3;9;1;1;1
258130880824;258130881018;194;1,3,5;3;9;1;1;1
258130881018;258130881975;957;1,3,5;3;9;1;1;1
258130881975;258130883326;1351;1,3,5;3;9;1;1;1
258130883326;258130883768;442;1,3,5;3;9;1;1;1
258130883768;258130887460;3692;1,3,5;3;9;1;1;1
258130887460;258130888146;686;1,3,5;3;9;1;1;1
258130888146;258130891417;3271;1,3,5;3;9;1;1;1
258130891417;258130891434;17;1,3,5;3;9;1;1;1
258130891434;258130892365;931;1,3,5;3;9;1;1;1
258130892365;258130892387;22;1,3,5;3;9;1;1;1
258130892387;258130893241;854;1,3,5;3;9;1;1;1
258130893241;258130896408;3167;1,3,5;3;9;1;1;1
258130896408;258130900081;3673;1,3,5;3;9;1;1;1
258130900081;258130900292;211;1,3,5;3;9;1;1;1
258130900292;258130900628;336;1,3,5;3;9;1;1;1
258130900628;258130907295;6667;1,3,5;3;9;1;1;1
258130907295;258130926643;19348;1,3,5;3;9;1;1;1
258130926643;258130931002;4359;1,3,5;3;9;1;1;1
258130931002;258130933267;2265;1,3,5;3;9;1;1;1
258130933267;258130934136;869;1,3,5;3;9;1;1;1
258130934136;258130936474;2338;1,3,5;3;9;1;1;1
258130936474;258130936869;395;1,3,4,5;4;2,9;2;1;1
258130936869;258130936944;75;1,3,4,5;4;2,9;2;1;1
258130936944;258130940037;3093;1,3,5;3;9;1;1;1
258130940037;258130941640;1603;1,3,5;3;9;1;1;1
258130941640;258130941834;194;1,3,5;3;9;1;1;1
258130941834;258130951071;9237;1,3,5;3;9;1;1;1
258130951071;258130953181;2110;1,3,5;3;9;1;1;1
258130953181;258130954038;857;1,3,5;3;9;1;1;1
258130954038;258130958470;4432;1,3,5;3;9;1;1;1
258130958470;258130960566;2096;1,3,5;3;9;1;1;1
258130960566;258130961672;1106;1,3,5;3;9;1;1;1
258130961672;258130967102;5430;1,3,5;3;9;1;1;1
258130967102;258130972171;5069;1,3,5;3;9;1;1;1
258130972171;258130974016;1845;1,3,5;3;9;1;1;1
258130974016;258130978314;4298;1,3,5;3;9;1;1;1
258130978314;258130982771;4457;1,3,5;3;9;1;1;1
258130982771;258130985355;2584;1,3,5;3;9;1;1;1
258130985355;258130985407;52;1,3,5;3;9;1;1;1
258130985407;258130986599;1192;1,3,5;3;9;1;1;1
258130986599;258130986840;241;1,3,5;3;9;1;1;1
258130986840;258130987274;434;1,3,5;3;9;1;1;1
258130987274;258130987751;477;1,3,5;3;9;1;1;1
258130987751;258130988370;619;1,3,5;3;9;1;1;1
258130988370;258130988540;170;1,3,5;3;9;1;1;1
258130988540;258130988550;10;1,3,5;3;9;1;1;1
258130988550;258130988612;62;1,3,5;3;9;1;1;1
258130988612;258130990761;2149;1,3,5;3;9;1;1;1
258130990761;258130991836;1075;1,3,5;3;9;1;1;1
258130991836;258130991895;59;1,3,5;3;9;1;1;1
258130991895;258130991931;36;1,3,5;3;9;1;1;1
258130991931;258130992710;779;1,3,5;3;9;1;1;1
258130992710;258130993920;1210;1,3,5;3;9;1;1;1
258130993920;258130994596;676;1,3,5;3;9;1;1;1
258130994596;258130994599;3;1,3,5;3;9;1;1;1
258130994599;258130994913;314;1,3,5;3;9;1;1;1
258130994913;258130994994;81;1,3,5;3;9;1;1;1
258130994994;258130995226;232;1,3,5;3;9;1;1;1
258130995226;258130995376;150;1,3,5;3;9;1;1;1
258130995376;258130995573;197;1,3,5;3;9;1;1;1
258130995573;258130996674;1101;1,3,5;3;9;1;1;1
258130996674;258130997458;784;1,3,5;3;9;1;1;1
258130997458;258130997904;446;1,3,5;3;9;1;1;1
258130997904;258130998414;510;1,3,5;3;9;1;1;1
258130998414;258130998536;122;1,3,5;3;9;1;1;1
258130998536;258130999283;747;1,3,5;3;9;1;1;1
258130999283;258131002210;2927;1,3,5;3;9;1;1;1
258131002210;258131002262;52;1,3,5;3;9;1;1;1
258131002262;258131002547;285;1,3,5;3;9;1;1;1
258131002547;258131002736;189;1,3,5;3;9;1;1;1
258131002736;258131003920;1184;1,3,5;3;9;1;1;1
258131003920;258131004225;305;1,3,5;3;9;1;1;1
258131004225;258131004368;143;1,3,5;3;9;1;1;1
258131004368;258131004693;325;1,3,5;3;9;1;1;1
258131004693;258131004941;248;1,3,5;3;9;1;1;1
258131004941;258131006830;1889;1,3,5;3;9;1;1;1
258131006830;258131007652;822;1,3,5;3;9;1;1;1
258131007652;258131007808;156;1,3,5;3;9;1;1;1
258131007808;258131011490;3682;1,3,5;3;9;1;1;1
258131011490;258131012577;1087;1,3,5;3;9;1;1;1
258131012577;258131013156;579;1,3,5;3;9;1;1;1
258131013156;258131013588;432;1,3,5;3;9;1;1;1
258131013588;258131014512;924;1,3,5;3;9;1;1;1
258131014512;258131015009;497;1,3,4,5;4;2,9;2;1;1
258131015009;258131015037;28;1,3,4,5;4;2,9;2;1;1
258131015037;258131019622;4585;1,3,5;3;9;1;1;1
258131019622;258131020995;1373;1,3,5;3;9;1;1;1
258131020995;258131021272;277;1,3,5;3;9;1;1;1
258131021272;258131021826;554;1,3,5;3;9;1;1;1
258131021826;258131023609;1783;1,3,5;3;9;1;1;1
258131023609;258131024252;643;1,3,5;3;9;1;1;1
258131024252;258131027393;3141;1,3,5;3;9;1;1;1
258131027393;258131032765;5372;1,3,5;3;9;1;1;1
258131032765;258131045300;12535;1,3,5;3;9;1;1;1
258131045300;258131046389;1089;1,3,5;3;9;1;1;1
258131046389;258131047849;1460;1,3,5;3;9;1;1;1
258131047849;258131048111;262;1,3,5;3;9;1;1;1
258131048111;258131050814;2703;1,3,5;3;9;1;1;1
258131050814;258131053089;2275;1,3,5;3;9;1;1;1
258131053089;258131058277;5188;1,3,5;3;9;1;1;1
258131058277;258131061781;3504;1,3,5;3;9;1;1;1
258131061781;258131063450;1669;1,3,5;3;9;1;1;1
258131063450;258131064343;893;1,3,5;3;9;1;1;1
258131064343;258131068311;3968;1,3,5;3;9;1;1;1
258131068311;258131071230;2919;1,3,5;3;9;1;1;1
258131071230;258131074577;3347;1,3,5;3;9;1;1;1
258131074577;258131076297;1720;1,3,5;3;9;1;1;1
258131076297;258131076967;670;1,3,5;3;9;1;1;1
258131076967;258131077320;353;1,3,5;3;9;1;1;1
258131077320;258131078865;1545;1,3,5;3;9;1;1;1
258131078865;258131082518;3653;1,3,5;3;9;1;1;1
258131082518;258131084480;1962;1,3,5;3;9;1;1;1
258131084480;258131084543;63;1,3,5;3;9;1;1;1
258131084543;258131085419;876;1,3,5;3;9;1;1;1
258131085419;258131086039;620;1,3,5;3;9;1;1;1
258131086039;258131087541;1502;1,3,5;3;9;1;1;1
258131087541;258131094473;6932;1,3,5;3;9;1;1;1
258131094473;258131097860;3387;1,3,5;3;9;1;1;1
258131097860;258131099110;1250;1,3,5;3;9;1;1;1
258131099110;258131100195;1085;1,3,5;3;9;1;1;1
258131100195;258131104077;3882;1,3,5;3;9;1;1;1
258131104077;258131104691;614;1,3,4,5;4;2,9;2;1;1
258131104691;258131106058;1367;1,3,5;3;9;1;1;1
258131106058;258131107545;1487;1,3,5;3;9;1;1;1
258131107545;258131108372;827;1,3,5;3;9;1;1;1
258131108372;258131112585;4213;1,3,5;3;9;1;1;1
258131112585;258131113787;1202;1,3,5;3;9;1;1;1
258131113787;258131120619;6832;1,3,5;3;9;1;1;1
258131120619;258131128286;7667;1,3,5;3;9;1;1;1
258131128286;258131138755;10469;1,3,5;3;9;1;1;1
258131138755;258131140126;1371;1,3,5;3;9;1;1;1
258131140126;258131144215;4089;1,3,5;3;9;1;1;1
258131144215;258131145313;1098;1,3,5;3;9;1;1;1
258131145313;258131160519;15206;1,3,5;3;9;1;1;1
258131160519;258131165607;5088;1,3,5;3;9;1;1;1
258131165607;258131166945;1338;1,3,5;3;9;1;1;1
258131166945;258131168270;1325;1,3,5;3;9;1;1;1
258131168270;258131169234;964;1,3,5;3;9;1;1;1
258131169234;258131173038;3804;1,3,5;3;9;1;1;1
258131173038;258131174010;972;1,3,4,5;4;2,9;2;1;1
258131174010;258131176237;2227;1,3,5;3;9;1;1;1
258131176237;258131178584;2347;1,3,5;3;9;1;1;1
258131178584;258131179182;598;1,3,5;3;9;1;1;1
258131179182;258131189839;10657;1,3,5;3;9;1;1;1
258131189839;258131190680;841;1,3,5;3;9;1;1;1
258131190680;258131190997;317;1,3,5;3;9;1;1;1
258131190997;258131196031;5034;1,3,5;3;9;1;1;1
258131196031;258131205943;9912;1,3,5;3;9;1;1;1
258131205943;258131206937;994;1,3,5;3;9;1;1;1
258131206937;258131210802;3865;1,3,5;3;9;1;1;1
258131210802;258131211810;1008;1,3,5;3;9;1;1;1
258131211810;258131214426;2616;1,3,5;3;9;1;1;1
258131214426;258131229140;14714;1,3,5;3;9;1;1;1
258131229140;258131230573;1433;1,3,5;3;9;1;1;1
258131230573;258131231423;850;1,3,5;3;9;1;1;1
258131231423;258131239260;7837;1,3,5;3;9;1;1;1
258131239260;258131240011;751;1,3,5;3;9;1;1;1
258131240011;258131240547;536;1,3,4,5;4;2,9;2;1;1
258131240547;258131241796;1249;1,3,5;3;9;1;1;1
258131241796;258131242641;845;1,3,5;3;9;1;1;1
258131242641;258131243052;411;1,3,5;3;9;1;1;1
258131243052;258131245471;2419;1,3,5;3;9;1;1;1
258131245471;258131246157;686;1,3,5;3;9;1;1;1
258131246157;258131247208;1051;1,3,5;3;9;1;1;1
258131247208;258131248289;1081;1,3,5;3;9;1;1;1
258131248289;258131248303;14;1,3,5;3;9;1;1;1
258131248303;258131249547;1244;1,3,5;3;9;1;1;1
258131249547;258131249945;398;1,3,5;3;9;1;1;1
258131249945;258131252734;2789;1,3,5;3;9;1;1;1
258131252734;258131252782;48;1,3,5;3;9;1;1;1
258131252782;258131252790;8;1,3,5;3;9;1;1;1
258131252790;258131253350;560;1,3,5;3;9;1;1;1
258131253350;258131253608;258;1,3,5;3;9;1;1;1
258131253608;258131255443;1835;1,3,5;3;9;1;1;1
258131255443;258131257336;1893;1,3,5;3;9;1;1;1
258131257336;258131257718;382;1,3,5;3;9;1;1;1
258131257718;258131259009;1291;1,3,5;3;9;1;1;1
258131259009;258131259435;426;1,3,5;3;9;1;1;1
258131259435;258131261638;2203;1,3,5;3;9;1;1;1
258131261638;258131263366;1728;1,3,5;3;9;1;1;1
258131263366;258131264012;646;1,3,5;3;9;1;1;1
258131264012;258131264613;601;1,3,5;3;9;1;1;1
258131264613;258131264907;294;1,3,5;3;9;1;1;1
258131264907;258131267169;2262;1,3,5;3;9;1;1;1
258131267169;258131268506;1337;1,3,5;3;9;1;1;1
258131268506;258131269269;763;1,3,5;3;9;1;1;1
258131269269;258131271266;1997;1,3,5;3;9;1;1;1
258131271266;258131271587;321;1,3,5;3;9;1;1;1
258131271587;258131272422;835;1,3,5;3;9;1;1;1
258131272422;258131275842;3420;1,3,5;3;9;1;1;1
258131275842;258131285654;9812;1,3,5;3;9;1;1;1
258131285654;258131298758;13104;1,3,5;3;9;1;1;1
258131298758;258131299036;278;1,3,5;3;9;1;1;1
258131299036;258131299117;81;1,3,5;3;9;1;1;1
258131299117;258131299313;196;1,3,5;3;9;1;1;1
258131299313;258131299391;78;1,3,5;3;9;1;1;1
258131299391;258131300222;831;1,3,5;3;9;1;1;1
258131300222;258131300232;10;1,3,5;3;9;1;1;1
258131300232;258131300595;363;1,3,5;3;9;1;1;1
258131300595;258131301320;725;1,3,5;3;9;1;1;1
258131301320;258131303889;2569;1,3,5;3;9;1;1;1
258131303889;258131304546;657;1,3,5;3;9;1;1;1
258131304546;258131306252;1706;1,3,5;3;9;1;1;1
258131306252;258131310506;4254;1,3,5;3;9;1;1;1
258131310506;258131314632;4126;1,3,5;3;9;1;1;1
258131314632;258131317207;2575;1,3,5;3;9;1;1;1
258131317207;258131317838;631;1,3,4,5;4;2,9;2;1;1
258131317838;258131319330;1492;1,3,5;3;9;1;1;1
258131319330;258131319952;622;1,3,5;3;9;1;1;1
258131319952;258131327249;7297;1,3,5;3;9;1;1;1
258131327249;258131329274;2025;1,3,5;3;9;1;1;1
258131329274;258131330683;1409;1,3,5;3;9;1;1;1
258131330683;258131335775;5092;1,3,5;3;9;1;1;1
258131335775;258131340374;4599;1,3,5;3;9;1;1;1
258131340374;258131347033;6659;1,3,5;3;9;1;1;1
258131347033;258131352390;5357;1,3,5;3;9;1;1;1
258131352390;258131362502;10112;1,3,5;3;9;1;1;1
258131362502;258131365941;3439;1,3,5;3;9;1;1;1
258131365941;258131369094;3153;1,3,5;3;9;1;1;1
258131369094;258131372119;3025;1,3,5;3;9;1;1;1
258131372119;258131375132;3013;1,3,5;3;9;1;1;1
258131375132;258131383016;7884;1,3,5;3;9;1;1;1
258131383016;258131385045;2029;1,3,5;3;9;1;1;1
258131385045;258131385647;602;1,3,5;3;9;1;1;1
258131385647;258131386764;1117;1,3,5;3;9;1;1;1
258131386764;258131390420;3656;1,3,5;3;9;1;1;1
258131390420;258131390735;315;1,3,5;3;9;1;1;1
258131390735;258131391124;389;1,3,4,5;4;2,9;2;1;1
258131391124;258131391203;79;1,3,4,5;4;2,9;2;1;1
258131391203;258131393400;2197;1,3,5;3;9;1;1;1
258131393400;258131393878;478;1,3,5;3;9;1;1;1
258131393878;258131394260;382;1,3,5;3;9;1;1;1
258131394260;258131395507;1247;1,3,5;3;9;1;1;1
258131395507;258131395554;47;1,3,5;3;9;1;1;1
258131395554;258131397154;1600;1,3,5;3;9;1;1;1
258131397154;258131398922;1768;1,3,5;3;9;1;1;1
258131398922;258131399020;98;1,3,5;3;9;1;1;1
258131399020;258131399378;358;1,3,5;3;9;1;1;1
258131399378;258131399627;249;1,3,5;3;9;1;1;1
258131399627;258131399653;26;1,3,5;3;9;1;1;1
258131399653;258131400604;951;1,3,5;3;9;1;1;1
258131400604;258131401534;930;1,3,5;3;9;1;1;1
258131401534;258131402817;1283;1,3,5;3;9;1;1;1
258131402817;258131404590;1773;1,3,5;3;9;1;1;1
258131404590;258131404713;123;1,3,5;3;9;1;1;1
258131404713;258131405668;955;1,3,5;3;9;1;1;1
258131405668;258131405782;114;1,3,5;3;9;1;1;1
258131405782;258131407563;1781;1,3,5;3;9;1;1;1
258131407563;258131407982;419;1,3,5;3;9;1;1;1
258131407982;258131408770;788;1,3,5;3;9;1;1;1
258131408770;258131409213;443;1,3,5;3;9;1;1;1
258131409213;258131410511;1298;1,3,5;3;9;1;1;1
258131410511;258131410784;273;1,3,5;3;9;1;1;1
258131410784;258131411297;513;1,3,5;3;9;1;1;1
258131411297;258131411532;235;1,3,5;3;9;1;1;1
258131411532;258131412608;1076;1,3,5;3;9;1;1;1
258131412608;258131413060;452;1,3,5;3;9;1;1;1
258131413060;258131415392;2332;1,3,5;3;9;1;1;1
258131415392;258131415502;110;1,3,5;3;9;1;1;1
258131415502;258131418048;2546;1,3,5;3;9;1;1;1
258131418048;258131420276;2228;1,3,5;3;9;1;1;1
258131420276;258131420973;697;1,3,5;3;9;1;1;1
258131420973;258131424433;3460;1,3,5;3;9;1;1;1
258131424433;258131425138;705;1,3,5;3;9;1;1;1
258131425138;258131425286;148;1,3,5;3;9;1;1;1
258131425286;258131427229;1943;1,3,5;3;9;1;1;1
258131427229;258131433570;6341;1,3,5;3;9;1;1;1
258131433570;258131433644;74;1,3,5;3;9;1;1;1
258131433644;258131433923;279;1,3,5;3;9;1;1;1
258131433923;258131435048;1125;1,3,5;3;9;1;1;1
258131435048;258131437510;2462;1,3,5;3;9;1;1;1
258131437510;258131438695;1185;1,3,5;3;9;1;1;1
258131438695;258131440139;1444;1,3,5;3;9;1;1;1
258131440139;258131441183;1044;1,3,5;3;9;1;1;1
258131441183;258131443374;2191;1,3,5;3;9;1;1;1
258131443374;258131445977;2603;1,3,5;3;9;1;1;1
258131445977;258131447450;1473;1,3,5;3;9;1;1;1
258131447450;258131453927;6477;1,3,5;3;9;1;1;1
258131453927;258131455099;1172;1,3,5;3;9;1;1;1
258131455099;258131455717;618;1,3,5;3;9;1;1;1
258131455717;258131455724;7;1,3,5;3;9;1;1;1
258131455724;258131455919;195;1,3,4,5;4;2,9;2;1;1
258131455919;258131456171;252;1,3,4,5;4;2,9;2;1;1
258131456171;258131456362;191;1,3,4,5;4;2,9;2;1;1
258131456362;258131460807;4445;1,3,5;3;9;1;1;1
258131460807;258131462350;1543;1,3,5;3;9;1;1;1
258131462350;258131464266;1916;1,3,5;3;9;1;1;1
258131464266;258131465491;1225;1,3,5;3;9;1;1;1
258131465491;258131466075;584;1,3,5;3;9;1;1;1
258131466075;258131469443;3368;1,3,5;3;9;1;1;1
258131469443;258131472971;3528;1,3,5;3;9;1;1;1
258131472971;258131474419;1448;1,3,5;3;9;1;1;1
258131474419;258131475351;932;1,3,5;3;9;1;1;1
258131475351;258131477354;2003;1,3,5;3;9;1;1;1
258131477354;258131479020;1666;1,3,5;3;9;1;1;1
258131479020;258131479280;260;1,3,5;3;9;1;1;1
258131479280;258131486783;7503;1,3,5;3;9;1;1;1
258131486783;258131488552;1769;1,3,5;3;9;1;1;1
258131488552;258131489943;1391;1,3,5;3;9;1;1;1
258131489943;258131491611;1668;1,3,5;3;9;1;1;1
258131491611;258131493071;1460;1,3,5;3;9;1;1;1
258131493071;258131493441;370;1,3,5;3;9;1;1;1
258131493441;258131497091;3650;1,3,5;3;9;1;1;1
258131497091;258131497901;810;1,3,5;3;9;1;1;1
258131497901;258131502116;4215;1,3,5;3;9;1;1;1
258131502116;258131503063;947;1,3,5;3;9;1;1;1
258131503063;258131504141;1078;1,3,5;3;9;1;1;1
258131504141;258131505273;1132;1,3,5;3;9;1;1;1
258131505273;258131505375;102;1,3,5;3;9;1;1;1
258131505375;258131513959;8584;1,3,5;3;9;1;1;1
258131513959;258131514490;531;1,3,4,5;4;2,9;2;1;1
258131514490;258131517449;2959;1,3,5;3;9;1;1;1
258131517449;258131518975;1526;1,3,5;3;9;1;1;1
258131518975;258131521730;2755;1,3,5;3;9;1;1;1
258131521730;258131534450;12720;1,3,5;3;9;1;1;1
258131534450;258131536507;2057;1,3,5;3;9;1;1;1
258131536507;258131551182;14675;1,3,5;3;9;1;1;1
258131551182;258131551250;68;1,3,5;3;9;1;1;1
258131551250;258131551815;565;1,3,5;3;9;1;1;1
258131551815;258131552638;823;1,3,5;3;9;1;1;1
258131552638;258131553414;776;1,3,5;3;9;1;1;1
258131553414;258131558404;4990;1,3,5;3;9;1;1;1
258131558404;258131565050;6646;1,3,5;3;9;1;1;1
258131565050;258131574953;9903;1,3,5;3;9;1;1;1
258131574953;258131575021;68;1,3,5;3;9;1;1;1
258131575021;258131580592;5571;1,3,5;3;9;1;1;1
258131580592;258131586793;6201;1,3,5;3;9;1;1;1
258131586793;258131586930;137;1,3,5;3;9;1;1;1
258131586930;258131587859;929;1,3,5;3;9;1;1;1
258131587859;258131592774;4915;1,3,5;3;9;1;1;1
258131592774;258131593718;944;1,3,5;3;9;1;1;1
258131593718;258131594028;310;1,3,5;3;9;1;1;1
258131594028;258131597238;3210;1,3,5;3;9;1;1;1
258131597238;258131597605;367;1,3,4,5;4;2,9;2;1;1
258131597605;258131597748;143;1,3,4,5;4;2,9;2;1;1
258131597748;258131597753;5;1,3,4,5;4;2,9;2;1;1
258131597753;258131598216;463;1,3,5;3;9;1;1;1
258131598216;258131599979;1763;1,3,5;3;9;1;1;1
258131599979;258131601399;1420;1,3,5;3;9;1;1;1
258131601399;258131607858;6459;1,3,5;3;9;1;1;1
258131607858;258131607946;88;1,3,5;3;9;1;1;1
258131607946;258131608647;701;1,3,5;3;9;1;1;1
258131608647;258131618143;9496;1,3,5;3;9;1;1;1
258131618143;258131619872;1729;1,3,5;3;9;1;1;1
258131619872;258131619909;37;1,3,5;3;9;1;1;1
258131619909;258131622053;2144;1,3,5;3;9;1;1;1
258131622053;258131622226;173;1,3,5;3;9;1;1;1
258131622226;258131622500;274;1,3,5;3;9;1;1;1
258131622500;258131622779;279;1,3,5;3;9;1;1;1
258131622779;258131626246;3467;1,3,5;3;9;1;1;1
258131626246;258131627372;1126;1,3,5;3;9;1;1;1
258131627372;258131627419;47;1,3,5;3;9;1;1;1
258131627419;258131633469;6050;1,3,5;3;9;1;1;1
258131633469;258131634520;1051;1,3,5;3;9;1;1;1
258131634520;258131635322;802;1,3,5;3;9;1;1;1
258131635322;258131635495;173;1,3,5;3;9;1;1;1
258131635495;258131640024;4529;1,3,5;3;9;1;1;1
258131640024;258131643976;3952;1,3,5;3;9;1;1;1
258131643976;258131644217;241;1,3,5;3;9;1;1;1
258131644217;258131645949;1732;1,3,5;3;9;1;1;1
258131645949;258131646140;191;1,3,5;3;9;1;1;1
258131646140;258131649268;3128;1,3,5;3;9;1;1;1
258131649268;258131650139;871;1,3,5;3;9;1;1;1
258131650139;258131659288;9149;1,3,5;3;9;1;1;1
258131659288;258131662260;2972;1,3,5;3;9;1;1;1
258131662260;258131662789;529;1,3,4,5;4;2,9;2;1;1
258131662789;258131667403;4614;1,3,5;3;9;1;1;1
258131667403;258131669430;2027;1,3,5;3;9;1;1;1
258131669430;258131674858;5428;1,3,5;3;9;1;1;1
258131674858;258131675968;1110;1,3,5;3;9;1;1;1
258131675968;258131678755;2787;1,3,5;3;9;1;1;1
258131678755;258131679981;1226;1,3,5;3;9;1;1;1
258131679981;258131680232;251;1,3,5;3;9;1;1;1
258131680232;258131681166;934;1,3,5;3;9;1;1;1
258131681166;258131681429;263;1,3,5;3;9;1;1;1
258131681429;258131681820;391;1,3,5;3;9;1;1;1
258131681820;258131690948;9128;1,3,5;3;9;1;1;1
258131690948;258131693160;2212;1,3,5;3;9;1;1;1
258131693160;258131695256;2096;1,3,5;3;9;1;1;1
258131695256;258131697053;1797;1,3,5;3;9;1;1;1
258131697053;258131699312;2259;1,3,5;3;9;1;1;1
258131699312;258131700356;1044;1,3,5;3;9;1;1;1
258131700356;258131703166;2810;1,3,5;3;9;1;1;1
258131703166;258131709120;5954;1,3,5;3;9;1;1;1
258131709120;258131711663;2543;1,3,5;3;9;1;1;1
258131711663;258131715067;3404;1,3,5;3;9;1;1;1
258131715067;258131718170;3103;1,3,5;3;9;1;1;1
258131718170;258131718952;782;1,3,5;3;9;1;1;1
258131718952;258131719192;240;1,3,5;3;9;1;1;1
258131719192;258131720544;1352;1,3,5;3;9;1;1;1
258131720544;258131721778;1234;1,3,5;3;9;1;1;1
258131721778;258131722956;1178;1,3,5;3;9;1;1;1
258131722956;258131723345;389;1,3,5;3;9;1;1;1
258131723345;258131727396;4051;1,3,5;3;9;1;1;1
258131727396;258131731349;3953;1,3,5;3;9;1;1;1
258131731349;258131733879;2530;1,3,5;3;9;1;1;1
258131733879;258131734304;425;1,3,5;3;9;1;1;1
258131734304;258131734921;617;1,3,4,5;4;2,9;2;1;1
258131734921;258131739670;4749;1,3,5;3;9;1;1;1
258131739670;258131754779;15109;1,3,5;3;9;1;1;1
258131754779;258131758857;4078;1,3,5;3;9;1;1;1
258131758857;258131759801;944;1,3,5;3;9;1;1;1
258131759801;258131767774;7973;1,3,5;3;9;1;1;1
258131767774;258131769600;1826;1,3,5;3;9;1;1;1
258131769600;258131770142;542;1,3,4,5;4;2,9;2;1;1
258131770142;258131773486;3344;1,3,5;3;9;1;1;1
258131773486;258131774371;885;1,3,5;3;9;1;1;1
258131774371;258131775546;1175;1,3,5;3;9;1;1;1
258131775546;258131775610;64;1,3,5;3;9;1;1;1
258131775610;258131776475;865;1,3,5;3;9;1;1;1
258131776475;258131777031;556;1,3,5;3;9;1;1;1
258131777031;258131788159;11128;1,3,5;3;9;1;1;1
258131788159;258131788691;532;1,3,5;3;9;1;1;1
258131788691;258131790702;2011;1,3,5;3;9;1;1;1
258131790702;258131792798;2096;1,3,5;3;9;1;1;1
258131792798;258131794102;1304;1,3,5;3;9;1;1;1
258131794102;258131794484;382;1,3,5;3;9;1;1;1
258131794484;258131794943;459;1,3,5;3;9;1;1;1
258131794943;258131795381;438;1,3,5;3;9;1;1;1
258131795381;258131795852;471;1,3,5;3;9;1;1;1
258131795852;258131798329;2477;1,3,5;3;9;1;1;1
258131798329;258131801783;3454;1,3,5;3;9;1;1;1
258131801783;258131802088;305;1,3,5;3;9;1;1;1
258131802088;258131802763;675;1,3,5;3;9;1;1;1
258131802763;258131823674;20911;1,3,5;3;9;1;1;1
258131823674;258131838577;14903;1,3,5;3;9;1;1;1
258131838577;258131838583;6;1,3,5;3;9;1;1;1
258131838583;258131840172;1589;1,3,5;3;9;1;1;1
258131840172;258131840664;492;1,3,5;3;9;1;1;1
258131840664;258131844212;3548;1,3,5;3;9;1;1;1
258131844212;258131854698;10486;1,3,5;3;9;1;1;1
258131854698;258131856585;1887;1,3,5;3;9;1;1;1
258131856585;258131857527;942;1,3,5;3;9;1;1;1
258131857527;258131857615;88;1,3,5;3;9;1;1;1
258131857615;258131858348;733;1,3,5;3;9;1;1;1
258131858348;258131860367;2019;1,3,5;3;9;1;1;1
258131860367;258131860618;251;1,3,5;3;9;1;1;1
258131860618;258131861625;1007;1,3,5;3;9;1;1;1
258131861625;258131862398;773;1,3,5;3;9;1;1;1
258131862398;258131863208;810;1,3,5;3;9;1;1;1
258131863208;258131864161;953;1,3,5;3;9;1;1;1
258131864161;258131865108;947;1,3,5;3;9;1;1;1
258131865108;258131865296;188;1,3,5;3;9;1;1;1
258131865296;258131865882;586;1,3,5;3;9;1;1;1
258131865882;258131865994;112;1,3,5;3;9;1;1;1
258131865994;258131866714;720;1,3,5;3;9;1;1;1
258131866714;258131866899;185;1,3,5;3;9;1;1;1
258131866899;258131866994;95;1,3,5;3;9;1;1;1
258131866994;258131867290;296;1,3,5;3;9;1;1;1
258131867290;258131868909;1619;1,3,5;3;9;1;1;1
258131868909;258131869860;951;1,3,5;3;9;1;1;1
258131869860;258131872807;2947;1,3,5;3;9;1;1;1
258131872807;258131873351;544;1,3,5;3;9;1;1;1
258131873351;258131873648;297;1,3,5;3;9;1;1;1
258131873648;258131874849;1201;1,3,5;3;9;1;1;1
258131874849;258131876485;1636;1,3,5;3;9;1;1;1
258131876485;258131877198;713;1,3,5;3;9;1;1;1
258131877198;258131880672;3474;1,3,5;3;9;1;1;1
258131880672;258131881671;999;1,3,5;3;9;1;1;1
258131881671;258131884315;2644;1,3,5;3;9;1;1;1
258131884315;258131884583;268;1,3,5;3;9;1;1;1
258131884583;258131892483;7900;1,3,5;3;9;1;1;1
258131892483;258131892850;367;1,3,5;3;9;1;1;1
258131892850;258131895109;2259;1,3,5;3;9;1;1;1
258131895109;258131896010;901;1,3,5;3;9;1;1;1
258131896010;258131897182;1172;1,3,5;3;9;1;1;1
258131897182;258131897477;295;1,3,5;3;9;1;1;1
258131897477;258131898226;749;1,3,5;3;9;1;1;1
258131898226;258131902759;4533;1,3,5;3;9;1;1;1
258131902759;258131903202;443;1,3,5;3;9;1;1;1
258131903202;258131904478;1276;1,3,5;3;9;1;1;1
258131904478;258131908310;3832;1,3,5;3;9;1;1;1
258131908310;258131913156;4846;1,3,5;3;9;1;1;1
258131913156;258131914821;1665;1,3,5;3;9;1;1;1
258131914821;258131915003;182;1,3,5;3;9;1;1;1
258131915003;258131919679;4676;1,3,5;3;9;1;1;1
258131919679;258131920462;783;1,3,5;3;9;1;1;1
258131920462;258131923084;2622;1,3,5;3;9;1;1;1
258131923084;258131924413;1329;1,3,5;3;9;1;1;1
258131924413;258131925862;1449;1,3,5;3;9;1;1;1
258131925862;258131926202;340;1,3,5;3;9;1;1;1
258131926202;258131929385;3183;1,3,5;3;9;1;1;1
258131929385;258131930178;793;1,3,4,5;4;2,9;2;1;1
258131930178;258131930505;327;1,3,4,5;4;2,9;2;1;1
258131930505;258131953789;23284;1,3,5;3;9;1;1;1
258131953789;258131958301;4512;1,3,5;3;9;1;1;1
258131958301;258131962759;4458;1,3,5;3;9;1;1;1
258131962759;258131964488;1729;1,3,5;3;9;1;1;1
258131964488;258131969326;4838;1,3,5;3;9;1;1;1
258131969326;258131975859;6533;1,3,5;3;9;1;1;1
258131975859;258131976187;328;1,3,5;3;9;1;1;1
258131976187;258131979992;3805;1,3,5;3;9;1;1;1
258131979992;258131980276;284;1,3,4,5;4;2,9;2;1;1
258131980276;258131980459;183;1,3,4,5;4;2,9;2;1;1
258131980459;258131983883;3424;1,3,5;3;9;1;1;1
258131983883;258131986311;2428;1,3,5;3;9;1;1;1
258131986311;258131992435;6124;1,3,5;3;9;1;1;1
258131992435;258131997062;4627;1,3,5;3;9;1;1;1
258131997062;258131998730;1668;1,3,5;3;9;1;1;1
258131998730;258131999124;394;1,3,5;3;9;1;1;1
258131999124;258132001133;2009;1,3,5;3;9;1;1;1
258132001133;258132001787;654;1,3,5;3;9;1;1;1
258132001787;258132002929;1142;1,3,5;3;9;1;1;1
258132002929;258132005149;2220;1,3,5;3;9;1;1;1
258132005149;258132005796;647;1,3,5;3;9;1;1;1
258132005796;258132012050;6254;1,3,5;3;9;1;1;1
258132012050;258132013248;1198;1,3,5;3;9;1;1;1
258132013248;258132013800;552;1,3,5;3;9;1;1;1
258132013800;258132015331;1531;1,3,5;3;9;1;1;1
258132015331;258132016084;753;1,3,5;3;9;1;1;1
258132016084;258132016861;777;1,3,5;3;9;1;1;1
258132016861;258132023154;6293;1,3,5;3;9;1;1;1
258132023154;258132023697;543;1,3,5;3;9;1;1;1
258132023697;258132026347;2650;1,3,5;3;9;1;1;1
258132026347;258132035410;9063;1,3,5;3;9;1;1;1
258132035410;258132036643;1233;1,3,5;3;9;1;1;1
258132036643;258132037676;1033;1,3,5;3;9;1;1;1
258132037676;258132038730;1054;1,3,5;3;9;1;1;1
258132038730;258132047410;8680;1,3,5;3;9;1;1;1
258132047410;258132048895;1485;1,3,5;3;9;1;1;1
258132048895;258132053946;5051;1,3,5;3;9;1;1;1
258132053946;258132054601;655;1,3,4,5;4;2,9;2;1;1
258132054601;258132060615;6014;1,3,5;3;9;1;1;1
258132060615;258132071178;10563;1,3,5;3;9;1;1;1
258132071178;258132073632;2454;1,3,5;3;9;1;1;1
258132073632;258132075878;2246;1,3,5;3;9;1;1;1
258132075878;258132092485;16607;1,3,5;3;9;1;1;1
258132092485;258132096418;3933;1,3,5;3;9;1;1;1
258132096418;258132097085;667;1,3,5;3;9;1;1;1
258132097085;258132108539;11454;1,3,5;3;9;1;1;1
258132108539;258132109283;744;1,3,5;3;9;1;1;1
258132109283;258132111511;2228;1,3,5;3;9;1;1;1
258132111511;258132114060;2549;1,3,5;3;9;1;1;1
258132114060;258132116541;2481;1,3,5;3;9;1;1;1
258132116541;258132117139;598;1,3,5;3;9;1;1;1
258132117139;258132117917;778;1,3,5;3;9;1;1;1
258132117917;258132118298;381;1,3,5;3;9;1;1;1
258132118298;258132118972;674;1,3,5;3;9;1;1;1
258132118972;258132119725;753;1,3,5;3;9;1;1;1
258132119725;258132120022;297;1,3,5;3;9;1;1;1
258132120022;258132121492;1470;1,3,5;3;9;1;1;1
258132121492;258132123877;2385;1,3,5;3;9;1;1;1
258132123877;258132125481;1604;1,3,5;3;9;1;1;1
258132125481;258132127547;2066;1,3,5;3;9;1;1;1
258132127547;258132128966;1419;1,3,5;3;9;1;1;1
258132128966;258132135918;6952;1,3,5;3;9;1;1;1
258132135918;258132139720;3802;1,3,5;3;9;1;1;1
258132139720;258132140087;367;1,3,5;3;9;1;1;1
258132140087;258132140232;145;1,3,5;3;9;1;1;1
258132140232;258132140260;28;1,3,5;3;9;1;1;1
258132140260;258132140536;276;1,3,5;3;9;1;1;1
258132140536;258132140916;380;1,3,5;3;9;1;1;1
258132140916;258132142636;1720;1,3,5;3;9;1;1;1
258132142636;258132144649;2013;1,3,5;3;9;1;1;1
258132144649;258132150435;5786;1,3,5;3;9;1;1;1
258132150435;258132151161;726;1,3,5;3;9;1;1;1
258132151161;258132152017;856;1,3,5;3;9;1;1;1
258132152017;258132152234;217;1,3,5;3;9;1;1;1
258132152234;258132153159;925;1,3,5;3;9;1;1;1
258132153159;258132154999;1840;1,3,5;3;9;1;1;1
258132154999;258132156006;1007;1,3,5;3;9;1;1;1
258132156006;258132156835;829;1,3,5;3;9;1;1;1
258132156835;258132173987;17152;1,3,5;3;9;1;1;1
258132173987;258132174041;54;1,3,5;3;9;1;1;1
258132174041;258132179079;5038;1,3,5;3;9;1;1;1
258132179079;258132180270;1191;1,3,5;3;9;1;1;1
258132180270;258132181640;1370;1,3,5;3;9;1;1;1
258132181640;258132185792;4152;1,3,5;3;9;1;1;1
258132185792;258132186493;701;1,3,5;3;9;1;1;1
258132186493;258132188171;1678;1,3,5;3;9;1;1;1
258132188171;258132188710;539;1,3,5;3;9;1;1;1
258132188710;258132190182;1472;1,3,5;3;9;1;1;1
258132190182;258132198198;8016;1,3,5;3;9;1;1;1
258132198198;258132202102;3904;1,3,5;3;9;1;1;1
258132202102;258132202310;208;1,3,5;3;9;1;1;1
258132202310;258132203587;1277;1,3,5;3;9;1;1;1
258132203587;258132204068;481;1,3,5;3;9;1;1;1
258132204068;258132205483;1415;1,3,5;3;9;1;1;1
258132205483;258132207338;1855;1,3,5;3;9;1;1;1
258132207338;258132208173;835;1,3,5;3;9;1;1;1
258132208173;258132210215;2042;1,3,5;3;9;1;1;1
258132210215;258132210245;30;1,3,5;3;9;1;1;1
258132210245;258132210808;563;1,3,5;3;9;1;1;1
258132210808;258132211346;538;1,3,5;3;9;1;1;1
258132211346;258132211649;303;1,3,5;3;9;1;1;1
258132211649;258132211979;330;1,3,5;3;9;1;1;1
258132211979;258132212345;366;1,3,5;3;9;1;1;1
258132212345;258132220684;8339;1,3,5;3;9;1;1;1
258132220684;258132230514;9830;1,3,5;3;9;1;1;1
258132230514;258132232185;1671;1,3,5;3;9;1;1;1
258132232185;258132232797;612;1,3,4,5;4;2,9;2;1;1
258132232797;258132235523;2726;1,3,5;3;9;1;1;1
258132235523;258132236479;956;1,3,5;3;9;1;1;1
258132236479;258132236598;119;1,3,5;3;9;1;1;1
258132236598;258132237848;1250;1,3,5;3;9;1;1;1
258132237848;258132238514;666;1,3,5;3;9;1;1;1
258132238514;258132239848;1334;1,3,5;3;9;1;1;1
258132239848;258132240522;674;1,3,5;3;9;1;1;1
258132240522;258132240572;50;1,3,5;3;9;1;1;1
258132240572;258132242415;1843;1,3,5;3;9;1;1;1
258132242415;258132244561;2146;1,3,5;3;9;1;1;1
258132244561;258132246726;2165;1,3,5;3;9;1;1;1
258132246726;258132247077;351;1,3,5;3;9;1;1;1
258132247077;258132247202;125;1,3,5;3;9;1;1;1
258132247202;258132247378;176;1,3,5;3;9;1;1;1
258132247378;258132250950;3572;1,3,5;3;9;1;1;1
258132250950;258132251643;693;1,3,5;3;9;1;1;1
258132251643;258132252602;959;1,3,5;3;9;1;1;1
258132252602;258132252693;91;1,3,5;3;9;1;1;1
258132252693;258132252906;213;1,3,5;3;9;1;1;1
258132252906;258132253442;536;1,3,5;3;9;1;1;1
258132253442;258132255590;2148;1,3,5;3;9;1;1;1
258132255590;258132258708;3118;1,3,5;3;9;1;1;1
258132258708;258132261265;2557;1,3,5;3;9;1;1;1
258132261265;258132262676;1411;1,3,5;3;9;1;1;1
258132262676;258132262899;223;1,3,5;3;9;1;1;1
258132262899;258132263900;1001;1,3,5;3;9;1;1;1
258132263900;258132264974;1074;1,3,5;3;9;1;1;1
258132264974;258132266213;1239;1,3,5;3;9;1;1;1
258132266213;258132266744;531;1,3,5;3;9;1;1;1
258132266744;258132268675;1931;1,3,5;3;9;1;1;1
258132268675;258132269128;453;1,3,5;3;9;1;1;1
258132269128;258132269536;408;1,3,5;3;9;1;1;1
258132269536;258132284671;15135;1,3,5;3;9;1;1;1
258132284671;258132287139;2468;1,3,5;3;9;1;1;1
258132287139;258132287696;557;1,3,5;3;9;1;1;1
258132287696;258132290005;2309;1,3,5;3;9;1;1;1
258132290005;258132291652;1647;1,3,5;3;9;1;1;1
258132291652;258132296537;4885;1,3,5;3;9;1;1;1
258132296537;258132297064;527;1,3,5;3;9;1;1;1
258132297064;258132307468;10404;1,3,5;3;9;1;1;1
258132307468;258132324525;17057;1,3,5;3;9;1;1;1
258132324525;258132327822;3297;1,3,5;3;9;1;1;1
258132327822;258132336625;8803;1,3,5;3;9;1;1;1
258132336625;258132339000;2375;1,3,5;3;9;1;1;1
258132339000;258132339835;835;1,3,5;3;9;1;1;1
258132339835;258132340683;848;1,3,5;3;9;1;1;1
258132340683;258132344111;3428;1,3,5;3;9;1;1;1
258132344111;258132349439;5328;1,3,5;3;9;1;1;1
258132349439;258132349455;16;1,3,5;3;9;1;1;1
258132349455;258132349713;258;1,3,5;3;9;1;1;1
258132349713;258132350775;1062;1,3,5;3;9;1;1;1
258132350775;258132351420;645;1,3,5;3;9;1;1;1
258132351420;258132351902;482;1,3,5;3;9;1;1;1
258132351902;258132352730;828;1,3,5;3;9;1;1;1
258132352730;258132353475;745;1,3,5;3;9;1;1;1
258132353475;258132353960;485;1,3,4,5;4;2,9;2;1;1
258132353960;258132354152;192;1,3,5;3;9;1;1;1
258132354152;258132355087;935;1,3,5;3;9;1;1;1
258132355087;258132355819;732;1,3,5;3;9;1;1;1
258132355819;258132365824;10005;1,3,5;3;9;1;1;1
258132365824;258132370585;4761;1,3,5;3;9;1;1;1
258132370585;258132371696;1111;1,3,5;3;9;1;1;1
258132371696;258132394111;22415;1,3,5;3;9;1;1;1
258132394111;258132394932;821;1,3,5;3;9;1;1;1
258132394932;258132401594;6662;1,3,5;3;9;1;1;1
258132401594;258132402794;1200;1,3,5;3;9;1;1;1
258132402794;258132420620;17826;1,3,5;3;9;1;1;1
258132420620;258132422094;1474;1,3,5;3;9;1;1;1
258132422094;258132425351;3257;1,3,5;3;9;1;1;1
258132425351;258132438120;12769;1,3,5;3;9;1;1;1
258132438120;258132438594;474;1,3,5;3;9;1;1;1
258132438594;258132448761;10167;1,3,5;3;9;1;1;1
258132448761;258132455466;6705;1,3,5;3;9;1;1;1
258132455466;258132457800;2334;1,3,5;3;9;1;1;1
258132457800;258132466316;8516;1,3,5;3;9;1;1;1
258132466316;258132466902;586;1,3,4,5;4;2,9;2;1;1
258132466902;258132467005;103;1,3,4,5;4;2,9;2;1;1
258132467005;258132467068;63;1,3,4,5;4;2,9;2;1;1
258132467068;258132467811;743;1,3,4,5;4;2,9;2;1;1
258132467811;258132469891;2080;1,3,5;3;9;1;1;1
258132469891;258132470228;337;1,3,5;3;9;1;1;1
258132470228;258132470745;517;1,3,5;3;9;1;1;1
258132470745;258132471352;607;1,3,5;3;9;1;1;1
258132471352;258132471688;336;1,3,5;3;9;1;1;1
258132471688;258132473378;1690;1,3,5;3;9;1;1;1
258132473378;258132475690;2312;1,3,5;3;9;1;1;1
258132475690;258132475873;183;1,3,5;3;9;1;1;1
258132475873;258132477246;1373;1,3,5;3;9;1;1;1
258132477246;258132480583;3337;1,3,5;3;9;1;1;1
258132480583;258132483622;3039;1,3,5;3;9;1;1;1
258132483622;258132483964;342;1,3,5;3;9;1;1;1
258132483964;258132542961;58997;1,3,5;3;9;1;1;1
258132542961;258132546781;3820;1,3,5;3;9;1;1;1
258132546781;258132548430;1649;1,3,5;3;9;1;1;1
258132548430;258132548578;148;1,3,5;3;9;1;1;1
258132548578;258132549224;646;1,3,5;3;9;1;1;1
258132549224;258132550402;1178;1,3,5;3;9;1;1;1
258132550402;258132555097;4695;1,3,5;3;9;1;1;1
258132555097;258132560453;5356;1,3,5;3;9;1;1;1
258132560453;258132561005;552;1,3,4,5;4;2,9;2;1;1
258132561005;258132569108;8103;1,3,5;3;9;1;1;1
258132569108;258132573379;4271;1,3,5;3;9;1;1;1
258132573379;258132594555;21176;1,3,5;3;9;1;1;1
258132594555;258132595008;453;1,3,4,5;4;2,9;2;1;1
258132595008;258132605896;10888;1,3,5;3;9;1;1;1
258132605896;258132607292;1396;1,3,5;3;9;1;1;1
258132607292;258132618122;10830;1,3,5;3;9;1;1;1
258132618122;258132631594;13472;1,3,5;3;9;1;1;1
258132631594;258132632640;1046;1,3,5;3;9;1;1;1
258132632640;258132634678;2038;1,3,5;3;9;1;1;1
258132634678;258132635095;417;1,3,5;3;9;1;1;1
258132635095;258132635621;526;1,3,4,5;4;2,9;2;1;1
258132635621;258132637756;2135;1,3,5;3;9;1;1;1
258132637756;258132638196;440;1,3,5;3;9;1;1;1
258132638196;258132638970;774;1,3,5;3;9;1;1;1
258132638970;258132643365;4395;1,3,5;3;9;1;1;1
258132643365;258132646889;3524;1,3,5;3;9;1;1;1
258132646889;258132648374;1485;1,3,5;3;9;1;1;1
258132648374;258132650749;2375;1,3,5;3;9;1;1;1
258132650749;258132653319;2570;1,3,5;3;9;1;1;1
258132653319;258132654303;984;1,3,5;3;9;1;1;1
258132654303;258132654488;185;1,3,5;3;9;1;1;1
258132654488;258132655419;931;1,3,5;3;9;1;1;1
258132655419;258132656072;653;1,3,5;3;9;1;1;1
258132656072;258132657056;984;1,3,5;3;9;1;1;1
258132657056;258132660560;3504;1,3,5;3;9;1;1;1
258132660560;258132664323;3763;1,3,5;3;9;1;1;1
258132664323;258132664370;47;1,3,5;3;9;1;1;1
258132664370;258132667339;2969;1,3,5;3;9;1;1;1
258132667339;258132672166;4827;1,3,5;3;9;1;1;1
258132672166;258132674946;2780;1,3,5;3;9;1;1;1
258132674946;258132677911;2965;1,3,5;3;9;1;1;1
258132677911;258132679167;1256;1,3,5;3;9;1;1;1
258132679167;258132679237;70;1,3,5;3;9;1;1;1
258132679237;258132680196;959;1,3,5;3;9;1;1;1
258132680196;258132680564;368;1,3,5;3;9;1;1;1
258132680564;258132680832;268;1,3,5;3;9;1;1;1
258132680832;258132680941;109;1,3,5;3;9;1;1;1
258132680941;258132681272;331;1,3,5;3;9;1;1;1
258132681272;258132681430;158;1,3,5;3;9;1;1;1
258132681430;258132681622;192;1,3,5;3;9;1;1;1
258132681622;258132681988;366;1,3,4,5;4;2,9;2;1;1
258132681988;258132682088;100;1,3,4,5;4;2,9;2;1;1
258132682088;258132682962;874;1,3,5;3;9;1;1;1
258132682962;258132683894;932;1,3,5;3;9;1;1;1
258132683894;258132684001;107;1,3,5;3;9;1;1;1
258132684001;258132685406;1405;1,3,5;3;9;1;1;1
258132685406;258132688686;3280;1,3,5;3;9;1;1;1
258132688686;258132693347;4661;1,3,5;3;9;1;1;1
258132693347;258132695506;2159;1,3,5;3;9;1;1;1
258132695506;258132701917;6411;1,3,5;3;9;1;1;1
258132701917;258132704504;2587;1,3,5;3;9;1;1;1
258132704504;258132714964;10460;1,3,5;3;9;1;1;1
258132714964;258132717188;2224;1,3,5;3;9;1;1;1
258132717188;258132718129;941;1,3,5;3;9;1;1;1
258132718129;258132723558;5429;1,3,5;3;9;1;1;1
258132723558;258132725126;1568;1,3,4,5;4;2,9;2;1;1
258132725126;258132725746;620;1,3,5;3;9;1;1;1
258132725746;258132726785;1039;1,3,4,5;4;2,9;2;1;1
258132726785;258132727284;499;1,3,5;3;9;1;1;1
258132727284;258132728091;807;1,3,5;3;9;1;1;1
258132728091;258132728717;626;1,3,4,5;4;2,9;2;1;1
258132728717;258132742547;13830;1,3,5;3;9;1;1;1
258132742547;258132751230;8683;1,3,5;3;9;1;1;1
258132751230;258132753445;2215;1,3,5;3;9;1;1;1
258132753445;258132757709;4264;1,3,5;3;9;1;1;1
258132757709;258132762096;4387;1,3,5;3;9;1;1;1
258132762096;258132773855;11759;1,3,5;3;9;1;1;1
258132773855;258132785373;11518;1,3,5;3;9;1;1;1
258132785373;258132786653;1280;1,3,5;3;9;1;1;1
258132786653;258132793912;7259;1,3,5;3;9;1;1;1
258132793912;258132811279;17367;1,3,5;3;9;1;1;1
258132811279;258132835820;24541;1,3,5;3;9;1;1;1
258132835820;258132838347;2527;1,3,5;3;9;1;1;1
258132838347;258132848298;9951;1,3,5;3;9;1;1;1
258132848298;258132848416;118;1,3,5;3;9;1;1;1
258132848416;258132849882;1466;1,3,5;3;9;1;1;1
258132849882;258132850692;810;1,3,5;3;9;1;1;1
258132850692;258132852565;1873;1,3,5;3;9;1;1;1
258132852565;258132852588;23;1,3,5;3;9;1;1;1
258132852588;258132857440;4852;1,3,5;3;9;1;1;1
258132857440;258132862639;5199;1,3,5;3;9;1;1;1
258132862639;258132872502;9863;1,3,5;3;9;1;1;1
258132872502;258132897306;24804;1,3,5;3;9;1;1;1
258132897306;258132921843;24537;1,3,5;3;9;1;1;1
258132921843;258132925950;4107;1,3,5;3;9;1;1;1
258132925950;258132927170;1220;1,3,5;3;9;1;1;1
258132927170;258132928400;1230;1,3,5;3;9;1;1;1
258132928400;258132928619;219;1,3,5;3;9;1;1;1
258132928619;258132928841;222;1,3,5;3;9;1;1;1
258132928841;258132929724;883;1,3,5;3;9;1;1;1
258132929724;258132929875;151;1,3,5;3;9;1;1;1
258132929875;258132930358;483;1,3,4,5;4;2,9;2;1;1
258132930358;258132930534;176;1,3,4,5;4;2,9;2;1;1
258132930534;258132930882;348;1,3,5;3;9;1;1;1
258132930882;258132931421;539;1,3,5;3;9;1;1;1
258132931421;258132931949;528;1,3,5;3;9;1;1;1
258132931949;258132932203;254;1,3,5;3;9;1;1;1
258132932203;258132932435;232;1,3,5;3;9;1;1;1
258132932435;258132933251;816;1,3,5;3;9;1;1;1
258132933251;258132934748;1497;1,3,5;3;9;1;1;1
258132934748;258132936132;1384;1,3,5;3;9;1;1;1
258132936132;258132936232;100;1,3,5;3;9;1;1;1
258132936232;258132936776;544;1,3,5;3;9;1;1;1
258132936776;258132938207;1431;1,3,5;3;9;1;1;1
258132938207;258132938458;251;1,3,5;3;9;1;1;1
258132938458;258132939282;824;1,3,5;3;9;1;1;1
258132939282;258132949451;10169;1,3,5;3;9;1;1;1
258132949451;258132949487;36;1,3,5;3;9;1;1;1
258132949487;258132949856;369;1,3,5;3;9;1;1;1
258132949856;258132949897;41;1,3,5;3;9;1;1;1
258132949897;258132952907;3010;1,3,5;3;9;1;1;1
258132952907;258132953411;504;1,3,5;3;9;1;1;1
258132953411;258132954687;1276;1,3,5;3;9;1;1;1
258132954687;258132954958;271;1,3,5;3;9;1;1;1
258132954958;258132955945;987;1,3,5;3;9;1;1;1
258132955945;258132957960;2015;1,3,5;3;9;1;1;1
258132957960;258132958323;363;1,3,5;3;9;1;1;1
258132958323;258132958700;377;1,3,5;3;9;1;1;1
258132958700;258132959092;392;1,3,5;3;9;1;1;1
258132959092;258132959206;114;1,3,5;3;9;1;1;1
258132959206;258132959770;564;1,3,5;3;9;1;1;1
258132959770;258132960538;768;1,3,5;3;9;1;1;1
258132960538;258132961052;514;1,3,5;3;9;1;1;1
258132961052;258132961555;503;1,3,5;3;9;1;1;1
258132961555;258132962055;500;1,3,5;3;9;1;1;1
258132962055;258132962700;645;1,3,5;3;9;1;1;1
258132962700;258132962904;204;1,3,5;3;9;1;1;1
258132962904;258132963969;1065;1,3,5;3;9;1;1;1
258132963969;258132964006;37;1,3,5;3;9;1;1;1
258132964006;258132964232;226;1,3,5;3;9;1;1;1
258132964232;258132965422;1190;1,3,5;3;9;1;1;1
258132965422;258132965535;113;1,3,5;3;9;1;1;1
258132965535;258132965615;80;1,3,5;3;9;1;1;1
258132965615;258132966542;927;1,3,5;3;9;1;1;1
258132966542;258132966795;253;1,3,5;3;9;1;1;1
258132966795;258132967086;291;1,3,5;3;9;1;1;1
258132967086;258132967312;226;1,3,5;3;9;1;1;1
258132967312;258132968786;1474;1,3,5;3;9;1;1;1
258132968786;258132969595;809;1,3,5;3;9;1;1;1
258132969595;258132969937;342;1,3,5;3;9;1;1;1
258132969937;258132970187;250;1,3,5;3;9;1;1;1
258132970187;258132970314;127;1,3,5;3;9;1;1;1
258132970314;258132971989;1675;1,3,5;3;9;1;1;1
258132971989;258132973364;1375;1,3,5;3;9;1;1;1
258132973364;258132974291;927;1,3,5;3;9;1;1;1
258132974291;258132974366;75;1,3,5;3;9;1;1;1
258132974366;258132975044;678;1,3,5;3;9;1;1;1
258132975044;258132979933;4889;1,3,5;3;9;1;1;1
258132979933;258132983172;3239;1,3,5;3;9;1;1;1
258132983172;258132983903;731;1,3,5;3;9;1;1;1
258132983903;258132984833;930;1,3,5;3;9;1;1;1
258132984833;258132985243;410;1,3,5;3;9;1;1;1
258132985243;258132988237;2994;1,3,5;3;9;1;1;1
258132988237;258133003578;15341;1,3,5;3;9;1;1;1
258133003578;258133003787;209;1,3,4,5;4;2,9;2;1;1
258133003787;258133003854;67;1,3,4,5;4;2,9;2;1;1
258133003854;258133004228;374;1,3,4,5;4;2,9;2;1;1
258133004228;258133005905;1677;1,3,5;3;9;1;1;1
258133005905;258133013268;7363;1,3,5;3;9;1;1;1
258133013268;258133033372;20104;1,3,5;3;9;1;1;1
258133033372;258133045243;11871;1,3,5;3;9;1;1;1
258133045243;258133050489;5246;1,3,5;3;9;1;1;1
258133050489;258133052025;1536;1,3,5;3;9;1;1;1
258133052025;258133063432;11407;1,3,5;3;9;1;1;1
258133063432;258133075056;11624;1,3,5;3;9;1;1;1
258133075056;258133080844;5788;1,3,5;3;9;1;1;1
258133080844;258133081414;570;1,3,4,5;4;2,9;2;1;1
258133081414;258133146183;64769;1,3,5;3;9;1;1;1
258133146183;258133148037;1854;1,3,4,5;4;2,9;2;1;1
258133148037;258133150145;2108;1,3,4,5;4;2,9;2;1;1
258133150145;258133176958;26813;1,3,4,5;4;2,9;2;1;1
258133176958;258133182623;5665;1,3,4,5;4;2,9;2;1;1
258133182623;258133183358;735;1,3,4,5;4;2,9;2;1;1
258133183358;258133186482;3124;1,3,4,5;4;2,9;2;1;1
258133186482;258133186946;464;1,3,4,5;4;2,9;2;1;1
258133186946;258133187027;81;1,3,4,5;4;2,9;2;1;1
258133187027;258133187420;393;1,3,4,5;4;2,9;2;1;1
258133187420;258133187787;367;1,3,4,5;4;2,9;2;1;1
258133187787;258133189177;1390;1,3,4,5;4;2,9;2;1;1
258133189177;258133191545;2368;1,3,4,5;4;2,9;2;1;1
258133191545;258133193829;2284;1,3,4,5;4;2,9;2;1;1
258133193829;258133194929;1100;1,3,4,5;4;2,9;2;1;1
258133194929;258133195673;744;1,3,4,5;4;2,9;2;1;1
258133195673;258133197304;1631;1,3,4,5;4;2,9;2;1;1
258133197304;258133197570;266;1,3,4,5;4;2,9;2;1;1
258133197570;258133197886;316;1,3,4,5;4;2,9;2;1;1
258133197886;258133198149;263;1,3,4,5;4;2,9;2;1;1
258133198149;258133198425;276;1,3,4,5;4;2,9;2;1;1
258133198425;258133199360;935;1,3,4,5;4;2,9;2;1;1
258133199360;258133201060;1700;1,3,4,5;4;2,9;2;1;1
258133201060;258133204229;3169;1,3,4,5;4;2,9;2;1;1
258133204229;258133205993;1764;1,3,4,5;4;2,9;2;1;1
258133205993;258133206312;319;1,3,4,5;4;2,9;2;1;1
258133206312;258133207057;745;1,3,4,5;4;2,9;2;1;1
258133207057;258133207278;221;1,3,5;3;9;1;1;1
258133207278;258133207339;61;1,3,5;3;9;1;1;1
258133207339;258133207552;213;1,3,4,5;4;2,9;2;1;1
258133207552;258133208367;815;1,3,4,5;4;2,9;2;1;1
258133208367;258133209207;840;1,3,5;3;9;1;1;1
258133209207;258133209588;381;1,3,5;3;9;1;1;1
258133209588;258133210145;557;1,3,4,5;4;2,9;2;1;1
258133210145;258133211874;1729;1,3,5;3;9;1;1;1
258133211874;258133211897;23;1,3,5;3;9;1;1;1
258133211897;258133212874;977;1,3,5;3;9;1;1;1
258133212874;258133213079;205;1,3,5;3;9;1;1;1
258133213079;258133216877;3798;1,3,5;3;9;1;1;1
258133216877;258133217312;435;1,3,5;3;9;1;1;1
258133217312;258133218606;1294;1,3,5;3;9;1;1;1
258133218606;258133218942;336;1,3,5;3;9;1;1;1
258133218942;258133220769;1827;1,3,5;3;9;1;1;1
258133220769;258133222118;1349;1,3,5;3;9;1;1;1
258133222118;258133222596;478;1,3,5;3;9;1;1;1
258133222596;258133224187;1591;1,3,5;3;9;1;1;1
258133224187;258133227092;2905;1,3,5;3;9;1;1;1
258133227092;258133237438;10346;1,3,5;3;9;1;1;1
258133237438;258133237913;475;1,3,4,5;4;2,9;2;1;1
258133237913;258133255408;17495;1,3,5;3;9;1;1;1
258133255408;258133255637;229;1,3,5;3;9;1;1;1
258133255637;258133267176;11539;1,3,5;3;9;1;1;1
258133267176;258133270380;3204;1,3,5;3;9;1;1;1
258133270380;258133272591;2211;1,3,5;3;9;1;1;1
258133272591;258133280150;7559;1,3,5;3;9;1;1;1
258133280150;258133329426;49276;1,3,5;3;9;1;1;1
258133329426;258133330363;937;1,3,4,5;4;2,9;2;1;1
258133330363;258133331578;1215;1,3,5;3;9;1;1;1
258133331578;258133332549;971;1,3,4,5;4;2,9;2;1;1
258133332549;258133333859;1310;1,3,5;3;9;1;1;1
258133333859;258133334525;666;1,3,4,5;4;2,9;2;1;1
258133334525;258133335801;1276;1,3,5;3;9;1;1;1
258133335801;258133352567;16766;1,3,5;3;9;1;1;1
258133352567;258133355628;3061;1,3,5;3;9;1;1;1
258133355628;258133361194;5566;1,3,5;3;9;1;1;1
258133361194;258133362292;1098;1,3,5;3;9;1;1;1
258133362292;258133363033;741;1,3,5;3;9;1;1;1
258133363033;258133363322;289;1,3,5;3;9;1;1;1
258133363322;258133363341;19;1,3,5;3;9;1;1;1
258133363341;258133364840;1499;1,3,5;3;9;1;1;1
258133364840;258133365343;503;1,3,5;3;9;1;1;1
258133365343;258133368131;2788;1,3,5;3;9;1;1;1
258133368131;258133381901;13770;1,3,5;3;9;1;1;1
258133381901;258133389052;7151;1,3,5;3;9;1;1;1
258133389052;258133389107;55;1,3,5;3;9;1;1;1
258133389107;258133400722;11615;1,3,5;3;9;1;1;1
258133400722;258133400750;28;1,3,5;3;9;1;1;1
258133400750;258133401137;387;1,3,5;3;9;1;1;1
258133401137;258133403092;1955;1,3,5;3;9;1;1;1
258133403092;258133403965;873;1,3,5;3;9;1;1;1
258133403965;258133404593;628;1,3,4,5;4;2,9;2;1;1
258133404593;258133409538;4945;1,3,5;3;9;1;1;1
258133409538;258133410039;501;1,3,5;3;9;1;1;1
258133410039;258133412872;2833;1,3,5;3;9;1;1;1
258133412872;258133413300;428;1,3,5;3;9;1;1;1
258133413300;258133414127;827;1,3,5;3;9;1;1;1
258133414127;258133416064;1937;1,3,5;3;9;1;1;1
258133416064;258133416512;448;1,3,5;3;9;1;1;1
258133416512;258133416972;460;1,3,5;3;9;1;1;1
258133416972;258133417992;1020;1,3,5;3;9;1;1;1
258133417992;258133419260;1268;1,3,5;3;9;1;1;1
258133419260;258133420966;1706;1,3,5;3;9;1;1;1
258133420966;258133423312;2346;1,3,5;3;9;1;1;1
258133423312;258133429198;5886;1,3,5;3;9;1;1;1
258133429198;258133429256;58;1,3,5;3;9;1;1;1
258133429256;258133431745;2489;1,3,5;3;9;1;1;1
258133431745;258133431931;186;1,3,5;3;9;1;1;1
258133431931;258133432870;939;1,3,5;3;9;1;1;1
258133432870;258133433551;681;1,3,5;3;9;1;1;1
258133433551;258133433758;207;1,3,5;3;9;1;1;1
258133433758;258133434931;1173;1,3,5;3;9;1;1;1
258133434931;258133435431;500;1,3,5;3;9;1;1;1
258133435431;258133436200;769;1,3,5;3;9;1;1;1
258133436200;258133436704;504;1,3,5;3;9;1;1;1
258133436704;258133438318;1614;1,3,5;3;9;1;1;1
258133438318;258133449306;10988;1,3,5;3;9;1;1;1
258133449306;258133458113;8807;1,3,5;3;9;1;1;1
258133458113;258133479173;21060;1,3,5;3;9;1;1;1
258133479173;258133479724;551;1,3,5;3;9;1;1;1
258133479724;258133486085;6361;1,3,5;3;9;1;1;1
258133486085;258133486719;634;1,3,4,5;4;2,9;2;1;1
258133486719;258133486925;206;1,3,5;3;9;1;1;1
258133486925;258133489291;2366;1,3;2;9;1;1;1
258133489291;258133498021;8730;1,3;2;9;1;1;1
258133498021;258133499439;1418;1,3;2;9;1;1;1
258133499439;258133501383;1944;1,3;2;9;1;1;1
258133501383;258133501386;3;1,3;2;9;1;1;1
258133501386;258133501650;264;1,3;2;9;1;1;1
258133501650;258133501814;164;1,3;2;9;1;1;1
258133501814;258133502402;588;1,3;2;9;1;1;1
258133502402;258133503621;1219;1,3;2;9;1;1;1
258133503621;258133513097;9476;1,3;2;9;1;1;1
258133513097;258133513124;27;1,3;2;9;1;1;1
258133513124;258133515298;2174;1,3;2;9;1;1;1
258133515298;258133524398;9100;1;1;9;1;1;1
258133524398;258133526480;2082;1,4;2;2,9;2;1;1
258133526480;258133526830;350;1;1;9;1;1;1
258133526830;258133527684;854;1,4;2;2,9;2;1;1
258133527684;258133528732;1048;1;1;9;1;1;1
258133528732;258133529369;637;1,4;2;2,9;2;1;1
258133529369;258133582749;53380;1;1;9;1;1;1
258133582749;258133591752;9003;1,3;2;9;1;1;1
258133591752;258133601628;9876;1,3;2;9;1;1;1
258133601628;258133602174;546;1,3,4;3;2,9;2;1;1
258133602174;258133611201;9027;1,3;2;9;1;1;1
258133611201;258133654326;43125;1,3;2;9;1;1;1
258133654326;258133666592;12266;1;1;9;1;1;1
258133666592;258133667234;642;1,4;2;2,9;2;1;1
258133667234;258133707912;40678;1;1;9;1;1;1
258133707912;258133736942;29030;1,3;2;9;1;1;1
258133736942;258133738033;1091;1,3,4;3;2,9;2;1;1
258133738033;258133739220;1187;1,3;2;9;1;1;1
258133739220;258133739792;572;1,3,4;3;2,9;2;1;1
258133739792;258133753847;14055;1,3;2;9;1;1;1
258133753847;258133780456;26609;1,3;2;9;1;1;1
258133780456;258133813790;33334;1,3;2;9;1;1;1
258133813790;258133814285;495;1,3,4;3;2,9;2;1;1
258133814285;258133840914;26629;1,3;2;9;1;1;1
258133840914;258133867528;26614;1;1;9;1;1;1
258133867528;258133868150;622;1,4;2;2,9;2;1;1
258133868150;258133871894;3744;1;1;9;1;1;1
258133871894;258133872596;702;1,4;2;9;1;1;1
258133872596;258133917492;44896;1;1;9;1;1;1
258133917492;258133917970;478;1,4;2;2,9;2;1;1
258133917970;258133950420;32450;1;1;9;1;1;1
258133950420;258133954317;3897;1,4;2;2,9;2;1;1
258133954317;258134007875;53558;1;1;9;1;1;1
258134007875;258134011861;3986;1,4;2;2,9;2;1;1
258134011861;258134091065;79204;1;1;9;1;1;1
258134091065;258134091700;635;1,4;2;2,9;2;1;1
258134091700;258134149317;57617;1;1;9;1;1;1
258134149317;258134149912;595;1,4;2;2,9;2;1;1
258134149912;258134150091;179;1;1;9;1;1;1
258134150091;258134150140;49;1,4;2;2,9;2;1;1
258134150140;258134151062;922;1,4;2;2,9;2;1;1
258134151062;258134151073;11;1,4;2;2,9;2;1;1
258134151073;258134275378;124305;1;1;9;1;1;1
258134275378;258134275969;591;1,4;2;2,9;2;1;1
258134275969;258134278526;2557;1;1;9;1;1;1
258134278526;258134279082;556;1,4;2;2,9;2;1;1
258134279082;258134279643;561;1;1;9;1;1;1
258134279643;258134280294;651;1,4;2;2,9;2;1;1
258134280294;258134338704;58410;1;1;9;1;1;1
258134338704;258134339253;549;1,4;2;2,9;2;1;1
258134339253;258134339810;557;1;1;9;1;1;1
258134339810;258134343745;3935;1,4;2;2,9;2;1;1
258134343745;258134424020;80275;1;1;9;1;1;1
258134424020;258134424670;650;1,4;2;2,9;2;1;1
258134424670;258134505053;80383;1;1;9;1;1;1
258134505053;258134505582;529;1,4;2;2,9;2;1;1
258134505582;258134579756;74174;1;1;9;1;1;1
258134579756;258134580394;638;1,4;2;2,9;2;1;1
258134580394;258134626158;45764;1;1;9;1;1;1
258134626158;258134626698;540;1,4;2;2,9;2;1;1
258134626698;258134704739;78041;1;1;9;1;1;1
258134704739;258134705380;641;1,4;2;2,9;2;1;1
258134705380;258134745040;39660;1;1;9;1;1;1
258134745040;258134745596;556;1,4;2;2,9;2;1;1
258134745596;258134790203;44607;1;1;9;1;1;1
258134790203;258134790768;565;1,4;2;2,9;2;1;1
258134790768;258134871448;80680;1;1;9;1;1;1
258134871448;258134872723;1275;1,4;2;2,9;2;1;1
258134872723;258134873219;496;1;1;9;1;1;1
258134873219;258134873765;546;1,4;2;2,9;2;1;1
258134873765;258134873838;73;1,4;2;2,9;2;1;1
258134873838;258134874502;664;1,4;2;2,9;2;1;1
258134874502;258134945610;71108;1;1;9;1;1;1
258134945610;258134946380;770;1,4;2;2,9;2;1;1
258134946380;258134946954;574;1;1;9;1;1;1
258134946954;258134947495;541;1,4;2;2,9;2;1;1
258134947495;258134995430;47935;1;1;9;1;1;1
258134995430;258134996330;900;1,4;2;2,9;2;1;1
258134996330;258134997298;968;1;1;9;1;1;1
258134997298;258134997862;564;1,4;2;2,9;2;1;1
258134997862;258135066801;68939;1;1;9;1;1;1
258135066801;258135067317;516;1,4;2;2,9;2;1;1
258135067317;258135151039;83722;1;1;9;1;1;1
258135151039;258135151697;658;1,4;2;2,9;2;1;1
258135151697;258135224329;72632;1;1;9;1;1;1
258135224329;258135224929;600;1,4;2;2,9;2;1;1
258135224929;258135225904;975;1,4;2;2,9;2;1;1
258135225904;258135227819;1915;1,4;2;2,9;2;1;1
258135227819;258135228566;747;1;1;9;1;1;1
258135228566;258135229204;638;1,4;2;2,9;2;1;1
258135229204;258135229562;358;1;1;9;1;1;1
258135229562;258135230716;1154;1,4;2;2,9;2;1;1
258135230716;258135310796;80080;1;1;9;1;1;1
258135310796;258135311430;634;1,4;2;2,9;2;1;1
258135311430;258135378946;67516;1;1;9;1;1;1
258135378946;258135379638;692;1,4;2;2,9;2;1;1
258135379638;258135462604;82966;1;1;9;1;1;1
258135462604;258135463773;1169;1,4;2;2,9;2;1;1
258135463773;258135464571;798;1,4;2;2,9;2;1;1
258135464571;258135466071;1500;1,4;2;2,9;2;1;1
258135466071;258135468954;2883;1;1;9;1;1;1
258135468954;258135472674;3720;1,4;2;2,9;2;1;1
258135472674;258135473072;398;1,4;2;2,9;2;1;1
258135473072;258135473412;340;1,4;2;2,9;2;1;1
258135473412;258135473799;387;1,4;2;2,9;2;1;1
258135473799;258135474005;206;1,4;2;2,9;2;1;1
258135474005;258135474585;580;1,4;2;2,9;2;1;1
258135474585;258135475284;699;1,4;2;2,9;2;1;1
258135475284;258135476621;1337;1;1;9;1;1;1
258135476621;258135476881;260;1,4;2;2,9;2;1;1
258135476881;258135477393;512;1,4;2;2,9;2;1;1
258135477393;258135477918;525;1,4;2;2,9;2;1;1
258135477918;258135534594;56676;1;1;9;1;1;1
258135534594;258135535162;568;1,4;2;2,9;2;1;1
258135535162;258135536071;909;1;1;9;1;1;1
258135536071;258135537224;1153;1,4;2;2,9;2;1;1
258135537224;258135574887;37663;1;1;9;1;1;1
258135574887;258135585110;10223;1;1;9;1;1;1
258135585110;258135585113;3;1;1;9;1;1;1
258135585113;258135585119;6;1;1;9;1;1;1
258135585119;258135585120;1;1;1;9;1;1;1
258135585120;258135585124;4;1;1;9;1;1;1
258135585124;258135585126;2;1;1;9;1;1;1
258135585126;258135585128;2;1;1;9;1;1;1
258135585128;258135585141;13;1;1;9;1;1;1
258135585141;258135585142;1;1;1;9;1;1;1
258135585142;258135585148;6;1;1;9;1;1;1
258135585148;258135585150;2;1;1;9;1;1;1
258135585150;258135585153;3;1;1;9;1;1;1
258135585153;258135585161;8;1;1;9;1;1;1
258135585161;258135585165;4;1;1;9;1;1;1
258135585165;258135585174;9;1;1;9;1;1;1
258135585174;258135585201;27;1;1;9;1;1;1
258135585201;258135585217;16;1;1;9;1;1;1
258135585217;258135585219;2;1;1;9;1;1;1
258135585219;258135585229;10;1;1;9;1;1;1
258135585229;258135585240;11;1;1;9;1;1;1
258135585240;258135585247;7;1;1;9;1;1;1
258135585247;258135585260;13;1;1;9;1;1;1
258135585260;258135585287;27;1;1;9;1;1;1
258135585287;258135585295;8;1;1;9;1;1;1
258135585295;258135585297;2;1;1;9;1;1;1
258135585297;258135585303;6;1;1;9;1;1;1
258135585303;258135585312;9;1;1;9;1;1;1
258135585312;258135585331;19;1;1;9;1;1;1
258135585331;258135585338;7;1;1;9;1;1;1
258135585338;258135585343;5;1;1;9;1;1;1
258135585343;258135585360;17;1;1;9;1;1;1
258135585360;258135585370;10;1;1;9;1;1;1
258135585370;258135585371;1;1;1;9;1;1;1
258135585371;258135585381;10;1;1;9;1;1;1
258135585381;258135585391;10;1;1;9;1;1;1
258135585391;258135585412;21;1;1;9;1;1;1
258135585412;258135585440;28;1;1;9;1;1;1
258135585440;258135585444;4;1;1;9;1;1;1
258135585444;258135585453;9;1;1;9;1;1;1
258135585453;258135585463;10;1;1;9;1;1;1
258135585463;258135585480;17;1;1;9;1;1;1
258135585480;258135585487;7;1;1;9;1;1;1
258135585487;258135585494;7;1;1;9;1;1;1
258135585494;258135585497;3;1;1;9;1;1;1
258135585497;258135585498;1;1;1;9;1;1;1
258135585498;258135585528;30;1;1;9;1;1;1
258135585528;258135585539;11;1;1;9;1;1;1
258135585539;258135585558;19;1;1;9;1;1;1
258135585558;258135585561;3;1;1;9;1;1;1
258135585561;258135585571;10;1;1;9;1;1;1
258135585571;258135585573;2;1;1;9;1;1;1
258135585573;258135585603;30;1;1;9;1;1;1
258135585603;258135585614;11;1;1;9;1;1;1
258135585614;258135585615;1;1;1;9;1;1;1
258135585615;258135585622;7;1;1;9;1;1;1
258135585622;258135585638;16;1;1;9;1;1;1
258135585638;258135585667;29;1;1;9;1;1;1
258135585667;258135585720;53;1;1;9;1;1;1
258135585720;258135585723;3;1;1;9;1;1;1
258135585723;258135585730;7;1;1;9;1;1;1
258135585730;258135585744;14;1;1;9;1;1;1
258135585744;258135585745;1;1;1;9;1;1;1
258135585745;258135585760;15;1;1;9;1;1;1
258135585760;258135585763;3;1;1;9;1;1;1
258135585763;258135585771;8;1;1;9;1;1;1
258135585771;258135585829;58;1;1;9;1;1;1
258135585829;258135585851;22;1;1;9;1;1;1
258135585851;258135585852;1;1;1;9;1;1;1
258135585852;258135585853;1;1;1;9;1;1;1
258135585853;258135585862;9;1;1;9;1;1;1
258135585862;258135585880;18;1;1;9;1;1;1
258135585880;258135585882;2;1;1;9;1;1;1
258135585882;258135585887;5;1;1;9;1;1;1
258135585887;258135585902;15;1;1;9;1;1;1
258135585902;258135585907;5;1;1;9;1;1;1
258135585907;258135585929;22;1;1;9;1;1;1
258135585929;258135585948;19;1;1;9;1;1;1
258135585948;258135585953;5;1;1;9;1;1;1
258135585953;258135585954;1;1;1;9;1;1;1
258135585954;258135585961;7;1;1;9;1;1;1
258135585961;258135585963;2;1;1;9;1;1;1
258135585963;258135585968;5;1;1;9;1;1;1
258135585968;258135586006;38;1;1;9;1;1;1
258135586006;258135586010;4;1;1;9;1;1;1
258135586010;258135586025;15;1;1;9;1;1;1
258135586025;258135586031;6;1;1;9;1;1;1
258135586031;258135586080;49;1;1;9;1;1;1
258135586080;258135586094;14;1;1;9;1;1;1
258135586094;258135586100;6;1;1;9;1;1;1
258135586100;258135586106;6;1;1;9;1;1;1
258135586106;258135586108;2;1;1;9;1;1;1
258135586108;258135586111;3;1;1;9;1;1;1
258135586111;258135586121;10;1;1;9;1;1;1
258135586121;258135586133;12;1;1;9;1;1;1
258135586133;258135586166;33;1;1;9;1;1;1
258135586166;258135586171;5;1;1;9;1;1;1
258135586171;258135586174;3;1;1;9;1;1;1
258135586174;258135586177;3;1;1;9;1;1;1
258135586177;258135586183;6;1;1;9;1;1;1
258135586183;258135586192;9;1;1;9;1;1;1
258135586192;258135586197;5;1;1;9;1;1;1
258135586197;258135586199;2;1;1;9;1;1;1
258135586199;258135586207;8;1;1;9;1;1;1
258135586207;258135586221;14;1;1;9;1;1;1
258135586221;258135586226;5;1;1;9;1;1;1
258135586226;258135586234;8;1;1;9;1;1;1
258135586234;258135586262;28;1;1;9;1;1;1
258135586262;258135586269;7;1;1;9;1;1;1
258135586269;258135586275;6;1;1;9;1;1;1
258135586275;258135586276;1;1;1;9;1;1;1
258135586276;258135586279;3;1;1;9;1;1;1
258135586279;258135586289;10;1;1;9;1;1;1
258135586289;258135586311;22;1;1;9;1;1;1
258135586311;258135586318;7;1;1;9;1;1;1
258135586318;258135586323;5;1;1;9;1;1;1
258135586323;258135586325;2;1;1;9;1;1;1
258135586325;258135586339;14;1;1;9;1;1;1
258135586339;258135586352;13;1;1;9;1;1;1
258135586352;258135586370;18;1;1;9;1;1;1
258135586370;258135586382;12;1;1;9;1;1;1
258135586382;258135586392;10;1;1;9;1;1;1
258135586392;258135586393;1;1;1;9;1;1;1
258135586393;258135586409;16;1;1;9;1;1;1
258135586409;258135586415;6;1;1;9;1;1;1
258135586415;258135586419;4;1;1;9;1;1;1
258135586419;258135586422;3;1;1;9;1;1;1
258135586422;258135586444;22;1;1;9;1;1;1
258135586444;258135586456;12;1;1;9;1;1;1
258135586456;258135586470;14;1;1;9;1;1;1
258135586470;258135586471;1;1;1;9;1;1;1
258135586471;258135586476;5;1;1;9;1;1;1
258135586476;258135586479;3;1;1;9;1;1;1
258135586479;258135586492;13;1;1;9;1;1;1
258135586492;258135586505;13;1;1;9;1;1;1
258135586505;258135586536;31;1;1;9;1;1;1
258135586536;258135586559;23;1;1;9;1;1;1
258135586559;258135586565;6;1;1;9;1;1;1
258135586565;258135586583;18;1;1;9;1;1;1
258135586583;258135586605;22;1;1;9;1;1;1
258135586605;258135586617;12;1;1;9;1;1;1
258135586617;258135586622;5;1;1;9;1;1;1
258135586622;258135586624;2;1;1;9;1;1;1
258135586624;258135586628;4;1;1;9;1;1;1
258135586628;258135586638;10;1;1;9;1;1;1
258135586638;258135586647;9;1;1;9;1;1;1
258135586647;258135586650;3;1;1;9;1;1;1
258135586650;258135586658;8;1;1;9;1;1;1
258135586658;258135586662;4;1;1;9;1;1;1
258135586662;258135586680;18;1;1;9;1;1;1
258135586680;258135586684;4;1;1;9;1;1;1
258135586684;258135586699;15;1;1;9;1;1;1
258135586699;258135586703;4;1;1;9;1;1;1
258135586703;258135586716;13;1;1;9;1;1;1
258135586716;258135586740;24;1;1;9;1;1;1
258135586740;258135586742;2;1;1;9;1;1;1
258135586742;258135586747;5;1;1;9;1;1;1
258135586747;258135586749;2;1;1;9;1;1;1
258135586749;258135586752;3;1;1;9;1;1;1
258135586752;258135586765;13;1;1;9;1;1;1
258135586765;258135586769;4;1;1;9;1;1;1
258135586769;258135586771;2;1;1;9;1;1;1
258135586771;258135586774;3;1;1;9;1;1;1
258135586774;258135586785;11;1;1;9;1;1;1
258135586785;258135586796;11;1;1;9;1;1;1
258135586796;258135586797;1;1;1;9;1;1;1
258135586797;258135586808;11;1;1;9;1;1;1
258135586808;258135586838;30;1;1;9;1;1;1
258135586838;258135586882;44;1;1;9;1;1;1
258135586882;258135586883;1;1;1;9;1;1;1
258135586883;258135586885;2;1;1;9;1;1;1
258135586885;258135586897;12;1;1;9;1;1;1
258135586897;258135586918;21;1;1;9;1;1;1
258135586918;258135586919;1;1;1;9;1;1;1
258135586919;258135586939;20;1;1;9;1;1;1
258135586939;258135586950;11;1;1;9;1;1;1
258135586950;258135586956;6;1;1;9;1;1;1
258135586956;258135586964;8;1;1;9;1;1;1
258135586964;258135586980;16;1;1;9;1;1;1
258135586980;258135586996;16;1;1;9;1;1;1
258135586996;258135587005;9;1;1;9;1;1;1
258135587005;258135587012;7;1;1;9;1;1;1
258135587012;258135587019;7;1;1;9;1;1;1
258135587019;258135587026;7;1;1;9;1;1;1
258135587026;258135587031;5;1;1;9;1;1;1
258135587031;258135587047;16;1;1;9;1;1;1
258135587047;258135587063;16;1;1;9;1;1;1
258135587063;258135587068;5;1;1;9;1;1;1
258135587068;258135587079;11;1;1;9;1;1;1
258135587079;258135587092;13;1;1;9;1;1;1
258135587092;258135587094;2;1;1;9;1;1;1
258135587094;258135587103;9;1;1;9;1;1;1
258135587103;258135587112;9;1;1;9;1;1;1
258135587112;258135587119;7;1;1;9;1;1;1
258135587119;258135587122;3;1;1;9;1;1;1
258135587122;258135587130;8;1;1;9;1;1;1
258135587130;258135587133;3;1;1;9;1;1;1
258135587133;258135587144;11;1;1;9;1;1;1
258135587144;258135587168;24;1;1;9;1;1;1
258135587168;258135587170;2;1;1;9;1;1;1
258135587170;258135587175;5;1;1;9;1;1;1
258135587175;258135587189;14;1;1;9;1;1;1
258135587189;258135587211;22;1;1;9;1;1;1
258135587211;258135587214;3;1;1;9;1;1;1
258135587214;258135587215;1;1;1;9;1;1;1
258135587215;258135587259;44;1;1;9;1;1;1
258135587259;258135587262;3;1;1;9;1;1;1
258135587262;258135587285;23;1;1;9;1;1;1
258135587285;258135587293;8;1;1;9;1;1;1
258135587293;258135587299;6;1;1;9;1;1;1
258135587299;258135587308;9;1;1;9;1;1;1
258135587308;258135587311;3;1;1;9;1;1;1
258135587311;258135587313;2;1;1;9;1;1;1
258135587313;258135587314;1;1;1;9;1;1;1
258135587314;258135587327;13;1;1;9;1;1;1
258135587327;258135587340;13;1;1;9;1;1;1
258135587340;258135587347;7;1;1;9;1;1;1
258135587347;258135587383;36;1;1;9;1;1;1
258135587383;258135587400;17;1;1;9;1;1;1
258135587400;258135587412;12;1;1;9;1;1;1
258135587412;258135587413;1;1;1;9;1;1;1
258135587413;258135587434;21;1;1;9;1;1;1
258135587434;258135587441;7;1;1;9;1;1;1
258135587441;258135587448;7;1;1;9;1;1;1
258135587448;258135587477;29;1;1;9;1;1;1
258135587477;258135587484;7;1;1;9;1;1;1
258135587484;258135587485;1;1;1;9;1;1;1
258135587485;258135587494;9;1;1;9;1;1;1
258135587494;258135587523;29;1;1;9;1;1;1
258135587523;258135587528;5;1;1;9;1;1;1
258135587528;258135587537;9;1;1;9;1;1;1
258135587537;258135587543;6;1;1;9;1;1;1
258135587543;258135587547;4;1;1;9;1;1;1
258135587547;258135587566;19;1;1;9;1;1;1
258135587566;258135587568;2;1;1;9;1;1;1
258135587568;258135587569;1;1;1;9;1;1;1
258135587569;258135587571;2;1;1;9;1;1;1
258135587571;258135587589;18;1;1;9;1;1;1
258135587589;258135587607;18;1;1;9;1;1;1
258135587607;258135587611;4;1;1;9;1;1;1
258135587611;258135587633;22;1;1;9;1;1;1
258135587633;258135587641;8;1;1;9;1;1;1
258135587641;258135587662;21;1;1;9;1;1;1
258135587662;258135587676;14;1;1;9;1;1;1
258135587676;258135587686;10;1;1;9;1;1;1
258135587686;258135587692;6;1;1;9;1;1;1
258135587692;258135587714;22;1;1;9;1;1;1
258135587714;258135587724;10;1;1;9;1;1;1
258135587724;258135587726;2;1;1;9;1;1;1
258135587726;258135587738;12;1;1;9;1;1;1
258135587738;258135587741;3;1;1;9;1;1;1
258135587741;258135587742;1;1;1;9;1;1;1
258135587742;258135587758;16;1;1;9;1;1;1
258135587758;258135587763;5;1;1;9;1;1;1
258135587763;258135587774;11;1;1;9;1;1;1
258135587774;258135587777;3;1;1;9;1;1;1
258135587777;258135587787;10;1;1;9;1;1;1
258135587787;258135587792;5;1;1;9;1;1;1
258135587792;258135587814;22;1;1;9;1;1;1
258135587814;258135587815;1;1;1;9;1;1;1
258135587815;258135587839;24;1;1;9;1;1;1
258135587839;258135587848;9;1;1;9;1;1;1
258135587848;258135587858;10;1;1;9;1;1;1
258135587858;258135587872;14;1;1;9;1;1;1
258135587872;258135587874;2;1;1;9;1;1;1
258135587874;258135587883;9;1;1;9;1;1;1
258135587883;258135587891;8;1;1;9;1;1;1
258135587891;258135587897;6;1;1;9;1;1;1
258135587897;258135587911;14;1;1;9;1;1;1
258135587911;258135587912;1;1;1;9;1;1;1
258135587912;258135587934;22;1;1;9;1;1;1
258135587934;258135587935;1;1;1;9;1;1;1
258135587935;258135587957;22;1;1;9;1;1;1
258135587957;258135587963;6;1;1;9;1;1;1
258135587963;258135587966;3;1;1;9;1;1;1
258135587966;258135587980;14;1;1;9;1;1;1
258135587980;258135587993;13;1;1;9;1;1;1
258135587993;258135588026;33;1;1;9;1;1;1
258135588026;258135588037;11;1;1;9;1;1;1
258135588037;258135588048;11;1;1;9;1;1;1
258135588048;258135588067;19;1;1;9;1;1;1
258135588067;258135588069;2;1;1;9;1;1;1
258135588069;258135588078;9;1;1;9;1;1;1
258135588078;258135588083;5;1;1;9;1;1;1
258135588083;258135588091;8;1;1;9;1;1;1
258135588091;258135588105;14;1;1;9;1;1;1
258135588105;258135588110;5;1;1;9;1;1;1
258135588110;258135588120;10;1;1;9;1;1;1
258135588120;258135588135;15;1;1;9;1;1;1
258135588135;258135588139;4;1;1;9;1;1;1
258135588139;258135588145;6;1;1;9;1;1;1
258135588145;258135588150;5;1;1;9;1;1;1
258135588150;258135588166;16;1;1;9;1;1;1
258135588166;258135588167;1;1;1;9;1;1;1
258135588167;258135588188;21;1;1;9;1;1;1
258135588188;258135588195;7;1;1;9;1;1;1
258135588195;258135588203;8;1;1;9;1;1;1
258135588203;258135588207;4;1;1;9;1;1;1
258135588207;258135588218;11;1;1;9;1;1;1
258135588218;258135588230;12;1;1;9;1;1;1
258135588230;258135588231;1;1;1;9;1;1;1
258135588231;258135588233;2;1;1;9;1;1;1
258135588233;258135588242;9;1;1;9;1;1;1
258135588242;258135588255;13;1;1;9;1;1;1
258135588255;258135588261;6;1;1;9;1;1;1
258135588261;258135588268;7;1;1;9;1;1;1
258135588268;258135588273;5;1;1;9;1;1;1
258135588273;258135588284;11;1;1;9;1;1;1
258135588284;258135588287;3;1;1;9;1;1;1
258135588287;258135588290;3;1;1;9;1;1;1
258135588290;258135588296;6;1;1;9;1;1;1
258135588296;258135588329;33;1;1;9;1;1;1
258135588329;258135588330;1;1;1;9;1;1;1
258135588330;258135588339;9;1;1;9;1;1;1
258135588339;258135588384;45;1;1;9;1;1;1
258135588384;258135588387;3;1;1;9;1;1;1
258135588387;258135588407;20;1;1;9;1;1;1
258135588407;258135588413;6;1;1;9;1;1;1
258135588413;258135588434;21;1;1;9;1;1;1
258135588434;258135588435;1;1;1;9;1;1;1
258135588435;258135588442;7;1;1;9;1;1;1
258135588442;258135588446;4;1;1;9;1;1;1
258135588446;258135588456;10;1;1;9;1;1;1
258135588456;258135588461;5;1;1;9;1;1;1
258135588461;258135588470;9;1;1;9;1;1;1
258135588470;258135588477;7;1;1;9;1;1;1
258135588477;258135588499;22;1;1;9;1;1;1
258135588499;258135588529;30;1;1;9;1;1;1
258135588529;258135588559;30;1;1;9;1;1;1
258135588559;258135588563;4;1;1;9;1;1;1
258135588563;258135588571;8;1;1;9;1;1;1
258135588571;258135588578;7;1;1;9;1;1;1
258135588578;258135588584;6;1;1;9;1;1;1
258135588584;258135588591;7;1;1;9;1;1;1
258135588591;258135588603;12;1;1;9;1;1;1
258135588603;258135588605;2;1;1;9;1;1;1
258135588605;258135588633;28;1;1;9;1;1;1
258135588633;258135588640;7;1;1;9;1;1;1
258135588640;258135588649;9;1;1;9;1;1;1
258135588649;258135588652;3;1;1;9;1;1;1
258135588652;258135588661;9;1;1;9;1;1;1
258135588661;258135588679;18;1;1;9;1;1;1
258135588679;258135588713;34;1;1;9;1;1;1
258135588713;258135588720;7;1;1;9;1;1;1
258135588720;258135588738;18;1;1;9;1;1;1
258135588738;258135588749;11;1;1;9;1;1;1
258135588749;258135588760;11;1;1;9;1;1;1
258135588760;258135588761;1;1;1;9;1;1;1
258135588761;258135588816;55;1;1;9;1;1;1
258135588816;258135588819;3;1;1;9;1;1;1
258135588819;258135588845;26;1;1;9;1;1;1
258135588845;258135588863;18;1;1;9;1;1;1
258135588863;258135588874;11;1;1;9;1;1;1
258135588874;258135588910;36;1;1;9;1;1;1
258135588910;258135588939;29;1;1;9;1;1;1
258135588939;258135588973;34;1;1;9;1;1;1
258135588973;258135589008;35;1;1;9;1;1;1
258135589008;258135589010;2;1;1;9;1;1;1
258135589010;258135589029;19;1;1;9;1;1;1
258135589029;258135589055;26;1;1;9;1;1;1
258135589055;258135589075;20;1;1;9;1;1;1
258135589075;258135589083;8;1;1;9;1;1;1
258135589083;258135589106;23;1;1;9;1;1;1
258135589106;258135589149;43;1;1;9;1;1;1
258135589149;258135589174;25;1;1;9;1;1;1
258135589174;258135589178;4;1;1;9;1;1;1
258135589178;258135589204;26;1;1;9;1;1;1
258135589204;258135589208;4;1;1;9;1;1;1
258135589208;258135589220;12;1;1;9;1;1;1
258135589220;258135589242;22;1;1;9;1;1;1
258135589242;258135589271;29;1;1;9;1;1;1
258135589271;258135589306;35;1;1;9;1;1;1
258135589306;258135589329;23;1;1;9;1;1;1
258135589329;258135589364;35;1;1;9;1;1;1
258135589364;258135589367;3;1;1;9;1;1;1
258135589367;258135589421;54;1;1;9;1;1;1
258135589421;258135589480;59;1;1;9;1;1;1
258135589480;258135589579;99;1;1;9;1;1;1
258135589579;258135589599;20;1;1;9;1;1;1
258135589599;258135589631;32;1;1;9;1;1;1
258135589631;258135589693;62;1;1;9;1;1;1
258135589693;258135589713;20;1;1;9;1;1;1
258135589713;258135589740;27;1;1;9;1;1;1
258135589740;258135589749;9;1;1;9;1;1;1
258135589749;258135589768;19;1;1;9;1;1;1
258135589768;258135589771;3;1;1;9;1;1;1
258135589771;258135589801;30;1;1;9;1;1;1
258135589801;258135589821;20;1;1;9;1;1;1
258135589821;258135589868;47;1;1;9;1;1;1
258135589868;258135589897;29;1;1;9;1;1;1
258135589897;258135589920;23;1;1;9;1;1;1
258135589920;258135590014;94;1;1;9;1;1;1
258135590014;258135590082;68;1;1;9;1;1;1
258135590082;258135590119;37;1;1;9;1;1;1
258135590119;258135590149;30;1;1;9;1;1;1
258135590149;258135590181;32;1;1;9;1;1;1
258135590181;258135590275;94;1;1;9;1;1;1
258135590275;258135590285;10;1;1;9;1;1;1
258135590285;258135590447;162;1;1;9;1;1;1
258135590447;258135590534;87;1;1;9;1;1;1
258135590534;258135590552;18;1;1;9;1;1;1
258135590552;258135590555;3;1;1;9;1;1;1
258135590555;258135590623;68;1;1;9;1;1;1
258135590623;258135590667;44;1;1;9;1;1;1
258135590667;258135590794;127;1;1;9;1;1;1
258135590794;258135590938;144;1;1;9;1;1;1
258135590938;258135590973;35;1;1;9;1;1;1
258135590973;258135591019;46;1;1;9;1;1;1
258135591019;258135591070;51;1;1;9;1;1;1
258135591070;258135591111;41;1;1;9;1;1;1
258135591111;258135591498;387;1;1;9;1;1;1
258135591498;258135591819;321;1;1;9;1;1;1
258135591819;258135592088;269;1;1;9;1;1;1
258135592088;258135592122;34;1;1;9;1;1;1
258135592122;258135592170;48;1;1;9;1;1;1
258135592170;258135592221;51;1;1;9;1;1;1
258135592221;258135592274;53;1;1;9;1;1;1
258135592274;258135592318;44;1;1;9;1;1;1
258135592318;258135592402;84;1;1;9;1;1;1
258135592402;258135592515;113;1;1;9;1;1;1
258135592515;258135592520;5;1;1;9;1;1;1
258135592520;258135592678;158;1;1;9;1;1;1
258135592678;258135592707;29;1;1;9;1;1;1
258135592707;258135592754;47;1;1;9;1;1;1
258135592754;258135592798;44;1;1;9;1;1;1
258135592798;258135592826;28;1;1;9;1;1;1
258135592826;258135592889;63;1;1;9;1;1;1
258135592889;258135593098;209;1;1;9;1;1;1
258135593098;258135593102;4;1;1;9;1;1;1
258135593102;258135593161;59;1;1;9;1;1;1
258135593161;258135593262;101;1;1;9;1;1;1
258135593262;258135593306;44;1;1;9;1;1;1
258135593306;258135593349;43;1;1;9;1;1;1
258135593349;258135593370;21;1;1;9;1;1;1
258135593370;258135593448;78;1;1;9;1;1;1
258135593448;258135593468;20;1;1;9;1;1;1
258135593468;258135593566;98;1;1;9;1;1;1
258135593566;258135593640;74;1;1;9;1;1;1
258135593640;258135593693;53;1;1;9;1;1;1
258135593693;258135593727;34;1;1;9;1;1;1
258135593727;258135593873;146;1;1;9;1;1;1
258135593873;258135594219;346;1;1;9;1;1;1
258135594219;258135594265;46;1;1;9;1;1;1
258135594265;258135594384;119;1;1;9;1;1;1
258135594384;258135595141;757;1;1;9;1;1;1
258135595141;258135595170;29;1;1;9;1;1;1
258135595170;258135595200;30;1;1;9;1;1;1
258135595200;258135595236;36;1;1;9;1;1;1
258135595236;258135595538;302;1;1;9;1;1;1
258135595538;258135595610;72;1;1;9;1;1;1
258135595610;258135595677;67;1;1;9;1;1;1
258135595677;258135595724;47;1;1;9;1;1;1
258135595724;258135595796;72;1;1;9;1;1;1
258135595796;258135595851;55;1;1;9;1;1;1
258135595851;258135595922;71;1;1;9;1;1;1
258135595922;258135596046;124;1;1;9;1;1;1
258135596046;258135596223;177;1;1;9;1;1;1
258135596223;258135596481;258;1;1;9;1;1;1
258135596481;258135596681;200;1;1;9;1;1;1
258135596681;258135598148;1467;1;1;9;1;1;1
258135598148;258135598684;536;1;1;9;1;1;1
258135598684;258135598696;12;1;1;9;1;1;1
258135598696;258135598836;140;1;1;9;1;1;1
258135598836;258135598869;33;1;1;9;1;1;1
258135598869;258135598967;98;1;1;9;1;1;1
258135598967;258135599693;726;1;1;9;1;1;1
258135599693;258135600451;758;1;1;9;1;1;1
258135600451;258135600512;61;1;1;9;1;1;1
258135600512;258135600630;118;1;1;9;1;1;1
258135600630;258135601747;1117;1;1;9;1;1;1
258135601747;258135603360;1613;1;1;9;1;1;1
258135603360;258135605276;1916;1;1;9;1;1;1
258135605276;258135608040;2764;1;1;9;1;1;1
258135608040;258135608976;936;-1;0;-1;0;1;1
258135608976;258135609445;469;4;1;2;1;1;1
258135609445;258135659165;49720;-1;0;-1;0;1;1
258135659165;258135659836;671;4;1;2;1;1;1
258135659836;258135659898;62;4;1;2;1;1;1
258135659898;258135660886;988;4;1;2;1;1;1
258135660886;258135731581;70695;-1;0;-1;0;1;1
258135731581;258135732127;546;4;1;2;1;1;1
258135732127;258135800837;68710;-1;0;-1;0;1;1
258135800837;258135801444;607;4;1;2;1;1;1
258135801444;258135884941;83497;-1;0;-1;0;1;1
258135884941;258135885489;548;4;1;2;1;1;1
258135885489;258135953007;67518;-1;0;-1;0;1;1
258135953007;258135953829;822;4;1;2;1;1;1
258135953829;258135954605;776;-1;0;-1;0;1;1
258135954605;258135955060;455;4;1;2;1;1;1
258135955060;258135955262;202;4;1;2;1;1;1
258135955262;258135955943;681;4;1;2;1;1;1
258135955943;258136045357;89414;-1;0;-1;0;1;1
258136045357;258136045820;463;4;1;2;1;1;1
258136045820;258136141873;96053;-1;0;-1;0;1;1
258136141873;258136142429;556;4;1;2;1;1;1
258136142429;258136205593;63164;-1;0;-1;0;1;1
258136205593;258136206116;523;4;1;2;1;1;1
258136206116;258136278570;72454;-1;0;-1;0;1;1
258136278570;258136279109;539;4;1;2;1;1;1
258136279109;258136279355;246;-1;0;-1;0;1;1
258136279355;258136279970;615;4;1;2;1;1;1
258136279970;258136363079;83109;-1;0;-1;0;1;1
258136363079;258136365700;2621;4;1;2;1;1;1
258136365700;258136367830;2130;-1;0;-1;0;1;1
258136367830;258136368459;629;4;1;2;1;1;1
258136368459;258136441888;73429;-1;0;-1;0;1;1
258136441888;258136442481;593;4;1;2;1;1;1
258136442481;258136442918;437;-1;0;-1;0;1;1
258136442918;258136443585;667;4;1;2;1;1;1
258136443585;258136519287;75702;-1;0;-1;0;1;1
258136519287;258136519931;644;4;1;2;1;1;1
258136519931;258136554160;34229;-1;0;-1;0;1;1
258136554160;258136554795;635;4;1;2;1;1;1
258136554795;258136627926;73131;-1;0;-1;0;1;1
258136627926;258136628509;583;4;1;2;1;1;1
258136628509;258136629418;909;-1;0;-1;0;1;1
258136629418;258136629976;558;4;1;2;1;1;1
258136629976;258136758710;128734;-1;0;-1;0;1;1
258136758710;258136760661;1951;4;1;2;1;1;1
258136760661;258136762123;1462;-1;0;-1;0;1;1
258136762123;258136762627;504;4;1;2;1;1;1
258136762627;258136762919;292;4;1;2;1;1;1
258136762919;258136763382;463;4;1;2;1;1;1
258136763382;258136832279;68897;-1;0;-1;0;1;1
258136832279;258136832748;469;4;1;2;1;1;1
258136832748;258136832876;128;4;1;2;1;1;1
258136832876;258136833472;596;4;1;2;1;1;1
258136833472;258136958306;124834;-1;0;-1;0;1;1
258136958306;258136958841;535;4;1;2;1;1;1
258136958841;258137036235;77394;-1;0;-1;0;1;1
258137036235;258137036774;539;4;1;2;1;1;1
258137036774;258137117335;80561;-1;0;-1;0;1;1
258137117335;258137117805;470;4;1;2;1;1;1
258137117805;258137167376;49571;-1;0;-1;0;1;1
258137167376;258137167916;540;4;1;2;1;1;1
258137167916;258137243660;75744;-1;0;-1;0;1;1
258137243660;258137244247;587;4;1;2;1;1;1
258137244247;258137244324;77;-1;0;-1;0;1;1
258137244324;258137244942;618;4;1;2;1;1;1
258137244942;258137245974;1032;4;1;2;1;1;1
258137245974;258137246476;502;4;1;2;1;1;1
258137246476;258137323614;77138;-1;0;-1;0;1;1
258137323614;258137324073;459;4;1;2;1;1;1
258137324073;258137388547;64474;-1;0;-1;0;1;1
258137388547;258137388779;232;4;1;2;1;1;1
258137388779;258137389195;416;4;1;2;1;1;1
258137389195;258137389544;349;4;1;2;1;1;1
258137389544;258137470228;80684;-1;0;-1;0;1;1
258137470228;258137470865;637;4;1;2;1;1;1
258137470865;258137545296;74431;-1;0;-1;0;1;1
258137545296;258137545967;671;4;1;2;1;1;1
258137545967;258137611663;65696;-1;0;-1;0;1;1
258137611663;258137612212;549;4;1;2;1;1;1
258137612212;258137646013;33801;-1;0;-1;0;1;1
258137646013;258137646553;540;4;1;2;1;1;1
258137646553;258137646908;355;-1;0;-1;0;1;1
258137646908;258137647505;597;4;1;2;1;1;1
258137647505;258137723781;76276;-1;0;-1;0;1;1
258137723781;258137725059;1278;4;1;2;1;1;1
258137725059;258137725878;819;-1;0;-1;0;1;1
258137725878;258137726179;301;4;1;2;1;1;1
258137726179;258137726593;414;4;1;2;1;1;1
258137726593;258137726994;401;4;1;2;1;1;1
258137726994;258137766417;39423;-1;0;-1;0;1;1
258137766417;258137766965;548;4;1;2;1;1;1
258137766965;258137816289;49324;-1;0;-1;0;1;1
258137816289;258137816924;635;4;1;2;1;1;1
258137816924;258137871170;54246;-1;0;-1;0;1;1
258137871170;258137871923;753;4;1;2;1;1;1
258137871923;258137872900;977;-1;0;-1;0;1;1
258137872900;258137873530;630;4;1;2;1;1;1
258137873530;258137947935;74405;-1;0;-1;0;1;1
258137947935;258137948557;622;4;1;2;1;1;1
258137948557;258138020653;72096;-1;0;-1;0;1;1
258138020653;258138021219;566;4;1;2;1;1;1
258138021219;258138048976;27757;-1;0;-1;0;1;1
258138048976;258138049617;641;4;1;2;1;1;1
258138049617;258138092729;43112;-1;0;-1;0;1;1
258138092729;258138093001;272;4;1;2;1;1;1
258138093001;258138093329;328;4;1;2;1;1;1
258138093329;258138093706;377;4;1;2;1;1;1
258138093706;258138181939;88233;-1;0;-1;0;1;1
258138181939;258138182230;291;4;1;2;1;1;1
258138182230;258138182682;452;4;1;2;1;1;1
258138182682;258138182865;183;4;1;2;1;1;1
258138182865;258138257115;74250;-1;0;-1;0;1;1
258138257115;258138257529;414;4;1;2;1;1;1
258138257529;258138257812;283;4;1;2;1;1;1
258138257812;258138258176;364;4;1;2;1;1;1
258138258176;258138329843;71667;-1;0;-1;0;1;1
258138329843;258138330720;877;4;1;2;1;1;1
258138330720;258138331253;533;4;1;2;1;1;1
258138331253;258138332647;1394;4;1;2;1;1;1
258138332647;258138333741;1094;-1;0;-1;0;1;1
258138333741;258138334382;641;4;1;2;1;1;1
258138334382;258138334716;334;-1;0;-1;0;1;1
258138334716;258138335473;757;4;1;2;1;1;1
258138335473;258138409291;73818;-1;0;-1;0;1;1
258138409291;258138411630;2339;4;1;2;1;1;1
258138411630;258138412148;518;-1;0;-1;0;1;1
258138412148;258138413897;1749;4;1;2;1;1;1
258138413897;258138414229;332;-1;0;-1;0;1;1
258138414229;258138414858;629;4;1;2;1;1;1
258138414858;258138415931;1073;-1;0;-1;0;1;1
258138415931;258138416611;680;4;1;2;1;1;1
258138416611;258138483831;67220;-1;0;-1;0;1;1
258138483831;258138484508;677;4;1;2;1;1;1
258138484508;258138553177;68669;-1;0;-1;0;1;1
258138553177;258138553791;614;4;1;2;1;1;1
258138553791;258138630213;76422;-1;0;-1;0;1;1
258138630213;258138630389;176;4;1;2;1;1;1
258138630389;258138630805;416;4;1;2;1;1;1
258138630805;258138630851;46;4;1;2;1;1;1
258138630851;258138631701;850;4;1;2;1;1;1
258138631701;258138632299;598;4;1;2;1;1;1
258138632299;258138633258;959;4;1;2;1;1;1
258138633258;258138633666;408;4;1;2;1;1;1
258138633666;258138707840;74174;-1;0;-1;0;1;1
258138707840;258138708474;634;4;1;2;1;1;1
258138708474;258138798052;89578;-1;0;-1;0;1;1
258138798052;258138798591;539;4;1;2;1;1;1
258138798591;258138865166;66575;-1;0;-1;0;1;1
258138865166;258138865641;475;4;1;2;1;1;1
258138865641;258138893008;27367;-1;0;-1;0;1;1
258138893008;258138893713;705;4;1;2;1;1;1
258138893713;258139085176;191463;-1;0;-1;0;1;1
258139085176;258139087161;1985;4;1;2;1;1;1
258139087161;258139462382;375221;-1;0;-1;0;1;1
258139462382;258139463059;677;4;1;2;1;1;1
258139463059;258139496299;33240;-1;0;-1;0;1;1
258139496299;258139496796;497;4;1;2;1;1;1
258139496796;258139558740;61944;-1;0;-1;0;1;1
258139558740;258139559733;993;4;1;2;1;1;1
258139559733;258139560881;1148;-1;0;-1;0;1;1
258139560881;258139561424;543;4;1;2;1;1;1
258139561424;258139561771;347;-1;0;-1;0;1;1
258139561771;258139562321;550;4;1;2;1;1;1
258139562321;258139702557;140236;-1;0;-1;0;1;1
258139702557;258139703111;554;4;1;2;1;1;1
258139703111;258139835726;132615;-1;0;-1;0;1;1
258139835726;258139836369;643;4;1;2;1;1;1
258139836369;258139876928;40559;-1;0;-1;0;1;1
258139876928;258139877500;572;4;1;2;1;1;1
258139877500;258139878162;662;-1;0;-1;0;1;1
258139878162;258139878185;23;4;1;2;1;1;1
258139878185;258139879008;823;4;1;2;1;1;1
258139879008;258139879022;14;4;1;2;1;1;1
258139879022;258140002042;123020;-1;0;-1;0;1;1
258140002042;258140002590;548;4;1;2;1;1;1
258140002590;258140076307;73717;-1;0;-1;0;1;1
258140076307;258140076867;560;4;1;2;1;1;1
258140076867;258140157798;80931;-1;0;-1;0;1;1
258140157798;258140158341;543;4;1;2;1;1;1
258140158341;258140301197;142856;-1;0;-1;0;1;1
258140301197;258140301749;552;4;1;2;1;1;1
258140301749;258140434487;132738;-1;0;-1;0;1;1
258140434487;258140435117;630;4;1;2;1;1;1
258140435117;258140485552;50435;-1;0;-1;0;1;1
258140485552;258140486183;631;4;1;2;1;1;1
258140486183;258140545182;58999;-1;0;-1;0;1;1
258140545182;258140545776;594;4;1;2;1;1;1
258140545776;258140589979;44203;-1;0;-1;0;1;1
258140589979;258140590585;606;4;1;2;1;1;1
258140590585;258140662346;71761;-1;0;-1;0;1;1
258140662346;258140662978;632;4;1;2;1;1;1
258140662978;258140775369;112391;-1;0;-1;0;1;1
258140775369;258140776048;679;4;1;2;1;1;1
258140776048;258140824321;48273;-1;0;-1;0;1;1
258140824321;258140825123;802;4;1;2;1;1;1
258140825123;258140825421;298;-1;0;-1;0;1;1
258140825421;258140825974;553;4;1;2;1;1;1
258140825974;258140899909;73935;-1;0;-1;0;1;1
258140899909;258140900556;647;4;1;2;1;1;1
258140900556;258140952474;51918;-1;0;-1;0;1;1
258140952474;258140952937;463;4;1;2;1;1;1
258140952937;258141066191;113254;-1;0;-1;0;1;1
258141066191;258141066841;650;4;1;2;1;1;1
258141066841;258141067100;259;-1;0;-1;0;1;1
258141067100;258141067836;736;4;1;2;1;1;1
258141067836;258141168786;100950;-1;0;-1;0;1;1
258141168786;258141169391;605;4;1;2;1;1;1
258141169391;258141260519;91128;-1;0;-1;0;1;1
258141260519;258141261901;1382;4;1;2;1;1;1
258141261901;258141262200;299;4;1;2;1;1;1
258141262200;258141263970;1770;4;1;2;1;1;1
258141263970;258141264283;313;-1;0;-1;0;1;1
258141264283;258141264711;428;4;1;2;1;1;1
258141264711;258141265091;380;4;1;2;1;1;1
258141265091;258141265944;853;4;1;2;1;1;1
258141265944;258141333596;67652;-1;0;-1;0;1;1
258141333596;258141334244;648;4;1;2;1;1;1
258141334244;258141416176;81932;-1;0;-1;0;1;1
258141416176;258141416731;555;4;1;2;1;1;1
258141416731;258141495164;78433;-1;0;-1;0;1;1
258141495164;258141495710;546;4;1;2;1;1;1
258141495710;258141495918;208;-1;0;-1;0;1;1
258141495918;258141496636;718;4;1;2;1;1;1
258141496636;258141568877;72241;-1;0;-1;0;1;1
258141568877;258141569889;1012;4;1;2;1;1;1
258141569889;258141570388;499;-1;0;-1;0;1;1
258141570388;258141571140;752;4;1;2;1;1;1
258141571140;258141571405;265;-1;0;-1;0;1;1
258141571405;258141572156;751;4;1;2;1;1;1
258141572156;258141616807;44651;-1;0;-1;0;1;1
258141616807;258141617361;554;4;1;2;1;1;1
258141617361;258141795178;177817;-1;0;-1;0;1;1
258141795178;258141795810;632;4;1;2;1;1;1
258141795810;258142210291;414481;-1;0;-1;0;1;1
258142210291;258142211344;1053;4;1;2;1;1;1
258142211344;258142221631;10287;-1;0;-1;0;1;1
258142221631;258142222180;549;4;1;2;1;1;1
258142222180;258142299754;77574;-1;0;-1;0;1;1
258142299754;258142300367;613;4;1;2;1;1;1
258142300367;258142442252;141885;-1;0;-1;0;1;1
258142442252;258142442799;547;4;1;2;1;1;1
258142442799;258142476653;33854;-1;0;-1;0;1;1
258142476653;258142476919;266;4;1;2;1;1;1
258142476919;258142477345;426;4;1;2;1;1;1
258142477345;258142477744;399;4;1;2;1;1;1
258142477744;258142612432;134688;-1;0;-1;0;1;1
258142612432;258142614057;1625;4;1;2;1;1;1
258142614057;258142614712;655;-1;0;-1;0;1;1
258142614712;258142616522;1810;4;1;2;1;1;1
258142616522;258142616698;176;4;1;2;1;1;1
258142616698;258142617188;490;4;1;2;1;1;1
258142617188;258142618233;1045;4;1;2;1;1;1
258142618233;258142619853;1620;4;1;2;1;1;1
258142619853;258142621312;1459;-1;0;-1;0;1;1
258142621312;258142622155;843;4;1;2;1;1;1
258142622155;258142622929;774;4;1;2;1;1;1
258142622929;258142623290;361;4;1;2;1;1;1
258142623290;258142683599;60309;-1;0;-1;0;1;1
258142683599;258142684160;561;4;1;2;1;1;1
258142684160;258142730178;46018;-1;0;-1;0;1;1
258142730178;258142730823;645;4;1;2;1;1;1
258142730823;258142796219;65396;-1;0;-1;0;1;1
258142796219;258142797248;1029;4;1;2;1;1;1
258142797248;258142870799;73551;-1;0;-1;0;1;1
258142870799;258142871354;555;4;1;2;1;1;1
258142871354;258142909151;37797;-1;0;-1;0;1;1
258142909151;258142909618;467;4;1;2;1;1;1
258142909618;258142910046;428;4;1;2;1;1;1
258142910046;258142910425;379;4;1;2;1;1;1
258142910425;258142912387;1962;-1;0;-1;0;1;1
258142912387;258142912937;550;4;1;2;1;1;1
258142912937;258143035920;122983;-1;0;-1;0;1;1
258143035920;258143036581;661;4;1;2;1;1;1
258143036581;258143037019;438;-1;0;-1;0;1;1
258143037019;258143037726;707;4;1;2;1;1;1
258143037726;258143078766;41040;-1;0;-1;0;1;1
258143078766;258143079318;552;4;1;2;1;1;1
258143079318;258143157664;78346;-1;0;-1;0;1;1
258143157664;258143158263;599;4;1;2;1;1;1
258143158263;258143244015;85752;-1;0;-1;0;1;1
258143244015;258143244563;548;4;1;2;1;1;1
258143244563;258143307571;63008;-1;0;-1;0;1;1
258143307571;258143308172;601;4;1;2;1;1;1
258143308172;258143417748;109576;-1;0;-1;0;1;1
258143417748;258143418350;602;4;1;2;1;1;1
258143418350;258143507111;88761;-1;0;-1;0;1;1
258143507111;258143507629;518;4;1;2;1;1;1
258143507629;258143507836;207;4;1;2;1;1;1
258143507836;258143507862;26;4;1;2;1;1;1
258143507862;258143508563;701;4;1;2;1;1;1
258143508563;258143509348;785;4;1;2;1;1;1
258143509348;258143626348;117000;-1;0;-1;0;1;1
258143626348;258143628750;2402;4;1;2;1;1;1
258143628750;258143632689;3939;4;1;2;1;1;1
258143632689;258143634232;1543;4;1;2;1;1;1
258143634232;258143637157;2925;-1;0;-1;0;1;1
258143637157;258143637615;458;4;1;2;1;1;1
258143637615;258143639140;1525;4;1;2;1;1;1
258143639140;258143640936;1796;4;1;2;1;1;1
258143640936;258143641076;140;4;1;2;1;1;1
258143641076;258143641380;304;4;1;2;1;1;1
258143641380;258143642242;862;4;1;2;1;1;1
258143642242;258143642414;172;4;1;2;1;1;1
258143642414;258143643219;805;-1;0;-1;0;1;1
258143643219;258143643847;628;4;1;2;1;1;1
258143643847;258143798202;154355;-1;0;-1;0;1;1
258143798202;258143798803;601;4;1;2;1;1;1
258143798803;258143918276;119473;-1;0;-1;0;1;1
258143918276;258143918919;643;4;1;2;1;1;1
258143918919;258143994154;75235;-1;0;-1;0;1;1
258143994154;258143994767;613;4;1;2;1;1;1
258143994767;258144026054;31287;-1;0;-1;0;1;1
258144026054;258144026687;633;4;1;2;1;1;1
258144026687;258144064747;38060;-1;0;-1;0;1;1
258144064747;258144065308;561;4;1;2;1;1;1
258144065308;258144065432;124;-1;0;-1;0;1;1
258144065432;258144066159;727;4;1;2;1;1;1
258144066159;258144129943;63784;-1;0;-1;0;1;1
258144129943;258144130789;846;4;1;2;1;1;1
258144130789;258144131717;928;-1;0;-1;0;1;1
258144131717;258144132266;549;4;1;2;1;1;1
258144132266;258144587021;454755;-1;0;-1;0;1;1
258144587021;258144587942;921;4;1;2;1;1;1
258144587942;258144588761;819;-1;0;-1;0;1;1
258144588761;258144589399;638;4;1;2;1;1;1
258144589399;258144632674;43275;-1;0;-1;0;1;1
258144632674;258144633365;691;4;1;2;1;1;1
258144633365;258144703171;69806;-1;0;-1;0;1;1
258144703171;258144703713;542;4;1;2;1;1;1
258144703713;258144764417;60704;-1;0;-1;0;1;1
258144764417;258144764964;547;4;1;2;1;1;1
258144764964;258144813536;48572;-1;0;-1;0;1;1
258144813536;258144814156;620;4;1;2;1;1;1
258144814156;258144903191;89035;-1;0;-1;0;1;1
258144903191;258144903839;648;4;1;2;1;1;1
258144903839;258144983551;79712;-1;0;-1;0;1;1
258144983551;258144984162;611;4;1;2;1;1;1
258144984162;258144984199;37;4;1;2;1;1;1
258144984199;258144985023;824;4;1;2;1;1;1
258144985023;258145060532;75509;-1;0;-1;0;1;1
258145060532;258145061714;1182;4;1;2;1;1;1
258145061714;258145062396;682;4;1;2;1;1;1
258145062396;258145062867;471;4;1;2;1;1;1
258145062867;258145063526;659;-1;0;-1;0;1;1
258145063526;258145064167;641;4;1;2;1;1;1
258145064167;258145140997;76830;-1;0;-1;0;1;1
258145140997;258145141562;565;4;1;2;1;1;1
258145141562;258145213461;71899;-1;0;-1;0;1;1
258145213461;258145214096;635;4;1;2;1;1;1
258145214096;258145262411;48315;-1;0;-1;0;1;1
258145262411;258145262778;367;4;1;2;1;1;1
258145262778;258145263173;395;4;1;2;1;1;1
258145263173;258145263550;377;4;1;2;1;1;1
258145263550;258145334098;70548;-1;0;-1;0;1;1
258145334098;258145334643;545;4;1;2;1;1;1
258145334643;258145376797;42154;-1;0;-1;0;1;1
258145376797;258145377922;1125;4;1;2;1;1;1
258145377922;258145423800;45878;-1;0;-1;0;1;1
258145423800;258145424475;675;4;1;2;1;1;1
258145424475;258145494020;69545;-1;0;-1;0;1;1
258145494020;258145495390;1370;4;1;2;1;1;1
258145495390;258145495652;262;4;1;2;1;1;1
258145495652;258145496101;449;4;1;2;1;1;1
258145496101;258145496634;533;-1;0;-1;0;1;1
258145496634;258145497287;653;4;1;2;1;1;1
258145497287;258145539713;42426;-1;0;-1;0;1;1
258145539713;258145540312;599;4;1;2;1;1;1
258145540312;258145540442;130;4;1;2;1;1;1
258145540442;258145540973;531;4;1;2;1;1;1
258145540973;258145705202;164229;-1;0;-1;0;1;1
258145705202;258145705976;774;4;1;2;1;1;1
258145705976;258145798440;92464;-1;0;-1;0;1;1
258145798440;258145799121;681;4;1;2;1;1;1
258145799121;258145954903;155782;-1;0;-1;0;1;1
258145954903;258145955524;621;4;1;2;1;1;1
258145955524;258146152694;197170;-1;0;-1;0;1;1
258146152694;258146153314;620;4;1;2;1;1;1
258146153314;258146294500;141186;-1;0;-1;0;1;1
258146294500;258146295127;627;4;1;2;1;1;1
258146295127;258146656301;361174;-1;0;-1;0;1;1
258146656301;258146656869;568;4;1;2;1;1;1
258146656869;258146700491;43622;-1;0;-1;0;1;1
258146700491;258146701347;856;4;1;2;1;1;1
258146701347;258146702099;752;-1;0;-1;0;1;1
258146702099;258146702699;600;4;1;2;1;1;1
258146702699;258146812761;110062;-1;0;-1;0;1;1
258146812761;258146813314;553;4;1;2;1;1;1
258146813314;258146853848;40534;-1;0;-1;0;1;1
258146853848;258146854498;650;4;1;2;1;1;1
258146854498;258146854598;100;-1;0;-1;0;1;1
258146854598;258146855317;719;4;1;2;1;1;1
258146855317;258146864698;9381;-1;0;-1;0;1;1
258146864698;258146865087;389;4;1;2;1;1;1
258146865087;258146865312;225;4;1;2;1;1;1
258146865312;258146865694;382;4;1;2;1;1;1
258146865694;258147008618;142924;-1;0;-1;0;1;1
258147008618;258147009378;760;4;1;2;1;1;1
258147009378;258147009890;512;-1;0;-1;0;1;1
258147009890;258147010669;779;4;1;2;1;1;1
258147010669;258147011628;959;-1;0;-1;0;1;1
258147011628;258147012250;622;4;1;2;1;1;1
258147012250;258147041607;29357;-1;0;-1;0;1;1
258147041607;258147043502;1895;4;1;2;1;1;1
258147043502;258147043864;362;-1;0;-1;0;1;1
258147043864;258147044689;825;4;1;2;1;1;1
258147044689;258147045695;1006;-1;0;-1;0;1;1
258147045695;258147046297;602;4;1;2;1;1;1
258147046297;258147088022;41725;-1;0;-1;0;1;1
258147088022;258147088571;549;4;1;2;1;1;1
258147088571;258147167216;78645;-1;0;-1;0;1;1
258147167216;258147167855;639;4;1;2;1;1;1
258147167855;258147214188;46333;-1;0;-1;0;1;1
258147214188;258147214805;617;4;1;2;1;1;1
258147214805;258147271201;56396;-1;0;-1;0;1;1
258147271201;258147271823;622;4;1;2;1;1;1
258147271823;258147341962;70139;-1;0;-1;0;1;1
258147341962;258147342894;932;4;1;2;1;1;1
258147342894;258147343745;851;-1;0;-1;0;1;1
258147343745;258147344288;543;4;1;2;1;1;1
258147344288;258147428118;83830;-1;0;-1;0;1;1
258147428118;258147430320;2202;4;1;2;1;1;1
258147430320;258147430920;600;4;1;2;1;1;1
258147430920;258147431666;746;4;1;2;1;1;1
258147431666;258147432113;447;4;1;2;1;1;1
258147432113;258147432804;691;4;1;2;1;1;1
258147432804;258147432889;85;4;1;2;1;1;1
258147432889;258147433655;766;4;1;2;1;1;1
258147433655;258147474857;41202;-1;0;-1;0;1;1
258147474857;258147475457;600;4;1;2;1;1;1
258147475457;258147521375;45918;-1;0;-1;0;1;1
258147521375;258147522013;638;4;1;2;1;1;1
258147522013;258147568895;46882;-1;0;-1;0;1;1
258147568895;258147569798;903;4;1;2;1;1;1
258147569798;258147571175;1377;-1;0;-1;0;1;1
258147571175;258147571786;611;4;1;2;1;1;1
258147571786;258147693964;122178;-1;0;-1;0;1;1
258147693964;258147694575;611;4;1;2;1;1;1
258147694575;258147737211;42636;-1;0;-1;0;1;1
258147737211;258147738057;846;4;1;2;1;1;1
258147738057;258147738273;216;-1;0;-1;0;1;1
258147738273;258147738977;704;4;1;2;1;1;1
258147738977;258147811435;72458;-1;0;-1;0;1;1
258147811435;258147812103;668;4;1;2;1;1;1
258147812103;258147812907;804;-1;0;-1;0;1;1
258147812907;258147813449;542;4;1;2;1;1;1
258147813449;258147885047;71598;-1;0;-1;0;1;1
258147885047;258147885658;611;4;1;2;1;1;1
258147885658;258148058244;172586;-1;0;-1;0;1;1
258148058244;258148058800;556;4;1;2;1;1;1
258148058800;258148105819;47019;-1;0;-1;0;1;1
258148105819;258148106452;633;4;1;2;1;1;1
258148106452;258148174560;68108;-1;0;-1;0;1;1
258148174560;258148175110;550;4;1;2;1;1;1
258148175110;258148217124;42014;-1;0;-1;0;1;1
258148217124;258148217727;603;4;1;2;1;1;1
258148217727;258148292528;74801;-1;0;-1;0;1;1
258148292528;258148293200;672;4;1;2;1;1;1
258148293200;258148459811;166611;-1;0;-1;0;1;1
258148459811;258148460931;1120;4;1;2;1;1;1
258148460931;258148532176;71245;-1;0;-1;0;1;1
258148532176;258148532789;613;4;1;2;1;1;1
258148532789;258148569303;36514;-1;0;-1;0;1;1
258148569303;258148569966;663;4;1;2;1;1;1
258148569966;258148612567;42601;-1;0;-1;0;1;1
258148612567;258148613204;637;4;1;2;1;1;1
258148613204;258148654200;40996;-1;0;-1;0;1;1
258148654200;258148654745;545;4;1;2;1;1;1
258148654745;258148727368;72623;-1;0;-1;0;1;1
258148727368;258148728091;723;4;1;2;1;1;1
258148728091;258148728456;365;4;1;2;1;1;1
258148728456;258148728933;477;4;1;2;1;1;1
258148728933;258148811121;82188;-1;0;-1;0;1;1
258148811121;258148811684;563;4;1;2;1;1;1
258148811684;258148860597;48913;-1;0;-1;0;1;1
258148860597;258148860878;281;4;1;2;1;1;1
258148860878;258148861512;634;4;1;2;1;1;1
258148861512;258148861526;14;4;1;2;1;1;1
258148861526;258148947303;85777;-1;0;-1;0;1;1
258148947303;258148947899;596;4;1;2;1;1;1
258148947899;258148948793;894;-1;0;-1;0;1;1
258148948793;258148949422;629;4;1;2;1;1;1
258148949422;258148984721;35299;-1;0;-1;0;1;1
258148984721;258148985269;548;4;1;2;1;1;1
258148985269;258149042049;56780;-1;0;-1;0;1;1
258149042049;258149042694;645;4;1;2;1;1;1
258149042694;258149189251;146557;-1;0;-1;0;1;1
258149189251;258149189825;574;4;1;2;1;1;1
258149189825;258149238426;48601;-1;0;-1;0;1;1
258149238426;258149239242;816;4;1;2;1;1;1
258149239242;258149240232;990;-1;0;-1;0;1;1
258149240232;258149240783;551;4;1;2;1;1;1
258149240783;258149312009;71226;-1;0;-1;0;1;1
258149312009;258149312658;649;4;1;2;1;1;1
258149312658;258149312838;180;-1;0;-1;0;1;1
258149312838;258149313499;661;4;1;2;1;1;1
258149313499;258149386522;73023;-1;0;-1;0;1;1
258149386522;258149387112;590;4;1;2;1;1;1
258149387112;258149425657;38545;-1;0;-1;0;1;1
258149425657;258149426289;632;4;1;2;1;1;1
258149426289;258149460521;34232;-1;0;-1;0;1;1
258149460521;258149461117;596;4;1;2;1;1;1
258149461117;258149461766;649;-1;0;-1;0;1;1
258149461766;258149462363;597;4;1;2;1;1;1
258149462363;258149536458;74095;-1;0;-1;0;1;1
258149536458;258149537465;1007;4;1;2;1;1;1
258149537465;258149610264;72799;-1;0;-1;0;1;1
258149610264;258149610910;646;4;1;2;1;1;1
258149610910;258149687830;76920;-1;0;-1;0;1;1
258149687830;258149688380;550;4;1;2;1;1;1
258149688380;258149747608;59228;-1;0;-1;0;1;1
258149747608;258149748292;684;4;1;2;1;1;1
258149748292;258149798681;50389;-1;0;-1;0;1;1
258149798681;258149799279;598;4;1;2;1;1;1
258149799279;258149874362;75083;-1;0;-1;0;1;1
258149874362;258149875804;1442;4;1;2;1;1;1
258149875804;258149876246;442;4;1;2;1;1;1
258149876246;258149878004;1758;4;1;2;1;1;1
258149878004;258150010347;132343;-1;0;-1;0;1;1
258150010347;258150010987;640;4;1;2;1;1;1
258150010987;258150062794;51807;-1;0;-1;0;1;1
258150062794;258150063353;559;4;1;2;1;1;1
258150063353;258150138871;75518;-1;0;-1;0;1;1
258150138871;258150139503;632;4;1;2;1;1;1
258150139503;258150180651;41148;-1;0;-1;0;1;1
258150180651;258150181194;543;4;1;2;1;1;1
258150181194;258150266191;84997;-1;0;-1;0;1;1
258150266191;258150268179;1988;4;1;2;1;1;1
258150268179;258150268827;648;-1;0;-1;0;1;1
258150268827;258150269945;1118;4;1;2;1;1;1
258150269945;258150270328;383;4;1;2;1;1;1
258150270328;258150272489;2161;4;1;2;1;1;1
258150272489;258150273487;998;-1;0;-1;0;1;1
258150273487;258150274093;606;4;1;2;1;1;1
258150274093;258150274826;733;-1;0;-1;0;1;1
258150274826;258150275429;603;4;1;2;1;1;1
258150275429;258150300298;24869;-1;0;-1;0;1;1
258150300298;258150300902;604;4;1;2;1;1;1
258150300902;258150349873;48971;-1;0;-1;0;1;1
258150349873;258150352641;2768;4;1;2;1;1;1
258150352641;258150353060;419;4;1;2;1;1;1
258150353060;258150353713;653;4;1;2;1;1;1
258150353713;258150354959;1246;-1;0;-1;0;1;1
258150354959;258150356530;1571;4;1;2;1;1;1
258150356530;258150357020;490;-1;0;-1;0;1;1
258150357020;258150357774;754;4;1;2;1;1;1
258150357774;258150358260;486;4;1;2;1;1;1
258150358260;258150358544;284;4;1;2;1;1;1
258150358544;258150359277;733;-1;0;-1;0;1;1
258150359277;258150359939;662;4;1;2;1;1;1
258150359939;258150438066;78127;-1;0;-1;0;1;1
258150438066;258150438637;571;4;1;2;1;1;1
258150438637;258150489397;50760;-1;0;-1;0;1;1
258150489397;258150489965;568;4;1;2;1;1;1
258150489965;258150568232;78267;-1;0;-1;0;1;1
258150568232;258150568705;473;4;1;2;1;1;1
258150568705;258150568886;181;4;1;2;1;1;1
258150568886;258150569840;954;4;1;2;1;1;1
258150569840;258150643481;73641;-1;0;-1;0;1;1
258150643481;258150644100;619;4;1;2;1;1;1
258150644100;258150693994;49894;-1;0;-1;0;1;1
258150693994;258150695021;1027;4;1;2;1;1;1
258150695021;258150731069;36048;-1;0;-1;0;1;1
258150731069;258150731623;554;4;1;2;1;1;1
258150731623;258150779077;47454;-1;0;-1;0;1;1
258150779077;258150781282;2205;4;1;2;1;1;1
258150781282;258150781567;285;4;1;2;1;1;1
258150781567;258150781978;411;4;1;2;1;1;1
258150781978;258150784215;2237;4;1;2;1;1;1
258150784215;258150784589;374;4;1;2;1;1;1
258150784589;258150786114;1525;-1;0;-1;0;1;1
258150786114;258150787635;1521;4;1;2;1;1;1
258150787635;258150790362;2727;-1;0;-1;0;1;1
258150790362;258150790378;16;4;1;2;1;1;1
258150790378;258150792429;2051;4;1;2;1;1;1
258150792429;258150793583;1154;4;1;2;1;1;1
258150793583;258150862985;69402;-1;0;-1;0;1;1
258150862985;258150863626;641;4;1;2;1;1;1
258150863626;258150931990;68364;-1;0;-1;0;1;1
258150931990;258150932665;675;4;1;2;1;1;1
258150932665;258151010341;77676;-1;0;-1;0;1;1
258151010341;258151011322;981;4;1;2;1;1;1
258151011322;258151014357;3035;-1;0;-1;0;1;1
258151014357;258151016329;1972;4;1;2;1;1;1
258151016329;258151016716;387;-1;0;-1;0;1;1
258151016716;258151018865;2149;4;1;2;1;1;1
258151018865;258151018950;85;-1;0;-1;0;1;1
258151018950;258151019744;794;4;1;2;1;1;1
258151019744;258151020172;428;-1;0;-1;0;1;1
258151020172;258151020568;396;4;1;2;1;1;1
258151020568;258151020963;395;4;1;2;1;1;1
258151020963;258151021538;575;4;1;2;1;1;1
258151021538;258151146968;125430;-1;0;-1;0;1;1
258151146968;258151147617;649;4;1;2;1;1;1
258151147617;258151185747;38130;-1;0;-1;0;1;1
258151185747;258151186174;427;4;1;2;1;1;1
258151186174;258151186407;233;4;1;2;1;1;1
258151186407;258151187023;616;4;1;2;1;1;1
258151187023;258151234428;47405;-1;0;-1;0;1;1
258151234428;258151236060;1632;4;1;2;1;1;1
258151236060;258151300671;64611;-1;0;-1;0;1;1
258151300671;258151301809;1138;4;1;2;1;1;1
258151301809;258151350577;48768;-1;0;-1;0;1;1
258151350577;258151351203;626;4;1;2;1;1;1
258151351203;258151421559;70356;-1;0;-1;0;1;1
258151421559;258151422114;555;4;1;2;1;1;1
258151422114;258151467733;45619;-1;0;-1;0;1;1
258151467733;258151468367;634;4;1;2;1;1;1
258151468367;258151659509;191142;-1;0;-1;0;1;1
258151659509;258151659928;419;4;1;2;1;1;1
258151659928;258151660330;402;4;1;2;1;1;1
258151660330;258151660711;381;4;1;2;1;1;1
258151660711;258151821478;160767;-1;0;-1;0;1;1
258151821478;258151822064;586;4;1;2;1;1;1
258151822064;258151913696;91632;-1;0;-1;0;1;1
258151913696;258151914334;638;4;1;2;1;1;1
258151914334;258151989065;74731;-1;0;-1;0;1;1
258151989065;258151989708;643;4;1;2;1;1;1
258151989708;258152229129;239421;-1;0;-1;0;1;1
258152229129;258152229603;474;4;1;2;1;1;1
258152229603;258152229950;347;4;1;2;1;1;1
258152229950;258152230320;370;4;1;2;1;1;1
258152230320;258152344791;114471;-1;0;-1;0;1;1
258152344791;258152345396;605;4;1;2;1;1;1
258152345396;258152345827;431;-1;0;-1;0;1;1
258152345827;258152346470;643;4;1;2;1;1;1
258152346470;258152385741;39271;-1;0;-1;0;1;1
258152385741;258152386376;635;4;1;2;1;1;1
258152386376;258152467991;81615;-1;0;-1;0;1;1
258152467991;258152468883;892;4;1;2;1;1;1
258152468883;258152470917;2034;-1;0;-1;0;1;1
258152470917;258152471538;621;4;1;2;1;1;1
258152471538;258152512201;40663;-1;0;-1;0;1;1
258152512201;258152512855;654;4;1;2;1;1;1
258152512855;258152567836;54981;-1;0;-1;0;1;1
258152567836;258152568469;633;4;1;2;1;1;1
258152568469;258152635827;67358;-1;0;-1;0;1;1
258152635827;258152636384;557;4;1;2;1;1;1
258152636384;258152708318;71934;-1;0;-1;0;1;1
258152708318;258152708976;658;4;1;2;1;1;1
258152708976;258152709016;40;-1;0;-1;0;1;1
258152709016;258152709889;873;4;1;2;1;1;1
258152709889;258152755919;46030;-1;0;-1;0;1;1
258152755919;258152758089;2170;4;1;2;1;1;1
258152758089;258152758916;827;4;1;2;1;1;1
258152758916;258152760276;1360;4;1;2;1;1;1
258152760276;258152761262;986;4;1;2;1;1;1
258152761262;258152762404;1142;4;1;2;1;1;1
258152762404;258152762435;31;4;1;2;1;1;1
258152762435;258152763036;601;4;1;2;1;1;1
258152763036;258152766330;3294;4;1;2;1;1;1
258152766330;258152767681;1351;4;1;2;1;1;1
258152767681;258152767803;122;4;1;2;1;1;1
258152767803;258152770315;2512;4;1;2;1;1;1
258152770315;258152772840;2525;-1;0;-1;0;1;1
258152772840;258152774214;1374;4;1;2;1;1;1
258152774214;258152775663;1449;-1;0;-1;0;1;1
258152775663;258152776059;396;4;1;2;1;1;1
258152776059;258152778815;2756;4;1;2;1;1;1
258152778815;258152779229;414;4;1;2;1;1;1
258152779229;258152779436;207;-1;0;-1;0;1;1
258152779436;258152780802;1366;4;1;2;1;1;1
258152780802;258152781170;368;-1;0;-1;0;1;1
258152781170;258152781765;595;4;1;2;1;1;1
258152781765;258152781837;72;-1;0;-1;0;1;1
258152781837;258152782585;748;4;1;2;1;1;1
258152782585;258152833133;50548;-1;0;-1;0;1;1
258152833133;258152833775;642;4;1;2;1;1;1
258152833775;258152834022;247;-1;0;-1;0;1;1
258152834022;258152834604;582;4;1;2;1;1;1
258152834604;258152910459;75855;-1;0;-1;0;1;1
258152910459;258152911108;649;4;1;2;1;1;1
258152911108;258152958042;46934;-1;0;-1;0;1;1
258152958042;258152958814;772;4;1;2;1;1;1
258152958814;258152960193;1379;-1;0;-1;0;1;1
258152960193;258152960867;674;4;1;2;1;1;1
258152960867;258153041724;80857;-1;0;-1;0;1;1
258153041724;258153042288;564;4;1;2;1;1;1
258153042288;258153042748;460;-1;0;-1;0;1;1
258153042748;258153043382;634;4;1;2;1;1;1
258153043382;258153089103;45721;-1;0;-1;0;1;1
258153089103;258153089754;651;4;1;2;1;1;1
258153089754;258153138711;48957;-1;0;-1;0;1;1
258153138711;258153139345;634;4;1;2;1;1;1
258153139345;258153189339;49994;-1;0;-1;0;1;1
258153189339;258153189997;658;4;1;2;1;1;1
258153189997;258153232285;42288;-1;0;-1;0;1;1
258153232285;258153234363;2078;4;1;2;1;1;1
258153234363;258153235326;963;-1;0;-1;0;1;1
258153235326;258153235934;608;4;1;2;1;1;1
258153235934;258153236315;381;-1;0;-1;0;1;1
258153236315;258153236964;649;4;1;2;1;1;1
258153236964;258153297661;60697;-1;0;-1;0;1;1
258153297661;258153298271;610;4;1;2;1;1;1
258153298271;258153372738;74467;-1;0;-1;0;1;1
258153372738;258153373288;550;4;1;2;1;1;1
258153373288;258153469722;96434;-1;0;-1;0;1;1
258153469722;258153470322;600;4;1;2;1;1;1
258153470322;258153507506;37184;-1;0;-1;0;1;1
258153507506;258153508049;543;4;1;2;1;1;1
258153508049;258153552142;44093;-1;0;-1;0;1;1
258153552142;258153552789;647;4;1;2;1;1;1
258153552789;258153599342;46553;-1;0;-1;0;1;1
258153599342;258153599973;631;4;1;2;1;1;1
258153599973;258153673137;73164;-1;0;-1;0;1;1
258153673137;258153675977;2840;4;1;2;1;1;1
258153675977;258153676508;531;4;1;2;1;1;1
258153676508;258153677011;503;4;1;2;1;1;1
258153677011;258153679130;2119;-1;0;-1;0;1;1
258153679130;258153679774;644;4;1;2;1;1;1
258153679774;258153757472;77698;-1;0;-1;0;1;1
258153757472;258153757638;166;4;1;2;1;1;1
258153757638;258153758253;615;4;1;2;1;1;1
258153758253;258153758632;379;4;1;2;1;1;1
258153758632;258153804872;46240;-1;0;-1;0;1;1
258153804872;258153805444;572;4;1;2;1;1;1
258153805444;258153805974;530;-1;0;-1;0;1;1
258153805974;258153806616;642;4;1;2;1;1;1
258153806616;258153853780;47164;-1;0;-1;0;1;1
258153853780;258153854380;600;4;1;2;1;1;1
258153854380;258153889967;35587;-1;0;-1;0;1;1
258153889967;258153890532;565;4;1;2;1;1;1
258153890532;258153970020;79488;-1;0;-1;0;1;1
258153970020;258153970585;565;4;1;2;1;1;1
258153970585;258154030728;60143;-1;0;-1;0;1;1
258154030728;258154031722;994;4;1;2;1;1;1
258154031722;258154032083;361;-1;0;-1;0;1;1
258154032083;258154033578;1495;4;1;2;1;1;1
258154033578;258154035574;1996;-1;0;-1;0;1;1
258154035574;258154035741;167;4;1;2;1;1;1
258154035741;258154036623;882;4;1;2;1;1;1
258154036623;258154036646;23;4;1;2;1;1;1
258154036646;258154110020;73374;-1;0;-1;0;1;1
258154110020;258154111175;1155;4;1;2;1;1;1
258154111175;258154183127;71952;-1;0;-1;0;1;1
258154183127;258154183747;620;4;1;2;1;1;1
258154183747;258154183812;65;-1;0;-1;0;1;1
258154183812;258154184622;810;4;1;2;1;1;1
258154184622;258154222974;38352;-1;0;-1;0;1;1
258154222974;258154223858;884;4;1;2;1;1;1
258154223858;258154224090;232;-1;0;-1;0;1;1
258154224090;258154226965;2875;4;1;2;1;1;1
258154226965;258154228765;1800;-1;0;-1;0;1;1
258154228765;258154228932;167;4;1;2;1;1;1
258154228932;258154229417;485;4;1;2;1;1;1
258154229417;258154229834;417;4;1;2;1;1;1
258154229834;258154360830;130996;-1;0;-1;0;1;1
258154360830;258154363046;2216;4;1;2;1;1;1
258154363046;258154363844;798;4;1;2;1;1;1
258154363844;258154364248;404;4;1;2;1;1;1
258154364248;258154364848;600;4;1;2;1;1;1
258154364848;258154365094;246;4;1;2;1;1;1
258154365094;258154367471;2377;-1;0;-1;0;1;1
258154367471;258154368177;706;4;1;2;1;1;1
258154368177;258154432896;64719;-1;0;-1;0;1;1
258154432896;258154433530;634;4;1;2;1;1;1
258154433530;258154514115;80585;-1;0;-1;0;1;1
258154514115;258154514726;611;4;1;2;1;1;1
258154514726;258154544408;29682;-1;0;-1;0;1;1
258154544408;258154545044;636;4;1;2;1;1;1
258154545044;258154677893;132849;-1;0;-1;0;1;1
258154677893;258154678519;626;4;1;2;1;1;1
258154678519;258154728648;50129;-1;0;-1;0;1;1
258154728648;258154729282;634;4;1;2;1;1;1
258154729282;258154792819;63537;-1;0;-1;0;1;1
258154792819;258154793362;543;4;1;2;1;1;1
258154793362;258154862463;69101;-1;0;-1;0;1;1
258154862463;258154863106;643;4;1;2;1;1;1
258154863106;258154924944;61838;-1;0;-1;0;1;1
258154924944;258154925558;614;4;1;2;1;1;1
258154925558;258154971130;45572;-1;0;-1;0;1;1
258154971130;258154971734;604;4;1;2;1;1;1
258154971734;258154972188;454;-1;0;-1;0;1;1
258154972188;258154972820;632;4;1;2;1;1;1
258154972820;258155051999;79179;-1;0;-1;0;1;1
258155051999;258155052550;551;4;1;2;1;1;1
258155052550;258155118803;66253;-1;0;-1;0;1;1
258155118803;258155119736;933;4;1;2;1;1;1
258155119736;258155120760;1024;-1;0;-1;0;1;1
258155120760;258155121437;677;4;1;2;1;1;1
258155121437;258155235139;113702;-1;0;-1;0;1;1
258155235139;258155235788;649;4;1;2;1;1;1
258155235788;258155274006;38218;-1;0;-1;0;1;1
258155274006;258155274660;654;4;1;2;1;1;1
258155274660;258155315841;41181;-1;0;-1;0;1;1
258155315841;258155316447;606;4;1;2;1;1;1
258155316447;258155410337;93890;-1;0;-1;0;1;1
258155410337;258155410972;635;4;1;2;1;1;1
258155410972;258155448977;38005;-1;0;-1;0;1;1
258155448977;258155449625;648;4;1;2;1;1;1
258155449625;258155496706;47081;-1;0;-1;0;1;1
258155496706;258155497330;624;4;1;2;1;1;1
258155497330;258155576467;79137;-1;0;-1;0;1;1
258155576467;258155577969;1502;4;1;2;1;1;1
258155577969;258155578390;421;-1;0;-1;0;1;1
258155578390;258155579564;1174;4;1;2;1;1;1
258155579564;258155655342;75778;-1;0;-1;0;1;1
258155655342;258155655882;540;4;1;2;1;1;1
258155655882;258155693306;37424;-1;0;-1;0;1;1
258155693306;258155693863;557;4;1;2;1;1;1
258155693863;258155802779;108916;-1;0;-1;0;1;1
258155802779;258155803397;618;4;1;2;1;1;1
258155803397;258155846443;43046;-1;0;-1;0;1;1
258155846443;258155847048;605;4;1;2;1;1;1
258155847048;258155909953;62905;-1;0;-1;0;1;1
258155909953;258155910601;648;4;1;2;1;1;1
258155910601;258155991096;80495;-1;0;-1;0;1;1
258155991096;258155991745;649;4;1;2;1;1;1
258155991745;258156034863;43118;-1;0;-1;0;1;1
258156034863;258156035473;610;4;1;2;1;1;1
258156035473;258156083624;48151;-1;0;-1;0;1;1
258156083624;258156084345;721;4;1;2;1;1;1
258156084345;258156085073;728;-1;0;-1;0;1;1
258156085073;258156085621;548;4;1;2;1;1;1
258156085621;258156196167;110546;-1;0;-1;0;1;1
258156196167;258156197762;1595;4;1;2;1;1;1
258156197762;258156198759;997;-1;0;-1;0;1;1
258156198759;258156199441;682;4;1;2;1;1;1
258156199441;258156200409;968;-1;0;-1;0;1;1
258156200409;258156200952;543;4;1;2;1;1;1
258156200952;258156274055;73103;-1;0;-1;0;1;1
258156274055;258156274222;167;4;1;2;1;1;1
258156274222;258156274832;610;4;1;2;1;1;1
258156274832;258156275216;384;4;1;2;1;1;1
258156275216;258156320624;45408;-1;0;-1;0;1;1
258156320624;258156321253;629;4;1;2;1;1;1
258156321253;258156407304;86051;-1;0;-1;0;1;1
258156407304;258156407921;617;4;1;2;1;1;1
258156407921;258156476534;68613;-1;0;-1;0;1;1
258156476534;258156477855;1321;4;1;2;1;1;1
258156477855;258156531632;53777;-1;0;-1;0;1;1
258156531632;258156532164;532;4;1;2;1;1;1
258156532164;258156532293;129;4;1;2;1;1;1
258156532293;258156532944;651;4;1;2;1;1;1
258156532944;258156605974;73030;-1;0;-1;0;1;1
258156605974;258156606517;543;4;1;2;1;1;1
258156606517;258156709309;102792;-1;0;-1;0;1;1
258156709309;258156709883;574;4;1;2;1;1;1
258156709883;258156727202;17319;-1;0;-1;0;1;1
258156727202;258156727885;683;4;1;2;1;1;1
258156727885;258156765015;37130;-1;0;-1;0;1;1
258156765015;258156765580;565;4;1;2;1;1;1
258156765580;258156966214;200634;-1;0;-1;0;1;1
258156966214;258156966821;607;4;1;2;1;1;1
258156966821;258157048621;81800;-1;0;-1;0;1;1
258157048621;258157049264;643;4;1;2;1;1;1
258157049264;258157162851;113587;-1;0;-1;0;1;1
258157162851;258157163398;547;4;1;2;1;1;1
258157163398;258157281898;118500;-1;0;-1;0;1;1
258157281898;258157282461;563;4;1;2;1;1;1
258157282461;258157375785;93324;-1;0;-1;0;1;1
258157375785;258157376445;660;4;1;2;1;1;1
258157376445;258157463145;86700;-1;0;-1;0;1;1
258157463145;258157463793;648;4;1;2;1;1;1
258157463793;258157547559;83766;-1;0;-1;0;1;1
258157547559;258157548173;614;4;1;2;1;1;1
258157548173;258157550258;2085;-1;0;-1;0;1;1
258157550258;258157550937;679;4;1;2;1;1;1
258157550937;258157618803;67866;-1;0;-1;0;1;1
258157618803;258157619415;612;4;1;2;1;1;1
258157619415;258157653844;34429;-1;0;-1;0;1;1
258157653844;258157654384;540;4;1;2;1;1;1
258157654384;258157746711;92327;-1;0;-1;0;1;1
258157746711;258157747310;599;4;1;2;1;1;1
258157747310;258157784253;36943;-1;0;-1;0;1;1
258157784253;258157784869;616;4;1;2;1;1;1
258157784869;258157824246;39377;-1;0;-1;0;1;1
258157824246;258157824792;546;4;1;2;1;1;1
258157824792;258157937461;112669;-1;0;-1;0;1;1
258157937461;258157938017;556;4;1;2;1;1;1
258157938017;258157978695;40678;-1;0;-1;0;1;1
258157978695;258157979244;549;4;1;2;1;1;1
258157979244;258158032582;53338;-1;0;-1;0;1;1
258158032582;258158033218;636;4;1;2;1;1;1
258158033218;258158043506;10288;-1;0;-1;0;1;1
258158043506;258158044058;552;4;1;2;1;1;1
258158044058;258158093777;49719;-1;0;-1;0;1;1
258158093777;258158094448;671;4;1;2;1;1;1
258158094448;258158095001;553;-1;0;-1;0;1;1
258158095001;258158095638;637;4;1;2;1;1;1
258158095638;258158139510;43872;-1;0;-1;0;1;1
258158139510;258158141326;1816;4;1;2;1;1;1
258158141326;258158142101;775;-1;0;-1;0;1;1
258158142101;258158142651;550;4;1;2;1;1;1
258158142651;258158143087;436;-1;0;-1;0;1;1
258158143087;258158143662;575;4;1;2;1;1;1
258158143662;258158185656;41994;-1;0;-1;0;1;1
258158185656;258158186616;960;4;1;2;1;1;1
258158186616;258158188488;1872;-1;0;-1;0;1;1
258158188488;258158189984;1496;4;1;2;1;1;1
258158189984;258158190969;985;4;1;2;1;1;1
258158190969;258158197362;6393;4;1;2;1;1;1
258158197362;258158197655;293;4;1;2;1;1;1
258158197655;258158198920;1265;4;1;2;1;1;1
258158198920;258158200480;1560;-1;0;-1;0;1;1
258158200480;258158201096;616;4;1;2;1;1;1
258158201096;258158234063;32967;-1;0;-1;0;1;1
258158234063;258158234610;547;4;1;2;1;1;1
258158234610;258158317655;83045;-1;0;-1;0;1;1
258158317655;258158318217;562;4;1;2;1;1;1
258158318217;258158408341;90124;-1;0;-1;0;1;1
258158408341;258158408885;544;4;1;2;1;1;1
258158408885;258158452415;43530;-1;0;-1;0;1;1
258158452415;258158453010;595;4;1;2;1;1;1
258158453010;258158491604;38594;-1;0;-1;0;1;1
258158491604;258158492234;630;4;1;2;1;1;1
258158492234;258158647000;154766;-1;0;-1;0;1;1
258158647000;258158647630;630;4;1;2;1;1;1
258158647630;258158657023;9393;-1;0;-1;0;1;1
258158657023;258158658012;989;4;1;2;1;1;1
258158658012;258158659047;1035;-1;0;-1;0;1;1
258158659047;258158660487;1440;4;1;2;1;1;1
258158660487;258158663384;2897;-1;0;-1;0;1;1
258158663384;258158663873;489;4;1;2;1;1;1
258158663873;258158664573;700;4;1;2;1;1;1
258158664573;258158664600;27;4;1;2;1;1;1
258158664600;258158665255;655;4;1;2;1;1;1
258158665255;258158665453;198;4;1;2;1;1;1
258158665453;258158779896;114443;-1;0;-1;0;1;1
258158779896;258158780462;566;4;1;2;1;1;1
258158780462;258158781001;539;-1;0;-1;0;1;1
258158781001;258158781658;657;4;1;2;1;1;1
258158781658;258158826188;44530;-1;0;-1;0;1;1
258158826188;258158826834;646;4;1;2;1;1;1
258158826834;258158900436;73602;-1;0;-1;0;1;1
258158900436;258158901004;568;4;1;2;1;1;1
258158901004;258158994992;93988;-1;0;-1;0;1;1
258158994992;258158995541;549;4;1;2;1;1;1
258158995541;258159004520;8979;-1;0;-1;0;1;1
258159004520;258159005073;553;4;1;2;1;1;1
258159005073;258159051459;46386;-1;0;-1;0;1;1
258159051459;258159051852;393;4;1;2;1;1;1
258159051852;258159052305;453;4;1;2;1;1;1
258159052305;258159052425;120;4;1;2;1;1;1
258159052425;258159052643;218;4;1;2;1;1;1
258159052643;258159052977;334;4;1;2;1;1;1
258159052977;258159053351;374;4;1;2;1;1;1
258159053351;258159053633;282;4;1;2;1;1;1
258159053633;258159054081;448;4;1;2;1;1;1
258159054081;258159054371;290;4;1;2;1;1;1
258159054371;258159110413;56042;-1;0;-1;0;1;1
258159110413;258159111090;677;4;1;2;1;1;1
258159111090;258159152199;41109;-1;0;-1;0;1;1
258159152199;258159153078;879;4;1;2;1;1;1
258159153078;258159155485;2407;-1;0;-1;0;1;1
258159155485;258159157703;2218;4;1;2;1;1;1
258159157703;258159157781;78;4;1;2;1;1;1
258159157781;258159160135;2354;4;1;2;1;1;1
258159160135;258159161095;960;4;1;2;1;1;1
258159161095;258159162320;1225;4;1;2;1;1;1
258159162320;258159163866;1546;4;1;2;1;1;1
258159163866;258159164425;559;4;1;2;1;1;1
258159164425;258159166670;2245;4;1;2;1;1;1
258159166670;258159169532;2862;4;1;2;1;1;1
258159169532;258159170234;702;-1;0;-1;0;1;1
258159170234;258159173106;2872;4;1;2;1;1;1
258159173106;258159174488;1382;-1;0;-1;0;1;1
258159174488;258159175707;1219;4;1;2;1;1;1
258159175707;258159177054;1347;4;1;2;1;1;1
258159177054;258159177489;435;4;1;2;1;1;1
258159177489;258159177670;181;4;1;2;1;1;1
258159177670;258159178802;1132;4;1;2;1;1;1
258159178802;258159180087;1285;-1;0;-1;0;1;1
258159180087;258159181373;1286;4;1;2;1;1;1
258159181373;258159182242;869;-1;0;-1;0;1;1
258159182242;258159182865;623;4;1;2;1;1;1
258159182865;258159182962;97;-1;0;-1;0;1;1
258159182962;258159183680;718;4;1;2;1;1;1
258159183680;258159201586;17906;-1;0;-1;0;1;1
258159201586;258159202219;633;4;1;2;1;1;1
258159202219;258159242831;40612;-1;0;-1;0;1;1
258159242831;258159243452;621;4;1;2;1;1;1
258159243452;258159284307;40855;-1;0;-1;0;1;1
258159284307;258159284927;620;4;1;2;1;1;1
258159284927;258159357720;72793;-1;0;-1;0;1;1
258159357720;258159358403;683;4;1;2;1;1;1
258159358403;258159426402;67999;-1;0;-1;0;1;1
258159426402;258159426961;559;4;1;2;1;1;1
258159426961;258159466328;39367;-1;0;-1;0;1;1
258159466328;258159466883;555;4;1;2;1;1;1
258159466883;258159518667;51784;-1;0;-1;0;1;1
258159518667;258159519166;499;4;1;2;1;1;1
258159519166;258159519366;200;4;1;2;1;1;1
258159519366;258159519841;475;4;1;2;1;1;1
258159519841;258159582447;62606;-1;0;-1;0;1;1
258159582447;258159582995;548;4;1;2;1;1;1
258159582995;258159654185;71190;-1;0;-1;0;1;1
258159654185;258159654806;621;4;1;2;1;1;1
258159654806;258159654971;165;-1;0;-1;0;1;1
258159654971;258159655811;840;4;1;2;1;1;1
258159655811;258159701735;45924;-1;0;-1;0;1;1
258159701735;258159701844;109;4;1;2;1;1;1
258159701844;258159702654;810;4;1;2;1;1;1
258159702654;258159702909;255;4;1;2;1;1;1
258159702909;258159703211;302;4;1;2;1;1;1
258159703211;258159703440;229;4;1;2;1;1;1
258159703440;258159703635;195;4;1;2;1;1;1
258159703635;258159704397;762;4;1;2;1;1;1
258159704397;258159704689;292;-1;0;-1;0;1;1
258159704689;258159705371;682;4;1;2;1;1;1
258159705371;258159763531;58160;-1;0;-1;0;1;1
258159763531;258159764085;554;4;1;2;1;1;1
258159764085;258159809082;44997;-1;0;-1;0;1;1
258159809082;258159809649;567;4;1;2;1;1;1
258159809649;258159853399;43750;-1;0;-1;0;1;1
258159853399;258159854019;620;4;1;2;1;1;1
258159854019;258159936895;82876;-1;0;-1;0;1;1
258159936895;258159937499;604;4;1;2;1;1;1
258159937499;258159992701;55202;-1;0;-1;0;1;1
258159992701;258159993248;547;4;1;2;1;1;1
258159993248;258160095852;102604;-1;0;-1;0;1;1
258160095852;258160098025;2173;4;1;2;1;1;1
258160098025;258160099602;1577;-1;0;-1;0;1;1
258160099602;258160099894;292;4;1;2;1;1;1
258160099894;258160100584;690;4;1;2;1;1;1
258160100584;258160100660;76;4;1;2;1;1;1
258160100660;258160176907;76247;-1;0;-1;0;1;1
258160176907;258160177191;284;4;1;2;1;1;1
258160177191;258160179334;2143;4;1;2;1;1;1
258160179334;258160179633;299;4;1;2;1;1;1
258160179633;258160180658;1025;4;1;2;1;1;1
258160180658;258160180729;71;4;1;2;1;1;1
258160180729;258160185215;4486;-1;0;-1;0;1;1
258160185215;258160185502;287;4;1;2;1;1;1
258160185502;258160185984;482;4;1;2;1;1;1
258160185984;258160186161;177;4;1;2;1;1;1
258160186161;258160186183;22;4;1;2;1;1;1
258160186183;258160187019;836;4;1;2;1;1;1
258160187019;258160251532;64513;-1;0;-1;0;1;1
258160251532;258160252187;655;4;1;2;1;1;1
258160252187;258160311132;58945;-1;0;-1;0;1;1
258160311132;258160311848;716;4;1;2;1;1;1
258160311848;258160311910;62;4;1;2;1;1;1
258160311910;258160312871;961;4;1;2;1;1;1
258160312871;258160433260;120389;-1;0;-1;0;1;1
258160433260;258160433912;652;4;1;2;1;1;1
258160433912;258160434007;95;-1;0;-1;0;1;1
258160434007;258160434821;814;4;1;2;1;1;1
258160434821;258160443867;9046;-1;0;-1;0;1;1
258160443867;258160444497;630;4;1;2;1;1;1
258160444497;258160483606;39109;-1;0;-1;0;1;1
258160483606;258160484246;640;4;1;2;1;1;1
258160484246;258160518795;34549;-1;0;-1;0;1;1
258160518795;258160519478;683;4;1;2;1;1;1
258160519478;258160599938;80460;-1;0;-1;0;1;1
258160599938;258160601423;1485;4;1;2;1;1;1
258160601423;258160602131;708;4;1;2;1;1;1
258160602131;258160602736;605;4;1;2;1;1;1
258160602736;258160603354;618;4;1;2;1;1;1
258160603354;258160604301;947;4;1;2;1;1;1
258160604301;258160605290;989;4;1;2;1;1;1
258160605290;258160605713;423;4;1;2;1;1;1
258160605713;258160607077;1364;4;1;2;1;1;1
258160607077;258160608866;1789;4;1;2;1;1;1
258160608866;258160609314;448;-1;0;-1;0;1;1
258160609314;258160609756;442;4;1;2;1;1;1
258160609756;258160610796;1040;4;1;2;1;1;1
258160610796;258160611087;291;4;1;2;1;1;1
258160611087;258160611471;384;-1;0;-1;0;1;1
258160611471;258160612104;633;4;1;2;1;1;1
258160612104;258160674183;62079;-1;0;-1;0;1;1
258160674183;258160674744;561;4;1;2;1;1;1
258160674744;258160772398;97654;-1;0;-1;0;1;1
258160772398;258160773038;640;4;1;2;1;1;1
258160773038;258160808641;35603;-1;0;-1;0;1;1
258160808641;258160809285;644;4;1;2;1;1;1
258160809285;258160809870;585;-1;0;-1;0;1;1
258160809870;258160810509;639;4;1;2;1;1;1
258160810509;258160849342;38833;-1;0;-1;0;1;1
258160849342;258160849976;634;4;1;2;1;1;1
258160849976;258160894956;44980;-1;0;-1;0;1;1
258160894956;258160895580;624;4;1;2;1;1;1
258160895580;258160944982;49402;-1;0;-1;0;1;1
258160944982;258160945531;549;4;1;2;1;1;1
258160945531;258161024859;79328;-1;0;-1;0;1;1
258161024859;258161025481;622;4;1;2;1;1;1
258161025481;258161070708;45227;-1;0;-1;0;1;1
258161070708;258161071349;641;4;1;2;1;1;1
258161071349;258161153535;82186;-1;0;-1;0;1;1
258161153535;258161154154;619;4;1;2;1;1;1
258161154154;258161255786;101632;-1;0;-1;0;1;1
258161255786;258161256421;635;4;1;2;1;1;1
258161256421;258161256860;439;-1;0;-1;0;1;1
258161256860;258161257565;705;4;1;2;1;1;1
258161257565;258161299059;41494;-1;0;-1;0;1;1
258161299059;258161299713;654;4;1;2;1;1;1
258161299713;258161381528;81815;-1;0;-1;0;1;1
258161381528;258161382110;582;4;1;2;1;1;1
258161382110;258161382219;109;4;1;2;1;1;1
258161382219;258161383038;819;4;1;2;1;1;1
258161383038;258161454677;71639;-1;0;-1;0;1;1
258161454677;258161455309;632;4;1;2;1;1;1
258161455309;258161500921;45612;-1;0;-1;0;1;1
258161500921;258161501485;564;4;1;2;1;1;1
258161501485;258161539757;38272;-1;0;-1;0;1;1
258161539757;258161540383;626;4;1;2;1;1;1
258161540383;258161580969;40586;-1;0;-1;0;1;1
258161580969;258161581706;737;4;1;2;1;1;1
258161581706;258161582130;424;-1;0;-1;0;1;1
258161582130;258161582771;641;4;1;2;1;1;1
258161582771;258161727604;144833;-1;0;-1;0;1;1
258161727604;258161728236;632;4;1;2;1;1;1
258161728236;258161772639;44403;-1;0;-1;0;1;1
258161772639;258161773183;544;4;1;2;1;1;1
258161773183;258161847840;74657;-1;0;-1;0;1;1
258161847840;258161848388;548;4;1;2;1;1;1
258161848388;258162175246;326858;-1;0;-1;0;1;1
258162175246;258162175851;605;4;1;2;1;1;1
258162175851;258162225048;49197;-1;0;-1;0;1;1
258162225048;258162225665;617;4;1;2;1;1;1
258162225665;258162268466;42801;-1;0;-1;0;1;1
258162268466;258162269119;653;4;1;2;1;1;1
258162269119;258162398886;129767;-1;0;-1;0;1;1
258162398886;258162399780;894;4;1;2;1;1;1
258162399780;258162400703;923;-1;0;-1;0;1;1
258162400703;258162401022;319;4;1;2;1;1;1
258162401022;258162401430;408;4;1;2;1;1;1
258162401430;258162402193;763;4;1;2;1;1;1
258162402193;258162517194;115001;-1;0;-1;0;1;1
258162517194;258162517803;609;4;1;2;1;1;1
258162517803;258162869690;351887;-1;0;-1;0;1;1
258162869690;258162870452;762;4;1;2;1;1;1
258162870452;258162918159;47707;-1;0;-1;0;1;1
258162918159;258162918707;548;4;1;2;1;1;1
258162918707;258162933498;14791;-1;0;-1;0;1;1
258162933498;258162934153;655;4;1;2;1;1;1
258162934153;258163008759;74606;-1;0;-1;0;1;1
258163008759;258163018814;10055;4;1;2;1;1;1
258163018814;258163019448;634;4;1;2;1;1;1
258163019448;258163039557;20109;4;1;2;1;1;1
258163039557;258163202905;163348;-1;0;-1;0;1;1
258163202905;258163203530;625;4;1;2;1;1;1
258163203530;258163279879;76349;-1;0;-1;0;1;1
258163279879;258163280518;639;4;1;2;1;1;1
258163280518;258163374044;93526;-1;0;-1;0;1;1
258163374044;258163374665;621;4;1;2;1;1;1
258163374665;258163423331;48666;-1;0;-1;0;1;1
258163423331;258163423972;641;4;1;2;1;1;1
258163423972;258163472611;48639;-1;0;-1;0;1;1
258163472611;258163473167;556;4;1;2;1;1;1
258163473167;258163509215;36048;-1;0;-1;0;1;1
258163509215;258163509696;481;4;1;2;1;1;1
258163509696;258163510210;514;4;1;2;1;1;1
258163510210;258163510728;518;4;1;2;1;1;1
258163510728;258163647217;136489;-1;0;-1;0;1;1
258163647217;258163649185;1968;4;1;2;1;1;1
258163649185;258163650752;1567;-1;0;-1;0;1;1
258163650752;258163650903;151;4;1;2;1;1;1
258163650903;258163651381;478;4;1;2;1;1;1
258163651381;258163651764;383;4;1;2;1;1;1
258163651764;258163709224;57460;-1;0;-1;0;1;1
258163709224;258163711184;1960;4;1;2;1;1;1
258163711184;258163712712;1528;-1;0;-1;0;1;1
258163712712;258163713089;377;4;1;2;1;1;1
258163713089;258163713475;386;4;1;2;1;1;1
258163713475;258163714202;727;4;1;2;1;1;1
258163714202;258163819231;105029;-1;0;-1;0;1;1
258163819231;258163819839;608;4;1;2;1;1;1
258163819839;258163874676;54837;-1;0;-1;0;1;1
258163874676;258163875219;543;4;1;2;1;1;1
258163875219;258163940080;64861;-1;0;-1;0;1;1
258163940080;258163940636;556;4;1;2;1;1;1
258163940636;258164014788;74152;-1;0;-1;0;1;1
258164014788;258164015423;635;4;1;2;1;1;1
258164015423;258164093507;78084;-1;0;-1;0;1;1
258164093507;258164096135;2628;4;1;2;1;1;1
258164096135;258164097884;1749;-1;0;-1;0;1;1
258164097884;258164099149;1265;4;1;2;1;1;1
258164099149;258164099210;61;4;1;2;1;1;1
258164099210;258164101916;2706;4;1;2;1;1;1
258164101916;258164168100;66184;-1;0;-1;0;1;1
258164168100;258164170831;2731;4;1;2;1;1;1
258164170831;258164171934;1103;-1;0;-1;0;1;1
258164171934;258164174399;2465;4;1;2;1;1;1
258164174399;258164175506;1107;-1;0;-1;0;1;1
258164175506;258164176703;1197;4;1;2;1;1;1
258164176703;258164177478;775;-1;0;-1;0;1;1
258164177478;258164178111;633;4;1;2;1;1;1
258164178111;258164204925;26814;-1;0;-1;0;1;1
258164204925;258164205556;631;4;1;2;1;1;1
258164205556;258164303549;97993;-1;0;-1;0;1;1
258164303549;258164304105;556;4;1;2;1;1;1
258164304105;258164345164;41059;-1;0;-1;0;1;1
258164345164;258164345433;269;4;1;2;1;1;1
258164345433;258164345919;486;4;1;2;1;1;1
258164345919;258164346285;366;4;1;2;1;1;1
258164346285;258164409602;63317;-1;0;-1;0;1;1
258164409602;258164410230;628;4;1;2;1;1;1
258164410230;258164558187;147957;-1;0;-1;0;1;1
258164558187;258164558795;608;4;1;2;1;1;1
258164558795;258164590246;31451;-1;0;-1;0;1;1
258164590246;258164591367;1121;4;1;2;1;1;1
258164591367;258164591825;458;-1;0;-1;0;1;1
258164591825;258164592862;1037;4;1;2;1;1;1
258164592862;258164593275;413;4;1;2;1;1;1
258164593275;258164594254;979;4;1;2;1;1;1
258164594254;258164596401;2147;-1;0;-1;0;1;1
258164596401;258164597381;980;4;1;2;1;1;1
258164597381;258164682541;85160;-1;0;-1;0;1;1
258164682541;258164683228;687;4;1;2;1;1;1
258164683228;258164683508;280;-1;0;-1;0;1;1
258164683508;258164684140;632;4;1;2;1;1;1
258164684140;258164701079;16939;-1;0;-1;0;1;1
258164701079;258164701723;644;4;1;2;1;1;1
258164701723;258164751655;49932;-1;0;-1;0;1;1
258164751655;258164752079;424;4;1;2;1;1;1
258164752079;258164752398;319;4;1;2;1;1;1
258164752398;258164752740;342;4;1;2;1;1;1
258164752740;258164818826;66086;-1;0;-1;0;1;1
258164818826;258164819758;932;4;1;2;1;1;1
258164819758;258164820450;692;-1;0;-1;0;1;1
258164820450;258164821133;683;4;1;2;1;1;1
258164821133;258164821229;96;-1;0;-1;0;1;1
258164821229;258164822673;1444;4;1;2;1;1;1
258164822673;258164901586;78913;-1;0;-1;0;1;1
258164901586;258164901766;180;4;1;2;1;1;1
258164901766;258164902696;930;4;1;2;1;1;1
258164902696;258164902846;150;4;1;2;1;1;1
258164902846;258164902873;27;4;1;2;1;1;1
258164902873;258164904041;1168;4;1;2;1;1;1
258164904041;258164905168;1127;-1;0;-1;0;1;1
258164905168;258164905952;784;4;1;2;1;1;1
258164905952;258165001127;95175;-1;0;-1;0;1;1
258165001127;258165001840;713;4;1;2;1;1;1
258165001840;258165002746;906;-1;0;-1;0;1;1
258165002746;258165003292;546;4;1;2;1;1;1
258165003292;258165080083;76791;-1;0;-1;0;1;1
258165080083;258165080642;559;4;1;2;1;1;1
258165080642;258165156881;76239;-1;0;-1;0;1;1
258165156881;258165158731;1850;4;1;2;1;1;1
258165158731;258165159654;923;-1;0;-1;0;1;1
258165159654;258165160340;686;4;1;2;1;1;1
258165160340;258165161575;1235;-1;0;-1;0;1;1
258165161575;258165162194;619;4;1;2;1;1;1
258165162194;258165207424;45230;-1;0;-1;0;1;1
258165207424;258165208025;601;4;1;2;1;1;1
258165208025;258165252317;44292;-1;0;-1;0;1;1
258165252317;258165254689;2372;4;1;2;1;1;1
258165254689;258165257108;2419;-1;0;-1;0;1;1
258165257108;258165257386;278;4;1;2;1;1;1
258165257386;258165257700;314;4;1;2;1;1;1
258165257700;258165257786;86;4;1;2;1;1;1
258165257786;258165258219;433;4;1;2;1;1;1
258165258219;258165258731;512;4;1;2;1;1;1
258165258731;258165284400;25669;-1;0;-1;0;1;1
258165284400;258165285031;631;4;1;2;1;1;1
258165285031;258165389188;104157;-1;0;-1;0;1;1
258165389188;258165390253;1065;4;1;2;1;1;1
258165390253;258165391126;873;-1;0;-1;0;1;1
258165391126;258165393071;1945;4;1;2;1;1;1
258165393071;258165393534;463;-1;0;-1;0;1;1
258165393534;258165394283;749;4;1;2;1;1;1
258165394283;258165459794;65511;-1;0;-1;0;1;1
258165459794;258165460397;603;4;1;2;1;1;1
258165460397;258165495282;34885;-1;0;-1;0;1;1
258165495282;258165495904;622;4;1;2;1;1;1
258165495904;258165496336;432;-1;0;-1;0;1;1
258165496336;258165496999;663;4;1;2;1;1;1
258165496999;258165539066;42067;-1;0;-1;0;1;1
258165539066;258165539705;639;4;1;2;1;1;1
258165539705;258165606229;66524;-1;0;-1;0;1;1
258165606229;258165606863;634;4;1;2;1;1;1
258165606863;258165645099;38236;-1;0;-1;0;1;1
258165645099;258165645862;763;4;1;2;1;1;1
258165645862;258165646242;380;4;1;2;1;1;1
258165646242;258165646968;726;4;1;2;1;1;1
258165646968;258165647151;183;-1;0;-1;0;1;1
258165647151;258165647907;756;4;1;2;1;1;1
258165647907;258165706539;58632;-1;0;-1;0;1;1
258165706539;258165707176;637;4;1;2;1;1;1
258165707176;258165745321;38145;-1;0;-1;0;1;1
258165745321;258165745868;547;4;1;2;1;1;1
258165745868;258165789384;43516;-1;0;-1;0;1;1
258165789384;258165790244;860;4;1;2;1;1;1
258165790244;258165868398;78154;-1;0;-1;0;1;1
258165868398;258165868944;546;4;1;2;1;1;1
258165868944;258165927184;58240;-1;0;-1;0;1;1
258165927184;258165931110;3926;4;1;2;1;1;1
258165931110;258165965856;34746;-1;0;-1;0;1;1
258165965856;258165966411;555;4;1;2;1;1;1
258165966411;258166013746;47335;-1;0;-1;0;1;1
258166013746;258166014368;622;4;1;2;1;1;1
258166014368;258166056510;42142;-1;0;-1;0;1;1
258166056510;258166057642;1132;4;1;2;1;1;1
258166057642;258166059221;1579;-1;0;-1;0;1;1
258166059221;258166059899;678;4;1;2;1;1;1
258166059899;258166125468;65569;-1;0;-1;0;1;1
258166125468;258166126024;556;4;1;2;1;1;1
258166126024;258166176741;50717;-1;0;-1;0;1;1
258166176741;258166177497;756;4;1;2;1;1;1
258166177497;258166180789;3292;-1;0;-1;0;1;1
258166180789;258166181535;746;4;1;2;1;1;1
258166181535;258166317427;135892;-1;0;-1;0;1;1
258166317427;258166317972;545;4;1;2;1;1;1
258166317972;258166391287;73315;-1;0;-1;0;1;1
258166391287;258166391841;554;4;1;2;1;1;1
258166391841;258166401626;9785;-1;0;-1;0;1;1
258166401626;258166402251;625;4;1;2;1;1;1
258166402251;258166470784;68533;-1;0;-1;0;1;1
258166470784;258166471403;619;4;1;2;1;1;1
258166471403;258166536411;65008;-1;0;-1;0;1;1
258166536411;258166537043;632;4;1;2;1;1;1
258166537043;258166596645;59602;-1;0;-1;0;1;1
258166596645;258166597866;1221;4;1;2;1;1;1
258166597866;258166598555;689;4;1;2;1;1;1
258166598555;258166599705;1150;4;1;2;1;1;1
258166599705;258166599848;143;-1;0;-1;0;1;1
258166599848;258166600627;779;4;1;2;1;1;1
258166600627;258166600971;344;-1;0;-1;0;1;1
258166600971;258166601868;897;4;1;2;1;1;1
258166601868;258166677983;76115;-1;0;-1;0;1;1
258166677983;258166678972;989;4;1;2;1;1;1
258166678972;258166679941;969;4;1;2;1;1;1
258166679941;258166680102;161;4;1;2;1;1;1
258166680102;258166680214;112;4;1;2;1;1;1
258166680214;258166680395;181;4;1;2;1;1;1
258166680395;258166680987;592;4;1;2;1;1;1
258166680987;258166681729;742;4;1;2;1;1;1
258166681729;258166683176;1447;-1;0;-1;0;1;1
258166683176;258166683724;548;4;1;2;1;1;1
258166683724;258166740527;56803;-1;0;-1;0;1;1
258166740527;258166741078;551;4;1;2;1;1;1
258166741078;258166795926;54848;-1;0;-1;0;1;1
258166795926;258166796608;682;4;1;2;1;1;1
258166796608;258166796681;73;-1;0;-1;0;1;1
258166796681;258166797426;745;4;1;2;1;1;1
258166797426;258166830136;32710;-1;0;-1;0;1;1
258166830136;258166831121;985;4;1;2;1;1;1
258166831121;258166831887;766;-1;0;-1;0;1;1
258166831887;258166832421;534;4;1;2;1;1;1
258166832421;258166878218;45797;-1;0;-1;0;1;1
258166878218;258166878859;641;4;1;2;1;1;1
258166878859;258166917565;38706;-1;0;-1;0;1;1
258166917565;258166918250;685;4;1;2;1;1;1
258166918250;258166920819;2569;-1;0;-1;0;1;1
258166920819;258166921410;591;4;1;2;1;1;1
258166921410;258166922317;907;-1;0;-1;0;1;1
258166922317;258166922952;635;4;1;2;1;1;1
258166922952;258166965459;42507;-1;0;-1;0;1;1
258166965459;258166966060;601;4;1;2;1;1;1
258166966060;258167014486;48426;-1;0;-1;0;1;1
258167014486;258167015040;554;4;1;2;1;1;1
258167015040;258167049531;34491;-1;0;-1;0;1;1
258167049531;258167050687;1156;4;1;2;1;1;1
258167050687;258167100374;49687;-1;0;-1;0;1;1
258167100374;258167101287;913;4;1;2;1;1;1
258167101287;258167104133;2846;-1;0;-1;0;1;1
258167104133;258167104275;142;4;1;2;1;1;1
258167104275;258167104938;663;4;1;2;1;1;1
258167104938;258167105547;609;4;1;2;1;1;1
258167105547;258167170306;64759;-1;0;-1;0;1;1
258167170306;258167170926;620;4;1;2;1;1;1
258167170926;258167260149;89223;-1;0;-1;0;1;1
258167260149;258167260699;550;4;1;2;1;1;1
258167260699;258167303047;42348;-1;0;-1;0;1;1
258167303047;258167303669;622;4;1;2;1;1;1
258167303669;258167338668;34999;-1;0;-1;0;1;1
258167338668;258167339279;611;4;1;2;1;1;1
258167339279;258167421076;81797;-1;0;-1;0;1;1
258167421076;258167421630;554;4;1;2;1;1;1
258167421630;258167490771;69141;-1;0;-1;0;1;1
258167490771;258167493674;2903;4;1;2;1;1;1
258167493674;258167496492;2818;-1;0;-1;0;1;1
258167496492;258167497116;624;4;1;2;1;1;1
258167497116;258167501692;4576;-1;0;-1;0;1;1
258167501692;258167502332;640;4;1;2;1;1;1
258167502332;258167550293;47961;-1;0;-1;0;1;1
258167550293;258167550928;635;4;1;2;1;1;1
258167550928;258167699894;148966;-1;0;-1;0;1;1
258167699894;258167700889;995;4;1;2;1;1;1
258167700889;258167757529;56640;-1;0;-1;0;1;1
258167757529;258167758087;558;4;1;2;1;1;1
258167758087;258167851318;93231;-1;0;-1;0;1;1
258167851318;258167851972;654;4;1;2;1;1;1
258167851972;258168072537;220565;-1;0;-1;0;1;1
258168072537;258168073174;637;4;1;2;1;1;1
258168073174;258168139787;66613;-1;0;-1;0;1;1
258168139787;258168140339;552;4;1;2;1;1;1
258168140339;258168201966;61627;-1;0;-1;0;1;1
258168201966;258168202580;614;4;1;2;1;1;1
258168202580;258168403645;201065;-1;0;-1;0;1;1
258168403645;258168404317;672;4;1;2;1;1;1
258168404317;258168496977;92660;-1;0;-1;0;1;1
258168496977;258168497608;631;4;1;2;1;1;1
258168497608;258168601124;103516;-1;0;-1;0;1;1
258168601124;258168601759;635;4;1;2;1;1;1
258168601759;258168646992;45233;-1;0;-1;0;1;1
258168646992;258168647632;640;4;1;2;1;1;1
258168647632;258168774966;127334;-1;0;-1;0;1;1
258168774966;258168775589;623;4;1;2;1;1;1
258168775589;258168816211;40622;-1;0;-1;0;1;1
258168816211;258168816815;604;4;1;2;1;1;1
258168816815;258168919330;102515;-1;0;-1;0;1;1
258168919330;258168919955;625;4;1;2;1;1;1
258168919955;258168999426;79471;-1;0;-1;0;1;1
258168999426;258169000385;959;4;1;2;1;1;1
258169000385;258169163455;163070;-1;0;-1;0;1;1
258169163455;258169164088;633;4;1;2;1;1;1
258169164088;258169213627;49539;-1;0;-1;0;1;1
258169213627;258169214292;665;4;1;2;1;1;1
258169214292;258169293083;78791;-1;0;-1;0;1;1
258169293083;258169293630;547;4;1;2;1;1;1
258169293630;258169368906;75276;-1;0;-1;0;1;1
258169368906;258169369450;544;4;1;2;1;1;1
258169369450;258169411055;41605;-1;0;-1;0;1;1
258169411055;258169411659;604;4;1;2;1;1;1
258169411659;258169472831;61172;-1;0;-1;0;1;1
258169472831;258169473502;671;4;1;2;1;1;1
258169473502;258169624463;150961;-1;0;-1;0;1;1
258169624463;258169625191;728;4;1;2;1;1;1
258169625191;258169697357;72166;-1;0;-1;0;1;1
258169697357;258169697910;553;4;1;2;1;1;1
258169697910;258169731856;33946;-1;0;-1;0;1;1
258169731856;258169732421;565;4;1;2;1;1;1
258169732421;258169818263;85842;-1;0;-1;0;1;1
258169818263;258169818814;551;4;1;2;1;1;1
258169818814;258169863441;44627;-1;0;-1;0;1;1
258169863441;258169863995;554;4;1;2;1;1;1
258169863995;258170049455;185460;-1;0;-1;0;1;1
258170049455;258170050409;954;4;1;2;1;1;1
258170050409;258170143824;93415;-1;0;-1;0;1;1
258170143824;258170144285;461;4;1;2;1;1;1
258170144285;258170175840;31555;-1;0;-1;0;1;1
258170175840;258170176496;656;4;1;2;1;1;1
258170176496;258170314981;138485;-1;0;-1;0;1;1
258170314981;258170315616;635;4;1;2;1;1;1
258170315616;258170316287;671;-1;0;-1;0;1;1
258170316287;258170317179;892;4;1;2;1;1;1
258170317179;258170386844;69665;-1;0;-1;0;1;1
258170386844;258170387396;552;4;1;2;1;1;1
258170387396;258170505870;118474;-1;0;-1;0;1;1
258170505870;258170506711;841;4;1;2;1;1;1
258170506711;258170649948;143237;-1;0;-1;0;1;1
258170649948;258170650504;556;4;1;2;1;1;1
258170650504;258170734604;84100;-1;0;-1;0;1;1
258170734604;258170735174;570;4;1;2;1;1;1
258170735174;258170845235;110061;-1;0;-1;0;1;1
258170845235;258170845877;642;4;1;2;1;1;1
258170845877;258170915463;69586;-1;0;-1;0;1;1
258170915463;258170916022;559;4;1;2;1;1;1
258170916022;258171100917;184895;-1;0;-1;0;1;1
258171100917;258171101559;642;4;1;2;1;1;1
258171101559;258171308538;206979;-1;0;-1;0;1;1
258171308538;258171309113;575;4;1;2;1;1;1
258171309113;258171389201;80088;-1;0;-1;0;1;1
258171389201;258171389842;641;4;1;2;1;1;1
258171389842;258171436117;46275;-1;0;-1;0;1;1
258171436117;258171436880;763;4;1;2;1;1;1
258171436880;258171561496;124616;-1;0;-1;0;1;1
258171561496;258171562056;560;4;1;2;1;1;1
258171562056;258171606355;44299;-1;0;-1;0;1;1
258171606355;258171607030;675;4;1;2;1;1;1
258171607030;258171720781;113751;-1;0;-1;0;1;1
258171720781;258171721407;626;4;1;2;1;1;1
258171721407;258171763159;41752;-1;0;-1;0;1;1
258171763159;258171763809;650;4;1;2;1;1;1
258171763809;258171946890;183081;-1;0;-1;0;1;1
258171946890;258171947517;627;4;1;2;1;1;1
258171947517;258171983640;36123;-1;0;-1;0;1;1
258171983640;258171984345;705;4;1;2;1;1;1
258171984345;258172099028;114683;-1;0;-1;0;1;1
258172099028;258172099598;570;4;1;2;1;1;1
258172099598;258172146537;46939;-1;0;-1;0;1;1
258172146537;258172147092;555;4;1;2;1;1;1
258172147092;258172186507;39415;-1;0;-1;0;1;1
258172186507;258172187586;1079;4;1;2;1;1;1
258172187586;258172236163;48577;-1;0;-1;0;1;1
258172236163;258172236720;557;4;1;2;1;1;1
258172236720;258172274587;37867;-1;0;-1;0;1;1
258172274587;258172275231;644;4;1;2;1;1;1
258172275231;258172356248;81017;-1;0;-1;0;1;1
258172356248;258172356885;637;4;1;2;1;1;1
258172356885;258172381622;24737;-1;0;-1;0;1;1
258172381622;258172382225;603;4;1;2;1;1;1
258172382225;258172434442;52217;-1;0;-1;0;1;1
258172434442;258172435087;645;4;1;2;1;1;1
258172435087;258173752020;1316933;-1;0;-1;0;1;1
258173752020;258173752580;560;4;1;2;1;1;1
258173752580;258173813864;61284;-1;0;-1;0;1;1
258173813864;258173814491;627;4;1;2;1;1;1
258173814491;258173865303;50812;-1;0;-1;0;1;1
258173865303;258173865954;651;4;1;2;1;1;1
258173865954;258173906547;40593;-1;0;-1;0;1;1
258173906547;258173907096;549;4;1;2;1;1;1
258173907096;258173981944;74848;-1;0;-1;0;1;1
258173981944;258173982506;562;4;1;2;1;1;1
258173982506;258174041580;59074;-1;0;-1;0;1;1
258174041580;258174043095;1515;4;1;2;1;1;1
258174043095;258174043096;1;-1;0;-1;0;1;1
258174043096;258174043652;556;4;1;2;1;1;1
258174043652;258174043680;28;-1;0;-1;0;1;1
258174043680;258174044421;741;4;1;2;1;1;1
258174044421;258174086025;41604;-1;0;-1;0;1;1
258174086025;258174086574;549;4;1;2;1;1;1
258174086574;258174141740;55166;-1;0;-1;0;1;1
258174141740;258174142388;648;4;1;2;1;1;1
258174142388;258174176490;34102;-1;0;-1;0;1;1
258174176490;258174178951;2461;4;1;2;1;1;1
258174178951;258174284062;105111;-1;0;-1;0;1;1
258174284062;258174284671;609;4;1;2;1;1;1
258174284671;258174297671;13000;-1;0;-1;0;1;1
258174297671;258174298297;626;4;1;2;1;1;1
258174298297;258174343931;45634;-1;0;-1;0;1;1
258174343931;258174344497;566;4;1;2;1;1;1
258174344497;258174440274;95777;-1;0;-1;0;1;1
258174440274;258174483905;43631;4;1;2;1;1;1
258174483905;258174508456;24551;-1;0;-1;0;1;1
258174508456;258174509220;764;4;1;2;1;1;1
258174509220;258174615549;106329;-1;0;-1;0;1;1
258174615549;258174616194;645;4;1;2;1;1;1
258174616194;258174725641;109447;-1;0;-1;0;1;1
258174725641;258174727065;1424;4;1;2;1;1;1
258174727065;258174804078;77013;-1;0;-1;0;1;1
258174804078;258174804694;616;4;1;2;1;1;1
258174804694;258174853334;48640;-1;0;-1;0;1;1
258174853334;258174853906;572;4;1;2;1;1;1
258174853906;258174936820;82914;-1;0;-1;0;1;1
258174936820;258174938592;1772;4;1;2;1;1;1
258174938592;258175013127;74535;-1;0;-1;0;1;1
258175013127;258175013462;335;4;1;2;1;1;1
258175013462;258175013869;407;4;1;2;1;1;1
258175013869;258175014110;241;4;1;2;1;1;1
258175014110;258175091629;77519;-1;0;-1;0;1;1
258175091629;258175092526;897;4;1;2;1;1;1
258175092526;258175094075;1549;-1;0;-1;0;1;1
258175094075;258175095420;1345;4;1;2;1;1;1
258175095420;258175128623;33203;-1;0;-1;0;1;1
258175128623;258175133637;5014;4;1;2;1;1;1
258175133637;258175139596;5959;-1;0;-1;0;1;1
258175139596;258175140245;649;4;1;2;1;1;1
258175140245;258175252038;111793;-1;0;-1;0;1;1
258175252038;258175252731;693;4;1;2;1;1;1
258175252731;258175532996;280265;-1;0;-1;0;1;1
258175532996;258175533628;632;4;1;2;1;1;1
258175533628;258175599570;65942;-1;0;-1;0;1;1
258175599570;258175600142;572;4;1;2;1;1;1
258175600142;258175699567;99425;-1;0;-1;0;1;1
258175699567;258175700358;791;4;1;2;1;1;1
258175700358;258175756176;55818;-1;0;-1;0;1;1
258175756176;258175756865;689;4;1;2;1;1;1
258175756865;258175821938;65073;-1;0;-1;0;1;1
258175821938;258175822943;1005;4;1;2;1;1;1
258175822943;258175823056;113;4;1;2;1;1;1
258175823056;258175824465;1409;4;1;2;1;1;1
258175824465;258175909611;85146;-1;0;-1;0;1;1
258175909611;258175910266;655;4;1;2;1;1;1
258175910266;258175960836;50570;-1;0;-1;0;1;1
258175960836;258175961892;1056;4;1;2;1;1;1
258175961892;258176006870;44978;-1;0;-1;0;1;1
258176006870;258176007868;998;4;1;2;1;1;1
258176007868;258176073367;65499;-1;0;-1;0;1;1
258176073367;258176073925;558;4;1;2;1;1;1
258176073925;258176217349;143424;-1;0;-1;0;1;1
258176217349;258176217915;566;4;1;2;1;1;1
258176217915;258176234692;16777;-1;0;-1;0;1;1
258176234692;258176235268;576;4;1;2;1;1;1
258176235268;258176272734;37466;-1;0;-1;0;1;1
258176272734;258176273452;718;4;1;2;1;1;1
258176273452;258176312529;39077;-1;0;-1;0;1;1
258176312529;258176313095;566;4;1;2;1;1;1
258176313095;258176351777;38682;-1;0;-1;0;1;1
258176351777;258176352390;613;4;1;2;1;1;1
258176352390;258176426298;73908;-1;0;-1;0;1;1
258176426298;258176426961;663;4;1;2;1;1;1
258176426961;258176478719;51758;-1;0;-1;0;1;1
258176478719;258176479359;640;4;1;2;1;1;1
258176479359;258176547932;68573;-1;0;-1;0;1;1
258176547932;258176548508;576;4;1;2;1;1;1
258176548508;258176584150;35642;-1;0;-1;0;1;1
258176584150;258176584787;637;4;1;2;1;1;1
258176584787;258176629017;44230;-1;0;-1;0;1;1
258176629017;258176629680;663;4;1;2;1;1;1
258176629680;258176692131;62451;-1;0;-1;0;1;1
258176692131;258176692768;637;4;1;2;1;1;1
258176692768;258176764667;71899;-1;0;-1;0;1;1
258176764667;258176765319;652;4;1;2;1;1;1
258176765319;258176879597;114278;-1;0;-1;0;1;1
258176879597;258176880166;569;4;1;2;1;1;1
258176880166;258176931274;51108;-1;0;-1;0;1;1
258176931274;258176931825;551;4;1;2;1;1;1
258176931825;258177004431;72606;-1;0;-1;0;1;1
258177004431;258177005065;634;4;1;2;1;1;1
258177005065;258177079881;74816;-1;0;-1;0;1;1
258177079881;258177080529;648;4;1;2;1;1;1
258177080529;258177126162;45633;-1;0;-1;0;1;1
258177126162;258177126714;552;4;1;2;1;1;1
258177126714;258177213064;86350;-1;0;-1;0;1;1
258177213064;258177213702;638;4;1;2;1;1;1
258177213702;258177257151;43449;-1;0;-1;0;1;1
258177257151;258177257649;498;4;1;2;1;1;1
258177257649;258177569821;312172;-1;0;-1;0;1;1
258177569821;258177570499;678;4;1;2;1;1;1
258177570499;258177645042;74543;-1;0;-1;0;1;1
258177645042;258177645520;478;4;1;2;1;1;1
258177645520;258177723895;78375;-1;0;-1;0;1;1
258177723895;258177725002;1107;4;1;2;1;1;1
258177725002;258177769247;44245;-1;0;-1;0;1;1
258177769247;258177769897;650;4;1;2;1;1;1
258177769897;258177812849;42952;-1;0;-1;0;1;1
258177812849;258177813406;557;4;1;2;1;1;1
258177813406;258177848186;34780;-1;0;-1;0;1;1
258177848186;258177848667;481;4;1;2;1;1;1
258177848667;258177927866;79199;-1;0;-1;0;1;1
258177927866;258177928396;530;4;1;2;1;1;1
258177928396;258177998765;70369;-1;0;-1;0;1;1
258177998765;258177999415;650;4;1;2;1;1;1
258177999415;258178128747;129332;-1;0;-1;0;1;1
258178128747;258178129486;739;4;1;2;1;1;1
258178129486;258178190606;61120;-1;0;-1;0;1;1
258178190606;258178191130;524;4;1;2;1;1;1
258178191130;258178278035;86905;-1;0;-1;0;1;1
258178278035;258178278894;859;4;1;2;1;1;1
258178278894;258178279451;557;-1;0;-1;0;1;1
258178279451;258178280201;750;4;1;2;1;1;1
258178280201;258178346910;66709;-1;0;-1;0;1;1
258178346910;258178347382;472;4;1;2;1;1;1
258178347382;258178397234;49852;-1;0;-1;0;1;1
258178397234;258178398039;805;4;1;2;1;1;1
258178398039;258178458977;60938;-1;0;-1;0;1;1
258178458977;258178459866;889;4;1;2;1;1;1
258178459866;258178542056;82190;-1;0;-1;0;1;1
258178542056;258178542605;549;4;1;2;1;1;1
258178542605;258178604331;61726;-1;0;-1;0;1;1
258178604331;258178604985;654;4;1;2;1;1;1
258178604985;258178605530;545;-1;0;-1;0;1;1
258178605530;258178606355;825;4;1;2;1;1;1
258178606355;258178694179;87824;-1;0;-1;0;1;1
258178694179;258178694740;561;4;1;2;1;1;1
258178694740;258178694741;1;4;1;2;1;1;1
258178694741;258178695667;926;4;1;2;1;1;1
258178695667;258178767172;71505;-1;0;-1;0;1;1
258178767172;258178767737;565;4;1;2;1;1;1
258178767737;258178768447;710;-1;0;-1;0;1;1
258178768447;258178769016;569;4;1;2;1;1;1
258178769016;258178837977;68961;-1;0;-1;0;1;1
258178837977;258178838528;551;4;1;2;1;1;1
258178838528;258178923320;84792;-1;0;-1;0;1;1
258178923320;258178923983;663;4;1;2;1;1;1
258178923983;258178924938;955;-1;0;-1;0;1;1
258178924938;258178925484;546;4;1;2;1;1;1
258178925484;258178964866;39382;-1;0;-1;0;1;1
258178964866;258178965361;495;4;1;2;1;1;1
258178965361;258179022624;57263;-1;0;-1;0;1;1
258179022624;258179023175;551;4;1;2;1;1;1
258179023175;258179092151;68976;-1;0;-1;0;1;1
258179092151;258179092709;558;4;1;2;1;1;1
258179092709;258179136692;43983;-1;0;-1;0;1;1
258179136692;258179137234;542;4;1;2;1;1;1
258179137234;258179207827;70593;-1;0;-1;0;1;1
258179207827;258179208506;679;4;1;2;1;1;1
258179208506;258179238556;30050;-1;0;-1;0;1;1
258179238556;258179239103;547;4;1;2;1;1;1
258179239103;258179305680;66577;-1;0;-1;0;1;1
258179305680;258179306312;632;4;1;2;1;1;1
258179306312;258179351347;45035;-1;0;-1;0;1;1
258179351347;258179352371;1024;4;1;2;1;1;1
258179352371;258179388140;35769;-1;0;-1;0;1;1
258179388140;258179388609;469;4;1;2;1;1;1
258179388609;258179465297;76688;-1;0;-1;0;1;1
258179465297;258179465818;521;4;1;2;1;1;1
258179465818;258179536583;70765;-1;0;-1;0;1;1
258179536583;258179537119;536;4;1;2;1;1;1
258179537119;258179582061;44942;-1;0;-1;0;1;1
258179582061;258179582700;639;4;1;2;1;1;1
258179582700;258179656026;73326;-1;0;-1;0;1;1
258179656026;258179656664;638;4;1;2;1;1;1
258179656664;258179706025;49361;-1;0;-1;0;1;1
258179706025;258179706507;482;4;1;2;1;1;1
258179706507;258179707148;641;-1;0;-1;0;1;1
258179707148;258179707796;648;4;1;2;1;1;1
258179707796;258179740096;32300;-1;0;-1;0;1;1
258179740096;258179740570;474;4;1;2;1;1;1
258179740570;258179822382;81812;-1;0;-1;0;1;1
258179822382;258179822995;613;4;1;2;1;1;1
258179822995;258179823365;370;-1;0;-1;0;1;1
258179823365;258179824022;657;4;1;2;1;1;1
258179824022;258179886050;62028;-1;0;-1;0;1;1
258179886050;258179886656;606;4;1;2;1;1;1
258179886656;258179887242;586;-1;0;-1;0;1;1
258179887242;258179887793;551;4;1;2;1;1;1
258179887793;258179951340;63547;-1;0;-1;0;1;1
258179951340;258179951959;619;4;1;2;1;1;1
258179951959;258179989989;38030;-1;0;-1;0;1;1
258179989989;258179990602;613;4;1;2;1;1;1
258179990602;258180069196;78594;-1;0;-1;0;1;1
258180069196;258180069760;564;4;1;2;1;1;1
258180069760;258180142636;72876;-1;0;-1;0;1;1
258180142636;258180143193;557;4;1;2;1;1;1
258180143193;258180174586;31393;-1;0;-1;0;1;1
258180174586;258180175044;458;4;1;2;1;1;1
258180175044;258180236827;61783;-1;0;-1;0;1;1
258180236827;258180237374;547;4;1;2;1;1;1
258180237374;258180308941;71567;-1;0;-1;0;1;1
258180308941;258180309492;551;4;1;2;1;1;1
258180309492;258180385635;76143;-1;0;-1;0;1;1
258180385635;258180386098;463;4;1;2;1;1;1
258180386098;258180445200;59102;-1;0;-1;0;1;1
258180445200;258180445713;513;4;1;2;1;1;1
258180445713;258180511863;66150;-1;0;-1;0;1;1
258180511863;258180512385;522;4;1;2;1;1;1
258180512385;258180589443;77058;-1;0;-1;0;1;1
258180589443;258180589905;462;4;1;2;1;1;1
258180589905;258180661202;71297;-1;0;-1;0;1;1
258180661202;258180661736;534;4;1;2;1;1;1
258180661736;258180705315;43579;-1;0;-1;0;1;1
258180705315;258180705862;547;4;1;2;1;1;1
258180705862;258180753153;47291;-1;0;-1;0;1;1
258180753153;258180753747;594;4;1;2;1;1;1
258180753747;258180799611;45864;-1;0;-1;0;1;1
258180799611;258180800109;498;4;1;2;1;1;1
258180800109;258180839301;39192;-1;0;-1;0;1;1
258180839301;258180839857;556;4;1;2;1;1;1
258180839857;258180906768;66911;-1;0;-1;0;1;1
258180906768;258180907318;550;4;1;2;1;1;1
258180907318;258180981443;74125;-1;0;-1;0;1;1
258180981443;258180981920;477;4;1;2;1;1;1
258180981920;258181060147;78227;-1;0;-1;0;1;1
258181060147;258181060701;554;4;1;2;1;1;1
258181060701;258181128884;68183;-1;0;-1;0;1;1
258181128884;258181129302;418;4;1;2;1;1;1
258181129302;258181129644;342;4;1;2;1;1;1
258181129644;258181130001;357;4;1;2;1;1;1
258181130001;258181219676;89675;-1;0;-1;0;1;1
258181219676;258181221597;1921;4;1;2;1;1;1
258181221597;258181221833;236;4;1;2;1;1;1
258181221833;258181223922;2089;4;1;2;1;1;1
258181223922;258181224407;485;-1;0;-1;0;1;1
258181224407;258181224493;86;4;1;2;1;1;1
258181224493;258181226041;1548;4;1;2;1;1;1
258181226041;258181226999;958;4;1;2;1;1;1
258181226999;258181228172;1173;-1;0;-1;0;1;1
258181228172;258181229096;924;4;1;2;1;1;1
258181229096;258181229151;55;4;1;2;1;1;1
258181229151;258181229907;756;4;1;2;1;1;1
258181229907;258181291623;61716;-1;0;-1;0;1;1
258181291623;258181292115;492;4;1;2;1;1;1
258181292115;258181362930;70815;-1;0;-1;0;1;1
258181362930;258181363541;611;4;1;2;1;1;1
258181363541;258181456080;92539;-1;0;-1;0;1;1
258181456080;258181457037;957;4;1;2;1;1;1
258181457037;258181459280;2243;-1;0;-1;0;1;1
258181459280;258181459938;658;4;1;2;1;1;1
258181459938;258181503885;43947;-1;0;-1;0;1;1
258181503885;258181504432;547;4;1;2;1;1;1
258181504432;258181567861;63429;-1;0;-1;0;1;1
258181567861;258181568482;621;4;1;2;1;1;1
258181568482;258181568607;125;-1;0;-1;0;1;1
258181568607;258181569243;636;4;1;2;1;1;1
258181569243;258181651835;82592;-1;0;-1;0;1;1
258181651835;258181652386;551;4;1;2;1;1;1
258181652386;258181699338;46952;-1;0;-1;0;1;1
258181699338;258181700393;1055;4;1;2;1;1;1
258181700393;258181734580;34187;-1;0;-1;0;1;1
258181734580;258181736178;1598;4;1;2;1;1;1
258181736178;258181808487;72309;-1;0;-1;0;1;1
258181808487;258181808960;473;4;1;2;1;1;1
258181808960;258181854564;45604;-1;0;-1;0;1;1
258181854564;258181855083;519;4;1;2;1;1;1
258181855083;258181922411;67328;-1;0;-1;0;1;1
258181922411;258181922419;8;4;1;2;1;1;1
258181922419;258181923119;700;4;1;2;1;1;1
258181923119;258181923421;302;4;1;2;1;1;1
258181923421;258181963436;40015;-1;0;-1;0;1;1
258181963436;258181964079;643;4;1;2;1;1;1
258181964079;258182038839;74760;-1;0;-1;0;1;1
258182038839;258182039456;617;4;1;2;1;1;1
258182039456;258182117909;78453;-1;0;-1;0;1;1
258182117909;258182118368;459;4;1;2;1;1;1
258182118368;258182189774;71406;-1;0;-1;0;1;1
258182189774;258182190317;543;4;1;2;1;1;1
258182190317;258182239757;49440;-1;0;-1;0;1;1
258182239757;258182240333;576;4;1;2;1;1;1
258182240333;258182310143;69810;-1;0;-1;0;1;1
258182310143;258182310799;656;4;1;2;1;1;1
258182310799;258182392772;81973;-1;0;-1;0;1;1
258182392772;258182393422;650;4;1;2;1;1;1
258182393422;258182435017;41595;-1;0;-1;0;1;1
258182435017;258182435657;640;4;1;2;1;1;1
258182435657;258182501543;65886;-1;0;-1;0;1;1
258182501543;258182502053;510;4;1;2;1;1;1
258182502053;258182502965;912;4;1;2;1;1;1
258182502965;258182503722;757;4;1;2;1;1;1
258182503722;258182504624;902;-1;0;-1;0;1;1
258182504624;258182504995;371;4;1;2;1;1;1
258182504995;258182505229;234;4;1;2;1;1;1
258182505229;258182505690;461;4;1;2;1;1;1
258182505690;258182579323;73633;-1;0;-1;0;1;1
258182579323;258182579983;660;4;1;2;1;1;1
258182579983;258182616541;36558;-1;0;-1;0;1;1
258182616541;258182617183;642;4;1;2;1;1;1
258182617183;258182659031;41848;-1;0;-1;0;1;1
258182659031;258182659578;547;4;1;2;1;1;1
258182659578;258182694119;34541;-1;0;-1;0;1;1
258182694119;258182694745;626;4;1;2;1;1;1
258182694745;258182729118;34373;-1;0;-1;0;1;1
258182729118;258182729664;546;4;1;2;1;1;1
258182729664;258182781047;51383;-1;0;-1;0;1;1
258182781047;258182781658;611;4;1;2;1;1;1
258182781658;258182782337;679;-1;0;-1;0;1;1
258182782337;258182782897;560;4;1;2;1;1;1
258182782897;258182878459;95562;-1;0;-1;0;1;1
258182878459;258182879026;567;4;1;2;1;1;1
258182879026;258182965266;86240;-1;0;-1;0;1;1
258182965266;258182965768;502;4;1;2;1;1;1
258182965768;258183005437;39669;-1;0;-1;0;1;1
258183005437;258183006054;617;4;1;2;1;1;1
258183006054;258183076821;70767;-1;0;-1;0;1;1
258183076821;258183077375;554;4;1;2;1;1;1
258183077375;258183114769;37394;-1;0;-1;0;1;1
258183114769;258183115312;543;4;1;2;1;1;1
258183115312;258183185070;69758;-1;0;-1;0;1;1
258183185070;258183185625;555;4;1;2;1;1;1
258183185625;258183234125;48500;-1;0;-1;0;1;1
258183234125;258183234650;525;4;1;2;1;1;1
258183234650;258183313174;78524;-1;0;-1;0;1;1
258183313174;258183313650;476;4;1;2;1;1;1
258183313650;258183383073;69423;-1;0;-1;0;1;1
258183383073;258183383960;887;4;1;2;1;1;1
258183383960;258183420879;36919;-1;0;-1;0;1;1
258183420879;258183421432;553;4;1;2;1;1;1
258183421432;258183421662;230;-1;0;-1;0;1;1
258183421662;258183422248;586;4;1;2;1;1;1
258183422248;258183500936;78688;-1;0;-1;0;1;1
258183500936;258183501416;480;4;1;2;1;1;1
258183501416;258183547720;46304;-1;0;-1;0;1;1
258183547720;258183548298;578;4;1;2;1;1;1
258183548298;258183813381;265083;-1;0;-1;0;1;1
258183813381;258183814940;1559;4;1;2;1;1;1
258183814940;258183818333;3393;-1;0;-1;0;1;1
258183818333;258183819070;737;4;1;2;1;1;1
258183819070;258183819140;70;-1;0;-1;0;1;1
258183819140;258183819796;656;4;1;2;1;1;1
258183819796;258183819908;112;-1;0;-1;0;1;1
258183819908;258183820653;745;4;1;2;1;1;1
258183820653;258183921890;101237;-1;0;-1;0;1;1
258183921890;258183922448;558;4;1;2;1;1;1
258183922448;258183978439;55991;-1;0;-1;0;1;1
258183978439;258183979062;623;4;1;2;1;1;1
258183979062;258183979618;556;-1;0;-1;0;1;1
258183979618;258183980233;615;4;1;2;1;1;1
258183980233;258184048173;67940;-1;0;-1;0;1;1
258184048173;258184048686;513;4;1;2;1;1;1
258184048686;258184150311;101625;-1;0;-1;0;1;1
258184150311;258184151379;1068;4;1;2;1;1;1
258184151379;258184152445;1066;-1;0;-1;0;1;1
258184152445;258184153204;759;4;1;2;1;1;1
258184153204;258184243456;90252;-1;0;-1;0;1;1
258184243456;258184244093;637;4;1;2;1;1;1
258184244093;258184348020;103927;-1;0;-1;0;1;1
258184348020;258184348677;657;4;1;2;1;1;1
258184348677;258184388826;40149;-1;0;-1;0;1;1
258184388826;258184389456;630;4;1;2;1;1;1
258184389456;258184501272;111816;-1;0;-1;0;1;1
258184501272;258184502090;818;4;1;2;1;1;1
258184502090;258184556568;54478;-1;0;-1;0;1;1
258184556568;258184557894;1326;4;1;2;1;1;1
258184557894;258184558581;687;-1;0;-1;0;1;1
258184558581;258184559338;757;4;1;2;1;1;1
258184559338;258184559415;77;-1;0;-1;0;1;1
258184559415;258184560167;752;4;1;2;1;1;1
258184560167;258184560274;107;4;1;2;1;1;1
258184560274;258184560902;628;4;1;2;1;1;1
258184560902;258184561813;911;-1;0;-1;0;1;1
258184561813;258184562362;549;4;1;2;1;1;1
258184562362;258184625525;63163;-1;0;-1;0;1;1
258184625525;258184626077;552;4;1;2;1;1;1
258184626077;258184689623;63546;-1;0;-1;0;1;1
258184689623;258184691043;1420;4;1;2;1;1;1
258184691043;258184726963;35920;-1;0;-1;0;1;1
258184726963;258184727514;551;4;1;2;1;1;1
258184727514;258184757722;30208;-1;0;-1;0;1;1
258184757722;258184758358;636;4;1;2;1;1;1
258184758358;258184832909;74551;-1;0;-1;0;1;1
258184832909;258184835236;2327;4;1;2;1;1;1
258184835236;258184836510;1274;-1;0;-1;0;1;1
258184836510;258184837099;589;4;1;2;1;1;1
258184837099;258184837171;72;4;1;2;1;1;1
258184837171;258184837996;825;4;1;2;1;1;1
258184837996;258184884935;46939;-1;0;-1;0;1;1
258184884935;258184885566;631;4;1;2;1;1;1
258184885566;258184962650;77084;-1;0;-1;0;1;1
258184962650;258184963691;1041;4;1;2;1;1;1
258184963691;258185064759;101068;-1;0;-1;0;1;1
258185064759;258185065365;606;4;1;2;1;1;1
258185065365;258185149134;83769;-1;0;-1;0;1;1
258185149134;258185149781;647;4;1;2;1;1;1
258185149781;258185149868;87;-1;0;-1;0;1;1
258185149868;258185150608;740;4;1;2;1;1;1
258185150608;258185216638;66030;-1;0;-1;0;1;1
258185216638;258185217470;832;4;1;2;1;1;1
258185217470;258185219230;1760;-1;0;-1;0;1;1
258185219230;258185219801;571;4;1;2;1;1;1
258185219801;258185295880;76079;-1;0;-1;0;1;1
258185295880;258185296515;635;4;1;2;1;1;1
258185296515;258185355005;58490;-1;0;-1;0;1;1
258185355005;258185355635;630;4;1;2;1;1;1
258185355635;258185425349;69714;-1;0;-1;0;1;1
258185425349;258185425990;641;4;1;2;1;1;1
258185425990;258185472509;46519;-1;0;-1;0;1;1
258185472509;258185473153;644;4;1;2;1;1;1
258185473153;258185549090;75937;-1;0;-1;0;1;1
258185549090;258185549734;644;4;1;2;1;1;1
258185549734;258185624546;74812;-1;0;-1;0;1;1
258185624546;258185625177;631;4;1;2;1;1;1
258185625177;258185715000;89823;-1;0;-1;0;1;1
258185715000;258185716097;1097;4;1;2;1;1;1
258185716097;258185718243;2146;-1;0;-1;0;1;1
258185718243;258185718522;279;4;1;2;1;1;1
258185718522;258185719007;485;4;1;2;1;1;1
258185719007;258185719237;230;4;1;2;1;1;1
258185719237;258185777233;57996;-1;0;-1;0;1;1
258185777233;258185777869;636;4;1;2;1;1;1
258185777869;258185859686;81817;-1;0;-1;0;1;1
258185859686;258185860243;557;4;1;2;1;1;1
258185860243;258185937828;77585;-1;0;-1;0;1;1
258185937828;258185938252;424;4;1;2;1;1;1
258185938252;258185938501;249;4;1;2;1;1;1
258185938501;258185938932;431;4;1;2;1;1;1
258185938932;258186012196;73264;-1;0;-1;0;1;1
258186012196;258186012838;642;4;1;2;1;1;1
258186012838;258186069555;56717;-1;0;-1;0;1;1
258186069555;258186070196;641;4;1;2;1;1;1
258186070196;258186114867;44671;-1;0;-1;0;1;1
258186114867;258186115471;604;4;1;2;1;1;1
258186115471;258186158581;43110;-1;0;-1;0;1;1
258186158581;258186160164;1583;4;1;2;1;1;1
258186160164;258186161122;958;-1;0;-1;0;1;1
258186161122;258186161470;348;4;1;2;1;1;1
258186161470;258186161775;305;4;1;2;1;1;1
258186161775;258186162237;462;4;1;2;1;1;1
258186162237;258186247190;84953;-1;0;-1;0;1;1
258186247190;258186247841;651;4;1;2;1;1;1
258186247841;258186248403;562;-1;0;-1;0;1;1
258186248403;258186249036;633;4;1;2;1;1;1
258186249036;258186308125;59089;-1;0;-1;0;1;1
258186308125;258186308614;489;4;1;2;1;1;1
258186308614;258186353424;44810;-1;0;-1;0;1;1
258186353424;258186353958;534;4;1;2;1;1;1
258186353958;258186399690;45732;-1;0;-1;0;1;1
258186399690;258186400250;560;4;1;2;1;1;1
258186400250;258186446636;46386;-1;0;-1;0;1;1
258186446636;258186447163;527;4;1;2;1;1;1
258186447163;258186509368;62205;-1;0;-1;0;1;1
258186509368;258186510024;656;4;1;2;1;1;1
258186510024;258186590449;80425;-1;0;-1;0;1;1
258186590449;258186591060;611;4;1;2;1;1;1
258186591060;258186591707;647;-1;0;-1;0;1;1
258186591707;258186592380;673;4;1;2;1;1;1
258186592380;258186668109;75729;-1;0;-1;0;1;1
258186668109;258186668748;639;4;1;2;1;1;1
258186668748;258186738067;69319;-1;0;-1;0;1;1
258186738067;258186738705;638;4;1;2;1;1;1
258186738705;258186808960;70255;-1;0;-1;0;1;1
258186808960;258186809604;644;4;1;2;1;1;1
258186809604;258186869340;59736;-1;0;-1;0;1;1
258186869340;258186869999;659;4;1;2;1;1;1
258186869999;258186945558;75559;-1;0;-1;0;1;1
258186945558;258186946187;629;4;1;2;1;1;1
258186946187;258186990056;43869;-1;0;-1;0;1;1
258186990056;258186990614;558;4;1;2;1;1;1
258186990614;258187040936;50322;-1;0;-1;0;1;1
258187040936;258187041537;601;4;1;2;1;1;1
258187041537;258187139169;97632;-1;0;-1;0;1;1
258187139169;258187139790;621;4;1;2;1;1;1
258187139790;258187222092;82302;-1;0;-1;0;1;1
258187222092;258187222603;511;4;1;2;1;1;1
258187222603;258187222805;202;4;1;2;1;1;1
258187222805;258187223244;439;4;1;2;1;1;1
258187223244;258187255417;32173;-1;0;-1;0;1;1
258187255417;258187256067;650;4;1;2;1;1;1
258187256067;258187334760;78693;-1;0;-1;0;1;1
258187334760;258187336583;1823;4;1;2;1;1;1
258187336583;258187337822;1239;-1;0;-1;0;1;1
258187337822;258187337846;24;4;1;2;1;1;1
258187337846;258187338674;828;4;1;2;1;1;1
258187338674;258187338686;12;4;1;2;1;1;1
258187338686;258187401157;62471;-1;0;-1;0;1;1
258187401157;258187401839;682;4;1;2;1;1;1
258187401839;258187445018;43179;-1;0;-1;0;1;1
258187445018;258187445646;628;4;1;2;1;1;1
258187445646;258187564188;118542;-1;0;-1;0;1;1
258187564188;258187564730;542;4;1;2;1;1;1
258187564730;258187645779;81049;-1;0;-1;0;1;1
258187645779;258187646621;842;4;1;2;1;1;1
258187646621;258187646805;184;-1;0;-1;0;1;1
258187646805;258187699781;52976;4;1;2;1;1;1
258187699781;258187701061;1280;-1;0;-1;0;1;1
258187701061;258187701516;455;4;1;2;1;1;1
258187701516;258187735683;34167;-1;0;-1;0;1;1
258187735683;258187736319;636;4;1;2;1;1;1
258187736319;258187801841;65522;-1;0;-1;0;1;1
258187801841;258187802441;600;4;1;2;1;1;1
258187802441;258187876850;74409;-1;0;-1;0;1;1
258187876850;258187877404;554;4;1;2;1;1;1
258187877404;258187960349;82945;-1;0;-1;0;1;1
258187960349;258187960972;623;4;1;2;1;1;1
258187960972;258188039669;78697;-1;0;-1;0;1;1
258188039669;258188040276;607;4;1;2;1;1;1
258188040276;258188082138;41862;-1;0;-1;0;1;1
258188082138;258188082783;645;4;1;2;1;1;1
258188082783;258188157301;74518;-1;0;-1;0;1;1
258188157301;258188157845;544;4;1;2;1;1;1
258188157845;258188201155;43310;-1;0;-1;0;1;1
258188201155;258188201702;547;4;1;2;1;1;1
258188201702;258188276956;75254;-1;0;-1;0;1;1
258188276956;258188277556;600;4;1;2;1;1;1
258188277556;258188278232;676;-1;0;-1;0;1;1
258188278232;258188278860;628;4;1;2;1;1;1
258188278860;258188357607;78747;-1;0;-1;0;1;1
258188357607;258188358236;629;4;1;2;1;1;1
258188358236;258188478307;120071;-1;0;-1;0;1;1
258188478307;258188478943;636;4;1;2;1;1;1
258188478943;258188553992;75049;-1;0;-1;0;1;1
258188553992;258188554542;550;4;1;2;1;1;1
258188554542;258188628048;73506;-1;0;-1;0;1;1
258188628048;258188628596;548;4;1;2;1;1;1
258188628596;258188672297;43701;-1;0;-1;0;1;1
258188672297;258188672929;632;4;1;2;1;1;1
258188672929;258188683107;10178;-1;0;-1;0;1;1
258188683107;258188683655;548;4;1;2;1;1;1
258188683655;258188684670;1015;-1;0;-1;0;1;1
258188684670;258188685309;639;4;1;2;1;1;1
258188685309;258188721586;36277;-1;0;-1;0;1;1
258188721586;258188722132;546;4;1;2;1;1;1
258188722132;258188811369;89237;-1;0;-1;0;1;1
258188811369;258188812090;721;4;1;2;1;1;1
258188812090;258188855953;43863;-1;0;-1;0;1;1
258188855953;258188856592;639;4;1;2;1;1;1
258188856592;258188975046;118454;-1;0;-1;0;1;1
258188975046;258188975859;813;4;1;2;1;1;1
258188975859;258189004926;29067;-1;0;-1;0;1;1
258189004926;258189005391;465;4;1;2;1;1;1
258189005391;258189047943;42552;-1;0;-1;0;1;1
258189047943;258189048430;487;4;1;2;1;1;1
258189048430;258189099691;51261;-1;0;-1;0;1;1
258189099691;258189100236;545;4;1;2;1;1;1
258189100236;258189211522;111286;-1;0;-1;0;1;1
258189211522;258189212647;1125;4;1;2;1;1;1
258189212647;258189284361;71714;-1;0;-1;0;1;1
258189284361;258189285311;950;4;1;2;1;1;1
258189285311;258189453738;168427;-1;0;-1;0;1;1
258189453738;258189454275;537;4;1;2;1;1;1
258189454275;258189542740;88465;-1;0;-1;0;1;1
258189542740;258189543289;549;4;1;2;1;1;1
258189543289;258189643698;100409;-1;0;-1;0;1;1
258189643698;258189644206;508;4;1;2;1;1;1
258189644206;258189741495;97289;-1;0;-1;0;1;1
258189741495;258189742058;563;4;1;2;1;1;1
258189742058;258189782783;40725;-1;0;-1;0;1;1
258189782783;258189783331;548;4;1;2;1;1;1
258189783331;258189922861;139530;-1;0;-1;0;1;1
258189922861;258189923517;656;4;1;2;1;1;1
258189923517;258189976177;52660;-1;0;-1;0;1;1
258189976177;258189976691;514;4;1;2;1;1;1
258189976691;258190074808;98117;-1;0;-1;0;1;1
258190074808;258190075434;626;4;1;2;1;1;1
258190075434;258190153932;78498;-1;0;-1;0;1;1
258190153932;258190154571;639;4;1;2;1;1;1
258190154571;258190223208;68637;-1;0;-1;0;1;1
258190223208;258190223850;642;4;1;2;1;1;1
258190223850;258190266651;42801;-1;0;-1;0;1;1
258190266651;258190267113;462;4;1;2;1;1;1
258190267113;258190346099;78986;-1;0;-1;0;1;1
258190346099;258190346753;654;4;1;2;1;1;1
258190346753;258190346936;183;-1;0;-1;0;1;1
258190346936;258190347592;656;4;1;2;1;1;1
258190347592;258190366716;19124;-1;0;-1;0;1;1
258190366716;258190367148;432;4;1;2;1;1;1
258190367148;258190367416;268;4;1;2;1;1;1
258190367416;258190367942;526;4;1;2;1;1;1
258190367942;258190422834;54892;-1;0;-1;0;1;1
258190422834;258190423738;904;4;1;2;1;1;1
258190423738;258190532234;108496;-1;0;-1;0;1;1
258190532234;258190533061;827;4;1;2;1;1;1
258190533061;258190609441;76380;-1;0;-1;0;1;1
258190609441;258190610118;677;4;1;2;1;1;1
258190610118;258190610602;484;-1;0;-1;0;1;1
258190610602;258190611513;911;4;1;2;1;1;1
258190611513;258190668245;56732;-1;0;-1;0;1;1
258190668245;258190668875;630;4;1;2;1;1;1
258190668875;258190700688;31813;-1;0;-1;0;1;1
258190700688;258190701325;637;4;1;2;1;1;1
258190701325;258190771976;70651;-1;0;-1;0;1;1
258190771976;258190772518;542;4;1;2;1;1;1
258190772518;258190848702;76184;-1;0;-1;0;1;1
258190848702;258190849371;669;4;1;2;1;1;1
258190849371;258190918330;68959;-1;0;-1;0;1;1
258190918330;258190918925;595;4;1;2;1;1;1
258190918925;258190997277;78352;-1;0;-1;0;1;1
258190997277;258190999751;2474;4;1;2;1;1;1
258190999751;258191060327;60576;-1;0;-1;0;1;1
258191060327;258191060963;636;4;1;2;1;1;1
258191060963;258191166440;105477;-1;0;-1;0;1;1
258191166440;258191167085;645;4;1;2;1;1;1
258191167085;258191167125;40;-1;0;-1;0;1;1
258191167125;258191167954;829;4;1;2;1;1;1
258191167954;258191242875;74921;-1;0;-1;0;1;1
258191242875;258191243558;683;4;1;2;1;1;1
258191243558;258191309611;66053;-1;0;-1;0;1;1
258191309611;258191310171;560;4;1;2;1;1;1
258191310171;258191377195;67024;-1;0;-1;0;1;1
258191377195;258191377744;549;4;1;2;1;1;1
258191377744;258191396912;19168;-1;0;-1;0;1;1
258191396912;258191397542;630;4;1;2;1;1;1
258191397542;258191470588;73046;-1;0;-1;0;1;1
258191470588;258191471235;647;4;1;2;1;1;1
258191471235;258191548685;77450;-1;0;-1;0;1;1
258191548685;258191549315;630;4;1;2;1;1;1
258191549315;258191620801;71486;-1;0;-1;0;1;1
258191620801;258191621385;584;4;1;2;1;1;1
258191621385;258191621458;73;4;1;2;1;1;1
258191621458;258191622280;822;4;1;2;1;1;1
258191622280;258191653347;31067;-1;0;-1;0;1;1
258191653347;258191653978;631;4;1;2;1;1;1
258191653978;258191708867;54889;-1;0;-1;0;1;1
258191708867;258191709567;700;4;1;2;1;1;1
258191709567;258191754774;45207;-1;0;-1;0;1;1
258191754774;258191755329;555;4;1;2;1;1;1
258191755329;258191801411;46082;-1;0;-1;0;1;1
258191801411;258191801961;550;4;1;2;1;1;1
258191801961;258191911998;110037;-1;0;-1;0;1;1
258191911998;258191912625;627;4;1;2;1;1;1
258191912625;258191960135;47510;-1;0;-1;0;1;1
258191960135;258191960662;527;4;1;2;1;1;1
258191960662;258191961386;724;-1;0;-1;0;1;1
258191961386;258191961973;587;4;1;2;1;1;1
258191961973;258192037107;75134;-1;0;-1;0;1;1
258192037107;258192037711;604;4;1;2;1;1;1
258192037711;258192126200;88489;-1;0;-1;0;1;1
258192126200;258192126753;553;4;1;2;1;1;1
258192126753;258192127199;446;-1;0;-1;0;1;1
258192127199;258192127776;577;4;1;2;1;1;1
258192127776;258192200466;72690;-1;0;-1;0;1;1
258192200466;258192201024;558;4;1;2;1;1;1
258192201024;258192235937;34913;-1;0;-1;0;1;1
258192235937;258192236560;623;4;1;2;1;1;1
258192236560;258192304648;68088;-1;0;-1;0;1;1
258192304648;258192305255;607;4;1;2;1;1;1
258192305255;258192391983;86728;-1;0;-1;0;1;1
258192391983;258192392658;675;4;1;2;1;1;1
258192392658;258192456592;63934;-1;0;-1;0;1;1
258192456592;258192456949;357;4;1;2;1;1;1
258192456949;258192458510;1561;4;1;2;1;1;1
258192458510;258192458637;127;4;1;2;1;1;1
258192458637;258192460394;1757;-1;0;-1;0;1;1
258192460394;258192460997;603;4;1;2;1;1;1
258192460997;258192544811;83814;-1;0;-1;0;1;1
258192544811;258192545524;713;4;1;2;1;1;1
258192545524;258192546194;670;-1;0;-1;0;1;1
258192546194;258192546785;591;4;1;2;1;1;1
258192546785;258192630675;83890;-1;0;-1;0;1;1
258192630675;258192631629;954;4;1;2;1;1;1
258192631629;258192633631;2002;-1;0;-1;0;1;1
258192633631;258192634247;616;4;1;2;1;1;1
258192634247;258192676100;41853;-1;0;-1;0;1;1
258192676100;258192676649;549;4;1;2;1;1;1
258192676649;258192677201;552;-1;0;-1;0;1;1
258192677201;258192677846;645;4;1;2;1;1;1
258192677846;258192753023;75177;-1;0;-1;0;1;1
258192753023;258192753569;546;4;1;2;1;1;1
258192753569;258193195160;441591;-1;0;-1;0;1;1
258193195160;258193195701;541;4;1;2;1;1;1
258193195701;258193277106;81405;-1;0;-1;0;1;1
258193277106;258193277711;605;4;1;2;1;1;1
258193277711;258193315479;37768;-1;0;-1;0;1;1
258193315479;258193316108;629;4;1;2;1;1;1
258193316108;258193396859;80751;-1;0;-1;0;1;1
258193396859;258193397491;632;4;1;2;1;1;1
258193397491;258193451918;54427;-1;0;-1;0;1;1
258193451918;258193452462;544;4;1;2;1;1;1
258193452462;258193452655;193;-1;0;-1;0;1;1
258193452655;258193453231;576;4;1;2;1;1;1
258193453231;258193531589;78358;-1;0;-1;0;1;1
258193531589;258193532137;548;4;1;2;1;1;1
258193532137;258193617683;85546;-1;0;-1;0;1;1
258193617683;258193618360;677;4;1;2;1;1;1
258193618360;258193727566;109206;-1;0;-1;0;1;1
258193727566;258193728122;556;4;1;2;1;1;1
258193728122;258193778275;50153;-1;0;-1;0;1;1
258193778275;258193778572;297;4;1;2;1;1;1
258193778572;258193778890;318;4;1;2;1;1;1
258193778890;258193779273;383;4;1;2;1;1;1
258193779273;258193856291;77018;-1;0;-1;0;1;1
258193856291;258193856927;636;4;1;2;1;1;1
258193856927;258193938920;81993;-1;0;-1;0;1;1
258193938920;258193939477;557;4;1;2;1;1;1
258193939477;258193975988;36511;-1;0;-1;0;1;1
258193975988;258193976537;549;4;1;2;1;1;1
258193976537;258194057010;80473;-1;0;-1;0;1;1
258194057010;258194060466;3456;4;1;2;1;1;1
258194060466;258194060612;146;-1;0;-1;0;1;1
258194060612;258194061664;1052;4;1;2;1;1;1
258194061664;258194061963;299;4;1;2;1;1;1
258194061963;258194063277;1314;4;1;2;1;1;1
258194063277;258194144365;81088;-1;0;-1;0;1;1
258194144365;258194144997;632;4;1;2;1;1;1
258194144997;258194214287;69290;-1;0;-1;0;1;1
258194214287;258194214839;552;4;1;2;1;1;1
258194214839;258194224113;9274;-1;0;-1;0;1;1
258194224113;258194224777;664;4;1;2;1;1;1
258194224777;258194293717;68940;-1;0;-1;0;1;1
258194293717;258194294653;936;4;1;2;1;1;1
258194294653;258194295739;1086;-1;0;-1;0;1;1
258194295739;258194296383;644;4;1;2;1;1;1
258194296383;258194418326;121943;-1;0;-1;0;1;1
258194418326;258194418958;632;4;1;2;1;1;1
258194418958;258194422132;3174;-1;0;-1;0;1;1
258194422132;258194422683;551;4;1;2;1;1;1
258194422683;258194508078;85395;-1;0;-1;0;1;1
258194508078;258194509799;1721;4;1;2;1;1;1
258194509799;258194510660;861;-1;0;-1;0;1;1
258194510660;258194512550;1890;4;1;2;1;1;1
258194512550;258194512664;114;-1;0;-1;0;1;1
258194512664;258194513493;829;4;1;2;1;1;1
258194513493;258194514288;795;-1;0;-1;0;1;1
258194514288;258194514887;599;4;1;2;1;1;1
258194514887;258194555600;40713;-1;0;-1;0;1;1
258194555600;258194556238;638;4;1;2;1;1;1
258194556238;258194565983;9745;-1;0;-1;0;1;1
258194565983;258194566614;631;4;1;2;1;1;1
258194566614;258194628169;61555;-1;0;-1;0;1;1
258194628169;258194628806;637;4;1;2;1;1;1
258194628806;258194716752;87946;-1;0;-1;0;1;1
258194716752;258194718058;1306;4;1;2;1;1;1
258194718058;258194718765;707;-1;0;-1;0;1;1
258194718765;258194719116;351;4;1;2;1;1;1
258194719116;258194719846;730;4;1;2;1;1;1
258194719846;258194719872;26;4;1;2;1;1;1
258194719872;258194860167;140295;-1;0;-1;0;1;1
258194860167;258194861006;839;4;1;2;1;1;1
258194861006;258194904938;43932;-1;0;-1;0;1;1
258194904938;258194905565;627;4;1;2;1;1;1
258194905565;258194951968;46403;-1;0;-1;0;1;1
258194951968;258194953096;1128;4;1;2;1;1;1
258194953096;258195097199;144103;-1;0;-1;0;1;1
258195097199;258195097973;774;4;1;2;1;1;1
258195097973;258195157243;59270;-1;0;-1;0;1;1
258195157243;258195157939;696;4;1;2;1;1;1
258195157939;258195199756;41817;-1;0;-1;0;1;1
258195199756;258195200077;321;4;1;2;1;1;1
258195200077;258195200749;672;4;1;2;1;1;1
258195200749;258195200930;181;4;1;2;1;1;1
258195200930;258195274107;73177;-1;0;-1;0;1;1
258195274107;258195274599;492;4;1;2;1;1;1
258195274599;258195399075;124476;-1;0;-1;0;1;1
258195399075;258195399739;664;4;1;2;1;1;1
258195399739;258195439954;40215;-1;0;-1;0;1;1
258195439954;258195440884;930;4;1;2;1;1;1
258195440884;258195514875;73991;-1;0;-1;0;1;1
258195514875;258195515401;526;4;1;2;1;1;1
258195515401;258195579219;63818;-1;0;-1;0;1;1
258195579219;258195579630;411;4;1;2;1;1;1
258195579630;258195580004;374;4;1;2;1;1;1
258195580004;258195580737;733;4;1;2;1;1;1
258195580737;258195652260;71523;-1;0;-1;0;1;1
258195652260;258195653104;844;4;1;2;1;1;1
258195653104;258195734936;81832;-1;0;-1;0;1;1
258195734936;258195735483;547;4;1;2;1;1;1
258195735483;258195979035;243552;-1;0;-1;0;1;1
258195979035;258195979677;642;4;1;2;1;1;1
258195979677;258195980148;471;-1;0;-1;0;1;1
258195980148;258195980821;673;4;1;2;1;1;1
258195980821;258196011414;30593;-1;0;-1;0;1;1
258196011414;258196012102;688;4;1;2;1;1;1
258196012102;258196144812;132710;-1;0;-1;0;1;1
258196144812;258196145366;554;4;1;2;1;1;1
258196145366;258196212507;67141;-1;0;-1;0;1;1
258196212507;258196213113;606;4;1;2;1;1;1
258196213113;258196268357;55244;-1;0;-1;0;1;1
258196268357;258196268886;529;4;1;2;1;1;1
258196268886;258196350392;81506;-1;0;-1;0;1;1
258196350392;258196351008;616;4;1;2;1;1;1
258196351008;258196391204;40196;-1;0;-1;0;1;1
258196391204;258196392373;1169;4;1;2;1;1;1
258196392373;258196424691;32318;-1;0;-1;0;1;1
258196424691;258196425220;529;4;1;2;1;1;1
258196425220;258196485258;60038;-1;0;-1;0;1;1
258196485258;258196485798;540;4;1;2;1;1;1
258196485798;258196559595;73797;-1;0;-1;0;1;1
258196559595;258196560219;624;4;1;2;1;1;1
258196560219;258196646008;85789;-1;0;-1;0;1;1
258196646008;258196646556;548;4;1;2;1;1;1
258196646556;258196656060;9504;-1;0;-1;0;1;1
258196656060;258196656615;555;4;1;2;1;1;1
258196656615;258196692643;36028;-1;0;-1;0;1;1
258196692643;258196693281;638;4;1;2;1;1;1
258196693281;258196731973;38692;-1;0;-1;0;1;1
258196731973;258196732749;776;4;1;2;1;1;1
258196732749;258196733843;1094;-1;0;-1;0;1;1
258196733843;258196734532;689;4;1;2;1;1;1
258196734532;258196798204;63672;-1;0;-1;0;1;1
258196798204;258196798658;454;4;1;2;1;1;1
258196798658;258196881769;83111;-1;0;-1;0;1;1
258196881769;258196881911;142;4;1;2;1;1;1
258196881911;258196882459;548;4;1;2;1;1;1
258196882459;258196883193;734;4;1;2;1;1;1
258196883193;258196918301;35108;-1;0;-1;0;1;1
258196918301;258196919137;836;4;1;2;1;1;1
258196919137;258196920222;1085;-1;0;-1;0;1;1
258196920222;258196921769;1547;4;1;2;1;1;1
258196921769;258197080700;158931;-1;0;-1;0;1;1
258197080700;258197081164;464;4;1;2;1;1;1
258197081164;258197095495;14331;-1;0;-1;0;1;1
258197095495;258197096125;630;4;1;2;1;1;1
258197096125;258197143714;47589;-1;0;-1;0;1;1
258197143714;258197144271;557;4;1;2;1;1;1
258197144271;258197144591;320;-1;0;-1;0;1;1
258197144591;258197145186;595;4;1;2;1;1;1
258197145186;258197226864;81678;-1;0;-1;0;1;1
258197226864;258197227410;546;4;1;2;1;1;1
258197227410;258197227594;184;-1;0;-1;0;1;1
258197227594;258197228430;836;4;1;2;1;1;1
258197228430;258197281494;53064;-1;0;-1;0;1;1
258197281494;258197282124;630;4;1;2;1;1;1
258197282124;258197358985;76861;-1;0;-1;0;1;1
258197358985;258197359614;629;4;1;2;1;1;1
258197359614;258197432385;72771;-1;0;-1;0;1;1
258197432385;258197433011;626;4;1;2;1;1;1
258197433011;258197467492;34481;-1;0;-1;0;1;1
258197467492;258197468089;597;4;1;2;1;1;1
258197468089;258197549974;81885;-1;0;-1;0;1;1
258197549974;258197550657;683;4;1;2;1;1;1
258197550657;258197639371;88714;-1;0;-1;0;1;1
258197639371;258197640888;1517;4;1;2;1;1;1
258197640888;258197641753;865;-1;0;-1;0;1;1
258197641753;258197642602;849;4;1;2;1;1;1
258197642602;258197643478;876;-1;0;-1;0;1;1
258197643478;258197644027;549;4;1;2;1;1;1
258197644027;258197676104;32077;-1;0;-1;0;1;1
258197676104;258197676183;79;4;1;2;1;1;1
258197676183;258197676882;699;4;1;2;1;1;1
258197676882;258197676909;27;4;1;2;1;1;1
258197676909;258197720762;43853;-1;0;-1;0;1;1
258197720762;258197721540;778;4;1;2;1;1;1
258197721540;258197722525;985;-1;0;-1;0;1;1
258197722525;258197723170;645;4;1;2;1;1;1
258197723170;258197808962;85792;-1;0;-1;0;1;1
258197808962;258197809510;548;4;1;2;1;1;1
258197809510;258197885485;75975;-1;0;-1;0;1;1
258197885485;258197885790;305;4;1;2;1;1;1
258197885790;258197886246;456;4;1;2;1;1;1
258197886246;258197886460;214;4;1;2;1;1;1
258197886460;258197886909;449;-1;0;-1;0;1;1
258197886909;258197887555;646;4;1;2;1;1;1
258197887555;258197929175;41620;-1;0;-1;0;1;1
258197929175;258197929816;641;4;1;2;1;1;1
258197929816;258197977125;47309;-1;0;-1;0;1;1
258197977125;258197977803;678;4;1;2;1;1;1
258197977803;258198025582;47779;-1;0;-1;0;1;1
258198025582;258198026227;645;4;1;2;1;1;1
258198026227;258198026793;566;-1;0;-1;0;1;1
258198026793;258198027428;635;4;1;2;1;1;1
258198027428;258198094150;66722;-1;0;-1;0;1;1
258198094150;258198094764;614;4;1;2;1;1;1
258198094764;258198168025;73261;-1;0;-1;0;1;1
258198168025;258198168665;640;4;1;2;1;1;1
258198168665;258198218921;50256;-1;0;-1;0;1;1
258198218921;258198220055;1134;4;1;2;1;1;1
258198220055;258198221033;978;-1;0;-1;0;1;1
258198221033;258198221578;545;4;1;2;1;1;1
258198221578;258198222024;446;-1;0;-1;0;1;1
258198222024;258198222667;643;4;1;2;1;1;1
258198222667;258198302792;80125;-1;0;-1;0;1;1
258198302792;258198303392;600;4;1;2;1;1;1
258198303392;258198339338;35946;-1;0;-1;0;1;1
258198339338;258198339965;627;4;1;2;1;1;1
258198339965;258198420464;80499;-1;0;-1;0;1;1
258198420464;258198421029;565;4;1;2;1;1;1
258198421029;258198511919;90890;-1;0;-1;0;1;1
258198511919;258198513911;1992;4;1;2;1;1;1
258198513911;258198515092;1181;4;1;2;1;1;1
258198515092;258198517070;1978;4;1;2;1;1;1
258198517070;258198519138;2068;4;1;2;1;1;1
258198519138;258198520932;1794;4;1;2;1;1;1
258198520932;258198522879;1947;-1;0;-1;0;1;1
258198522879;258198523525;646;4;1;2;1;1;1
258198523525;258198523661;136;-1;0;-1;0;1;1
258198523661;258198524312;651;4;1;2;1;1;1
258198524312;258198548124;23812;-1;0;-1;0;1;1
258198548124;258198548677;553;4;1;2;1;1;1
258198548677;258198606763;58086;-1;0;-1;0;1;1
258198606763;258198608492;1729;4;1;2;1;1;1
258198608492;258198610742;2250;-1;0;-1;0;1;1
258198610742;258198610812;70;4;1;2;1;1;1
258198610812;258198611541;729;4;1;2;1;1;1
258198611541;258198611571;30;4;1;2;1;1;1
258198611571;258198679032;67461;-1;0;-1;0;1;1
258198679032;258198679590;558;4;1;2;1;1;1
258198679590;258198762048;82458;-1;0;-1;0;1;1
258198762048;258198763424;1376;4;1;2;1;1;1
258198763424;258198803726;40302;-1;0;-1;0;1;1
258198803726;258198804271;545;4;1;2;1;1;1
258198804271;258198867313;63042;-1;0;-1;0;1;1
258198867313;258198867915;602;4;1;2;1;1;1
258198867915;258198949264;81349;-1;0;-1;0;1;1
258198949264;258198949818;554;4;1;2;1;1;1
258198949818;258198990295;40477;-1;0;-1;0;1;1
258198990295;258198990937;642;4;1;2;1;1;1
258198990937;258199060859;69922;-1;0;-1;0;1;1
258199060859;258199061421;562;4;1;2;1;1;1
258199061421;258199113035;51614;-1;0;-1;0;1;1
258199113035;258199113590;555;4;1;2;1;1;1
258199113590;258199177189;63599;-1;0;-1;0;1;1
258199177189;258199177731;542;4;1;2;1;1;1
258199177731;258199255938;78207;-1;0;-1;0;1;1
258199255938;258199256571;633;4;1;2;1;1;1
258199256571;258199283916;27345;-1;0;-1;0;1;1
258199283916;258199284554;638;4;1;2;1;1;1
258199284554;258199360482;75928;-1;0;-1;0;1;1
258199360482;258199361029;547;4;1;2;1;1;1
258199361029;258199361427;398;-1;0;-1;0;1;1
258199361427;258199362088;661;4;1;2;1;1;1
258199362088;258199403976;41888;-1;0;-1;0;1;1
258199403976;258199404778;802;4;1;2;1;1;1
258199404778;258199406385;1607;-1;0;-1;0;1;1
258199406385;258199406990;605;4;1;2;1;1;1
258199406990;258199482400;75410;-1;0;-1;0;1;1
258199482400;258199483026;626;4;1;2;1;1;1
258199483026;258199557427;74401;-1;0;-1;0;1;1
258199557427;258199558063;636;4;1;2;1;1;1
258199558063;258199641510;83447;-1;0;-1;0;1;1
258199641510;258199642141;631;4;1;2;1;1;1
258199642141;258199764708;122567;-1;0;-1;0;1;1
258199764708;258199766325;1617;4;1;2;1;1;1
258199766325;258199767140;815;-1;0;-1;0;1;1
258199767140;258199768517;1377;4;1;2;1;1;1
258199768517;258199820499;51982;-1;0;-1;0;1;1
258199820499;258199821065;566;4;1;2;1;1;1
258199821065;258199874128;53063;-1;0;-1;0;1;1
258199874128;258199874674;546;4;1;2;1;1;1
258199874674;258199886377;11703;-1;0;-1;0;1;1
258199886377;258199886838;461;4;1;2;1;1;1
258199886838;258199950464;63626;-1;0;-1;0;1;1
258199950464;258199951026;562;4;1;2;1;1;1
258199951026;258200003794;52768;-1;0;-1;0;1;1
258200003794;258200004782;988;4;1;2;1;1;1
258200004782;258200006793;2011;-1;0;-1;0;1;1
258200006793;258200007823;1030;4;1;2;1;1;1
258200007823;258200009065;1242;-1;0;-1;0;1;1
258200009065;258200010359;1294;4;1;2;1;1;1
258200010359;258200142257;131898;-1;0;-1;0;1;1
258200142257;258200142804;547;4;1;2;1;1;1
258200142804;258200143035;231;-1;0;-1;0;1;1
258200143035;258200143635;600;4;1;2;1;1;1
258200143635;258200184221;40586;-1;0;-1;0;1;1
258200184221;258200184771;550;4;1;2;1;1;1
258200184771;258200230316;45545;-1;0;-1;0;1;1
258200230316;258200230918;602;4;1;2;1;1;1
258200230918;258200231136;218;4;1;2;1;1;1
258200231136;258200231529;393;4;1;2;1;1;1
258200231529;258200302251;70722;-1;0;-1;0;1;1
258200302251;258200302884;633;4;1;2;1;1;1
258200302884;258200396643;93759;-1;0;-1;0;1;1
258200396643;258200397269;626;4;1;2;1;1;1
258200397269;258200440560;43291;-1;0;-1;0;1;1
258200440560;258200441109;549;4;1;2;1;1;1
258200441109;258200513539;72430;-1;0;-1;0;1;1
258200513539;258200514181;642;4;1;2;1;1;1
258200514181;258200596305;82124;-1;0;-1;0;1;1
258200596305;258200596925;620;4;1;2;1;1;1
258200596925;258200714941;118016;-1;0;-1;0;1;1
258200714941;258200716113;1172;4;1;2;1;1;1
258200716113;258200780237;64124;-1;0;-1;0;1;1
258200780237;258200780799;562;4;1;2;1;1;1
258200780799;258200830194;49395;-1;0;-1;0;1;1
258200830194;258200830670;476;4;1;2;1;1;1
258200830670;258200879666;48996;-1;0;-1;0;1;1
258200879666;258200882069;2403;4;1;2;1;1;1
258200882069;258201031530;149461;-1;0;-1;0;1;1
258201031530;258201032374;844;4;1;2;1;1;1
258201032374;258201110568;78194;-1;0;-1;0;1;1
258201110568;258201111220;652;4;1;2;1;1;1
258201111220;258201132825;21605;-1;0;-1;0;1;1
258201132825;258201133435;610;4;1;2;1;1;1
258201133435;258201134142;707;-1;0;-1;0;1;1
258201134142;258201134780;638;4;1;2;1;1;1
258201134780;258201252899;118119;-1;0;-1;0;1;1
258201252899;258201253518;619;4;1;2;1;1;1
258201253518;258201322770;69252;-1;0;-1;0;1;1
258201322770;258201323401;631;4;1;2;1;1;1
258201323401;258201363488;40087;-1;0;-1;0;1;1
258201363488;258201364756;1268;4;1;2;1;1;1
258201364756;258201365049;293;4;1;2;1;1;1
258201365049;258201365796;747;4;1;2;1;1;1
258201365796;258201366774;978;-1;0;-1;0;1;1
258201366774;258201371136;4362;4;1;2;1;1;1
258201371136;258201514990;143854;-1;0;-1;0;1;1
258201514990;258201515627;637;4;1;2;1;1;1
258201515627;258201561219;45592;-1;0;-1;0;1;1
258201561219;258201561683;464;4;1;2;1;1;1
258201561683;258201614702;53019;-1;0;-1;0;1;1
258201614702;258201615254;552;4;1;2;1;1;1
258201615254;258201715216;99962;-1;0;-1;0;1;1
258201715216;258201716165;949;4;1;2;1;1;1
258201716165;258201759278;43113;-1;0;-1;0;1;1
258201759278;258201763473;4195;4;1;2;1;1;1
258201763473;258201825474;62001;-1;0;-1;0;1;1
258201825474;258201825998;524;4;1;2;1;1;1
258201825998;258201912411;86413;-1;0;-1;0;1;1
258201912411;258201913044;633;4;1;2;1;1;1
258201913044;258202029296;116252;-1;0;-1;0;1;1
258202029296;258202029929;633;4;1;2;1;1;1
258202029929;258202165301;135372;-1;0;-1;0;1;1
258202165301;258202165769;468;4;1;2;1;1;1
258202165769;258202205716;39947;-1;0;-1;0;1;1
258202205716;258202212999;7283;4;1;2;1;1;1
258202212999;258202251065;38066;-1;0;-1;0;1;1
258202251065;258202251579;514;4;1;2;1;1;1
258202251579;258202302838;51259;-1;0;-1;0;1;1
258202302838;258202303464;626;4;1;2;1;1;1
258202303464;258202344800;41336;-1;0;-1;0;1;1
258202344800;258202345431;631;4;1;2;1;1;1
258202345431;258202394207;48776;-1;0;-1;0;1;1
258202394207;258202395767;1560;4;1;2;1;1;1
258202395767;258202430744;34977;-1;0;-1;0;1;1
258202430744;258202431582;838;4;1;2;1;1;1
258202431582;258202431944;362;4;1;2;1;1;1
258202431944;258202433560;1616;4;1;2;1;1;1
258202433560;258202434126;566;-1;0;-1;0;1;1
258202434126;258202434773;647;4;1;2;1;1;1
258202434773;258202471636;36863;-1;0;-1;0;1;1
258202471636;258202472577;941;4;1;2;1;1;1
258202472577;258202517596;45019;-1;0;-1;0;1;1
258202517596;258202518201;605;4;1;2;1;1;1
258202518201;258202567962;49761;-1;0;-1;0;1;1
258202567962;258202568512;550;4;1;2;1;1;1
258202568512;258202623015;54503;-1;0;-1;0;1;1
258202623015;258202623612;597;4;1;2;1;1;1
258202623612;258202623749;137;-1;0;-1;0;1;1
258202623749;258202624545;796;4;1;2;1;1;1
258202624545;258202663947;39402;-1;0;-1;0;1;1
258202663947;258202664577;630;4;1;2;1;1;1
258202664577;258202802659;138082;-1;0;-1;0;1;1
258202802659;258202804173;1514;4;1;2;1;1;1
258202804173;258202813829;9656;-1;0;-1;0;1;1
258202813829;258202814840;1011;4;1;2;1;1;1
258202814840;258202817026;2186;-1;0;-1;0;1;1
258202817026;258202817659;633;4;1;2;1;1;1
258202817659;258202869055;51396;-1;0;-1;0;1;1
258202869055;258202869607;552;4;1;2;1;1;1
258202869607;258202869758;151;4;1;2;1;1;1
258202869758;258202870277;519;4;1;2;1;1;1
258202870277;258203032021;161744;-1;0;-1;0;1;1
258203032021;258203032742;721;4;1;2;1;1;1
258203032742;258203043855;11113;-1;0;-1;0;1;1
258203043855;258203044482;627;4;1;2;1;1;1
258203044482;258203090562;46080;-1;0;-1;0;1;1
258203090562;258203090953;391;4;1;2;1;1;1
258203090953;258203091402;449;4;1;2;1;1;1
258203091402;258203092251;849;4;1;2;1;1;1
258203092251;258203164668;72417;-1;0;-1;0;1;1
258203164668;258203165302;634;4;1;2;1;1;1
258203165302;258203196051;30749;-1;0;-1;0;1;1
258203196051;258203196684;633;4;1;2;1;1;1
258203196684;258203276709;80025;-1;0;-1;0;1;1
258203276709;258203277358;649;4;1;2;1;1;1
258203277358;258203277568;210;-1;0;-1;0;1;1
258203277568;258203278149;581;4;1;2;1;1;1
258203278149;258203354481;76332;-1;0;-1;0;1;1
258203354481;258203356612;2131;4;1;2;1;1;1
258203356612;258203403597;46985;-1;0;-1;0;1;1
258203403597;258203404200;603;4;1;2;1;1;1
258203404200;258203450172;45972;-1;0;-1;0;1;1
258203450172;258203450795;623;4;1;2;1;1;1
258203450795;258203499138;48343;-1;0;-1;0;1;1
258203499138;258203499790;652;4;1;2;1;1;1
258203499790;258203544950;45160;-1;0;-1;0;1;1
258203544950;258203545581;631;4;1;2;1;1;1
258203545581;258203592730;47149;-1;0;-1;0;1;1
258203592730;258203593374;644;4;1;2;1;1;1
258203593374;258203662487;69113;-1;0;-1;0;1;1
258203662487;258203663034;547;4;1;2;1;1;1
258203663034;258203724239;61205;-1;0;-1;0;1;1
258203724239;258203724787;548;4;1;2;1;1;1
258203724787;258203776346;51559;-1;0;-1;0;1;1
258203776346;258203776947;601;4;1;2;1;1;1
258203776947;258203857577;80630;-1;0;-1;0;1;1
258203857577;258203858211;634;4;1;2;1;1;1
258203858211;258203877805;19594;-1;0;-1;0;1;1
258203877805;258203878435;630;4;1;2;1;1;1
258203878435;258203880052;1617;-1;0;-1;0;1;1
258203880052;258203880610;558;4;1;2;1;1;1
258203880610;258203953299;72689;-1;0;-1;0;1;1
258203953299;258203956497;3198;4;1;2;1;1;1
258203956497;258203957566;1069;4;1;2;1;1;1
258203957566;258203959136;1570;4;1;2;1;1;1
258203959136;258203959417;281;4;1;2;1;1;1
258203959417;258203960221;804;4;1;2;1;1;1
258203960221;258203961288;1067;-1;0;-1;0;1;1
258203961288;258203961624;336;4;1;2;1;1;1
258203961624;258203962040;416;4;1;2;1;1;1
258203962040;258203962437;397;4;1;2;1;1;1
258203962437;258204029464;67027;-1;0;-1;0;1;1
258204029464;258204030042;578;4;1;2;1;1;1
258204030042;258204031001;959;-1;0;-1;0;1;1
258204031001;258204031608;607;4;1;2;1;1;1
258204031608;258204151699;120091;-1;0;-1;0;1;1
258204151699;258204152257;558;4;1;2;1;1;1
258204152257;258204207395;55138;-1;0;-1;0;1;1
258204207395;258204207786;391;4;1;2;1;1;1
258204207786;258204207913;127;4;1;2;1;1;1
258204207913;258204208250;337;4;1;2;1;1;1
258204208250;258204208654;404;4;1;2;1;1;1
258204208654;258204209493;839;4;1;2;1;1;1
258204209493;258204249949;40456;-1;0;-1;0;1;1
258204249949;258204250511;562;4;1;2;1;1;1
258204250511;258204439287;188776;-1;0;-1;0;1;1
258204439287;258204439989;702;4;1;2;1;1;1
258204439989;258204440130;141;4;1;2;1;1;1
258204440130;258204440978;848;4;1;2;1;1;1
258204440978;258204474380;33402;-1;0;-1;0;1;1
258204474380;258204474980;600;4;1;2;1;1;1
258204474980;258204532525;57545;-1;0;-1;0;1;1
258204532525;258204533090;565;4;1;2;1;1;1
258204533090;258204563251;30161;-1;0;-1;0;1;1
258204563251;258204563855;604;4;1;2;1;1;1
258204563855;258204603412;39557;-1;0;-1;0;1;1
258204603412;258204603968;556;4;1;2;1;1;1
258204603968;258204642350;38382;-1;0;-1;0;1;1
258204642350;258204642896;546;4;1;2;1;1;1
258204642896;258204726691;83795;-1;0;-1;0;1;1
258204726691;258204727242;551;4;1;2;1;1;1
258204727242;258204787215;59973;-1;0;-1;0;1;1
258204787215;258204787816;601;4;1;2;1;1;1
258204787816;258204824462;36646;-1;0;-1;0;1;1
258204824462;258204825096;634;4;1;2;1;1;1
258204825096;258204897226;72130;-1;0;-1;0;1;1
258204897226;258204897829;603;4;1;2;1;1;1
258204897829;258204932797;34968;-1;0;-1;0;1;1
258204932797;258204933423;626;4;1;2;1;1;1
258204933423;258204976074;42651;-1;0;-1;0;1;1
258204976074;258204976625;551;4;1;2;1;1;1
258204976625;258205056321;79696;-1;0;-1;0;1;1
258205056321;258205056957;636;4;1;2;1;1;1
258205056957;258205189752;132795;-1;0;-1;0;1;1
258205189752;258205190699;947;4;1;2;1;1;1
258205190699;258205191923;1224;-1;0;-1;0;1;1
258205191923;258205192706;783;4;1;2;1;1;1
258205192706;258205193038;332;4;1;2;1;1;1
258205193038;258205193409;371;4;1;2;1;1;1
258205193409;258205194133;724;-1;0;-1;0;1;1
258205194133;258205194690;557;4;1;2;1;1;1
258205194690;258205233087;38397;-1;0;-1;0;1;1
258205233087;258205233573;486;4;1;2;1;1;1
258205233573;258205394988;161415;-1;0;-1;0;1;1
258205394988;258205395617;629;4;1;2;1;1;1
258205395617;258205424630;29013;-1;0;-1;0;1;1
258205424630;258205425188;558;4;1;2;1;1;1
258205425188;258205436008;10820;-1;0;-1;0;1;1
258205436008;258205436501;493;4;1;2;1;1;1
258205436501;258205532893;96392;-1;0;-1;0;1;1
258205532893;258205533532;639;4;1;2;1;1;1
258205533532;258205595612;62080;-1;0;-1;0;1;1
258205595612;258205596320;708;4;1;2;1;1;1
258205596320;258205596956;636;-1;0;-1;0;1;1
258205596956;258205597599;643;4;1;2;1;1;1
258205597599;258205671353;73754;-1;0;-1;0;1;1
258205671353;258205672036;683;4;1;2;1;1;1
258205672036;258205672719;683;-1;0;-1;0;1;1
258205672719;258205673337;618;4;1;2;1;1;1
258205673337;258205742650;69313;-1;0;-1;0;1;1
258205742650;258205743730;1080;4;1;2;1;1;1
258205743730;258205744239;509;-1;0;-1;0;1;1
258205744239;258205744845;606;4;1;2;1;1;1
258205744845;258205797997;53152;-1;0;-1;0;1;1
258205797997;258205798688;691;4;1;2;1;1;1
258205798688;258205800859;2171;4;1;2;1;1;1
258205800859;258205802143;1284;4;1;2;1;1;1
258205802143;258205803034;891;-1;0;-1;0;1;1
258205803034;258205804502;1468;4;1;2;1;1;1
258205804502;258205805172;670;-1;0;-1;0;1;1
258205805172;258205806590;1418;4;1;2;1;1;1
258205806590;258205806614;24;4;1;2;1;1;1
258205806614;258205807743;1129;4;1;2;1;1;1
258205807743;258205872943;65200;-1;0;-1;0;1;1
258205872943;258205873619;676;4;1;2;1;1;1
258205873619;258205937192;63573;-1;0;-1;0;1;1
258205937192;258205939246;2054;4;1;2;1;1;1
258205939246;258205939612;366;-1;0;-1;0;1;1
258205939612;258205940832;1220;4;1;2;1;1;1
258205940832;258205941783;951;-1;0;-1;0;1;1
258205941783;258205942416;633;4;1;2;1;1;1
258205942416;258205984499;42083;-1;0;-1;0;1;1
258205984499;258205985138;639;4;1;2;1;1;1
258205985138;258206022396;37258;-1;0;-1;0;1;1
258206022396;258206023027;631;4;1;2;1;1;1
258206023027;258206071966;48939;-1;0;-1;0;1;1
258206071966;258206072499;533;4;1;2;1;1;1
258206072499;258206157094;84595;-1;0;-1;0;1;1
258206157094;258206157650;556;4;1;2;1;1;1
258206157650;258206275686;118036;-1;0;-1;0;1;1
258206275686;258206279103;3417;4;1;2;1;1;1
258206279103;258206308371;29268;-1;0;-1;0;1;1
258206308371;258206308861;490;4;1;2;1;1;1
258206308861;258206355440;46579;-1;0;-1;0;1;1
258206355440;258206355927;487;4;1;2;1;1;1
258206355927;258206356666;739;-1;0;-1;0;1;1
258206356666;258206357305;639;4;1;2;1;1;1
258206357305;258206430053;72748;-1;0;-1;0;1;1
258206430053;258206430788;735;4;1;2;1;1;1
258206430788;258206499244;68456;-1;0;-1;0;1;1
258206499244;258206499867;623;4;1;2;1;1;1
258206499867;258206539829;39962;-1;0;-1;0;1;1
258206539829;258206540441;612;4;1;2;1;1;1
258206540441;258206573384;32943;-1;0;-1;0;1;1
258206573384;258206573853;469;4;1;2;1;1;1
258206573853;258206626301;52448;-1;0;-1;0;1;1
258206626301;258206626955;654;4;1;2;1;1;1
258206626955;258206671356;44401;-1;0;-1;0;1;1
258206671356;258206671924;568;4;1;2;1;1;1
258206671924;258206719424;47500;-1;0;-1;0;1;1
258206719424;258206720081;657;4;1;2;1;1;1
258206720081;258206763649;43568;-1;0;-1;0;1;1
258206763649;258206764182;533;4;1;2;1;1;1
258206764182;258206839815;75633;-1;0;-1;0;1;1
258206839815;258206841201;1386;4;1;2;1;1;1
258206841201;258207110371;269170;-1;0;-1;0;1;1
258207110371;258207111427;1056;4;1;2;1;1;1
258207111427;258207157864;46437;-1;0;-1;0;1;1
258207157864;258207158494;630;4;1;2;1;1;1
258207158494;258207194626;36132;-1;0;-1;0;1;1
258207194626;258207195701;1075;4;1;2;1;1;1
258207195701;258207274325;78624;-1;0;-1;0;1;1
258207274325;258207274863;538;4;1;2;1;1;1
258207274863;258207408694;133831;-1;0;-1;0;1;1
258207408694;258207409247;553;4;1;2;1;1;1
258207409247;258207466352;57105;-1;0;-1;0;1;1
258207466352;258207466988;636;4;1;2;1;1;1
258207466988;258207478629;11641;-1;0;-1;0;1;1
258207478629;258207479265;636;4;1;2;1;1;1
258207479265;258207613041;133776;-1;0;-1;0;1;1
258207613041;258207613649;608;4;1;2;1;1;1
258207613649;258207680970;67321;-1;0;-1;0;1;1
258207680970;258207682586;1616;4;1;2;1;1;1
258207682586;258207759012;76426;-1;0;-1;0;1;1
258207759012;258207759483;471;4;1;2;1;1;1
258207759483;258207802746;43263;-1;0;-1;0;1;1
258207802746;258207803296;550;4;1;2;1;1;1
258207803296;258207881636;78340;-1;0;-1;0;1;1
258207881636;258207882240;604;4;1;2;1;1;1
258207882240;258207946997;64757;-1;0;-1;0;1;1
258207946997;258207947679;682;4;1;2;1;1;1
258207947679;258208021529;73850;-1;0;-1;0;1;1
258208021529;258208022160;631;4;1;2;1;1;1
258208022160;258208063913;41753;-1;0;-1;0;1;1
258208063913;258208064559;646;4;1;2;1;1;1
258208064559;258208115013;50454;-1;0;-1;0;1;1
258208115013;258208116231;1218;4;1;2;1;1;1
258208116231;258208160520;44289;-1;0;-1;0;1;1
258208160520;258208161167;647;4;1;2;1;1;1
258208161167;258208215795;54628;-1;0;-1;0;1;1
258208215795;258208216344;549;4;1;2;1;1;1
258208216344;258208319765;103421;-1;0;-1;0;1;1
258208319765;258208320400;635;4;1;2;1;1;1
258208320400;258208320495;95;-1;0;-1;0;1;1
258208320495;258208321334;839;4;1;2;1;1;1
258208321334;258208358615;37281;-1;0;-1;0;1;1
258208358615;258208360084;1469;4;1;2;1;1;1
258208360084;258208441715;81631;-1;0;-1;0;1;1
258208441715;258208442366;651;4;1;2;1;1;1
258208442366;258208453594;11228;-1;0;-1;0;1;1
258208453594;258208454151;557;4;1;2;1;1;1
258208454151;258208499141;44990;-1;0;-1;0;1;1
258208499141;258208499709;568;4;1;2;1;1;1
258208499709;258208548829;49120;-1;0;-1;0;1;1
258208548829;258208549327;498;4;1;2;1;1;1
258208549327;258208549559;232;4;1;2;1;1;1
258208549559;258208549944;385;4;1;2;1;1;1
258208549944;258208617185;67241;-1;0;-1;0;1;1
258208617185;258208617813;628;4;1;2;1;1;1
258208617813;258208693538;75725;-1;0;-1;0;1;1
258208693538;258208694325;787;4;1;2;1;1;1
258208694325;258208695461;1136;-1;0;-1;0;1;1
258208695461;258208696098;637;4;1;2;1;1;1
258208696098;258208760719;64621;-1;0;-1;0;1;1
258208760719;258208761324;605;4;1;2;1;1;1
258208761324;258208839413;78089;-1;0;-1;0;1;1
258208839413;258208839972;559;4;1;2;1;1;1
258208839972;258208899934;59962;-1;0;-1;0;1;1
258208899934;258208900868;934;4;1;2;1;1;1
258208900868;258208991121;90253;-1;0;-1;0;1;1
258208991121;258208991694;573;4;1;2;1;1;1
258208991694;258209049192;57498;-1;0;-1;0;1;1
258209049192;258209049851;659;4;1;2;1;1;1
258209049851;258209050013;162;-1;0;-1;0;1;1
258209050013;258209050571;558;4;1;2;1;1;1
258209050571;258209089917;39346;-1;0;-1;0;1;1
258209089917;258209090725;808;4;1;2;1;1;1
258209090725;258209092820;2095;4;1;2;1;1;1
258209092820;258209097051;4231;4;1;2;1;1;1
258209097051;258209098126;1075;4;1;2;1;1;1
258209098126;258209098484;358;4;1;2;1;1;1
258209098484;258209100797;2313;-1;0;-1;0;1;1
258209100797;258209101441;644;4;1;2;1;1;1
258209101441;258209128035;26594;-1;0;-1;0;1;1
258209128035;258209128589;554;4;1;2;1;1;1
258209128589;258209158655;30066;-1;0;-1;0;1;1
258209158655;258209159287;632;4;1;2;1;1;1
258209159287;258209226262;66975;-1;0;-1;0;1;1
258209226262;258209226816;554;4;1;2;1;1;1
258209226816;258209306368;79552;-1;0;-1;0;1;1
258209306368;258209306989;621;4;1;2;1;1;1
258209306989;258209351747;44758;-1;0;-1;0;1;1
258209351747;258209352401;654;4;1;2;1;1;1
258209352401;258209440566;88165;-1;0;-1;0;1;1
258209440566;258209441219;653;4;1;2;1;1;1
258209441219;258209502752;61533;-1;0;-1;0;1;1
258209502752;258209504335;1583;4;1;2;1;1;1
258209504335;258209504686;351;-1;0;-1;0;1;1
258209504686;258209505455;769;4;1;2;1;1;1
258209505455;258209506216;761;-1;0;-1;0;1;1
258209506216;258209506838;622;4;1;2;1;1;1
258209506838;258209608578;101740;-1;0;-1;0;1;1
258209608578;258209609132;554;4;1;2;1;1;1
258209609132;258209696790;87658;-1;0;-1;0;1;1
258209696790;258209697321;531;4;1;2;1;1;1
258209697321;258209743032;45711;-1;0;-1;0;1;1
258209743032;258209743637;605;4;1;2;1;1;1
258209743637;258209785628;41991;-1;0;-1;0;1;1
258209785628;258209786227;599;4;1;2;1;1;1
258209786227;258209857674;71447;-1;0;-1;0;1;1
258209857674;258209858293;619;4;1;2;1;1;1
258209858293;258209868360;10067;-1;0;-1;0;1;1
258209868360;258209868982;622;4;1;2;1;1;1
258209868982;258209952080;83098;-1;0;-1;0;1;1
258209952080;258209952724;644;4;1;2;1;1;1
258209952724;258210035018;82294;-1;0;-1;0;1;1
258210035018;258210035652;634;4;1;2;1;1;1
258210035652;258210081286;45634;-1;0;-1;0;1;1
258210081286;258210081843;557;4;1;2;1;1;1
258210081843;258210141717;59874;-1;0;-1;0;1;1
258210141717;258210142445;728;4;1;2;1;1;1
258210142445;258210145567;3122;-1;0;-1;0;1;1
258210145567;258210147768;2201;4;1;2;1;1;1
258210147768;258210149920;2152;-1;0;-1;0;1;1
258210149920;258210150623;703;4;1;2;1;1;1
258210150623;258210151195;572;-1;0;-1;0;1;1
258210151195;258210151591;396;4;1;2;1;1;1
258210151591;258210151888;297;4;1;2;1;1;1
258210151888;258210152355;467;4;1;2;1;1;1
258210152355;258210176864;24509;-1;0;-1;0;1;1
258210176864;258210177493;629;4;1;2;1;1;1
258210177493;258210212111;34618;-1;0;-1;0;1;1
258210212111;258210213605;1494;4;1;2;1;1;1
258210213605;258210215260;1655;-1;0;-1;0;1;1
258210215260;258210215795;535;4;1;2;1;1;1
258210215795;258210293021;77226;-1;0;-1;0;1;1
258210293021;258210293705;684;4;1;2;1;1;1
258210293705;258210338164;44459;-1;0;-1;0;1;1
258210338164;258210338792;628;4;1;2;1;1;1
258210338792;258210372171;33379;-1;0;-1;0;1;1
258210372171;258210372827;656;4;1;2;1;1;1
258210372827;258210373084;257;-1;0;-1;0;1;1
258210373084;258210373830;746;4;1;2;1;1;1
258210373830;258210449074;75244;-1;0;-1;0;1;1
258210449074;258210449744;670;4;1;2;1;1;1
258210449744;258210449968;224;-1;0;-1;0;1;1
258210449968;258210450553;585;4;1;2;1;1;1
258210450553;258210532965;82412;-1;0;-1;0;1;1
258210532965;258210533527;562;4;1;2;1;1;1
258210533527;258210639882;106355;-1;0;-1;0;1;1
258210639882;258210640524;642;4;1;2;1;1;1
258210640524;258210757085;116561;-1;0;-1;0;1;1
258210757085;258210757867;782;4;1;2;1;1;1
258210757867;258210768934;11067;-1;0;-1;0;1;1
258210768934;258210769616;682;4;1;2;1;1;1
258210769616;258210804689;35073;-1;0;-1;0;1;1
258210804689;258210805740;1051;4;1;2;1;1;1
258210805740;258210873637;67897;-1;0;-1;0;1;1
258210873637;258210874278;641;4;1;2;1;1;1
258210874278;258211009016;134738;-1;0;-1;0;1;1
258211009016;258211009565;549;4;1;2;1;1;1
258211009565;258211056615;47050;-1;0;-1;0;1;1
258211056615;258211057391;776;4;1;2;1;1;1
258211057391;258211094886;37495;-1;0;-1;0;1;1
258211094886;258211095607;721;4;1;2;1;1;1
258211095607;258211142959;47352;-1;0;-1;0;1;1
258211142959;258211143512;553;4;1;2;1;1;1
258211143512;258211179001;35489;-1;0;-1;0;1;1
258211179001;258211179695;694;4;1;2;1;1;1
258211179695;258211215966;36271;-1;0;-1;0;1;1
258211215966;258211216594;628;4;1;2;1;1;1
258211216594;258211258333;41739;-1;0;-1;0;1;1
258211258333;258211259163;830;4;1;2;1;1;1
258211259163;258211259715;552;-1;0;-1;0;1;1
258211259715;258211260309;594;4;1;2;1;1;1
258211260309;258211275880;15571;-1;0;-1;0;1;1
258211275880;258211276434;554;4;1;2;1;1;1
258211276434;258211328940;52506;-1;0;-1;0;1;1
258211328940;258211329411;471;4;1;2;1;1;1
258211329411;258211379473;50062;-1;0;-1;0;1;1
258211379473;258211395143;15670;4;1;2;1;1;1
258211395143;258211493654;98511;-1;0;-1;0;1;1
258211493654;258211494270;616;4;1;2;1;1;1
258211494270;258211512011;17741;-1;0;-1;0;1;1
258211512011;258211512569;558;4;1;2;1;1;1
258211512569;258211554110;41541;-1;0;-1;0;1;1
258211554110;258211555268;1158;4;1;2;1;1;1
258211555268;258211556102;834;-1;0;-1;0;1;1
258211556102;258211556521;419;4;1;2;1;1;1
258211556521;258211557141;620;4;1;2;1;1;1
258211557141;258211557535;394;4;1;2;1;1;1
258211557535;258211669528;111993;-1;0;-1;0;1;1
258211669528;258211670070;542;4;1;2;1;1;1
258211670070;258211710260;40190;-1;0;-1;0;1;1
258211710260;258211711364;1104;4;1;2;1;1;1
258211711364;258211712367;1003;-1;0;-1;0;1;1
258211712367;258211713025;658;4;1;2;1;1;1
258211713025;258211756179;43154;-1;0;-1;0;1;1
258211756179;258211756724;545;4;1;2;1;1;1
258211756724;258211826843;70119;-1;0;-1;0;1;1
258211826843;258211828771;1928;4;1;2;1;1;1
258211828771;258211829238;467;4;1;2;1;1;1
258211829238;258211831726;2488;4;1;2;1;1;1
258211831726;258211833648;1922;-1;0;-1;0;1;1
258211833648;258211834550;902;4;1;2;1;1;1
258211834550;258211836510;1960;-1;0;-1;0;1;1
258211836510;258211837070;560;4;1;2;1;1;1
258211837070;258211894374;57304;-1;0;-1;0;1;1
258211894374;258211895092;718;4;1;2;1;1;1
258211895092;258211895459;367;-1;0;-1;0;1;1
258211895459;258211896547;1088;4;1;2;1;1;1
258211896547;258211940487;43940;-1;0;-1;0;1;1
258211940487;258211941126;639;4;1;2;1;1;1
258211941126;258211986613;45487;-1;0;-1;0;1;1
258211986613;258211987268;655;4;1;2;1;1;1
258211987268;258212020668;33400;-1;0;-1;0;1;1
258212020668;258212021915;1247;4;1;2;1;1;1
258212021915;258212054557;32642;-1;0;-1;0;1;1
258212054557;258212055167;610;4;1;2;1;1;1
258212055167;258212097019;41852;-1;0;-1;0;1;1
258212097019;258212098312;1293;4;1;2;1;1;1
258212098312;258212099132;820;-1;0;-1;0;1;1
258212099132;258212099686;554;4;1;2;1;1;1
258212099686;258212142485;42799;-1;0;-1;0;1;1
258212142485;258212144360;1875;4;1;2;1;1;1
258212144360;258212205831;61471;-1;0;-1;0;1;1
258212205831;258212206594;763;4;1;2;1;1;1
258212206594;258212206799;205;4;1;2;1;1;1
258212206799;258212214164;7365;4;1;2;1;1;1
258212214164;258212289514;75350;-1;0;-1;0;1;1
258212289514;258212290630;1116;4;1;2;1;1;1
258212290630;258212327346;36716;-1;0;-1;0;1;1
258212327346;258212327893;547;4;1;2;1;1;1
258212327893;258212406969;79076;-1;0;-1;0;1;1
258212406969;258212407875;906;4;1;2;1;1;1
258212407875;258212408313;438;-1;0;-1;0;1;1
258212408313;258212409135;822;4;1;2;1;1;1
258212409135;258212472016;62881;-1;0;-1;0;1;1
258212472016;258212472560;544;4;1;2;1;1;1
258212472560;258212512491;39931;-1;0;-1;0;1;1
258212512491;258212513160;669;4;1;2;1;1;1
258212513160;258212551690;38530;-1;0;-1;0;1;1
258212551690;258212552227;537;4;1;2;1;1;1
258212552227;258212587369;35142;-1;0;-1;0;1;1
258212587369;258212587910;541;4;1;2;1;1;1
258212587910;258212628267;40357;-1;0;-1;0;1;1
258212628267;258212628906;639;4;1;2;1;1;1
258212628906;258212737380;108474;-1;0;-1;0;1;1
258212737380;258212737868;488;4;1;2;1;1;1
258212737868;258212806848;68980;-1;0;-1;0;1;1
258212806848;258212813651;6803;4;1;2;1;1;1
258212813651;258212890639;76988;-1;0;-1;0;1;1
258212890639;258212891129;490;4;1;2;1;1;1
258212891129;258212939665;48536;-1;0;-1;0;1;1
258212939665;258212940290;625;4;1;2;1;1;1
258212940290;258212990860;50570;-1;0;-1;0;1;1
258212990860;258212991431;571;4;1;2;1;1;1
258212991431;258213060301;68870;-1;0;-1;0;1;1
258213060301;258213061824;1523;4;1;2;1;1;1
258213061824;258213061896;72;4;1;2;1;1;1
258213061896;258213062681;785;4;1;2;1;1;1
258213062681;258213129671;66990;-1;0;-1;0;1;1
258213129671;258213130305;634;4;1;2;1;1;1
258213130305;258213176001;45696;-1;0;-1;0;1;1
258213176001;258213176531;530;4;1;2;1;1;1
258213176531;258213187290;10759;-1;0;-1;0;1;1
258213187290;258213187836;546;4;1;2;1;1;1
258213187836;258213230355;42519;-1;0;-1;0;1;1
258213230355;258213230853;498;4;1;2;1;1;1
258213230853;258213270182;39329;-1;0;-1;0;1;1
258213270182;258213271196;1014;4;1;2;1;1;1
258213271196;258213349699;78503;-1;0;-1;0;1;1
258213349699;258213354307;4608;4;1;2;1;1;1
258213354307;258213386090;31783;-1;0;-1;0;1;1
258213386090;258213386625;535;4;1;2;1;1;1
258213386625;258213472472;85847;-1;0;-1;0;1;1
258213472472;258213473009;537;4;1;2;1;1;1
258213473009;258213515735;42726;-1;0;-1;0;1;1
258213515735;258213516578;843;4;1;2;1;1;1
258213516578;258213565266;48688;-1;0;-1;0;1;1
258213565266;258213566071;805;4;1;2;1;1;1
258213566071;258213566268;197;-1;0;-1;0;1;1
258213566268;258213568685;2417;4;1;2;1;1;1
258213568685;258213643253;74568;-1;0;-1;0;1;1
258213643253;258213643868;615;4;1;2;1;1;1
258213643868;258213684079;40211;-1;0;-1;0;1;1
258213684079;258213684760;681;4;1;2;1;1;1
258213684760;258213731757;46997;-1;0;-1;0;1;1
258213731757;258213732396;639;4;1;2;1;1;1
258213732396;258213802801;70405;-1;0;-1;0;1;1
258213802801;258213804670;1869;4;1;2;1;1;1
258213804670;258213851221;46551;-1;0;-1;0;1;1
258213851221;258213851773;552;4;1;2;1;1;1
258213851773;258213898710;46937;-1;0;-1;0;1;1
258213898710;258213899316;606;4;1;2;1;1;1
258213899316;258213937320;38004;-1;0;-1;0;1;1
258213937320;258213938203;883;4;1;2;1;1;1
258213938203;258213971443;33240;-1;0;-1;0;1;1
258213971443;258213972006;563;4;1;2;1;1;1
258213972006;258213973222;1216;4;1;2;1;1;1
258213973222;258213973725;503;4;1;2;1;1;1
258213973725;258214043871;70146;-1;0;-1;0;1;1
258214043871;258214044456;585;4;1;2;1;1;1
258214044456;258214045366;910;-1;0;-1;0;1;1
258214045366;258214046003;637;4;1;2;1;1;1
258214046003;258214106452;60449;-1;0;-1;0;1;1
258214106452;258214107085;633;4;1;2;1;1;1
258214107085;258214185618;78533;-1;0;-1;0;1;1
258214185618;258214186264;646;4;1;2;1;1;1
258214186264;258214230745;44481;-1;0;-1;0;1;1
258214230745;258214231636;891;4;1;2;1;1;1
258214231636;258214291432;59796;-1;0;-1;0;1;1
258214291432;258214292686;1254;4;1;2;1;1;1
258214292686;258214328511;35825;-1;0;-1;0;1;1
258214328511;258214329113;602;4;1;2;1;1;1
258214329113;258214375503;46390;-1;0;-1;0;1;1
258214375503;258214376136;633;4;1;2;1;1;1
258214376136;258214424408;48272;-1;0;-1;0;1;1
258214424408;258214426370;1962;4;1;2;1;1;1
258214426370;258214467817;41447;-1;0;-1;0;1;1
258214467817;258214468365;548;4;1;2;1;1;1
258214468365;258214513256;44891;-1;0;-1;0;1;1
258214513256;258214513932;676;4;1;2;1;1;1
258214513932;258214554710;40778;-1;0;-1;0;1;1
258214554710;258214555267;557;4;1;2;1;1;1
258214555267;258214615538;60271;-1;0;-1;0;1;1
258214615538;258214616349;811;4;1;2;1;1;1
258214616349;258214616389;40;-1;0;-1;0;1;1
258214616389;258214617374;985;4;1;2;1;1;1
258214617374;258214674720;57346;-1;0;-1;0;1;1
258214674720;258214675356;636;4;1;2;1;1;1
258214675356;258214745353;69997;-1;0;-1;0;1;1
258214745353;258214745990;637;4;1;2;1;1;1
258214745990;258214786502;40512;-1;0;-1;0;1;1
258214786502;258214787136;634;4;1;2;1;1;1
258214787136;258214835441;48305;-1;0;-1;0;1;1
258214835441;258214836040;599;4;1;2;1;1;1
258214836040;258214908654;72614;-1;0;-1;0;1;1
258214908654;258214909204;550;4;1;2;1;1;1
258214909204;258214987477;78273;-1;0;-1;0;1;1
258214987477;258214988018;541;4;1;2;1;1;1
258214988018;258215150411;162393;-1;0;-1;0;1;1
258215150411;258215150979;568;4;1;2;1;1;1
258215150979;258215221621;70642;-1;0;-1;0;1;1
258215221621;258215222261;640;4;1;2;1;1;1
258215222261;258215293230;70969;-1;0;-1;0;1;1
258215293230;258215293828;598;4;1;2;1;1;1
258215293828;258215343649;49821;-1;0;-1;0;1;1
258215343649;258215347415;3766;4;1;2;1;1;1
258215347415;258215348326;911;-1;0;-1;0;1;1
258215348326;258215349079;753;4;1;2;1;1;1
258215349079;258215349155;76;-1;0;-1;0;1;1
258215349155;258215349597;442;4;1;2;1;1;1
258215349597;258215350359;762;4;1;2;1;1;1
258215350359;258215350371;12;4;1;2;1;1;1
258215350371;258215410343;59972;-1;0;-1;0;1;1
258215410343;258215410990;647;4;1;2;1;1;1
258215410990;258215411325;335;-1;0;-1;0;1;1
258215411325;258215412072;747;4;1;2;1;1;1
258215412072;258215490639;78567;-1;0;-1;0;1;1
258215490639;258215491196;557;4;1;2;1;1;1
258215491196;258215536363;45167;-1;0;-1;0;1;1
258215536363;258215536994;631;4;1;2;1;1;1
258215536994;258215575740;38746;-1;0;-1;0;1;1
258215575740;258215576373;633;4;1;2;1;1;1
258215576373;258215628540;52167;-1;0;-1;0;1;1
258215628540;258215629233;693;4;1;2;1;1;1
258215629233;258215630015;782;4;1;2;1;1;1
258215630015;258215630562;547;4;1;2;1;1;1
258215630562;258215631901;1339;-1;0;-1;0;1;1
258215631901;258215632538;637;4;1;2;1;1;1
258215632538;258215676272;43734;-1;0;-1;0;1;1
258215676272;258215676803;531;4;1;2;1;1;1
258215676803;258215715971;39168;-1;0;-1;0;1;1
258215715971;258215716525;554;4;1;2;1;1;1
258215716525;258215762732;46207;-1;0;-1;0;1;1
258215762732;258215763229;497;4;1;2;1;1;1
258215763229;258215803919;40690;-1;0;-1;0;1;1
258215803919;258215804486;567;4;1;2;1;1;1
258215804486;258215872465;67979;-1;0;-1;0;1;1
258215872465;258215873069;604;4;1;2;1;1;1
258215873069;258215964125;91056;-1;0;-1;0;1;1
258215964125;258215964762;637;4;1;2;1;1;1
258215964762;258216032140;67378;-1;0;-1;0;1;1
258216032140;258216032745;605;4;1;2;1;1;1
258216032745;258216070206;37461;-1;0;-1;0;1;1
258216070206;258216071602;1396;4;1;2;1;1;1
258216071602;258216147975;76373;-1;0;-1;0;1;1
258216147975;258216148664;689;4;1;2;1;1;1
258216148664;258216192184;43520;-1;0;-1;0;1;1
258216192184;258216193082;898;4;1;2;1;1;1
258216193082;258216227682;34600;-1;0;-1;0;1;1
258216227682;258216228272;590;4;1;2;1;1;1
258216228272;258216296418;68146;-1;0;-1;0;1;1
258216296418;258216296969;551;4;1;2;1;1;1
258216296969;258216332103;35134;-1;0;-1;0;1;1
258216332103;258216332757;654;4;1;2;1;1;1
258216332757;258216440136;107379;-1;0;-1;0;1;1
258216440136;258216440811;675;4;1;2;1;1;1
258216440811;258216478324;37513;-1;0;-1;0;1;1
258216478324;258216479497;1173;4;1;2;1;1;1
258216479497;258216540779;61282;-1;0;-1;0;1;1
258216540779;258216541427;648;4;1;2;1;1;1
258216541427;258216696064;154637;-1;0;-1;0;1;1
258216696064;258216696695;631;4;1;2;1;1;1
258216696695;258216737931;41236;-1;0;-1;0;1;1
258216737931;258216738541;610;4;1;2;1;1;1
258216738541;258216788356;49815;-1;0;-1;0;1;1
258216788356;258216788905;549;4;1;2;1;1;1
258216788905;258216849681;60776;-1;0;-1;0;1;1
258216849681;258216850163;482;4;1;2;1;1;1
258216850163;258216860746;10583;-1;0;-1;0;1;1
258216860746;258216861730;984;4;1;2;1;1;1
258216861730;258216904817;43087;-1;0;-1;0;1;1
258216904817;258216906893;2076;4;1;2;1;1;1
258216906893;258216933627;26734;-1;0;-1;0;1;1
258216933627;258216934186;559;4;1;2;1;1;1
258216934186;258217161573;227387;-1;0;-1;0;1;1
258217161573;258217162123;550;4;1;2;1;1;1
258217162123;258217232148;70025;-1;0;-1;0;1;1
258217232148;258217233172;1024;4;1;2;1;1;1
258217233172;258217281925;48753;-1;0;-1;0;1;1
258217281925;258217282420;495;4;1;2;1;1;1
258217282420;258217615505;333085;-1;0;-1;0;1;1
258217615505;258217616004;499;4;1;2;1;1;1
258217616004;258217662142;46138;-1;0;-1;0;1;1
258217662142;258217662639;497;4;1;2;1;1;1
258217662639;258217731993;69354;-1;0;-1;0;1;1
258217731993;258217732525;532;4;1;2;1;1;1
258217732525;258217791260;58735;-1;0;-1;0;1;1
258217791260;258217791815;555;4;1;2;1;1;1
258217791815;258217791929;114;-1;0;-1;0;1;1
258217791929;258217792832;903;4;1;2;1;1;1
258217792832;258217869437;76605;-1;0;-1;0;1;1
258217869437;258217869904;467;4;1;2;1;1;1
258217869904;258217917979;48075;-1;0;-1;0;1;1
258217917979;258217918438;459;4;1;2;1;1;1
258217918438;258217969332;50894;-1;0;-1;0;1;1
258217969332;258217969967;635;4;1;2;1;1;1
258217969967;258218002863;32896;-1;0;-1;0;1;1
258218002863;258218003325;462;4;1;2;1;1;1
258218003325;258218064487;61162;-1;0;-1;0;1;1
258218064487;258218065141;654;4;1;2;1;1;1
258218065141;258218227244;162103;-1;0;-1;0;1;1
258218227244;258218228054;810;4;1;2;1;1;1
258218228054;258218230735;2681;-1;0;-1;0;1;1
258218230735;258218231625;890;4;1;2;1;1;1
258218231625;258218304114;72489;-1;0;-1;0;1;1
258218304114;258218304758;644;4;1;2;1;1;1
258218304758;258218389959;85201;-1;0;-1;0;1;1
258218389959;258218395384;5425;4;1;2;1;1;1
258218395384;258218432905;37521;-1;0;-1;0;1;1
258218432905;258218434114;1209;4;1;2;1;1;1
258218434114;258218453759;19645;-1;0;-1;0;1;1
258218453759;258218454361;602;4;1;2;1;1;1
258218454361;258218564569;110208;-1;0;-1;0;1;1
258218564569;258218565214;645;4;1;2;1;1;1
258218565214;258218637221;72007;-1;0;-1;0;1;1
258218637221;258218637690;469;4;1;2;1;1;1
258218637690;258218677579;39889;-1;0;-1;0;1;1
258218677579;258218678725;1146;4;1;2;1;1;1
258218678725;258218720856;42131;-1;0;-1;0;1;1
258218720856;258218721331;475;4;1;2;1;1;1
258218721331;258218792743;71412;-1;0;-1;0;1;1
258218792743;258218793898;1155;4;1;2;1;1;1
258218793898;258218832984;39086;-1;0;-1;0;1;1
258218832984;258218833535;551;4;1;2;1;1;1
258218833535;258218878353;44818;-1;0;-1;0;1;1
258218878353;258218879310;957;4;1;2;1;1;1
258218879310;258218882073;2763;-1;0;-1;0;1;1
258218882073;258218883065;992;4;1;2;1;1;1
258218883065;258218883427;362;-1;0;-1;0;1;1
258218883427;258218884323;896;4;1;2;1;1;1
258218884323;258218921825;37502;-1;0;-1;0;1;1
258218921825;258218922419;594;4;1;2;1;1;1
258218922419;258218968665;46246;-1;0;-1;0;1;1
258218968665;258218969162;497;4;1;2;1;1;1
258218969162;258219048825;79663;-1;0;-1;0;1;1
258219048825;258219049375;550;4;1;2;1;1;1
258219049375;258219088710;39335;-1;0;-1;0;1;1
258219088710;258219089261;551;4;1;2;1;1;1
258219089261;258219124730;35469;-1;0;-1;0;1;1
258219124730;258219125288;558;4;1;2;1;1;1
258219125288;258219135923;10635;-1;0;-1;0;1;1
258219135923;258219136469;546;4;1;2;1;1;1
258219136469;258219247174;110705;-1;0;-1;0;1;1
258219247174;258219247775;601;4;1;2;1;1;1
258219247775;258219247842;67;4;1;2;1;1;1
258219247842;258219248633;791;4;1;2;1;1;1
258219248633;258219322374;73741;-1;0;-1;0;1;1
258219322374;258219322840;466;4;1;2;1;1;1
258219322840;258219361677;38837;-1;0;-1;0;1;1
258219361677;258219362140;463;4;1;2;1;1;1
258219362140;258219438654;76514;-1;0;-1;0;1;1
258219438654;258219439253;599;4;1;2;1;1;1
258219439253;258219547251;107998;-1;0;-1;0;1;1
258219547251;258219547804;553;4;1;2;1;1;1
258219547804;258219609394;61590;-1;0;-1;0;1;1
258219609394;258219610257;863;4;1;2;1;1;1
258219610257;258219672368;62111;-1;0;-1;0;1;1
258219672368;258219672933;565;4;1;2;1;1;1
258219672933;258219736187;63254;-1;0;-1;0;1;1
258219736187;258219736733;546;4;1;2;1;1;1
258219736733;258219775882;39149;-1;0;-1;0;1;1
258219775882;258219776432;550;4;1;2;1;1;1
258219776432;258219829736;53304;-1;0;-1;0;1;1
258219829736;258219830393;657;4;1;2;1;1;1
258219830393;258219832696;2303;-1;0;-1;0;1;1
258219832696;258219833708;1012;4;1;2;1;1;1
258219833708;258219916537;82829;-1;0;-1;0;1;1
258219916537;258219917077;540;4;1;2;1;1;1
258219917077;258219954957;37880;-1;0;-1;0;1;1
258219954957;258219956090;1133;4;1;2;1;1;1
258219956090;258219992263;36173;-1;0;-1;0;1;1
258219992263;258219992861;598;4;1;2;1;1;1
258219992861;258220074560;81699;-1;0;-1;0;1;1
258220074560;258220075204;644;4;1;2;1;1;1
258220075204;258220075565;361;-1;0;-1;0;1;1
258220075565;258220076227;662;4;1;2;1;1;1
258220076227;258220112594;36367;-1;0;-1;0;1;1
258220112594;258220113195;601;4;1;2;1;1;1
258220113195;258220168126;54931;-1;0;-1;0;1;1
258220168126;258220168754;628;4;1;2;1;1;1
258220168754;258220219403;50649;-1;0;-1;0;1;1
258220219403;258220219964;561;4;1;2;1;1;1
258220219964;258220266545;46581;-1;0;-1;0;1;1
258220266545;258220267193;648;4;1;2;1;1;1
258220267193;258220397940;130747;-1;0;-1;0;1;1
258220397940;258220398790;850;4;1;2;1;1;1
258220398790;258220441217;42427;-1;0;-1;0;1;1
258220441217;258220441821;604;4;1;2;1;1;1
258220441821;258220442328;507;-1;0;-1;0;1;1
258220442328;258220442964;636;4;1;2;1;1;1
258220442964;258220480706;37742;-1;0;-1;0;1;1
258220480706;258220482134;1428;4;1;2;1;1;1
258220482134;258220567794;85660;-1;0;-1;0;1;1
258220567794;258220568766;972;4;1;2;1;1;1
258220568766;258220635286;66520;-1;0;-1;0;1;1
258220635286;258220635840;554;4;1;2;1;1;1
258220635840;258220681258;45418;-1;0;-1;0;1;1
258220681258;258220681837;579;4;1;2;1;1;1
258220681837;258220721763;39926;-1;0;-1;0;1;1
258220721763;258220722523;760;4;1;2;1;1;1
258220722523;258220733479;10956;-1;0;-1;0;1;1
258220733479;258220734048;569;4;1;2;1;1;1
258220734048;258220774406;40358;-1;0;-1;0;1;1
258220774406;258220775008;602;4;1;2;1;1;1
258220775008;258220837452;62444;-1;0;-1;0;1;1
258220837452;258220837852;400;4;1;2;1;1;1
258220837852;258220838399;547;4;1;2;1;1;1
258220838399;258220839633;1234;4;1;2;1;1;1
258220839633;258220880928;41295;-1;0;-1;0;1;1
258220880928;258220881565;637;4;1;2;1;1;1
258220881565;258220959522;77957;-1;0;-1;0;1;1
258220959522;258220960084;562;4;1;2;1;1;1
258220960084;258221026213;66129;-1;0;-1;0;1;1
258221026213;258221026849;636;4;1;2;1;1;1
258221026849;258221068673;41824;-1;0;-1;0;1;1
258221068673;258221069236;563;4;1;2;1;1;1
258221069236;258221111866;42630;-1;0;-1;0;1;1
258221111866;258221112499;633;4;1;2;1;1;1
258221112499;258221155908;43409;-1;0;-1;0;1;1
258221155908;258221156526;618;4;1;2;1;1;1
258221156526;258221202429;45903;-1;0;-1;0;1;1
258221202429;258221203033;604;4;1;2;1;1;1
258221203033;258221264385;61352;-1;0;-1;0;1;1
258221264385;258221264950;565;4;1;2;1;1;1
258221264950;258221265405;455;-1;0;-1;0;1;1
258221265405;258221266034;629;4;1;2;1;1;1
258221266034;258221302235;36201;-1;0;-1;0;1;1
258221302235;258221302862;627;4;1;2;1;1;1
258221302862;258221348429;45567;-1;0;-1;0;1;1
258221348429;258221349060;631;4;1;2;1;1;1
258221349060;258221405239;56179;-1;0;-1;0;1;1
258221405239;258221405859;620;4;1;2;1;1;1
258221405859;258221453280;47421;-1;0;-1;0;1;1
258221453280;258221453750;470;4;1;2;1;1;1
258221453750;258221519195;65445;-1;0;-1;0;1;1
258221519195;258221519858;663;4;1;2;1;1;1
258221519858;258221570475;50617;-1;0;-1;0;1;1
258221570475;258221571004;529;4;1;2;1;1;1
258221571004;258221635015;64011;-1;0;-1;0;1;1
258221635015;258221635585;570;4;1;2;1;1;1
258221635585;258221715982;80397;-1;0;-1;0;1;1
258221715982;258221716914;932;4;1;2;1;1;1
258221716914;258221718172;1258;-1;0;-1;0;1;1
258221718172;258221718972;800;4;1;2;1;1;1
258221718972;258221854010;135038;-1;0;-1;0;1;1
258221854010;258221854487;477;4;1;2;1;1;1
258221854487;258221900448;45961;-1;0;-1;0;1;1
258221900448;258221901054;606;4;1;2;1;1;1
258221901054;258221957889;56835;-1;0;-1;0;1;1
258221957889;258221958926;1037;4;1;2;1;1;1
258221958926;258221992471;33545;-1;0;-1;0;1;1
258221992471;258221992994;523;4;1;2;1;1;1
258221992994;258222038056;45062;-1;0;-1;0;1;1
258222038056;258222039136;1080;4;1;2;1;1;1
258222039136;258222080934;41798;-1;0;-1;0;1;1
258222080934;258222083072;2138;4;1;2;1;1;1
258222083072;258222110536;27464;-1;0;-1;0;1;1
258222110536;258222111180;644;4;1;2;1;1;1
258222111180;258222153662;42482;-1;0;-1;0;1;1
258222153662;258222154286;624;4;1;2;1;1;1
258222154286;258222195242;40956;-1;0;-1;0;1;1
258222195242;258222196481;1239;4;1;2;1;1;1
258222196481;258222267559;71078;-1;0;-1;0;1;1
258222267559;258222268117;558;4;1;2;1;1;1
258222268117;258222311460;43343;-1;0;-1;0;1;1
258222311460;258222312450;990;4;1;2;1;1;1
258222312450;258222331183;18733;-1;0;-1;0;1;1
258222331183;258222331865;682;4;1;2;1;1;1
258222331865;258222373219;41354;-1;0;-1;0;1;1
258222373219;258222373819;600;4;1;2;1;1;1
258222373819;258222431341;57522;-1;0;-1;0;1;1
258222431341;258222431973;632;4;1;2;1;1;1
258222431973;258222565261;133288;-1;0;-1;0;1;1
258222565261;258222565822;561;4;1;2;1;1;1
258222565822;258222614660;48838;-1;0;-1;0;1;1
258222614660;258222615976;1316;4;1;2;1;1;1
258222615976;258222688857;72881;-1;0;-1;0;1;1
258222688857;258222689424;567;4;1;2;1;1;1
258222689424;258222689451;27;-1;0;-1;0;1;1
258222689451;258222690326;875;4;1;2;1;1;1
258222690326;258222763667;73341;-1;0;-1;0;1;1
258222763667;258222764218;551;4;1;2;1;1;1
258222764218;258222820465;56247;-1;0;-1;0;1;1
258222820465;258222821110;645;4;1;2;1;1;1
258222821110;258222880002;58892;-1;0;-1;0;1;1
258222880002;258222881407;1405;4;1;2;1;1;1
258222881407;258222926522;45115;-1;0;-1;0;1;1
258222926522;258222927075;553;4;1;2;1;1;1
258222927075;258223003308;76233;-1;0;-1;0;1;1
258223003308;258223004175;867;4;1;2;1;1;1
258223004175;258223034135;29960;-1;0;-1;0;1;1
258223034135;258223034745;610;4;1;2;1;1;1
258223034745;258223081622;46877;-1;0;-1;0;1;1
258223081622;258223082228;606;4;1;2;1;1;1
258223082228;258223121943;39715;-1;0;-1;0;1;1
258223121943;258223122778;835;4;1;2;1;1;1
258223122778;258223279681;156903;-1;0;-1;0;1;1
258223279681;258223280223;542;4;1;2;1;1;1
258223280223;258223349868;69645;-1;0;-1;0;1;1
258223349868;258223350703;835;4;1;2;1;1;1
258223350703;258223351359;656;-1;0;-1;0;1;1
258223351359;258223351979;620;4;1;2;1;1;1
258223351979;258223382037;30058;-1;0;-1;0;1;1
258223382037;258223383399;1362;4;1;2;1;1;1
258223383399;258223453545;70146;-1;0;-1;0;1;1
258223453545;258223454072;527;4;1;2;1;1;1
258223454072;258223561757;107685;-1;0;-1;0;1;1
258223561757;258223562381;624;4;1;2;1;1;1
258223562381;258223604124;41743;-1;0;-1;0;1;1
258223604124;258223605845;1721;4;1;2;1;1;1
258223605845;258223691484;85639;-1;0;-1;0;1;1
258223691484;258223691931;447;4;1;2;1;1;1
258223691931;258223692572;641;4;1;2;1;1;1
258223692572;258223693178;606;4;1;2;1;1;1
258223693178;258223742353;49175;-1;0;-1;0;1;1
258223742353;258223744302;1949;4;1;2;1;1;1
258223744302;258223829050;84748;-1;0;-1;0;1;1
258223829050;258223829693;643;4;1;2;1;1;1
258223829693;258223902776;73083;-1;0;-1;0;1;1
258223902776;258223903255;479;4;1;2;1;1;1
258223903255;258223934469;31214;-1;0;-1;0;1;1
258223934469;258223934923;454;4;1;2;1;1;1
258223934923;258223965577;30654;-1;0;-1;0;1;1
258223965577;258223966045;468;4;1;2;1;1;1
258223966045;258223966498;453;-1;0;-1;0;1;1
258223966498;258223967119;621;4;1;2;1;1;1
258223967119;258223984807;17688;-1;0;-1;0;1;1
258223984807;258223984954;147;4;1;2;1;1;1
258223984954;258223986313;1359;4;1;2;1;1;1
258223986313;258223986603;290;4;1;2;1;1;1
258223986603;258223986774;171;4;1;2;1;1;1
258223986774;258223988320;1546;4;1;2;1;1;1
258223988320;258224017515;29195;-1;0;-1;0;1;1
258224017515;258224018752;1237;4;1;2;1;1;1
258224018752;258224086277;67525;-1;0;-1;0;1;1
258224086277;258224087400;1123;4;1;2;1;1;1
258224087400;258224088427;1027;-1;0;-1;0;1;1
258224088427;258224088956;529;4;1;2;1;1;1
258224088956;258224175673;86717;-1;0;-1;0;1;1
258224175673;258224176312;639;4;1;2;1;1;1
258224176312;258224217797;41485;-1;0;-1;0;1;1
258224217797;258224218431;634;4;1;2;1;1;1
258224218431;258224265075;46644;-1;0;-1;0;1;1
258224265075;258224265617;542;4;1;2;1;1;1
258224265617;258224308817;43200;-1;0;-1;0;1;1
258224308817;258224309371;554;4;1;2;1;1;1
258224309371;258224352820;43449;-1;0;-1;0;1;1
258224352820;258224353344;524;4;1;2;1;1;1
258224353344;258224383107;29763;-1;0;-1;0;1;1
258224383107;258224383674;567;4;1;2;1;1;1
258224383674;258224424548;40874;-1;0;-1;0;1;1
258224424548;258224424792;244;4;1;2;1;1;1
258224424792;258224425345;553;4;1;2;1;1;1
258224425345;258224425717;372;4;1;2;1;1;1
258224425717;258224566074;140357;-1;0;-1;0;1;1
258224566074;258224566785;711;4;1;2;1;1;1
258224566785;258224608405;41620;-1;0;-1;0;1;1
258224608405;258224609038;633;4;1;2;1;1;1
258224609038;258224609814;776;-1;0;-1;0;1;1
258224609814;258224610608;794;4;1;2;1;1;1
258224610608;258224649019;38411;-1;0;-1;0;1;1
258224649019;258224649682;663;4;1;2;1;1;1
258224649682;258224813687;164005;-1;0;-1;0;1;1
258224813687;258224814502;815;4;1;2;1;1;1
258224814502;258224855078;40576;-1;0;-1;0;1;1
258224855078;258224855629;551;4;1;2;1;1;1
258224855629;258224883955;28326;-1;0;-1;0;1;1
258224883955;258224884586;631;4;1;2;1;1;1
258224884586;258224938715;54129;-1;0;-1;0;1;1
258224938715;258224939421;706;4;1;2;1;1;1
258224939421;258224940347;926;-1;0;-1;0;1;1
258224940347;258224940980;633;4;1;2;1;1;1
258224940980;258224998515;57535;-1;0;-1;0;1;1
258224998515;258224999442;927;4;1;2;1;1;1
258224999442;258225050330;50888;-1;0;-1;0;1;1
258225050330;258225051397;1067;4;1;2;1;1;1
258225051397;258225172277;120880;-1;0;-1;0;1;1
258225172277;258225172833;556;4;1;2;1;1;1
258225172833;258225237203;64370;-1;0;-1;0;1;1
258225237203;258225237744;541;4;1;2;1;1;1
258225237744;258225336327;98583;-1;0;-1;0;1;1
258225336327;258225336888;561;4;1;2;1;1;1
258225336888;258225337321;433;-1;0;-1;0;1;1
258225337321;258225337985;664;4;1;2;1;1;1
258225337985;258225372770;34785;-1;0;-1;0;1;1
258225372770;258225388312;15542;4;1;2;1;1;1
258225388312;258225408656;20344;-1;0;-1;0;1;1
258225408656;258225409207;551;4;1;2;1;1;1
258225409207;258225451649;42442;-1;0;-1;0;1;1
258225451649;258225452330;681;4;1;2;1;1;1
258225452330;258225452437;107;-1;0;-1;0;1;1
258225452437;258225453469;1032;4;1;2;1;1;1
258225453469;258225520217;66748;-1;0;-1;0;1;1
258225520217;258225520849;632;4;1;2;1;1;1
258225520849;258225558469;37620;-1;0;-1;0;1;1
258225558469;258225558935;466;4;1;2;1;1;1
258225558935;258225735604;176669;-1;0;-1;0;1;1
258225735604;258225736066;462;4;1;2;1;1;1
258225736066;258225774297;38231;-1;0;-1;0;1;1
258225774297;258225774842;545;4;1;2;1;1;1
258225774842;258225856163;81321;-1;0;-1;0;1;1
258225856163;258225856792;629;4;1;2;1;1;1
258225856792;258225910717;53925;-1;0;-1;0;1;1
258225910717;258225911185;468;4;1;2;1;1;1
258225911185;258225955731;44546;-1;0;-1;0;1;1
258225955731;258225956324;593;4;1;2;1;1;1
258225956324;258225956363;39;-1;0;-1;0;1;1
258225956363;258225957158;795;4;1;2;1;1;1
258225957158;258225998898;41740;-1;0;-1;0;1;1
258225998898;258225999456;558;4;1;2;1;1;1
258225999456;258226096201;96745;-1;0;-1;0;1;1
258226096201;258226097031;830;4;1;2;1;1;1
258226097031;258226167332;70301;-1;0;-1;0;1;1
258226167332;258226167877;545;4;1;2;1;1;1
258226167877;258226213414;45537;-1;0;-1;0;1;1
258226213414;258226214046;632;4;1;2;1;1;1
258226214046;258226307587;93541;-1;0;-1;0;1;1
258226307587;258226308870;1283;4;1;2;1;1;1
258226308870;258226309688;818;-1;0;-1;0;1;1
258226309688;258226310362;674;4;1;2;1;1;1
258226310362;258226310832;470;-1;0;-1;0;1;1
258226310832;258226311541;709;4;1;2;1;1;1
258226311541;258226350069;38528;-1;0;-1;0;1;1
258226350069;258226350635;566;4;1;2;1;1;1
258226350635;258226350806;171;-1;0;-1;0;1;1
258226350806;258226351467;661;4;1;2;1;1;1
258226351467;258226399141;47674;-1;0;-1;0;1;1
258226399141;258226399703;562;4;1;2;1;1;1
258226399703;258226437547;37844;-1;0;-1;0;1;1
258226437547;258226438184;637;4;1;2;1;1;1
258226438184;258226484767;46583;-1;0;-1;0;1;1
258226484767;258226485320;553;4;1;2;1;1;1
258226485320;258226535707;50387;-1;0;-1;0;1;1
258226535707;258226536336;629;4;1;2;1;1;1
258226536336;258226574794;38458;-1;0;-1;0;1;1
258226574794;258226575420;626;4;1;2;1;1;1
258226575420;258226612297;36877;-1;0;-1;0;1;1
258226612297;258226612943;646;4;1;2;1;1;1
258226612943;258226655472;42529;-1;0;-1;0;1;1
258226655472;258226701854;46382;4;1;2;1;1;1
258226701854;258226716993;15139;-1;0;-1;0;1;1
258226716993;258226717629;636;4;1;2;1;1;1
258226717629;258226756538;38909;-1;0;-1;0;1;1
258226756538;258226757142;604;4;1;2;1;1;1
258226757142;258226830078;72936;-1;0;-1;0;1;1
258226830078;258226830690;612;4;1;2;1;1;1
258226830690;258226876461;45771;-1;0;-1;0;1;1
258226876461;258226877097;636;4;1;2;1;1;1
258226877097;258226962649;85552;-1;0;-1;0;1;1
258226962649;258226963181;532;4;1;2;1;1;1
258226963181;258227003300;40119;-1;0;-1;0;1;1
258227003300;258227003399;99;4;1;2;1;1;1
258227003399;258227004055;656;4;1;2;1;1;1
258227004055;258227004129;74;4;1;2;1;1;1
258227004129;258227004719;590;-1;0;-1;0;1;1
258227004719;258227005541;822;4;1;2;1;1;1
258227005541;258227046514;40973;-1;0;-1;0;1;1
258227046514;258227047026;512;4;1;2;1;1;1
258227047026;258227093231;46205;-1;0;-1;0;1;1
258227093231;258227093696;465;4;1;2;1;1;1
258227093696;258227144365;50669;-1;0;-1;0;1;1
258227144365;258227144994;629;4;1;2;1;1;1
258227144994;258227194845;49851;-1;0;-1;0;1;1
258227194845;258227195795;950;4;1;2;1;1;1
258227195795;258227196717;922;-1;0;-1;0;1;1
258227196717;258227197350;633;4;1;2;1;1;1
258227197350;258227314492;117142;-1;0;-1;0;1;1
258227314492;258227315441;949;4;1;2;1;1;1
258227315441;258227351847;36406;-1;0;-1;0;1;1
258227351847;258227352390;543;4;1;2;1;1;1
258227352390;258227392075;39685;-1;0;-1;0;1;1
258227392075;258227392563;488;4;1;2;1;1;1
258227392563;258227437417;44854;-1;0;-1;0;1;1
258227437417;258227437888;471;4;1;2;1;1;1
258227437888;258227460613;22725;-1;0;-1;0;1;1
258227460613;258227461171;558;4;1;2;1;1;1
258227461171;258227510367;49196;-1;0;-1;0;1;1
258227510367;258227511012;645;4;1;2;1;1;1
258227511012;258227680521;169509;-1;0;-1;0;1;1
258227680521;258227681133;612;4;1;2;1;1;1
258227681133;258227810581;129448;-1;0;-1;0;1;1
258227810581;258227811219;638;4;1;2;1;1;1
258227811219;258227852769;41550;-1;0;-1;0;1;1
258227852769;258227853592;823;4;1;2;1;1;1
258227853592;258227864318;10726;-1;0;-1;0;1;1
258227864318;258227864946;628;4;1;2;1;1;1
258227864946;258227903958;39012;-1;0;-1;0;1;1
258227903958;258227904511;553;4;1;2;1;1;1
258227904511;258227943659;39148;-1;0;-1;0;1;1
258227943659;258227944183;524;4;1;2;1;1;1
258227944183;258227989963;45780;-1;0;-1;0;1;1
258227989963;258227991100;1137;4;1;2;1;1;1
258227991100;258228038827;47727;-1;0;-1;0;1;1
258228038827;258228039371;544;4;1;2;1;1;1
258228039371;258228075227;35856;-1;0;-1;0;1;1
258228075227;258228075862;635;4;1;2;1;1;1
258228075862;258228155624;79762;-1;0;-1;0;1;1
258228155624;258228156828;1204;4;1;2;1;1;1
258228156828;258228282568;125740;-1;0;-1;0;1;1
258228282568;258228284436;1868;4;1;2;1;1;1
258228284436;258228285954;1518;-1;0;-1;0;1;1
258228285954;258228286971;1017;4;1;2;1;1;1
258228286971;258228378955;91984;-1;0;-1;0;1;1
258228378955;258228380051;1096;4;1;2;1;1;1
258228380051;258228484803;104752;-1;0;-1;0;1;1
258228484803;258228485623;820;4;1;2;1;1;1
258228485623;258228485654;31;-1;0;-1;0;1;1
258228485654;258228487712;2058;4;1;2;1;1;1
258228487712;258228495188;7476;-1;0;-1;0;1;1
258228495188;258228495741;553;4;1;2;1;1;1
258228495741;258228540695;44954;-1;0;-1;0;1;1
258228540695;258228542027;1332;4;1;2;1;1;1
258228542027;258228604021;61994;-1;0;-1;0;1;1
258228604021;258228604627;606;4;1;2;1;1;1
258228604627;258228696753;92126;-1;0;-1;0;1;1
258228696753;258228697403;650;4;1;2;1;1;1
258228697403;258228741642;44239;-1;0;-1;0;1;1
258228741642;258228742170;528;4;1;2;1;1;1
258228742170;258228784180;42010;-1;0;-1;0;1;1
258228784180;258228784776;596;4;1;2;1;1;1
258228784776;258228865372;80596;-1;0;-1;0;1;1
258228865372;258228867107;1735;4;1;2;1;1;1
258228867107;258228903444;36337;-1;0;-1;0;1;1
258228903444;258228904053;609;4;1;2;1;1;1
258228904053;258228942861;38808;-1;0;-1;0;1;1
258228942861;258228943328;467;4;1;2;1;1;1
258228943328;258228974250;30922;-1;0;-1;0;1;1
258228974250;258228974870;620;4;1;2;1;1;1
258228974870;258228978315;3445;-1;0;-1;0;1;1
258228978315;258228978858;543;4;1;2;1;1;1
258228978858;258229094564;115706;-1;0;-1;0;1;1
258229094564;258229096028;1464;4;1;2;1;1;1
258229096028;258229097527;1499;-1;0;-1;0;1;1
258229097527;258229097765;238;4;1;2;1;1;1
258229097765;258229098352;587;4;1;2;1;1;1
258229098352;258229098982;630;4;1;2;1;1;1
258229098982;258229161737;62755;-1;0;-1;0;1;1
258229161737;258229162674;937;4;1;2;1;1;1
258229162674;258229209467;46793;-1;0;-1;0;1;1
258229209467;258229210119;652;4;1;2;1;1;1
258229210119;258229239373;29254;-1;0;-1;0;1;1
258229239373;258229240204;831;4;1;2;1;1;1
258229240204;258229291544;51340;-1;0;-1;0;1;1
258229291544;258229292102;558;4;1;2;1;1;1
258229292102;258229323700;31598;-1;0;-1;0;1;1
258229323700;258229324254;554;4;1;2;1;1;1
258229324254;258229357748;33494;-1;0;-1;0;1;1
258229357748;258229358347;599;4;1;2;1;1;1
258229358347;258229386813;28466;-1;0;-1;0;1;1
258229386813;258229387365;552;4;1;2;1;1;1
258229387365;258229440488;53123;-1;0;-1;0;1;1
258229440488;258229441110;622;4;1;2;1;1;1
258229441110;258229602768;161658;-1;0;-1;0;1;1
258229602768;258229603846;1078;4;1;2;1;1;1
258229603846;258229686674;82828;-1;0;-1;0;1;1
258229686674;258229687485;811;4;1;2;1;1;1
258229687485;258229760909;73424;-1;0;-1;0;1;1
258229760909;258229761548;639;4;1;2;1;1;1
258229761548;258229787850;26302;-1;0;-1;0;1;1
258229787850;258229788482;632;4;1;2;1;1;1
258229788482;258229841445;52963;-1;0;-1;0;1;1
258229841445;258229843105;1660;4;1;2;1;1;1
258229843105;258229955155;112050;-1;0;-1;0;1;1
258229955155;258229955700;545;4;1;2;1;1;1
258229955700;258229997877;42177;-1;0;-1;0;1;1
258229997877;258229998659;782;4;1;2;1;1;1
258229998659;258230000268;1609;-1;0;-1;0;1;1
258230000268;258230000885;617;4;1;2;1;1;1
258230000885;258230010020;9135;-1;0;-1;0;1;1
258230010020;258230010444;424;4;1;2;1;1;1
258230010444;258230011302;858;4;1;2;1;1;1
258230011302;258230012095;793;4;1;2;1;1;1
258230012095;258230054777;42682;-1;0;-1;0;1;1
258230054777;258230055336;559;4;1;2;1;1;1
258230055336;258230101758;46422;-1;0;-1;0;1;1
258230101758;258230102308;550;4;1;2;1;1;1
258230102308;258230136517;34209;-1;0;-1;0;1;1
258230136517;258230137030;513;4;1;2;1;1;1
258230137030;258230207287;70257;-1;0;-1;0;1;1
258230207287;258230207320;33;4;1;2;1;1;1
258230207320;258230208133;813;4;1;2;1;1;1
258230208133;258230214912;6779;4;1;2;1;1;1
258230214912;258230215518;606;4;1;2;1;1;1
258230215518;258230215539;21;4;1;2;1;1;1
258230215539;258230257162;41623;-1;0;-1;0;1;1
258230257162;258230257719;557;4;1;2;1;1;1
258230257719;258230297535;39816;-1;0;-1;0;1;1
258230297535;258230297651;116;4;1;2;1;1;1
258230297651;258230299253;1602;4;1;2;1;1;1
258230299253;258230300503;1250;4;1;2;1;1;1
258230300503;258230334401;33898;-1;0;-1;0;1;1
258230334401;258230335056;655;4;1;2;1;1;1
258230335056;258230376830;41774;-1;0;-1;0;1;1
258230376830;258230377461;631;4;1;2;1;1;1
258230377461;258230413634;36173;-1;0;-1;0;1;1
258230413634;258230414092;458;4;1;2;1;1;1
258230414092;258230459739;45647;-1;0;-1;0;1;1
258230459739;258230460381;642;4;1;2;1;1;1
258230460381;258230505920;45539;-1;0;-1;0;1;1
258230505920;258230506542;622;4;1;2;1;1;1
258230506542;258230555930;49388;-1;0;-1;0;1;1
258230555930;258230557854;1924;4;1;2;1;1;1
258230557854;258230558532;678;-1;0;-1;0;1;1
258230558532;258230560816;2284;4;1;2;1;1;1
258230560816;258230562554;1738;-1;0;-1;0;1;1
258230562554;258230563577;1023;4;1;2;1;1;1
258230563577;258230564009;432;4;1;2;1;1;1
258230564009;258230564461;452;4;1;2;1;1;1
258230564461;258230564866;405;4;1;2;1;1;1
258230564866;258230567220;2354;4;1;2;1;1;1
258230567220;258230633776;66556;-1;0;-1;0;1;1
258230633776;258230634459;683;4;1;2;1;1;1
258230634459;258230645224;10765;-1;0;-1;0;1;1
258230645224;258230646069;845;4;1;2;1;1;1
258230646069;258230693082;47013;-1;0;-1;0;1;1
258230693082;258230693684;602;4;1;2;1;1;1
258230693684;258230771344;77660;-1;0;-1;0;1;1
258230771344;258230771966;622;4;1;2;1;1;1
258230771966;258230810220;38254;-1;0;-1;0;1;1
258230810220;258230810944;724;4;1;2;1;1;1
258230810944;258230810992;48;-1;0;-1;0;1;1
258230810992;258230812005;1013;4;1;2;1;1;1
258230812005;258230855509;43504;-1;0;-1;0;1;1
258230855509;258230856138;629;4;1;2;1;1;1
258230856138;258230903476;47338;-1;0;-1;0;1;1
258230903476;258230904524;1048;4;1;2;1;1;1
258230904524;258230944520;39996;-1;0;-1;0;1;1
258230944520;258230944732;212;4;1;2;1;1;1
258230944732;258230945761;1029;4;1;2;1;1;1
258230945761;258230946526;765;4;1;2;1;1;1
258230946526;258230991728;45202;-1;0;-1;0;1;1
258230991728;258230992225;497;4;1;2;1;1;1
258230992225;258230992443;218;4;1;2;1;1;1
258230992443;258230992806;363;4;1;2;1;1;1
258230992806;258231052410;59604;-1;0;-1;0;1;1
258231052410;258231052954;544;4;1;2;1;1;1
258231052954;258231113043;60089;-1;0;-1;0;1;1
258231113043;258231113601;558;4;1;2;1;1;1
258231113601;258231158964;45363;-1;0;-1;0;1;1
258231158964;258231159513;549;4;1;2;1;1;1
258231159513;258231191748;32235;-1;0;-1;0;1;1
258231191748;258231192397;649;4;1;2;1;1;1
258231192397;258231229033;36636;-1;0;-1;0;1;1
258231229033;258231229588;555;4;1;2;1;1;1
258231229588;258231300516;70928;-1;0;-1;0;1;1
258231300516;258231301149;633;4;1;2;1;1;1
258231301149;258231347738;46589;-1;0;-1;0;1;1
258231347738;258231348359;621;4;1;2;1;1;1
258231348359;258231348886;527;-1;0;-1;0;1;1
258231348886;258231349519;633;4;1;2;1;1;1
258231349519;258231387541;38022;-1;0;-1;0;1;1
258231387541;258231388099;558;4;1;2;1;1;1
258231388099;258231433595;45496;-1;0;-1;0;1;1
258231433595;258231434143;548;4;1;2;1;1;1
258231434143;258231482378;48235;-1;0;-1;0;1;1
258231482378;258231482987;609;4;1;2;1;1;1
258231482987;258231534763;51776;-1;0;-1;0;1;1
258231534763;258231535483;720;4;1;2;1;1;1
258231535483;258231535590;107;-1;0;-1;0;1;1
258231535590;258231536569;979;4;1;2;1;1;1
258231536569;258231568768;32199;-1;0;-1;0;1;1
258231568768;258231569369;601;4;1;2;1;1;1
258231569369;258231602656;33287;-1;0;-1;0;1;1
258231602656;258231603339;683;4;1;2;1;1;1
258231603339;258231651785;48446;-1;0;-1;0;1;1
258231651785;258231652341;556;4;1;2;1;1;1
258231652341;258231652631;290;-1;0;-1;0;1;1
258231652631;258231653250;619;4;1;2;1;1;1
258231653250;258231686429;33179;-1;0;-1;0;1;1
258231686429;258231687018;589;4;1;2;1;1;1
258231687018;258231731710;44692;-1;0;-1;0;1;1
258231731710;258231732366;656;4;1;2;1;1;1
258231732366;258231732889;523;-1;0;-1;0;1;1
258231732889;258231733472;583;4;1;2;1;1;1
258231733472;258231778490;45018;-1;0;-1;0;1;1
258231778490;258231779148;658;4;1;2;1;1;1
258231779148;258231779921;773;-1;0;-1;0;1;1
258231779921;258231780527;606;4;1;2;1;1;1
258231780527;258231846836;66309;-1;0;-1;0;1;1
258231846836;258231847355;519;4;1;2;1;1;1
258231847355;258231888287;40932;-1;0;-1;0;1;1
258231888287;258231888831;544;4;1;2;1;1;1
258231888831;258231930575;41744;-1;0;-1;0;1;1
258231930575;258231931201;626;4;1;2;1;1;1
258231931201;258232014670;83469;-1;0;-1;0;1;1
258232014670;258232015318;648;4;1;2;1;1;1
258232015318;258232134899;119581;-1;0;-1;0;1;1
258232134899;258232137195;2296;4;1;2;1;1;1
258232137195;258232140650;3455;-1;0;-1;0;1;1
258232140650;258232141287;637;4;1;2;1;1;1
258232141287;258232145309;4022;-1;0;-1;0;1;1
258232145309;258232145942;633;4;1;2;1;1;1
258232145942;258232194073;48131;-1;0;-1;0;1;1
258232194073;258232194701;628;4;1;2;1;1;1
258232194701;258232268819;74118;-1;0;-1;0;1;1
258232268819;258232269360;541;4;1;2;1;1;1
258232269360;258232392831;123471;-1;0;-1;0;1;1
258232392831;258232393375;544;4;1;2;1;1;1
258232393375;258232454540;61165;-1;0;-1;0;1;1
258232454540;258232455005;465;4;1;2;1;1;1
258232455005;258232506675;51670;-1;0;-1;0;1;1
258232506675;258232507640;965;4;1;2;1;1;1
258232507640;258232507659;19;4;1;2;1;1;1
258232507659;258232508345;686;4;1;2;1;1;1
258232508345;258232615111;106766;-1;0;-1;0;1;1
258232615111;258232615651;540;4;1;2;1;1;1
258232615651;258232660224;44573;-1;0;-1;0;1;1
258232660224;258232660787;563;4;1;2;1;1;1
258232660787;258232731317;70530;-1;0;-1;0;1;1
258232731317;258232732146;829;4;1;2;1;1;1
258232732146;258232732281;135;-1;0;-1;0;1;1
258232732281;258232734791;2510;4;1;2;1;1;1
258232734791;258232767848;33057;-1;0;-1;0;1;1
258232767848;258232768622;774;4;1;2;1;1;1
258232768622;258232777880;9258;-1;0;-1;0;1;1
258232777880;258232778511;631;4;1;2;1;1;1
258232778511;258232825293;46782;-1;0;-1;0;1;1
258232825293;258232825846;553;4;1;2;1;1;1
258232825846;258232893688;67842;-1;0;-1;0;1;1
258232893688;258232894325;637;4;1;2;1;1;1
258232894325;258232928718;34393;-1;0;-1;0;1;1
258232928718;258232929336;618;4;1;2;1;1;1
258232929336;258232929434;98;-1;0;-1;0;1;1
258232929434;258232930197;763;4;1;2;1;1;1
258232930197;258233046747;116550;-1;0;-1;0;1;1
258233046747;258233047622;875;4;1;2;1;1;1
258233047622;258233097029;49407;-1;0;-1;0;1;1
258233097029;258233097640;611;4;1;2;1;1;1
258233097640;258233141177;43537;-1;0;-1;0;1;1
258233141177;258233141839;662;4;1;2;1;1;1
258233141839;258233196306;54467;-1;0;-1;0;1;1
258233196306;258233197330;1024;4;1;2;1;1;1
258233197330;258233269900;72570;-1;0;-1;0;1;1
258233269900;258233271335;1435;4;1;2;1;1;1
258233271335;258233272766;1431;-1;0;-1;0;1;1
258233272766;258233274151;1385;4;1;2;1;1;1
258233274151;258233344175;70024;-1;0;-1;0;1;1
258233344175;258233344790;615;4;1;2;1;1;1
258233344790;258233430691;85901;-1;0;-1;0;1;1
258233430691;258233431177;486;4;1;2;1;1;1
258233431177;258233441887;10710;-1;0;-1;0;1;1
258233441887;258233442553;666;4;1;2;1;1;1
258233442553;258233485478;42925;-1;0;-1;0;1;1
258233485478;258233486522;1044;4;1;2;1;1;1
258233486522;258233529863;43341;-1;0;-1;0;1;1
258233529863;258233530354;491;4;1;2;1;1;1
258233530354;258233571401;41047;-1;0;-1;0;1;1
258233571401;258233571944;543;4;1;2;1;1;1
258233571944;258233677169;105225;-1;0;-1;0;1;1
258233677169;258233677798;629;4;1;2;1;1;1
258233677798;258233714932;37134;-1;0;-1;0;1;1
258233714932;258233715537;605;4;1;2;1;1;1
258233715537;258233762920;47383;-1;0;-1;0;1;1
258233762920;258233763838;918;4;1;2;1;1;1
258233763838;258233815255;51417;-1;0;-1;0;1;1
258233815255;258233815787;532;4;1;2;1;1;1
258233815787;258233846889;31102;-1;0;-1;0;1;1
258233846889;258233847441;552;4;1;2;1;1;1
258233847441;258233922311;74870;-1;0;-1;0;1;1
258233922311;258233922872;561;4;1;2;1;1;1
258233922872;258233924063;1191;-1;0;-1;0;1;1
258233924063;258233924581;518;4;1;2;1;1;1
258233924581;258233954474;29893;-1;0;-1;0;1;1
258233954474;258233955936;1462;4;1;2;1;1;1
258233955936;258233957705;1769;-1;0;-1;0;1;1
258233957705;258233958236;531;4;1;2;1;1;1
258233958236;258233958424;188;4;1;2;1;1;1
258233958424;258233974371;15947;4;1;2;1;1;1
258233974371;258233995836;21465;-1;0;-1;0;1;1
258233995836;258233996389;553;4;1;2;1;1;1
258233996389;258234031335;34946;-1;0;-1;0;1;1
258234031335;258234032037;702;4;1;2;1;1;1
258234032037;258234032076;39;-1;0;-1;0;1;1
258234032076;258234032966;890;4;1;2;1;1;1
258234032966;258234061300;28334;-1;0;-1;0;1;1
258234061300;258234061956;656;4;1;2;1;1;1
258234061956;258234166293;104337;-1;0;-1;0;1;1
258234166293;258234167788;1495;4;1;2;1;1;1
258234167788;258234177472;9684;-1;0;-1;0;1;1
258234177472;258234178497;1025;4;1;2;1;1;1
258234178497;258234224732;46235;-1;0;-1;0;1;1
258234224732;258234225260;528;4;1;2;1;1;1
258234225260;258234327543;102283;-1;0;-1;0;1;1
258234327543;258234328179;636;4;1;2;1;1;1
258234328179;258234338813;10634;-1;0;-1;0;1;1
258234338813;258234340078;1265;4;1;2;1;1;1
258234340078;258234343361;3283;-1;0;-1;0;1;1
258234343361;258234344182;821;4;1;2;1;1;1
258234344182;258234344301;119;4;1;2;1;1;1
258234344301;258234346267;1966;4;1;2;1;1;1
258234346267;258234368991;22724;-1;0;-1;0;1;1
258234368991;258234369610;619;4;1;2;1;1;1
258234369610;258234412528;42918;-1;0;-1;0;1;1
258234412528;258234413160;632;4;1;2;1;1;1
258234413160;258234543227;130067;-1;0;-1;0;1;1
258234543227;258234543830;603;4;1;2;1;1;1
258234543830;258234599248;55418;-1;0;-1;0;1;1
258234599248;258234599889;641;4;1;2;1;1;1
258234599889;258234668670;68781;-1;0;-1;0;1;1
258234668670;258234669133;463;4;1;2;1;1;1
258234669133;258234706974;37841;-1;0;-1;0;1;1
258234706974;258234708450;1476;4;1;2;1;1;1
258234708450;258234751230;42780;-1;0;-1;0;1;1
258234751230;258234751862;632;4;1;2;1;1;1
258234751862;258234790424;38562;-1;0;-1;0;1;1
258234790424;258234790987;563;4;1;2;1;1;1
258234790987;258234881463;90476;-1;0;-1;0;1;1
258234881463;258234882323;860;4;1;2;1;1;1
258234882323;258234955443;73120;-1;0;-1;0;1;1
258234955443;258234956231;788;4;1;2;1;1;1
258234956231;258235008645;52414;-1;0;-1;0;1;1
258235008645;258235009208;563;4;1;2;1;1;1
258235009208;258235019540;10332;-1;0;-1;0;1;1
258235019540;258235020589;1049;4;1;2;1;1;1
258235020589;258235081709;61120;-1;0;-1;0;1;1
258235081709;258235082539;830;4;1;2;1;1;1
258235082539;258235083614;1075;-1;0;-1;0;1;1
258235083614;258235084171;557;4;1;2;1;1;1
258235084171;258235126995;42824;-1;0;-1;0;1;1
258235126995;258235127604;609;4;1;2;1;1;1
258235127604;258235175188;47584;-1;0;-1;0;1;1
258235175188;258235175816;628;4;1;2;1;1;1
258235175816;258235209660;33844;-1;0;-1;0;1;1
258235209660;258235210124;464;4;1;2;1;1;1
258235210124;258235287291;77167;-1;0;-1;0;1;1
258235287291;258235287947;656;4;1;2;1;1;1
258235287947;258235331024;43077;-1;0;-1;0;1;1
258235331024;258235331566;542;4;1;2;1;1;1
258235331566;258235375124;43558;-1;0;-1;0;1;1
258235375124;258235375678;554;4;1;2;1;1;1
258235375678;258235446869;71191;-1;0;-1;0;1;1
258235446869;258235447402;533;4;1;2;1;1;1
258235447402;258235530589;83187;-1;0;-1;0;1;1
258235530589;258235531236;647;4;1;2;1;1;1
258235531236;258235642064;110828;-1;0;-1;0;1;1
258235642064;258235642973;909;4;1;2;1;1;1
258235642973;258235683590;40617;-1;0;-1;0;1;1
258235683590;258235684187;597;4;1;2;1;1;1
258235684187;258235695566;11379;-1;0;-1;0;1;1
258235695566;258235696107;541;4;1;2;1;1;1
258235696107;258235740157;44050;-1;0;-1;0;1;1
258235740157;258235740965;808;4;1;2;1;1;1
258235740965;258235802034;61069;-1;0;-1;0;1;1
258235802034;258235802597;563;4;1;2;1;1;1
258235802597;258235831273;28676;-1;0;-1;0;1;1
258235831273;258235831846;573;4;1;2;1;1;1
258235831846;258235892220;60374;-1;0;-1;0;1;1
258235892220;258235892779;559;4;1;2;1;1;1
258235892779;258235941911;49132;-1;0;-1;0;1;1
258235941911;258235942953;1042;4;1;2;1;1;1
258235942953;258235975320;32367;-1;0;-1;0;1;1
258235975320;258235975952;632;4;1;2;1;1;1
258235975952;258236021602;45650;-1;0;-1;0;1;1
258236021602;258236024573;2971;4;1;2;1;1;1
258236024573;258236025478;905;-1;0;-1;0;1;1
258236025478;258236026267;789;4;1;2;1;1;1
258236026267;258236027836;1569;-1;0;-1;0;1;1
258236027836;258236028489;653;4;1;2;1;1;1
258236028489;258236103549;75060;-1;0;-1;0;1;1
258236103549;258236104518;969;4;1;2;1;1;1
258236104518;258236105444;926;-1;0;-1;0;1;1
258236105444;258236105996;552;4;1;2;1;1;1
258236105996;258236178177;72181;-1;0;-1;0;1;1
258236178177;258236178809;632;4;1;2;1;1;1
258236178809;258236223646;44837;-1;0;-1;0;1;1
258236223646;258236224248;602;4;1;2;1;1;1
258236224248;258236268798;44550;-1;0;-1;0;1;1
258236268798;258236269427;629;4;1;2;1;1;1
258236269427;258236313618;44191;-1;0;-1;0;1;1
258236313618;258236314225;607;4;1;2;1;1;1
258236314225;258236361795;47570;-1;0;-1;0;1;1
258236361795;258236362349;554;4;1;2;1;1;1
258236362349;258236393638;31289;-1;0;-1;0;1;1
258236393638;258236394196;558;4;1;2;1;1;1
258236394196;258236442076;47880;-1;0;-1;0;1;1
258236442076;258236442675;599;4;1;2;1;1;1
258236442675;258236482483;39808;-1;0;-1;0;1;1
258236482483;258236483043;560;4;1;2;1;1;1
258236483043;258236519168;36125;-1;0;-1;0;1;1
258236519168;258236519817;649;4;1;2;1;1;1
258236519817;258236862335;342518;-1;0;-1;0;1;1
258236862335;258236863924;1589;4;1;2;1;1;1
258236863924;258236864588;664;-1;0;-1;0;1;1
258236864588;258236865075;487;4;1;2;1;1;1
258236865075;258236865282;207;4;1;2;1;1;1
258236865282;258236865662;380;4;1;2;1;1;1
258236865662;258236961279;95617;-1;0;-1;0;1;1
258236961279;258236961833;554;4;1;2;1;1;1
258236961833;258236971455;9622;-1;0;-1;0;1;1
258236971455;258236971960;505;4;1;2;1;1;1
258236971960;258236972039;79;-1;0;-1;0;1;1
258236972039;258236972887;848;4;1;2;1;1;1
258236972887;258237017518;44631;-1;0;-1;0;1;1
258237017518;258237018108;590;4;1;2;1;1;1
258237018108;258237063744;45636;-1;0;-1;0;1;1
258237063744;258237064422;678;4;1;2;1;1;1
258237064422;258237096161;31739;-1;0;-1;0;1;1
258237096161;258237096792;631;4;1;2;1;1;1
258237096792;258237145586;48794;-1;0;-1;0;1;1
258237145586;258237146145;559;4;1;2;1;1;1
258237146145;258237211549;65404;-1;0;-1;0;1;1
258237211549;258237212592;1043;4;1;2;1;1;1
258237212592;258237260796;48204;-1;0;-1;0;1;1
258237260796;258237261483;687;4;1;2;1;1;1
258237261483;258237301916;40433;-1;0;-1;0;1;1
258237301916;258237302548;632;4;1;2;1;1;1
258237302548;258237346918;44370;-1;0;-1;0;1;1
258237346918;258237347547;629;4;1;2;1;1;1
258237347547;258237520243;172696;-1;0;-1;0;1;1
258237520243;258237520943;700;4;1;2;1;1;1
258237520943;258237521087;144;-1;0;-1;0;1;1
258237521087;258237522793;1706;4;1;2;1;1;1
258237522793;258237564378;41585;-1;0;-1;0;1;1
258237564378;258237565009;631;4;1;2;1;1;1
258237565009;258237611798;46789;-1;0;-1;0;1;1
258237611798;258237612576;778;4;1;2;1;1;1
258237612576;258237613817;1241;-1;0;-1;0;1;1
258237613817;258237616315;2498;4;1;2;1;1;1
258237616315;258237686187;69872;-1;0;-1;0;1;1
258237686187;258237686811;624;4;1;2;1;1;1
258237686811;258237732959;46148;-1;0;-1;0;1;1
258237732959;258237733874;915;4;1;2;1;1;1
258237733874;258237778375;44501;-1;0;-1;0;1;1
258237778375;258237779054;679;4;1;2;1;1;1
258237779054;258237817629;38575;-1;0;-1;0;1;1
258237817629;258237818244;615;4;1;2;1;1;1
258237818244;258237908126;89882;-1;0;-1;0;1;1
258237908126;258237908979;853;4;1;2;1;1;1
258237908979;258237980727;71748;-1;0;-1;0;1;1
258237980727;258237997456;16729;4;1;2;1;1;1
258237997456;258238032189;34733;-1;0;-1;0;1;1
258238032189;258238033037;848;4;1;2;1;1;1
258238033037;258238085718;52681;-1;0;-1;0;1;1
258238085718;258238086272;554;4;1;2;1;1;1
258238086272;258238128363;42091;-1;0;-1;0;1;1
258238128363;258238129032;669;4;1;2;1;1;1
258238129032;258238164860;35828;-1;0;-1;0;1;1
258238164860;258238165904;1044;4;1;2;1;1;1
258238165904;258238235225;69321;-1;0;-1;0;1;1
258238235225;258238236529;1304;4;1;2;1;1;1
258238236529;258238356094;119565;-1;0;-1;0;1;1
258238356094;258238357228;1134;4;1;2;1;1;1
258238357228;258238357476;248;4;1;2;1;1;1
258238357476;258238358431;955;4;1;2;1;1;1
258238358431;258238369674;11243;-1;0;-1;0;1;1
258238369674;258238370352;678;4;1;2;1;1;1
258238370352;258238422511;52159;-1;0;-1;0;1;1
258238422511;258238424138;1627;4;1;2;1;1;1
258238424138;258238425054;916;4;1;2;1;1;1
258238425054;258238425633;579;4;1;2;1;1;1
258238425633;258238426541;908;-1;0;-1;0;1;1
258238426541;258238427893;1352;4;1;2;1;1;1
258238427893;258238468392;40499;-1;0;-1;0;1;1
258238468392;258238469026;634;4;1;2;1;1;1
258238469026;258238524429;55403;-1;0;-1;0;1;1
258238524429;258238524977;548;4;1;2;1;1;1
258238524977;258238562080;37103;-1;0;-1;0;1;1
258238562080;258238562607;527;4;1;2;1;1;1
258238562607;258238641736;79129;-1;0;-1;0;1;1
258238641736;258238642211;475;4;1;2;1;1;1
258238642211;258238681058;38847;-1;0;-1;0;1;1
258238681058;258238682494;1436;4;1;2;1;1;1
258238682494;258238774877;92383;-1;0;-1;0;1;1
258238774877;258238775428;551;4;1;2;1;1;1
258238775428;258238835121;59693;-1;0;-1;0;1;1
258238835121;258238835611;490;4;1;2;1;1;1
258238835611;258238900964;65353;-1;0;-1;0;1;1
258238900964;258238901602;638;4;1;2;1;1;1
258238901602;258238950886;49284;-1;0;-1;0;1;1
258238950886;258238951515;629;4;1;2;1;1;1
258238951515;258238991578;40063;-1;0;-1;0;1;1
258238991578;258238992385;807;4;1;2;1;1;1
258238992385;258239054291;61906;-1;0;-1;0;1;1
258239054291;258239055718;1427;4;1;2;1;1;1
258239055718;258239128132;72414;-1;0;-1;0;1;1
258239128132;258239128765;633;4;1;2;1;1;1
258239128765;258239156386;27621;-1;0;-1;0;1;1
258239156386;258239156933;547;4;1;2;1;1;1
258239156933;258239211791;54858;-1;0;-1;0;1;1
258239211791;258239212252;461;4;1;2;1;1;1
258239212252;258239289197;76945;-1;0;-1;0;1;1
258239289197;258239289922;725;4;1;2;1;1;1
258239289922;258239290148;226;4;1;2;1;1;1
258239290148;258239291736;1588;4;1;2;1;1;1
258239291736;258239324389;32653;-1;0;-1;0;1;1
258239324389;258239324938;549;4;1;2;1;1;1
258239324938;258239364143;39205;-1;0;-1;0;1;1
258239364143;258239365317;1174;4;1;2;1;1;1
258239365317;258239365941;624;4;1;2;1;1;1
258239365941;258239366195;254;4;1;2;1;1;1
258239366195;258239366848;653;-1;0;-1;0;1;1
258239366848;258239367487;639;4;1;2;1;1;1
258239367487;258239368306;819;-1;0;-1;0;1;1
258239368306;258239368942;636;4;1;2;1;1;1
258239368942;258239467646;98704;-1;0;-1;0;1;1
258239467646;258239469703;2057;4;1;2;1;1;1
258239469703;258239508516;38813;-1;0;-1;0;1;1
258239508516;258239509065;549;4;1;2;1;1;1
258239509065;258239549257;40192;-1;0;-1;0;1;1
258239549257;258239550331;1074;4;1;2;1;1;1
258239550331;258239577892;27561;-1;0;-1;0;1;1
258239577892;258239578567;675;4;1;2;1;1;1
258239578567;258239620088;41521;-1;0;-1;0;1;1
258239620088;258239620646;558;4;1;2;1;1;1
258239620646;258239673237;52591;-1;0;-1;0;1;1
258239673237;258239674359;1122;4;1;2;1;1;1
258239674359;258239676228;1869;-1;0;-1;0;1;1
258239676228;258239677019;791;4;1;2;1;1;1
258239677019;258239677408;389;4;1;2;1;1;1
258239677408;258239678432;1024;4;1;2;1;1;1
258239678432;258239707900;29468;-1;0;-1;0;1;1
258239707900;258239708530;630;4;1;2;1;1;1
258239708530;258239759262;50732;-1;0;-1;0;1;1
258239759262;258239760191;929;4;1;2;1;1;1
258239760191;258239760265;74;4;1;2;1;1;1
258239760265;258239761174;909;4;1;2;1;1;1
258239761174;258239761582;408;-1;0;-1;0;1;1
258239761582;258239762220;638;4;1;2;1;1;1
258239762220;258239789257;27037;-1;0;-1;0;1;1
258239789257;258239790217;960;4;1;2;1;1;1
258239790217;258239790620;403;-1;0;-1;0;1;1
258239790620;258239791673;1053;4;1;2;1;1;1
258239791673;258239883595;91922;-1;0;-1;0;1;1
258239883595;258239884067;472;4;1;2;1;1;1
258239884067;258239956949;72882;-1;0;-1;0;1;1
258239956949;258239957444;495;4;1;2;1;1;1
258239957444;258239997335;39891;-1;0;-1;0;1;1
258239997335;258239997859;524;4;1;2;1;1;1
258239997859;258240033926;36067;-1;0;-1;0;1;1
258240033926;258240034533;607;4;1;2;1;1;1
258240034533;258240078948;44415;-1;0;-1;0;1;1
258240078948;258240079467;519;4;1;2;1;1;1
258240079467;258240116194;36727;-1;0;-1;0;1;1
258240116194;258240116744;550;4;1;2;1;1;1
258240116744;258240188418;71674;-1;0;-1;0;1;1
258240188418;258240189037;619;4;1;2;1;1;1
258240189037;258240234311;45274;-1;0;-1;0;1;1
258240234311;258240235545;1234;4;1;2;1;1;1
258240235545;258240301407;65862;-1;0;-1;0;1;1
258240301407;258240301961;554;4;1;2;1;1;1
258240301961;258240343658;41697;-1;0;-1;0;1;1
258240343658;258240344216;558;4;1;2;1;1;1
258240344216;258240387925;43709;-1;0;-1;0;1;1
258240387925;258240392459;4534;4;1;2;1;1;1
258240392459;258240434247;41788;-1;0;-1;0;1;1
258240434247;258240435178;931;4;1;2;1;1;1
258240435178;258240435256;78;-1;0;-1;0;1;1
258240435256;258240436008;752;4;1;2;1;1;1
258240436008;258240436377;369;-1;0;-1;0;1;1
258240436377;258240437025;648;4;1;2;1;1;1
258240437025;258240469949;32924;-1;0;-1;0;1;1
258240469949;258240470581;632;4;1;2;1;1;1
258240470581;258240517064;46483;-1;0;-1;0;1;1
258240517064;258240517614;550;4;1;2;1;1;1
258240517614;258240560236;42622;-1;0;-1;0;1;1
258240560236;258240560786;550;4;1;2;1;1;1
258240560786;258240600475;39689;-1;0;-1;0;1;1
258240600475;258240601090;615;4;1;2;1;1;1
258240601090;258240637344;36254;-1;0;-1;0;1;1
258240637344;258240637979;635;4;1;2;1;1;1
258240637979;258240682551;44572;-1;0;-1;0;1;1
258240682551;258240683085;534;4;1;2;1;1;1
258240683085;258240786093;103008;-1;0;-1;0;1;1
258240786093;258240786590;497;4;1;2;1;1;1
258240786590;258240786820;230;4;1;2;1;1;1
258240786820;258240787178;358;4;1;2;1;1;1
258240787178;258240811512;24334;-1;0;-1;0;1;1
258240811512;258240812069;557;4;1;2;1;1;1
258240812069;258240872335;60266;-1;0;-1;0;1;1
258240872335;258240873890;1555;4;1;2;1;1;1
258240873890;258240883921;10031;-1;0;-1;0;1;1
258240883921;258240884479;558;4;1;2;1;1;1
258240884479;258240884594;115;4;1;2;1;1;1
258240884594;258240885053;459;4;1;2;1;1;1
258240885053;258240933328;48275;-1;0;-1;0;1;1
258240933328;258240934264;936;4;1;2;1;1;1
258240934264;258240935973;1709;-1;0;-1;0;1;1
258240935973;258240936941;968;4;1;2;1;1;1
258240936941;258240977964;41023;-1;0;-1;0;1;1
258240977964;258240978593;629;4;1;2;1;1;1
258240978593;258241041916;63323;-1;0;-1;0;1;1
258241041916;258241042459;543;4;1;2;1;1;1
258241042459;258241078817;36358;-1;0;-1;0;1;1
258241078817;258241079447;630;4;1;2;1;1;1
258241079447;258241157191;77744;-1;0;-1;0;1;1
258241157191;258241157971;780;4;1;2;1;1;1
258241157971;258241158856;885;-1;0;-1;0;1;1
258241158856;258241159465;609;4;1;2;1;1;1
258241159465;258241205320;45855;-1;0;-1;0;1;1
258241205320;258241205946;626;4;1;2;1;1;1
258241205946;258241253492;47546;-1;0;-1;0;1;1
258241253492;258241254167;675;4;1;2;1;1;1
258241254167;258241254670;503;-1;0;-1;0;1;1
258241254670;258241255239;569;4;1;2;1;1;1
258241255239;258241337572;82333;-1;0;-1;0;1;1
258241337572;258241338206;634;4;1;2;1;1;1
258241338206;258241374861;36655;-1;0;-1;0;1;1
258241374861;258241375489;628;4;1;2;1;1;1
258241375489;258241431782;56293;-1;0;-1;0;1;1
258241431782;258241432403;621;4;1;2;1;1;1
258241432403;258241483452;51049;-1;0;-1;0;1;1
258241483452;258241484057;605;4;1;2;1;1;1
258241484057;258241522172;38115;-1;0;-1;0;1;1
258241522172;258241522765;593;4;1;2;1;1;1
258241522765;258241522842;77;4;1;2;1;1;1
258241522842;258241523664;822;4;1;2;1;1;1
258241523664;258241555223;31559;-1;0;-1;0;1;1
258241555223;258241555852;629;4;1;2;1;1;1
258241555852;258241593126;37274;-1;0;-1;0;1;1
258241593126;258241593599;473;4;1;2;1;1;1
258241593599;258241594052;453;4;1;2;1;1;1
258241594052;258241594449;397;4;1;2;1;1;1
258241594449;258241595108;659;-1;0;-1;0;1;1
258241595108;258241595663;555;4;1;2;1;1;1
258241595663;258241839725;244062;-1;0;-1;0;1;1
258241839725;258241840277;552;4;1;2;1;1;1
258241840277;258241883881;43604;-1;0;-1;0;1;1
258241883881;258241884483;602;4;1;2;1;1;1
258241884483;258241924088;39605;-1;0;-1;0;1;1
258241924088;258241924639;551;4;1;2;1;1;1
258241924639;258241982570;57931;-1;0;-1;0;1;1
258241982570;258241983206;636;4;1;2;1;1;1
258241983206;258242036116;52910;-1;0;-1;0;1;1
258242036116;258242037186;1070;4;1;2;1;1;1
258242037186;258242084131;46945;-1;0;-1;0;1;1
258242084131;258242084677;546;4;1;2;1;1;1
258242084677;258242128741;44064;-1;0;-1;0;1;1
258242128741;258242129607;866;4;1;2;1;1;1
258242129607;258242130970;1363;-1;0;-1;0;1;1
258242130970;258242131595;625;4;1;2;1;1;1
258242131595;258242166729;35134;-1;0;-1;0;1;1
258242166729;258242167370;641;4;1;2;1;1;1
258242167370;258242236116;68746;-1;0;-1;0;1;1
258242236116;258242236656;540;4;1;2;1;1;1
258242236656;258242273885;37229;-1;0;-1;0;1;1
258242273885;258242274874;989;4;1;2;1;1;1
258242274874;258242275420;546;-1;0;-1;0;1;1
258242275420;258242280006;4586;4;1;2;1;1;1
258242280006;258242344559;64553;-1;0;-1;0;1;1
258242344559;258242346073;1514;4;1;2;1;1;1
258242346073;258242346742;669;4;1;2;1;1;1
258242346742;258242350181;3439;4;1;2;1;1;1
258242350181;258242433616;83435;-1;0;-1;0;1;1
258242433616;258242434378;762;4;1;2;1;1;1
258242434378;258242434957;579;-1;0;-1;0;1;1
258242434957;258242435732;775;4;1;2;1;1;1
258242435732;258242523507;87775;-1;0;-1;0;1;1
258242523507;258242524058;551;4;1;2;1;1;1
258242524058;258242588491;64433;-1;0;-1;0;1;1
258242588491;258242588957;466;4;1;2;1;1;1
258242588957;258242671247;82290;-1;0;-1;0;1;1
258242671247;258242671859;612;4;1;2;1;1;1
258242671859;258242715533;43674;-1;0;-1;0;1;1
258242715533;258242716056;523;4;1;2;1;1;1
258242716056;258242754036;37980;-1;0;-1;0;1;1
258242754036;258242754678;642;4;1;2;1;1;1
258242754678;258242766078;11400;-1;0;-1;0;1;1
258242766078;258242766708;630;4;1;2;1;1;1
258242766708;258242766737;29;-1;0;-1;0;1;1
258242766737;258242767541;804;4;1;2;1;1;1
258242767541;258242800460;32919;-1;0;-1;0;1;1
258242800460;258242801245;785;4;1;2;1;1;1
258242801245;258242840961;39716;-1;0;-1;0;1;1
258242840961;258242841876;915;4;1;2;1;1;1
258242841876;258242911550;69674;-1;0;-1;0;1;1
258242911550;258242918863;7313;4;1;2;1;1;1
258242918863;258242986689;67826;-1;0;-1;0;1;1
258242986689;258242987181;492;4;1;2;1;1;1
258242987181;258243034024;46843;-1;0;-1;0;1;1
258243034024;258243035478;1454;4;1;2;1;1;1
258243035478;258243035982;504;-1;0;-1;0;1;1
258243035982;258243037192;1210;4;1;2;1;1;1
258243037192;258243037896;704;-1;0;-1;0;1;1
258243037896;258243041280;3384;4;1;2;1;1;1
258243041280;258243265743;224463;-1;0;-1;0;1;1
258243265743;258243266235;492;4;1;2;1;1;1
258243266235;258243303519;37284;-1;0;-1;0;1;1
258243303519;258243303993;474;4;1;2;1;1;1
258243303993;258243388967;84974;-1;0;-1;0;1;1
258243388967;258243389518;551;4;1;2;1;1;1
258243389518;258243443984;54466;-1;0;-1;0;1;1
258243443984;258243444615;631;4;1;2;1;1;1
258243444615;258243502807;58192;-1;0;-1;0;1;1
258243502807;258243503394;587;4;1;2;1;1;1
258243503394;258243503769;375;4;1;2;1;1;1
258243503769;258243504214;445;4;1;2;1;1;1
258243504214;258243504683;469;-1;0;-1;0;1;1
258243504683;258243505273;590;4;1;2;1;1;1
258243505273;258243534635;29362;-1;0;-1;0;1;1
258243534635;258243535251;616;4;1;2;1;1;1
258243535251;258243608854;73603;-1;0;-1;0;1;1
258243608854;258243609392;538;4;1;2;1;1;1
258243609392;258243609993;601;-1;0;-1;0;1;1
258243609993;258243610662;669;4;1;2;1;1;1
258243610662;258243685410;74748;-1;0;-1;0;1;1
258243685410;258243686115;705;4;1;2;1;1;1
258243686115;258243841831;155716;-1;0;-1;0;1;1
258243841831;258243842420;589;4;1;2;1;1;1
258243842420;258243842939;519;4;1;2;1;1;1
258243842939;258243847502;4563;4;1;2;1;1;1
258243847502;258243895559;48057;-1;0;-1;0;1;1
258243895559;258243896183;624;4;1;2;1;1;1
258243896183;258243954273;58090;-1;0;-1;0;1;1
258243954273;258243954807;534;4;1;2;1;1;1
258243954807;258243987071;32264;-1;0;-1;0;1;1
258243987071;258243987608;537;4;1;2;1;1;1
258243987608;258244055530;67922;-1;0;-1;0;1;1
258244055530;258244056065;535;4;1;2;1;1;1
258244056065;258244105672;49607;-1;0;-1;0;1;1
258244105672;258244106220;548;4;1;2;1;1;1
258244106220;258244161427;55207;-1;0;-1;0;1;1
258244161427;258244162086;659;4;1;2;1;1;1
258244162086;258244192832;30746;-1;0;-1;0;1;1
258244192832;258244193990;1158;4;1;2;1;1;1
258244193990;258244194596;606;-1;0;-1;0;1;1
258244194596;258244195583;987;4;1;2;1;1;1
258244195583;258244196352;769;-1;0;-1;0;1;1
258244196352;258244196900;548;4;1;2;1;1;1
258244196900;258244224476;27576;-1;0;-1;0;1;1
258244224476;258244225033;557;4;1;2;1;1;1
258244225033;258244288440;63407;-1;0;-1;0;1;1
258244288440;258244288994;554;4;1;2;1;1;1
258244288994;258244289375;381;-1;0;-1;0;1;1
258244289375;258244289985;610;4;1;2;1;1;1
258244289985;258244322444;32459;-1;0;-1;0;1;1
258244322444;258244330023;7579;4;1;2;1;1;1
258244330023;258244358898;28875;-1;0;-1;0;1;1
258244358898;258244359455;557;4;1;2;1;1;1
258244359455;258244359875;420;-1;0;-1;0;1;1
258244359875;258244360454;579;4;1;2;1;1;1
258244360454;258244504675;144221;-1;0;-1;0;1;1
258244504675;258244505909;1234;4;1;2;1;1;1
258244505909;258244506397;488;-1;0;-1;0;1;1
258244506397;258244507424;1027;4;1;2;1;1;1
258244507424;258244508399;975;-1;0;-1;0;1;1
258244508399;258244509076;677;4;1;2;1;1;1
258244509076;258244536926;27850;-1;0;-1;0;1;1
258244536926;258244537839;913;4;1;2;1;1;1
258244537839;258244643519;105680;-1;0;-1;0;1;1
258244643519;258244644839;1320;4;1;2;1;1;1
258244644839;258244712356;67517;-1;0;-1;0;1;1
258244712356;258244712982;626;4;1;2;1;1;1
258244712982;258244756071;43089;-1;0;-1;0;1;1
258244756071;258244756536;465;4;1;2;1;1;1
258244756536;258244824116;67580;-1;0;-1;0;1;1
258244824116;258244826162;2046;4;1;2;1;1;1
258244826162;258244827465;1303;-1;0;-1;0;1;1
258244827465;258244828370;905;4;1;2;1;1;1
258244828370;258244828487;117;-1;0;-1;0;1;1
258244828487;258244829806;1319;4;1;2;1;1;1
258244829806;258244857558;27752;-1;0;-1;0;1;1
258244857558;258244858189;631;4;1;2;1;1;1
258244858189;258244905063;46874;-1;0;-1;0;1;1
258244905063;258244905769;706;4;1;2;1;1;1
258244905769;258244951938;46169;-1;0;-1;0;1;1
258244951938;258244952767;829;4;1;2;1;1;1
258244952767;258244984457;31690;-1;0;-1;0;1;1
258244984457;258244984959;502;4;1;2;1;1;1
258244984959;258245047400;62441;-1;0;-1;0;1;1
258245047400;258245047957;557;4;1;2;1;1;1
258245047957;258245085283;37326;-1;0;-1;0;1;1
258245085283;258245085933;650;4;1;2;1;1;1
258245085933;258245134420;48487;-1;0;-1;0;1;1
258245134420;258245135032;612;4;1;2;1;1;1
258245135032;258245213757;78725;-1;0;-1;0;1;1
258245213757;258245214312;555;4;1;2;1;1;1
258245214312;258245262219;47907;-1;0;-1;0;1;1
258245262219;258245262774;555;4;1;2;1;1;1
258245262774;258245296661;33887;-1;0;-1;0;1;1
258245296661;258245297300;639;4;1;2;1;1;1
258245297300;258245341193;43893;-1;0;-1;0;1;1
258245341193;258245341740;547;4;1;2;1;1;1
258245341740;258245397405;55665;-1;0;-1;0;1;1
258245397405;258245397964;559;4;1;2;1;1;1
258245397964;258245460392;62428;-1;0;-1;0;1;1
258245460392;258245461654;1262;4;1;2;1;1;1
258245461654;258245555081;93427;-1;0;-1;0;1;1
258245555081;258245555660;579;4;1;2;1;1;1
258245555660;258245587908;32248;-1;0;-1;0;1;1
258245587908;258245588518;610;4;1;2;1;1;1
258245588518;258245588677;159;-1;0;-1;0;1;1
258245588677;258245589452;775;4;1;2;1;1;1
258245589452;258245620586;31134;-1;0;-1;0;1;1
258245620586;258245621144;558;4;1;2;1;1;1
258245621144;258245656371;35227;-1;0;-1;0;1;1
258245656371;258245657441;1070;4;1;2;1;1;1
258245657441;258245658149;708;-1;0;-1;0;1;1
258245658149;258245658797;648;4;1;2;1;1;1
258245658797;258245743745;84948;-1;0;-1;0;1;1
258245743745;258245744396;651;4;1;2;1;1;1
258245744396;258245744846;450;-1;0;-1;0;1;1
258245744846;258245746040;1194;4;1;2;1;1;1
258245746040;258245752080;6040;-1;0;-1;0;1;1
258245752080;258245752627;547;4;1;2;1;1;1
258245752627;258245873128;120501;-1;0;-1;0;1;1
258245873128;258245874250;1122;4;1;2;1;1;1
258245874250;258245911810;37560;-1;0;-1;0;1;1
258245911810;258245912693;883;4;1;2;1;1;1
258245912693;258245955601;42908;-1;0;-1;0;1;1
258245955601;258245956204;603;4;1;2;1;1;1
258245956204;258245990531;34327;-1;0;-1;0;1;1
258245990531;258245991399;868;4;1;2;1;1;1
258245991399;258245992286;887;-1;0;-1;0;1;1
258245992286;258245992930;644;4;1;2;1;1;1
258245992930;258246054992;62062;-1;0;-1;0;1;1
258246054992;258246055545;553;4;1;2;1;1;1
258246055545;258246055769;224;4;1;2;1;1;1
258246055769;258246056179;410;4;1;2;1;1;1
258246056179;258246056606;427;-1;0;-1;0;1;1
258246056606;258246057261;655;4;1;2;1;1;1
258246057261;258246097633;40372;-1;0;-1;0;1;1
258246097633;258246098263;630;4;1;2;1;1;1
258246098263;258246143793;45530;-1;0;-1;0;1;1
258246143793;258246144353;560;4;1;2;1;1;1
258246144353;258246208008;63655;-1;0;-1;0;1;1
258246208008;258246208652;644;4;1;2;1;1;1
258246208652;258246287490;78838;-1;0;-1;0;1;1
258246287490;258246288129;639;4;1;2;1;1;1
258246288129;258246332725;44596;-1;0;-1;0;1;1
258246332725;258246333333;608;4;1;2;1;1;1
258246333333;258246378011;44678;-1;0;-1;0;1;1
258246378011;258246378562;551;4;1;2;1;1;1
258246378562;258246429212;50650;-1;0;-1;0;1;1
258246429212;258246431208;1996;4;1;2;1;1;1
258246431208;258246432340;1132;-1;0;-1;0;1;1
258246432340;258246433014;674;4;1;2;1;1;1
258246433014;258246433109;95;-1;0;-1;0;1;1
258246433109;258246434111;1002;4;1;2;1;1;1
258246434111;258246473687;39576;-1;0;-1;0;1;1
258246473687;258246474235;548;4;1;2;1;1;1
258246474235;258246600279;126044;-1;0;-1;0;1;1
258246600279;258246600905;626;4;1;2;1;1;1
258246600905;258246653118;52213;-1;0;-1;0;1;1
258246653118;258246653793;675;4;1;2;1;1;1
258246653793;258246705704;51911;-1;0;-1;0;1;1
258246705704;258246706313;609;4;1;2;1;1;1
258246706313;258246755577;49264;-1;0;-1;0;1;1
258246755577;258246756291;714;4;1;2;1;1;1
258246756291;258246757331;1040;-1;0;-1;0;1;1
258246757331;258246757960;629;4;1;2;1;1;1
258246757960;258246802261;44301;-1;0;-1;0;1;1
258246802261;258246802899;638;4;1;2;1;1;1
258246802899;258246849658;46759;-1;0;-1;0;1;1
258246849658;258246850386;728;4;1;2;1;1;1
258246850386;258246851425;1039;-1;0;-1;0;1;1
258246851425;258246852075;650;4;1;2;1;1;1
258246852075;258246935425;83350;-1;0;-1;0;1;1
258246935425;258246936057;632;4;1;2;1;1;1
258246936057;258246969293;33236;-1;0;-1;0;1;1
258246969293;258246969863;570;4;1;2;1;1;1
258246969863;258247004736;34873;-1;0;-1;0;1;1
258247004736;258247005406;670;4;1;2;1;1;1
258247005406;258247095413;90007;-1;0;-1;0;1;1
258247095413;258247095760;347;4;1;2;1;1;1
258247095760;258247096036;276;4;1;2;1;1;1
258247096036;258247096641;605;4;1;2;1;1;1
258247096641;258247103742;7101;-1;0;-1;0;1;1
258247103742;258247104380;638;4;1;2;1;1;1
258247104380;258247167368;62988;-1;0;-1;0;1;1
258247167368;258247167995;627;4;1;2;1;1;1
258247167995;258247234563;66568;-1;0;-1;0;1;1
258247234563;258247235226;663;4;1;2;1;1;1
258247235226;258247235240;14;4;1;2;1;1;1
258247235240;258247236041;801;4;1;2;1;1;1
258247236041;258247374772;138731;-1;0;-1;0;1;1
258247374772;258247375955;1183;4;1;2;1;1;1
258247375955;258247403501;27546;-1;0;-1;0;1;1
258247403501;258247404923;1422;4;1;2;1;1;1
258247404923;258247440156;35233;-1;0;-1;0;1;1
258247440156;258247440795;639;4;1;2;1;1;1
258247440795;258247481180;40385;-1;0;-1;0;1;1
258247481180;258247481814;634;4;1;2;1;1;1
258247481814;258247526229;44415;-1;0;-1;0;1;1
258247526229;258247527980;1751;4;1;2;1;1;1
258247527980;258247528532;552;-1;0;-1;0;1;1
258247528532;258247529242;710;4;1;2;1;1;1
258247529242;258247578209;48967;-1;0;-1;0;1;1
258247578209;258247582365;4156;4;1;2;1;1;1
258247582365;258247615413;33048;-1;0;-1;0;1;1
258247615413;258247616960;1547;4;1;2;1;1;1
258247616960;258247618887;1927;-1;0;-1;0;1;1
258247618887;258247619448;561;4;1;2;1;1;1
258247619448;258247734733;115285;-1;0;-1;0;1;1
258247734733;258247735578;845;4;1;2;1;1;1
258247735578;258247817911;82333;-1;0;-1;0;1;1
258247817911;258247818527;616;4;1;2;1;1;1
258247818527;258247898130;79603;-1;0;-1;0;1;1
258247898130;258247898942;812;4;1;2;1;1;1
258247898942;258247945873;46931;-1;0;-1;0;1;1
258247945873;258247947359;1486;4;1;2;1;1;1
258247947359;258247981215;33856;-1;0;-1;0;1;1
258247981215;258247981706;491;4;1;2;1;1;1
258247981706;258248029286;47580;-1;0;-1;0;1;1
258248029286;258248029510;224;4;1;2;1;1;1
258248029510;258248030598;1088;4;1;2;1;1;1
258248030598;258248031610;1012;4;1;2;1;1;1
258248031610;258248033332;1722;-1;0;-1;0;1;1
258248033332;258248034532;1200;4;1;2;1;1;1
258248034532;258248034574;42;-1;0;-1;0;1;1
258248034574;258248035444;870;4;1;2;1;1;1
258248035444;258248147202;111758;-1;0;-1;0;1;1
258248147202;258248147827;625;4;1;2;1;1;1
258248147827;258248354962;207135;-1;0;-1;0;1;1
258248354962;258248355498;536;4;1;2;1;1;1
258248355498;258248526417;170919;-1;0;-1;0;1;1
258248526417;258248527934;1517;4;1;2;1;1;1
258248527934;258248565723;37789;-1;0;-1;0;1;1
258248565723;258248566343;620;4;1;2;1;1;1
258248566343;258248566838;495;-1;0;-1;0;1;1
258248566838;258248567485;647;4;1;2;1;1;1
258248567485;258248580208;12723;-1;0;-1;0;1;1
258248580208;258248580767;559;4;1;2;1;1;1
258248580767;258248610645;29878;-1;0;-1;0;1;1
258248610645;258248611267;622;4;1;2;1;1;1
258248611267;258248659590;48323;-1;0;-1;0;1;1
258248659590;258248660152;562;4;1;2;1;1;1
258248660152;258248871180;211028;-1;0;-1;0;1;1
258248871180;258248871882;702;4;1;2;1;1;1
258248871882;258248872208;326;4;1;2;1;1;1
258248872208;258248872817;609;4;1;2;1;1;1
258248872817;258248913718;40901;-1;0;-1;0;1;1
258248913718;258248914375;657;4;1;2;1;1;1
258248914375;258248981545;67170;-1;0;-1;0;1;1
258248981545;258248982147;602;4;1;2;1;1;1
258248982147;258249195407;213260;-1;0;-1;0;1;1
258249195407;258249196712;1305;4;1;2;1;1;1
258249196712;258249230942;34230;-1;0;-1;0;1;1
258249230942;258249231442;500;4;1;2;1;1;1
258249231442;258249270808;39366;-1;0;-1;0;1;1
258249270808;258249271476;668;4;1;2;1;1;1
258249271476;258249338400;66924;-1;0;-1;0;1;1
258249338400;258249339031;631;4;1;2;1;1;1
258249339031;258249359721;20690;-1;0;-1;0;1;1
258249359721;258249360338;617;4;1;2;1;1;1
258249360338;258249398823;38485;-1;0;-1;0;1;1
258249398823;258249399372;549;4;1;2;1;1;1
258249399372;258249436560;37188;-1;0;-1;0;1;1
258249436560;258249437196;636;4;1;2;1;1;1
258249437196;258249496342;59146;-1;0;-1;0;1;1
258249496342;258249497486;1144;4;1;2;1;1;1
258249497486;258249541089;43603;-1;0;-1;0;1;1
258249541089;258249541641;552;4;1;2;1;1;1
258249541641;258249714145;172504;-1;0;-1;0;1;1
258249714145;258249714709;564;4;1;2;1;1;1
258249714709;258249752932;38223;-1;0;-1;0;1;1
258249752932;258249753566;634;4;1;2;1;1;1
258249753566;258249883015;129449;-1;0;-1;0;1;1
258249883015;258249886910;3895;4;1;2;1;1;1
258249886910;258249922371;35461;-1;0;-1;0;1;1
258249922371;258249923015;644;4;1;2;1;1;1
258249923015;258249962948;39933;-1;0;-1;0;1;1
258249962948;258249963484;536;4;1;2;1;1;1
258249963484;258250085269;121785;-1;0;-1;0;1;1
258250085269;258250085921;652;4;1;2;1;1;1
258250085921;258250204863;118942;-1;0;-1;0;1;1
258250204863;258250205609;746;4;1;2;1;1;1
258250205609;258250217812;12203;-1;0;-1;0;1;1
258250217812;258250218556;744;4;1;2;1;1;1
258250218556;258250309823;91267;-1;0;-1;0;1;1
258250309823;258250310370;547;4;1;2;1;1;1
258250310370;258250359362;48992;-1;0;-1;0;1;1
258250359362;258250359869;507;4;1;2;1;1;1
258250359869;258250433302;73433;-1;0;-1;0;1;1
258250433302;258250434281;979;4;1;2;1;1;1
258250434281;258250445237;10956;-1;0;-1;0;1;1
258250445237;258250445845;608;4;1;2;1;1;1
258250445845;258250485894;40049;-1;0;-1;0;1;1
258250485894;258250486709;815;4;1;2;1;1;1
258250486709;258250519115;32406;-1;0;-1;0;1;1
258250519115;258250519757;642;4;1;2;1;1;1
258250519757;258250556144;36387;-1;0;-1;0;1;1
258250556144;258250556833;689;4;1;2;1;1;1
258250556833;258250557495;662;-1;0;-1;0;1;1
258250557495;258250573843;16348;4;1;2;1;1;1
258250573843;258250596513;22670;-1;0;-1;0;1;1
258250596513;258250597069;556;4;1;2;1;1;1
258250597069;258250642963;45894;-1;0;-1;0;1;1
258250642963;258250643594;631;4;1;2;1;1;1
258250643594;258250684466;40872;-1;0;-1;0;1;1
258250684466;258250685103;637;4;1;2;1;1;1
258250685103;258250728188;43085;-1;0;-1;0;1;1
258250728188;258250728726;538;4;1;2;1;1;1
258250728726;258250773260;44534;-1;0;-1;0;1;1
258250773260;258250773805;545;4;1;2;1;1;1
258250773805;258250882192;108387;-1;0;-1;0;1;1
258250882192;258250882938;746;4;1;2;1;1;1
258250882938;258250927313;44375;-1;0;-1;0;1;1
258250927313;258250927513;200;4;1;2;1;1;1
258250927513;258250928120;607;4;1;2;1;1;1
258250928120;258250932287;4167;4;1;2;1;1;1
258250932287;258250961201;28914;-1;0;-1;0;1;1
258250961201;258250961830;629;4;1;2;1;1;1
258250961830;258250993763;31933;-1;0;-1;0;1;1
258250993763;258250994232;469;4;1;2;1;1;1
258250994232;258250994653;421;-1;0;-1;0;1;1
258250994653;258250995250;597;4;1;2;1;1;1
258250995250;258251071985;76735;-1;0;-1;0;1;1
258251071985;258251072589;604;4;1;2;1;1;1
258251072589;258251110596;38007;-1;0;-1;0;1;1
258251110596;258251111220;624;4;1;2;1;1;1
258251111220;258251238123;126903;-1;0;-1;0;1;1
258251238123;258251238683;560;4;1;2;1;1;1
258251238683;258251281178;42495;-1;0;-1;0;1;1
258251281178;258251281641;463;4;1;2;1;1;1
258251281641;258251331346;49705;-1;0;-1;0;1;1
258251331346;258251331982;636;4;1;2;1;1;1
258251331982;258251380275;48293;-1;0;-1;0;1;1
258251380275;258251382314;2039;4;1;2;1;1;1
258251382314;258251435836;53522;-1;0;-1;0;1;1
258251435836;258251436480;644;4;1;2;1;1;1
258251436480;258251478669;42189;-1;0;-1;0;1;1
258251478669;258251480363;1694;4;1;2;1;1;1
258251480363;258251524677;44314;-1;0;-1;0;1;1
258251524677;258251525525;848;4;1;2;1;1;1
258251525525;258251569084;43559;-1;0;-1;0;1;1
258251569084;258251570011;927;4;1;2;1;1;1
258251570011;258251573445;3434;4;1;2;1;1;1
258251573445;258251573834;389;4;1;2;1;1;1
258251573834;258251617567;43733;-1;0;-1;0;1;1
258251617567;258251618118;551;4;1;2;1;1;1
258251618118;258251661453;43335;-1;0;-1;0;1;1
258251661453;258251665481;4028;4;1;2;1;1;1
258251665481;258251706467;40986;-1;0;-1;0;1;1
258251706467;258251711166;4699;4;1;2;1;1;1
258251711166;258251766413;55247;-1;0;-1;0;1;1
258251766413;258251766960;547;4;1;2;1;1;1
258251766960;258251821257;54297;-1;0;-1;0;1;1
258251821257;258251821890;633;4;1;2;1;1;1
258251821890;258251841259;19369;-1;0;-1;0;1;1
258251841259;258251842378;1119;4;1;2;1;1;1
258251842378;258251883555;41177;-1;0;-1;0;1;1
258251883555;258251884167;612;4;1;2;1;1;1
258251884167;258251934659;50492;-1;0;-1;0;1;1
258251934659;258251935270;611;4;1;2;1;1;1
258251935270;258251979160;43890;-1;0;-1;0;1;1
258251979160;258251979859;699;4;1;2;1;1;1
258251979859;258252019220;39361;-1;0;-1;0;1;1
258252019220;258252020023;803;4;1;2;1;1;1
258252020023;258252020140;117;-1;0;-1;0;1;1
258252020140;258252020957;817;4;1;2;1;1;1
258252020957;258252062498;41541;-1;0;-1;0;1;1
258252062498;258252063054;556;4;1;2;1;1;1
258252063054;258252153252;90198;-1;0;-1;0;1;1
258252153252;258252157287;4035;4;1;2;1;1;1
258252157287;258252185080;27793;-1;0;-1;0;1;1
258252185080;258252185764;684;4;1;2;1;1;1
258252185764;258252248247;62483;-1;0;-1;0;1;1
258252248247;258252248800;553;4;1;2;1;1;1
258252248800;258252295280;46480;-1;0;-1;0;1;1
258252295280;258252295351;71;4;1;2;1;1;1
258252295351;258252296006;655;4;1;2;1;1;1
258252296006;258252296300;294;4;1;2;1;1;1
258252296300;258252378135;81835;-1;0;-1;0;1;1
258252378135;258252379041;906;4;1;2;1;1;1
258252379041;258252436943;57902;-1;0;-1;0;1;1
258252436943;258252438304;1361;4;1;2;1;1;1
258252438304;258252441276;2972;-1;0;-1;0;1;1
258252441276;258252441829;553;4;1;2;1;1;1
258252441829;258252460682;18853;-1;0;-1;0;1;1
258252460682;258252461310;628;4;1;2;1;1;1
258252461310;258252499851;38541;-1;0;-1;0;1;1
258252499851;258252500507;656;4;1;2;1;1;1
258252500507;258252545396;44889;-1;0;-1;0;1;1
258252545396;258252545883;487;4;1;2;1;1;1
258252545883;258252715051;169168;-1;0;-1;0;1;1
258252715051;258252716494;1443;4;1;2;1;1;1
258252716494;258252745025;28531;-1;0;-1;0;1;1
258252745025;258252745647;622;4;1;2;1;1;1
258252745647;258252792379;46732;-1;0;-1;0;1;1
258252792379;258252793648;1269;4;1;2;1;1;1
258252793648;258252837498;43850;-1;0;-1;0;1;1
258252837498;258252838138;640;4;1;2;1;1;1
258252838138;258252881600;43462;-1;0;-1;0;1;1
258252881600;258252882235;635;4;1;2;1;1;1
258252882235;258252959483;77248;-1;0;-1;0;1;1
258252959483;258252960018;535;4;1;2;1;1;1
258252960018;258252996920;36902;-1;0;-1;0;1;1
258252996920;258252997476;556;4;1;2;1;1;1
258252997476;258253077778;80302;-1;0;-1;0;1;1
258253077778;258253078279;501;4;1;2;1;1;1
258253078279;258253079006;727;4;1;2;1;1;1
258253079006;258253079937;931;4;1;2;1;1;1
258253079937;258253113692;33755;-1;0;-1;0;1;1
258253113692;258253157472;43780;4;1;2;1;1;1
258253157472;258253158098;626;4;1;2;1;1;1
258253158098;258253158171;73;4;1;2;1;1;1
258253158171;258253208620;50449;-1;0;-1;0;1;1
258253208620;258253209256;636;4;1;2;1;1;1
258253209256;258253244116;34860;-1;0;-1;0;1;1
258253244116;258253244575;459;4;1;2;1;1;1
258253244575;258253336846;92271;-1;0;-1;0;1;1
258253336846;258253337372;526;4;1;2;1;1;1
258253337372;258253337770;398;-1;0;-1;0;1;1
258253337770;258253338351;581;4;1;2;1;1;1
258253338351;258253441878;103527;-1;0;-1;0;1;1
258253441878;258253442514;636;4;1;2;1;1;1
258253442514;258253521057;78543;-1;0;-1;0;1;1
258253521057;258253521618;561;4;1;2;1;1;1
258253521618;258253532243;10625;-1;0;-1;0;1;1
258253532243;258253532851;608;4;1;2;1;1;1
258253532851;258253745757;212906;-1;0;-1;0;1;1
258253745757;258253746307;550;4;1;2;1;1;1
258253746307;258253784904;38597;-1;0;-1;0;1;1
258253784904;258253785880;976;4;1;2;1;1;1
258253785880;258253846340;60460;-1;0;-1;0;1;1
258253846340;258253847429;1089;4;1;2;1;1;1
258253847429;258253888511;41082;-1;0;-1;0;1;1
258253888511;258253889143;632;4;1;2;1;1;1
258253889143;258253933968;44825;-1;0;-1;0;1;1
258253933968;258253935447;1479;4;1;2;1;1;1
258253935447;258254119599;184152;-1;0;-1;0;1;1
258254119599;258254120139;540;4;1;2;1;1;1
258254120139;258254162621;42482;-1;0;-1;0;1;1
258254162621;258254163148;527;4;1;2;1;1;1
258254163148;258254252226;89078;-1;0;-1;0;1;1
258254252226;258254252796;570;4;1;2;1;1;1
258254252796;258254282660;29864;-1;0;-1;0;1;1
258254282660;258254283206;546;4;1;2;1;1;1
258254283206;258254324846;41640;-1;0;-1;0;1;1
258254324846;258254326039;1193;4;1;2;1;1;1
258254326039;258254375659;49620;-1;0;-1;0;1;1
258254375659;258254376656;997;4;1;2;1;1;1
258254376656;258254377677;1021;-1;0;-1;0;1;1
258254377677;258254378851;1174;4;1;2;1;1;1
258254378851;258254412123;33272;-1;0;-1;0;1;1
258254412123;258254412738;615;4;1;2;1;1;1
258254412738;258254440776;28038;-1;0;-1;0;1;1
258254440776;258254441358;582;4;1;2;1;1;1
258254441358;258254484087;42729;-1;0;-1;0;1;1
258254484087;258254484722;635;4;1;2;1;1;1
258254484722;258254514790;30068;-1;0;-1;0;1;1
258254514790;258254515336;546;4;1;2;1;1;1
258254515336;258254604933;89597;-1;0;-1;0;1;1
258254604933;258254605561;628;4;1;2;1;1;1
258254605561;258254605949;388;-1;0;-1;0;1;1
258254605949;258254606530;581;4;1;2;1;1;1
258254606530;258254641878;35348;-1;0;-1;0;1;1
258254641878;258254642730;852;4;1;2;1;1;1
258254642730;258254643797;1067;-1;0;-1;0;1;1
258254643797;258254644349;552;4;1;2;1;1;1
258254644349;258254689818;45469;-1;0;-1;0;1;1
258254689818;258254690469;651;4;1;2;1;1;1
258254690469;258254690697;228;-1;0;-1;0;1;1
258254690697;258254691282;585;4;1;2;1;1;1
258254691282;258254731819;40537;-1;0;-1;0;1;1
258254731819;258254732460;641;4;1;2;1;1;1
258254732460;258254776751;44291;-1;0;-1;0;1;1
258254776751;258254777354;603;4;1;2;1;1;1
258254777354;258254823697;46343;-1;0;-1;0;1;1
258254823697;258254824276;579;4;1;2;1;1;1
258254824276;258254887938;63662;-1;0;-1;0;1;1
258254887938;258254888541;603;4;1;2;1;1;1
258254888541;258254957233;68692;-1;0;-1;0;1;1
258254957233;258254962396;5163;4;1;2;1;1;1
258254962396;258255015898;53502;-1;0;-1;0;1;1
258255015898;258255015979;81;4;1;2;1;1;1
258255015979;258255016782;803;4;1;2;1;1;1
258255016782;258255016800;18;4;1;2;1;1;1
258255016800;258255100858;84058;-1;0;-1;0;1;1
258255100858;258255102958;2100;4;1;2;1;1;1
258255102958;258255104534;1576;-1;0;-1;0;1;1
258255104534;258255105182;648;4;1;2;1;1;1
258255105182;258255105280;98;-1;0;-1;0;1;1
258255105280;258255105433;153;4;1;2;1;1;1
258255105433;258255106221;788;4;1;2;1;1;1
258255106221;258255106520;299;4;1;2;1;1;1
258255106520;258255178178;71658;-1;0;-1;0;1;1
258255178178;258255178921;743;4;1;2;1;1;1
258255178921;258255179916;995;-1;0;-1;0;1;1
258255179916;258255180607;691;4;1;2;1;1;1
258255180607;258255194877;14270;-1;0;-1;0;1;1
258255194877;258255198795;3918;4;1;2;1;1;1
258255198795;258255312820;114025;-1;0;-1;0;1;1
258255312820;258255313445;625;4;1;2;1;1;1
258255313445;258255359013;45568;-1;0;-1;0;1;1
258255359013;258255359577;564;4;1;2;1;1;1
258255359577;258255444206;84629;-1;0;-1;0;1;1
258255444206;258255444753;547;4;1;2;1;1;1
258255444753;258255561633;116880;-1;0;-1;0;1;1
258255561633;258255563217;1584;4;1;2;1;1;1
258255563217;258255573052;9835;-1;0;-1;0;1;1
258255573052;258255574527;1475;4;1;2;1;1;1
258255574527;258255616412;41885;-1;0;-1;0;1;1
258255616412;258255617047;635;4;1;2;1;1;1
258255617047;258255664535;47488;-1;0;-1;0;1;1
258255664535;258255668853;4318;4;1;2;1;1;1
258255668853;258255676623;7770;-1;0;-1;0;1;1
258255676623;258255677174;551;4;1;2;1;1;1
258255677174;258255756630;79456;-1;0;-1;0;1;1
258255756630;258255757191;561;4;1;2;1;1;1
258255757191;258255757596;405;-1;0;-1;0;1;1
258255757596;258255758249;653;4;1;2;1;1;1
258255758249;258255790202;31953;-1;0;-1;0;1;1
258255790202;258255790764;562;4;1;2;1;1;1
258255790764;258255835616;44852;-1;0;-1;0;1;1
258255835616;258255836577;961;4;1;2;1;1;1
258255836577;258255882100;45523;-1;0;-1;0;1;1
258255882100;258255883914;1814;4;1;2;1;1;1
258255883914;258255884118;204;-1;0;-1;0;1;1
258255884118;258255885688;1570;4;1;2;1;1;1
258255885688;258255957822;72134;-1;0;-1;0;1;1
258255957822;258255958281;459;4;1;2;1;1;1
258255958281;258255968939;10658;-1;0;-1;0;1;1
258255968939;258255969455;516;4;1;2;1;1;1
258255969455;258256012600;43145;-1;0;-1;0;1;1
258256012600;258256013148;548;4;1;2;1;1;1
258256013148;258256050329;37181;-1;0;-1;0;1;1
258256050329;258256050947;618;4;1;2;1;1;1
258256050947;258256051432;485;-1;0;-1;0;1;1
258256051432;258256052067;635;4;1;2;1;1;1
258256052067;258256059919;7852;-1;0;-1;0;1;1
258256059919;258256060530;611;4;1;2;1;1;1
258256060530;258256130268;69738;-1;0;-1;0;1;1
258256130268;258256130837;569;4;1;2;1;1;1
258256130837;258256164127;33290;-1;0;-1;0;1;1
258256164127;258256164746;619;4;1;2;1;1;1
258256164746;258256202173;37427;-1;0;-1;0;1;1
258256202173;258256202803;630;4;1;2;1;1;1
258256202803;258256240712;37909;-1;0;-1;0;1;1
258256240712;258256241588;876;4;1;2;1;1;1
258256241588;258256243406;1818;-1;0;-1;0;1;1
258256243406;258256243952;546;4;1;2;1;1;1
258256243952;258256277583;33631;-1;0;-1;0;1;1
258256277583;258256278125;542;4;1;2;1;1;1
258256278125;258256326703;48578;-1;0;-1;0;1;1
258256326703;258256328325;1622;4;1;2;1;1;1
258256328325;258256330416;2091;4;1;2;1;1;1
258256330416;258256330783;367;4;1;2;1;1;1
258256330783;258256330959;176;4;1;2;1;1;1
258256330959;258256331945;986;4;1;2;1;1;1
258256331945;258256332340;395;4;1;2;1;1;1
258256332340;258256332499;159;4;1;2;1;1;1
258256332499;258256367732;35233;-1;0;-1;0;1;1
258256367732;258256368278;546;4;1;2;1;1;1
258256368278;258256415940;47662;-1;0;-1;0;1;1
258256415940;258256416495;555;4;1;2;1;1;1
258256416495;258256459083;42588;-1;0;-1;0;1;1
258256459083;258256459646;563;4;1;2;1;1;1
258256459646;258256501096;41450;-1;0;-1;0;1;1
258256501096;258256501645;549;4;1;2;1;1;1
258256501645;258256561305;59660;-1;0;-1;0;1;1
258256561305;258256561956;651;4;1;2;1;1;1
258256561956;258256606184;44228;-1;0;-1;0;1;1
258256606184;258256606775;591;4;1;2;1;1;1
258256606775;258256670752;63977;-1;0;-1;0;1;1
258256670752;258256671318;566;4;1;2;1;1;1
258256671318;258256764470;93152;-1;0;-1;0;1;1
258256764470;258256765102;632;4;1;2;1;1;1
258256765102;258256801912;36810;-1;0;-1;0;1;1
258256801912;258256802456;544;4;1;2;1;1;1
258256802456;258256850428;47972;-1;0;-1;0;1;1
258256850428;258256850980;552;4;1;2;1;1;1
258256850980;258256889152;38172;-1;0;-1;0;1;1
258256889152;258256889705;553;4;1;2;1;1;1
258256889705;258256970819;81114;-1;0;-1;0;1;1
258256970819;258256971492;673;4;1;2;1;1;1
258256971492;258257017306;45814;-1;0;-1;0;1;1
258257017306;258257017934;628;4;1;2;1;1;1
258257017934;258257026714;8780;-1;0;-1;0;1;1
258257026714;258257027266;552;4;1;2;1;1;1
258257027266;258257075343;48077;-1;0;-1;0;1;1
258257075343;258257075940;597;4;1;2;1;1;1
258257075940;258257112201;36261;-1;0;-1;0;1;1
258257112201;258257112690;489;4;1;2;1;1;1
258257112690;258257160238;47548;-1;0;-1;0;1;1
258257160238;258257160776;538;4;1;2;1;1;1
258257160776;258257326570;165794;-1;0;-1;0;1;1
258257326570;258257327566;996;4;1;2;1;1;1
258257327566;258257328309;743;4;1;2;1;1;1
258257328309;258257328494;185;4;1;2;1;1;1
258257328494;258257329681;1187;-1;0;-1;0;1;1
258257329681;258257330323;642;4;1;2;1;1;1
258257330323;258257354141;23818;-1;0;-1;0;1;1
258257354141;258257354765;624;4;1;2;1;1;1
258257354765;258257403121;48356;-1;0;-1;0;1;1
258257403121;258257403972;851;4;1;2;1;1;1
258257403972;258257448835;44863;-1;0;-1;0;1;1
258257448835;258257450509;1674;4;1;2;1;1;1
258257450509;258257451187;678;-1;0;-1;0;1;1
258257451187;258257452520;1333;4;1;2;1;1;1
258257452520;258257510348;57828;-1;0;-1;0;1;1
258257510348;258257510993;645;4;1;2;1;1;1
258257510993;258257511504;511;-1;0;-1;0;1;1
258257511504;258257512196;692;4;1;2;1;1;1
258257512196;258257551711;39515;-1;0;-1;0;1;1
258257551711;258257552859;1148;4;1;2;1;1;1
258257552859;258257595489;42630;-1;0;-1;0;1;1
258257595489;258257603182;7693;4;1;2;1;1;1
258257603182;258257638455;35273;-1;0;-1;0;1;1
258257638455;258257642709;4254;4;1;2;1;1;1
258257642709;258257674172;31463;-1;0;-1;0;1;1
258257674172;258257674946;774;4;1;2;1;1;1
258257674946;258257717966;43020;-1;0;-1;0;1;1
258257717966;258257718509;543;4;1;2;1;1;1
258257718509;258257804800;86291;-1;0;-1;0;1;1
258257804800;258257805432;632;4;1;2;1;1;1
258257805432;258257881851;76419;-1;0;-1;0;1;1
258257881851;258257882789;938;4;1;2;1;1;1
258257882789;258257882861;72;-1;0;-1;0;1;1
258257882861;258257883808;947;4;1;2;1;1;1
258257883808;258257884470;662;4;1;2;1;1;1
258257884470;258257884623;153;4;1;2;1;1;1
258257884623;258257919629;35006;-1;0;-1;0;1;1
258257919629;258257920099;470;4;1;2;1;1;1
258257920099;258257962286;42187;-1;0;-1;0;1;1
258257962286;258257963166;880;4;1;2;1;1;1
258257963166;258258047527;84361;-1;0;-1;0;1;1
258258047527;258258048890;1363;4;1;2;1;1;1
258258048890;258258094072;45182;-1;0;-1;0;1;1
258258094072;258258095125;1053;4;1;2;1;1;1
258258095125;258258139810;44685;-1;0;-1;0;1;1
258258139810;258258140369;559;4;1;2;1;1;1
258258140369;258258297122;156753;-1;0;-1;0;1;1
258258297122;258258297642;520;4;1;2;1;1;1
258258297642;258258346351;48709;-1;0;-1;0;1;1
258258346351;258258347185;834;4;1;2;1;1;1
258258347185;258258355714;8529;-1;0;-1;0;1;1
258258355714;258258356361;647;4;1;2;1;1;1
258258356361;258258429962;73601;-1;0;-1;0;1;1
258258429962;258258431417;1455;4;1;2;1;1;1
258258431417;258258471183;39766;-1;0;-1;0;1;1
258258471183;258258471779;596;4;1;2;1;1;1
258258471779;258258531162;59383;-1;0;-1;0;1;1
258258531162;258258531945;783;4;1;2;1;1;1
258258531945;258258618096;86151;-1;0;-1;0;1;1
258258618096;258258618648;552;4;1;2;1;1;1
258258618648;258258688320;69672;-1;0;-1;0;1;1
258258688320;258258688948;628;4;1;2;1;1;1
258258688948;258258750682;61734;-1;0;-1;0;1;1
258258750682;258258751328;646;4;1;2;1;1;1
258258751328;258258876008;124680;-1;0;-1;0;1;1
258258876008;258258876640;632;4;1;2;1;1;1
258258876640;258258923514;46874;-1;0;-1;0;1;1
258258923514;258258925695;2181;4;1;2;1;1;1
258258925695;258258968500;42805;-1;0;-1;0;1;1
258258968500;258258969129;629;4;1;2;1;1;1
258258969129;258259008132;39003;-1;0;-1;0;1;1
258259008132;258259008981;849;4;1;2;1;1;1
258259008981;258259009326;345;4;1;2;1;1;1
258259009326;258259009527;201;4;1;2;1;1;1
258259009527;258259010175;648;-1;0;-1;0;1;1
258259010175;258259010950;775;4;1;2;1;1;1
258259010950;258259040286;29336;-1;0;-1;0;1;1
258259040286;258259044220;3934;4;1;2;1;1;1
258259044220;258259074991;30771;-1;0;-1;0;1;1
258259074991;258259075554;563;4;1;2;1;1;1
258259075554;258259111729;36175;-1;0;-1;0;1;1
258259111729;258259112365;636;4;1;2;1;1;1
258259112365;258259113930;1565;-1;0;-1;0;1;1
258259113930;258259114532;602;4;1;2;1;1;1
258259114532;258259143140;28608;-1;0;-1;0;1;1
258259143140;258259143693;553;4;1;2;1;1;1
258259143693;258259177506;33813;-1;0;-1;0;1;1
258259177506;258259178056;550;4;1;2;1;1;1
258259178056;258259209954;31898;-1;0;-1;0;1;1
258259209954;258259210183;229;4;1;2;1;1;1
258259210183;258259210798;615;4;1;2;1;1;1
258259210798;258259211179;381;4;1;2;1;1;1
258259211179;258259238771;27592;-1;0;-1;0;1;1
258259238771;258259239370;599;4;1;2;1;1;1
258259239370;258259332948;93578;-1;0;-1;0;1;1
258259332948;258259350042;17094;4;1;2;1;1;1
258259350042;258259455501;105459;-1;0;-1;0;1;1
258259455501;258259455993;492;4;1;2;1;1;1
258259455993;258259501875;45882;-1;0;-1;0;1;1
258259501875;258259508078;6203;4;1;2;1;1;1
258259508078;258259546319;38241;-1;0;-1;0;1;1
258259546319;258259547284;965;4;1;2;1;1;1
258259547284;258259753365;206081;-1;0;-1;0;1;1
258259753365;258259753828;463;4;1;2;1;1;1
258259753828;258259788311;34483;-1;0;-1;0;1;1
258259788311;258259788837;526;4;1;2;1;1;1
258259788837;258259799818;10981;-1;0;-1;0;1;1
258259799818;258259801109;1291;4;1;2;1;1;1
258259801109;258259892667;91558;-1;0;-1;0;1;1
258259892667;258259893221;554;4;1;2;1;1;1
258259893221;258259937651;44430;-1;0;-1;0;1;1
258259937651;258259938120;469;4;1;2;1;1;1
258259938120;258259997555;59435;-1;0;-1;0;1;1
258259997555;258259998192;637;4;1;2;1;1;1
258259998192;258260041567;43375;-1;0;-1;0;1;1
258260041567;258260042177;610;4;1;2;1;1;1
258260042177;258260077815;35638;-1;0;-1;0;1;1
258260077815;258260078334;519;4;1;2;1;1;1
258260078334;258260122482;44148;-1;0;-1;0;1;1
258260122482;258260123074;592;4;1;2;1;1;1
258260123074;258260161688;38614;-1;0;-1;0;1;1
258260161688;258260162168;480;4;1;2;1;1;1
258260162168;258260201595;39427;-1;0;-1;0;1;1
258260201595;258260202147;552;4;1;2;1;1;1
258260202147;258260236521;34374;-1;0;-1;0;1;1
258260236521;258260237598;1077;4;1;2;1;1;1
258260237598;258260273642;36044;-1;0;-1;0;1;1
258260273642;258260274789;1147;4;1;2;1;1;1
258260274789;258260307002;32213;-1;0;-1;0;1;1
258260307002;258260307644;642;4;1;2;1;1;1
258260307644;258260350921;43277;-1;0;-1;0;1;1
258260350921;258260351455;534;4;1;2;1;1;1
258260351455;258260463334;111879;-1;0;-1;0;1;1
258260463334;258260463887;553;4;1;2;1;1;1
258260463887;258260511895;48008;-1;0;-1;0;1;1
258260511895;258260512536;641;4;1;2;1;1;1
258260512536;258260521608;9072;-1;0;-1;0;1;1
258260521608;258260522723;1115;4;1;2;1;1;1
258260522723;258260575778;53055;-1;0;-1;0;1;1
258260575778;258260576413;635;4;1;2;1;1;1
258260576413;258260607111;30698;-1;0;-1;0;1;1
258260607111;258260607739;628;4;1;2;1;1;1
258260607739;258260690436;82697;-1;0;-1;0;1;1
258260690436;258260691020;584;4;1;2;1;1;1
258260691020;258260735807;44787;-1;0;-1;0;1;1
258260735807;258260736362;555;4;1;2;1;1;1
258260736362;258260789687;53325;-1;0;-1;0;1;1
258260789687;258260791961;2274;4;1;2;1;1;1
258260791961;258260822561;30600;-1;0;-1;0;1;1
258260822561;258260823166;605;4;1;2;1;1;1
258260823166;258260861822;38656;-1;0;-1;0;1;1
258260861822;258260862461;639;4;1;2;1;1;1
258260862461;258260892192;29731;-1;0;-1;0;1;1
258260892192;258260892744;552;4;1;2;1;1;1
258260892744;258260959391;66647;-1;0;-1;0;1;1
258260959391;258260960090;699;4;1;2;1;1;1
258260960090;258261000404;40314;-1;0;-1;0;1;1
258261000404;258261001063;659;4;1;2;1;1;1
258261001063;258261074971;73908;-1;0;-1;0;1;1
258261074971;258261076106;1135;4;1;2;1;1;1
258261076106;258261119617;43511;-1;0;-1;0;1;1
258261119617;258261120178;561;4;1;2;1;1;1
258261120178;258261182794;62616;-1;0;-1;0;1;1
258261182794;258261183331;537;4;1;2;1;1;1
258261183331;258261218328;34997;-1;0;-1;0;1;1
258261218328;258261218961;633;4;1;2;1;1;1
258261218961;258261266398;47437;-1;0;-1;0;1;1
258261266398;258261266948;550;4;1;2;1;1;1
258261266948;258261385803;118855;-1;0;-1;0;1;1
258261385803;258261386756;953;4;1;2;1;1;1
258261386756;258261491465;104709;-1;0;-1;0;1;1
258261491465;258261492286;821;4;1;2;1;1;1
258261492286;258261534006;41720;-1;0;-1;0;1;1
258261534006;258261534568;562;4;1;2;1;1;1
258261534568;258261771839;237271;-1;0;-1;0;1;1
258261771839;258261772845;1006;4;1;2;1;1;1
258261772845;258261774567;1722;-1;0;-1;0;1;1
258261774567;258261775534;967;4;1;2;1;1;1
258261775534;258261780171;4637;-1;0;-1;0;1;1
258261780171;258261780920;749;4;1;2;1;1;1
258261780920;258261782850;1930;4;1;2;1;1;1
258261782850;258261784002;1152;4;1;2;1;1;1
258261784002;258261784419;417;-1;0;-1;0;1;1
258261784419;258261785990;1571;4;1;2;1;1;1
258261785990;258261786689;699;4;1;2;1;1;1
258261786689;258261787695;1006;4;1;2;1;1;1
258261787695;258261789449;1754;4;1;2;1;1;1
258261789449;258261789953;504;4;1;2;1;1;1
258261789953;258261790480;527;4;1;2;1;1;1
258261790480;258261791240;760;4;1;2;1;1;1
258261791240;258261792523;1283;-1;0;-1;0;1;1
258261792523;258261793424;901;4;1;2;1;1;1
258261793424;258261827317;33893;-1;0;-1;0;1;1
258261827317;258261827793;476;4;1;2;1;1;1
258261827793;258261862986;35193;-1;0;-1;0;1;1
258261862986;258261863616;630;4;1;2;1;1;1
258261863616;258261901097;37481;-1;0;-1;0;1;1
258261901097;258261901655;558;4;1;2;1;1;1
258261901655;258261942152;40497;-1;0;-1;0;1;1
258261942152;258261942695;543;4;1;2;1;1;1
258261942695;258261986774;44079;-1;0;-1;0;1;1
258261986774;258261987422;648;4;1;2;1;1;1
258261987422;258262019942;32520;-1;0;-1;0;1;1
258262019942;258262020592;650;4;1;2;1;1;1
258262020592;258262024770;4178;-1;0;-1;0;1;1
258262024770;258262025242;472;4;1;2;1;1;1
258262025242;258262069516;44274;-1;0;-1;0;1;1
258262069516;258262070173;657;4;1;2;1;1;1
258262070173;258262203428;133255;-1;0;-1;0;1;1
258262203428;258262204080;652;4;1;2;1;1;1
258262204080;258262329862;125782;-1;0;-1;0;1;1
258262329862;258262330427;565;4;1;2;1;1;1
258262330427;258262408662;78235;-1;0;-1;0;1;1
258262408662;258262409597;935;4;1;2;1;1;1
258262409597;258262457416;47819;-1;0;-1;0;1;1
258262457416;258262457970;554;4;1;2;1;1;1
258262457970;258262495503;37533;-1;0;-1;0;1;1
258262495503;258262496135;632;4;1;2;1;1;1
258262496135;258262528656;32521;-1;0;-1;0;1;1
258262528656;258262529288;632;4;1;2;1;1;1
258262529288;258262626152;96864;-1;0;-1;0;1;1
258262626152;258262626650;498;4;1;2;1;1;1
258262626650;258262626877;227;4;1;2;1;1;1
258262626877;258262627319;442;4;1;2;1;1;1
258262627319;258262668631;41312;-1;0;-1;0;1;1
258262668631;258262669438;807;4;1;2;1;1;1
258262669438;258262704831;35393;-1;0;-1;0;1;1
258262704831;258262705531;700;4;1;2;1;1;1
258262705531;258262746285;40754;-1;0;-1;0;1;1
258262746285;258262746847;562;4;1;2;1;1;1
258262746847;258262884033;137186;-1;0;-1;0;1;1
258262884033;258262885028;995;4;1;2;1;1;1
258262885028;258262968152;83124;-1;0;-1;0;1;1
258262968152;258262968721;569;4;1;2;1;1;1
258262968721;258262978335;9614;-1;0;-1;0;1;1
258262978335;258262978888;553;4;1;2;1;1;1
258262978888;258263014983;36095;-1;0;-1;0;1;1
258263014983;258263015616;633;4;1;2;1;1;1
258263015616;258263052571;36955;-1;0;-1;0;1;1
258263052571;258263053224;653;4;1;2;1;1;1
258263053224;258263197417;144193;-1;0;-1;0;1;1
258263197417;258263198188;771;4;1;2;1;1;1
258263198188;258263259040;60852;-1;0;-1;0;1;1
258263259040;258263260437;1397;4;1;2;1;1;1
258263260437;258263260551;114;-1;0;-1;0;1;1
258263260551;258263261577;1026;4;1;2;1;1;1
258263261577;258263311427;49850;-1;0;-1;0;1;1
258263311427;258263312265;838;4;1;2;1;1;1
258263312265;258263392199;79934;-1;0;-1;0;1;1
258263392199;258263393310;1111;4;1;2;1;1;1
258263393310;258263443414;50104;-1;0;-1;0;1;1
258263443414;258263444245;831;4;1;2;1;1;1
258263444245;258263457183;12938;-1;0;-1;0;1;1
258263457183;258263457838;655;4;1;2;1;1;1
258263457838;258263497859;40021;-1;0;-1;0;1;1
258263497859;258263499075;1216;4;1;2;1;1;1
258263499075;258263563185;64110;-1;0;-1;0;1;1
258263563185;258263563957;772;4;1;2;1;1;1
258263563957;258263648625;84668;-1;0;-1;0;1;1
258263648625;258263649273;648;4;1;2;1;1;1
258263649273;258263736769;87496;-1;0;-1;0;1;1
258263736769;258263738003;1234;4;1;2;1;1;1
258263738003;258263739157;1154;-1;0;-1;0;1;1
258263739157;258263743171;4014;4;1;2;1;1;1
258263743171;258263786631;43460;-1;0;-1;0;1;1
258263786631;258263787320;689;4;1;2;1;1;1
258263787320;258263866566;79246;-1;0;-1;0;1;1
258263866566;258263867401;835;4;1;2;1;1;1
258263867401;258263913846;46445;-1;0;-1;0;1;1
258263913846;258263914477;631;4;1;2;1;1;1
258263914477;258263967884;53407;-1;0;-1;0;1;1
258263967884;258263968903;1019;4;1;2;1;1;1
258263968903;258264046539;77636;-1;0;-1;0;1;1
258264046539;258264047177;638;4;1;2;1;1;1
258264047177;258264081627;34450;-1;0;-1;0;1;1
258264081627;258264083151;1524;4;1;2;1;1;1
258264083151;258264083874;723;-1;0;-1;0;1;1
258264083874;258264084920;1046;4;1;2;1;1;1
258264084920;258264086871;1951;-1;0;-1;0;1;1
258264086871;258264087825;954;4;1;2;1;1;1
258264087825;258264113116;25291;-1;0;-1;0;1;1
258264113116;258264120440;7324;4;1;2;1;1;1
258264120440;258264178919;58479;-1;0;-1;0;1;1
258264178919;258264179489;570;4;1;2;1;1;1
258264179489;258264245843;66354;-1;0;-1;0;1;1
258264245843;258264246475;632;4;1;2;1;1;1
258264246475;258264294371;47896;-1;0;-1;0;1;1
258264294371;258264294913;542;4;1;2;1;1;1
258264294913;258264332575;37662;-1;0;-1;0;1;1
258264332575;258264333130;555;4;1;2;1;1;1
258264333130;258264362143;29013;-1;0;-1;0;1;1
258264362143;258264362761;618;4;1;2;1;1;1
258264362761;258264426453;63692;-1;0;-1;0;1;1
258264426453;258264426997;544;4;1;2;1;1;1
258264426997;258264508361;81364;-1;0;-1;0;1;1
258264508361;258264508991;630;4;1;2;1;1;1
258264508991;258264545635;36644;-1;0;-1;0;1;1
258264545635;258264546628;993;4;1;2;1;1;1
258264546628;258264621499;74871;-1;0;-1;0;1;1
258264621499;258264621977;478;4;1;2;1;1;1
258264621977;258264663345;41368;-1;0;-1;0;1;1
258264663345;258264663891;546;4;1;2;1;1;1
258264663891;258264717368;53477;-1;0;-1;0;1;1
258264717368;258264717920;552;4;1;2;1;1;1
258264717920;258264804988;87068;-1;0;-1;0;1;1
258264804988;258264855738;50750;4;1;2;1;1;1
258264855738;258264885599;29861;-1;0;-1;0;1;1
258264885599;258264886145;546;4;1;2;1;1;1
258264886145;258264971902;85757;-1;0;-1;0;1;1
258264971902;258264973502;1600;4;1;2;1;1;1
258264973502;258264974030;528;-1;0;-1;0;1;1
258264974030;258264974528;498;4;1;2;1;1;1
258264974528;258264974752;224;4;1;2;1;1;1
258264974752;258264975108;356;4;1;2;1;1;1
258264975108;258265008090;32982;-1;0;-1;0;1;1
258265008090;258265008644;554;4;1;2;1;1;1
258265008644;258265041199;32555;-1;0;-1;0;1;1
258265041199;258265041833;634;4;1;2;1;1;1
258265041833;258265092655;50822;-1;0;-1;0;1;1
258265092655;258265094236;1581;4;1;2;1;1;1
258265094236;258265094424;188;-1;0;-1;0;1;1
258265094424;258265095119;695;4;1;2;1;1;1
258265095119;258265095377;258;-1;0;-1;0;1;1
258265095377;258265095963;586;4;1;2;1;1;1
258265095963;258265137448;41485;-1;0;-1;0;1;1
258265137448;258265138075;627;4;1;2;1;1;1
258265138075;258265169163;31088;-1;0;-1;0;1;1
258265169163;258265169725;562;4;1;2;1;1;1
258265169725;258265241554;71829;-1;0;-1;0;1;1
258265241554;258265242110;556;4;1;2;1;1;1
258265242110;258265276365;34255;-1;0;-1;0;1;1
258265276365;258265276893;528;4;1;2;1;1;1
258265276893;258265353412;76519;-1;0;-1;0;1;1
258265353412;258265354024;612;4;1;2;1;1;1
258265354024;258265411119;57095;-1;0;-1;0;1;1
258265411119;258265411646;527;4;1;2;1;1;1
258265411646;258265447519;35873;-1;0;-1;0;1;1
258265447519;258265448165;646;4;1;2;1;1;1
258265448165;258265524306;76141;-1;0;-1;0;1;1
258265524306;258265524858;552;4;1;2;1;1;1
258265524858;258265559695;34837;-1;0;-1;0;1;1
258265559695;258265560347;652;4;1;2;1;1;1
258265560347;258265642807;82460;-1;0;-1;0;1;1
258265642807;258265643281;474;4;1;2;1;1;1
258265643281;258265689340;46059;-1;0;-1;0;1;1
258265689340;258265689986;646;4;1;2;1;1;1
258265689986;258265720875;30889;-1;0;-1;0;1;1
258265720875;258265721429;554;4;1;2;1;1;1
258265721429;258265847195;125766;-1;0;-1;0;1;1
258265847195;258265847667;472;4;1;2;1;1;1
258265847667;258265881940;34273;-1;0;-1;0;1;1
258265881940;258265883625;1685;4;1;2;1;1;1
258265883625;258265922718;39093;-1;0;-1;0;1;1
258265922718;258265923185;467;4;1;2;1;1;1
258265923185;258265958444;35259;-1;0;-1;0;1;1
258265958444;258265958905;461;4;1;2;1;1;1
258265958905;258265993953;35048;-1;0;-1;0;1;1
258265993953;258265994410;457;4;1;2;1;1;1
258265994410;258266055273;60863;-1;0;-1;0;1;1
258266055273;258266055914;641;4;1;2;1;1;1
258266055914;258266089005;33091;-1;0;-1;0;1;1
258266089005;258266089565;560;4;1;2;1;1;1
258266089565;258266135672;46107;-1;0;-1;0;1;1
258266135672;258266136201;529;4;1;2;1;1;1
258266136201;258266136395;194;-1;0;-1;0;1;1
258266136395;258266137062;667;4;1;2;1;1;1
258266137062;258266173400;36338;-1;0;-1;0;1;1
258266173400;258266189006;15606;4;1;2;1;1;1
258266189006;258266246049;57043;-1;0;-1;0;1;1
258266246049;258266246595;546;4;1;2;1;1;1
258266246595;258266285806;39211;-1;0;-1;0;1;1
258266285806;258266286478;672;4;1;2;1;1;1
258266286478;258266331191;44713;-1;0;-1;0;1;1
258266331191;258266331723;532;4;1;2;1;1;1
258266331723;258266379667;47944;-1;0;-1;0;1;1
258266379667;258266380131;464;4;1;2;1;1;1
258266380131;258266436441;56310;-1;0;-1;0;1;1
258266436441;258266436984;543;4;1;2;1;1;1
258266436984;258266482192;45208;-1;0;-1;0;1;1
258266482192;258266482808;616;4;1;2;1;1;1
258266482808;258266529213;46405;-1;0;-1;0;1;1
258266529213;258266529751;538;4;1;2;1;1;1
258266529751;258266617190;87439;-1;0;-1;0;1;1
258266617190;258266617651;461;4;1;2;1;1;1
258266617651;258266660576;42925;-1;0;-1;0;1;1
258266660576;258266661069;493;4;1;2;1;1;1
258266661069;258266697126;36057;-1;0;-1;0;1;1
258266697126;258266697688;562;4;1;2;1;1;1
258266697688;258266736749;39061;-1;0;-1;0;1;1
258266736749;258266737336;587;4;1;2;1;1;1
258266737336;258266739058;1722;-1;0;-1;0;1;1
258266739058;258266739937;879;4;1;2;1;1;1
258266739937;258266904392;164455;-1;0;-1;0;1;1
258266904392;258266911293;6901;4;1;2;1;1;1
258266911293;258266951789;40496;-1;0;-1;0;1;1
258266951789;258266952424;635;4;1;2;1;1;1
258266952424;258267000479;48055;-1;0;-1;0;1;1
258267000479;258267001107;628;4;1;2;1;1;1
258267001107;258267149405;148298;-1;0;-1;0;1;1
258267149405;258267150036;631;4;1;2;1;1;1
258267150036;258267224194;74158;-1;0;-1;0;1;1
258267224194;258267224721;527;4;1;2;1;1;1
258267224721;258267291602;66881;-1;0;-1;0;1;1
258267291602;258267292236;634;4;1;2;1;1;1
258267292236;258267341528;49292;-1;0;-1;0;1;1
258267341528;258267342838;1310;4;1;2;1;1;1
258267342838;258267383604;40766;-1;0;-1;0;1;1
258267383604;258267384395;791;4;1;2;1;1;1
258267384395;258267428501;44106;-1;0;-1;0;1;1
258267428501;258267429132;631;4;1;2;1;1;1
258267429132;258267505712;76580;-1;0;-1;0;1;1
258267505712;258267506186;474;4;1;2;1;1;1
258267506186;258267570038;63852;-1;0;-1;0;1;1
258267570038;258267570507;469;4;1;2;1;1;1
258267570507;258267629378;58871;-1;0;-1;0;1;1
258267629378;258267629856;478;4;1;2;1;1;1
258267629856;258267680467;50611;-1;0;-1;0;1;1
258267680467;258267680929;462;4;1;2;1;1;1
258267680929;258267756987;76058;-1;0;-1;0;1;1
258267756987;258267758103;1116;4;1;2;1;1;1
258267758103;258267759564;1461;-1;0;-1;0;1;1
258267759564;258267760818;1254;4;1;2;1;1;1
258267760818;258267776837;16019;-1;0;-1;0;1;1
258267776837;258267777474;637;4;1;2;1;1;1
258267777474;258267823391;45917;-1;0;-1;0;1;1
258267823391;258267824004;613;4;1;2;1;1;1
258267824004;258267838707;14703;-1;0;-1;0;1;1
258267838707;258267839353;646;4;1;2;1;1;1
258267839353;258267883160;43807;-1;0;-1;0;1;1
258267883160;258267883665;505;4;1;2;1;1;1
258267883665;258267883721;56;4;1;2;1;1;1
258267883721;258267884444;723;4;1;2;1;1;1
258267884444;258267959368;74924;-1;0;-1;0;1;1
258267959368;258267959940;572;4;1;2;1;1;1
258267959940;258268058091;98151;-1;0;-1;0;1;1
258268058091;258268059280;1189;4;1;2;1;1;1
258268059280;258268137037;77757;-1;0;-1;0;1;1
258268137037;258268137869;832;4;1;2;1;1;1
258268137869;258268184251;46382;-1;0;-1;0;1;1
258268184251;258268184888;637;4;1;2;1;1;1
258268184888;258268260662;75774;-1;0;-1;0;1;1
258268260662;258268261226;564;4;1;2;1;1;1
258268261226;258268304824;43598;-1;0;-1;0;1;1
258268304824;258268305386;562;4;1;2;1;1;1
258268305386;258268370620;65234;-1;0;-1;0;1;1
258268370620;258268371176;556;4;1;2;1;1;1
258268371176;258268455735;84559;-1;0;-1;0;1;1
258268455735;258268456190;455;4;1;2;1;1;1
258268456190;258268576842;120652;-1;0;-1;0;1;1
258268576842;258268577392;550;4;1;2;1;1;1
258268577392;258268658624;81232;-1;0;-1;0;1;1
258268658624;258268660172;1548;4;1;2;1;1;1
258268660172;258268707015;46843;-1;0;-1;0;1;1
258268707015;258268707649;634;4;1;2;1;1;1
258268707649;258268773721;66072;-1;0;-1;0;1;1
258268773721;258268774282;561;4;1;2;1;1;1
258268774282;258268819958;45676;-1;0;-1;0;1;1
258268819958;258268820520;562;4;1;2;1;1;1
258268820520;258268870089;49569;-1;0;-1;0;1;1
258268870089;258268870776;687;4;1;2;1;1;1
258268870776;258268974579;103803;-1;0;-1;0;1;1
258268974579;258268975207;628;4;1;2;1;1;1
258268975207;258269118056;142849;-1;0;-1;0;1;1
258269118056;258269119123;1067;4;1;2;1;1;1
258269119123;258269161961;42838;-1;0;-1;0;1;1
258269161961;258269162611;650;4;1;2;1;1;1
258269162611;258269166075;3464;-1;0;-1;0;1;1
258269166075;258269166844;769;4;1;2;1;1;1
258269166844;258269239783;72939;-1;0;-1;0;1;1
258269239783;258269243350;3567;4;1;2;1;1;1
258269243350;258269246936;3586;-1;0;-1;0;1;1
258269246936;258269248172;1236;4;1;2;1;1;1
258269248172;258269249863;1691;-1;0;-1;0;1;1
258269249863;258269251600;1737;4;1;2;1;1;1
258269251600;258269259062;7462;-1;0;-1;0;1;1
258269259062;258269259109;47;4;1;2;1;1;1
258269259109;258269262066;2957;4;1;2;1;1;1
258269262066;258269263092;1026;4;1;2;1;1;1
258269263092;258269264146;1054;4;1;2;1;1;1
258269264146;258269264830;684;4;1;2;1;1;1
258269264830;258269265436;606;4;1;2;1;1;1
258269265436;258269266578;1142;4;1;2;1;1;1
258269266578;258269268396;1818;-1;0;-1;0;1;1
258269268396;258269270577;2181;4;1;2;1;1;1
258269270577;258269271346;769;4;1;2;1;1;1
258269271346;258269272586;1240;4;1;2;1;1;1
258269272586;258269273218;632;4;1;2;1;1;1
258269273218;258269278309;5091;4;1;2;1;1;1
258269278309;258269279147;838;-1;0;-1;0;1;1
258269279147;258269282568;3421;4;1;2;1;1;1
258269282568;258269283297;729;-1;0;-1;0;1;1
258269283297;258269286146;2849;4;1;2;1;1;1
258269286146;258269286307;161;4;1;2;1;1;1
258269286307;258269289466;3159;4;1;2;1;1;1
258269289466;258269296728;7262;-1;0;-1;0;1;1
258269296728;258269302860;6132;4;1;2;1;1;1
258269302860;258269304276;1416;-1;0;-1;0;1;1
258269304276;258269322571;18295;4;1;2;1;1;1
258269322571;258269485804;163233;-1;0;-1;0;1;1
258269485804;258269486437;633;4;1;2;1;1;1
258269486437;258269488174;1737;-1;0;-1;0;1;1
258269488174;258269488776;602;4;1;2;1;1;1
258269488776;258269593193;104417;-1;0;-1;0;1;1
258269593193;258269593755;562;4;1;2;1;1;1
258269593755;258269667930;74175;-1;0;-1;0;1;1
258269667930;258269669458;1528;4;1;2;1;1;1
258269669458;258269672312;2854;-1;0;-1;0;1;1
258269672312;258269673986;1674;4;1;2;1;1;1
258269673986;258269674427;441;-1;0;-1;0;1;1
258269674427;258269675379;952;4;1;2;1;1;1
258269675379;258269680070;4691;-1;0;-1;0;1;1
258269680070;258269682949;2879;4;1;2;1;1;1
258269682949;258269686831;3882;-1;0;-1;0;1;1
258269686831;258269687440;609;4;1;2;1;1;1
258269687440;258269687643;203;4;1;2;1;1;1
258269687643;258269688665;1022;4;1;2;1;1;1
258269688665;258269690067;1402;4;1;2;1;1;1
258269690067;258269691085;1018;4;1;2;1;1;1
258269691085;258269697775;6690;-1;0;-1;0;1;1
258269697775;258269698916;1141;4;1;2;1;1;1
258269698916;258269699747;831;-1;0;-1;0;1;1
258269699747;258269700497;750;4;1;2;1;1;1
258269700497;258269704709;4212;-1;0;-1;0;1;1
258269704709;258269745431;40722;4;1;2;1;1;1
258269745431;258269745951;520;4;1;2;1;1;1
258269745951;258269753865;7914;4;1;2;1;1;1
258269753865;258269784852;30987;-1;0;-1;0;1;1
258269784852;258269785402;550;4;1;2;1;1;1
258269785402;258269804182;18780;-1;0;-1;0;1;1
258269804182;258269804813;631;4;1;2;1;1;1
258269804813;258269861665;56852;-1;0;-1;0;1;1
258269861665;258269862365;700;4;1;2;1;1;1
258269862365;258269862841;476;-1;0;-1;0;1;1
258269862841;258269863485;644;4;1;2;1;1;1
258269863485;258269866982;3497;-1;0;-1;0;1;1
258269866982;258269867614;632;4;1;2;1;1;1
258269867614;258269868194;580;-1;0;-1;0;1;1
258269868194;258269868825;631;4;1;2;1;1;1
258269868825;258269877188;8363;-1;0;-1;0;1;1
258269877188;258269882924;5736;4;1;2;1;1;1
258269882924;258269962051;79127;-1;0;-1;0;1;1
258269962051;258269962941;890;4;1;2;1;1;1
258269962941;258269963647;706;-1;0;-1;0;1;1
258269963647;258269964819;1172;4;1;2;1;1;1
258269964819;258269996952;32133;-1;0;-1;0;1;1
258269996952;258269997509;557;4;1;2;1;1;1
258269997509;258270060089;62580;-1;0;-1;0;1;1
258270060089;258270061187;1098;4;1;2;1;1;1
258270061187;258270064257;3070;-1;0;-1;0;1;1
258270064257;258270065161;904;4;1;2;1;1;1
258270065161;258270065951;790;4;1;2;1;1;1
258270065951;258270066204;253;4;1;2;1;1;1
258270066204;258270069522;3318;-1;0;-1;0;1;1
258270069522;258270070676;1154;4;1;2;1;1;1
258270070676;258270073697;3021;-1;0;-1;0;1;1
258270073697;258270078189;4492;4;1;2;1;1;1
258270078189;258270079177;988;4;1;2;1;1;1
258270079177;258270082166;2989;4;1;2;1;1;1
258270082166;258270083480;1314;-1;0;-1;0;1;1
258270083480;258270085317;1837;4;1;2;1;1;1
258270085317;258270086695;1378;-1;0;-1;0;1;1
258270086695;258270088827;2132;4;1;2;1;1;1
258270088827;258270090086;1259;4;1;2;1;1;1
258270090086;258270090191;105;4;1;2;1;1;1
258270090191;258270092097;1906;4;1;2;1;1;1
258270092097;258270096241;4144;4;1;2;1;1;1
258270096241;258270096538;297;4;1;2;1;1;1
258270096538;258270098012;1474;4;1;2;1;1;1
258270098012;258270098518;506;4;1;2;1;1;1
258270098518;258270099127;609;4;1;2;1;1;1
258270099127;258270100860;1733;4;1;2;1;1;1
258270100860;258270101291;431;4;1;2;1;1;1
258270101291;258270104905;3614;-1;0;-1;0;1;1
258270104905;258270105983;1078;4;1;2;1;1;1
258270105983;258270106326;343;-1;0;-1;0;1;1
258270106326;258270107824;1498;4;1;2;1;1;1
258270107824;258270108394;570;-1;0;-1;0;1;1
258270108394;258270110176;1782;4;1;2;1;1;1
258270110176;258270157237;47061;-1;0;-1;0;1;1
258270157237;258270157792;555;4;1;2;1;1;1
258270157792;258270187775;29983;-1;0;-1;0;1;1
258270187775;258270188293;518;4;1;2;1;1;1
258270188293;258270234051;45758;-1;0;-1;0;1;1
258270234051;258270234609;558;4;1;2;1;1;1
258270234609;258270235742;1133;-1;0;-1;0;1;1
258270235742;258270236375;633;4;1;2;1;1;1
258270236375;258270255785;19410;-1;0;-1;0;1;1
258270255785;258270256315;530;4;1;2;1;1;1
258270256315;258270306786;50471;-1;0;-1;0;1;1
258270306786;258270308264;1478;4;1;2;1;1;1
258270308264;258270309334;1070;-1;0;-1;0;1;1
258270309334;258270309816;482;4;1;2;1;1;1
258270309816;258270311124;1308;-1;0;-1;0;1;1
258270311124;258270311699;575;4;1;2;1;1;1
258270311699;258270535851;224152;-1;0;-1;0;1;1
258270535851;258270536476;625;4;1;2;1;1;1
258270536476;258270669554;133078;-1;0;-1;0;1;1
258270669554;258270670190;636;4;1;2;1;1;1
258270670190;258270706526;36336;-1;0;-1;0;1;1
258270706526;258270706911;385;4;1;2;1;1;1
258270706911;258270707044;133;4;1;2;1;1;1
258270707044;258270707801;757;4;1;2;1;1;1
258270707801;258270795445;87644;-1;0;-1;0;1;1
258270795445;258270796103;658;4;1;2;1;1;1
258270796103;258270803857;7754;-1;0;-1;0;1;1
258270803857;258270804911;1054;4;1;2;1;1;1
258270804911;258270897842;92931;-1;0;-1;0;1;1
258270897842;258270898394;552;4;1;2;1;1;1
258270898394;258270899666;1272;-1;0;-1;0;1;1
258270899666;258270900203;537;4;1;2;1;1;1
258270900203;258270935228;35025;-1;0;-1;0;1;1
258270935228;258270935858;630;4;1;2;1;1;1
258270935858;258270981743;45885;-1;0;-1;0;1;1
258270981743;258270982579;836;4;1;2;1;1;1
258270982579;258271025807;43228;-1;0;-1;0;1;1
258271025807;258271026278;471;4;1;2;1;1;1
258271026278;258271076950;50672;-1;0;-1;0;1;1
258271076950;258271077503;553;4;1;2;1;1;1
258271077503;258271117260;39757;-1;0;-1;0;1;1
258271117260;258271117749;489;4;1;2;1;1;1
258271117749;258271163424;45675;-1;0;-1;0;1;1
258271163424;258271163891;467;4;1;2;1;1;1
258271163891;258271231892;68001;-1;0;-1;0;1;1
258271231892;258271232550;658;4;1;2;1;1;1
258271232550;258271304738;72188;-1;0;-1;0;1;1
258271304738;258271305514;776;4;1;2;1;1;1
258271305514;258271345342;39828;-1;0;-1;0;1;1
258271345342;258271345900;558;4;1;2;1;1;1
258271345900;258271395685;49785;-1;0;-1;0;1;1
258271395685;258271396306;621;4;1;2;1;1;1
258271396306;258271443104;46798;-1;0;-1;0;1;1
258271443104;258271443733;629;4;1;2;1;1;1
258271443733;258271508828;65095;-1;0;-1;0;1;1
258271508828;258271509444;616;4;1;2;1;1;1
258271509444;258271564087;54643;-1;0;-1;0;1;1
258271564087;258271564711;624;4;1;2;1;1;1
258271564711;258271576173;11462;-1;0;-1;0;1;1
258271576173;258271576735;562;4;1;2;1;1;1
258271576735;258271621832;45097;-1;0;-1;0;1;1
258271621832;258271622371;539;4;1;2;1;1;1
258271622371;258271674253;51882;-1;0;-1;0;1;1
258271674253;258271675084;831;4;1;2;1;1;1
258271675084;258271751837;76753;-1;0;-1;0;1;1
258271751837;258271753365;1528;4;1;2;1;1;1
258271753365;258271828940;75575;-1;0;-1;0;1;1
258271828940;258271829476;536;4;1;2;1;1;1
258271829476;258271863647;34171;-1;0;-1;0;1;1
258271863647;258271864182;535;4;1;2;1;1;1
258271864182;258271921659;57477;-1;0;-1;0;1;1
258271921659;258271922151;492;4;1;2;1;1;1
258271922151;258271999888;77737;-1;0;-1;0;1;1
258271999888;258272000423;535;4;1;2;1;1;1
258272000423;258272084724;84301;-1;0;-1;0;1;1
258272084724;258272085267;543;4;1;2;1;1;1
258272085267;258272122563;37296;-1;0;-1;0;1;1
258272122563;258272123103;540;4;1;2;1;1;1
258272123103;258272168718;45615;-1;0;-1;0;1;1
258272168718;258272169371;653;4;1;2;1;1;1
258272169371;258272217061;47690;-1;0;-1;0;1;1
258272217061;258272217686;625;4;1;2;1;1;1
258272217686;258272625345;407659;-1;0;-1;0;1;1
258272625345;258272626212;867;4;1;2;1;1;1
258272626212;258272744765;118553;-1;0;-1;0;1;1
258272744765;258272746957;2192;4;1;2;1;1;1
258272746957;258272748498;1541;-1;0;-1;0;1;1
258272748498;258272750013;1515;4;1;2;1;1;1
258272750013;258272754693;4680;-1;0;-1;0;1;1
258272754693;258272756103;1410;4;1;2;1;1;1
258272756103;258272757227;1124;-1;0;-1;0;1;1
258272757227;258272758727;1500;4;1;2;1;1;1
258272758727;258272759473;746;-1;0;-1;0;1;1
258272759473;258272760521;1048;4;1;2;1;1;1
258272760521;258272763730;3209;-1;0;-1;0;1;1
258272763730;258272764357;627;4;1;2;1;1;1
258272764357;258272802565;38208;-1;0;-1;0;1;1
258272802565;258272803120;555;4;1;2;1;1;1
258272803120;258272839934;36814;-1;0;-1;0;1;1
258272839934;258272840484;550;4;1;2;1;1;1
258272840484;258272921689;81205;-1;0;-1;0;1;1
258272921689;258272922375;686;4;1;2;1;1;1
258272922375;258272923472;1097;-1;0;-1;0;1;1
258272923472;258272923958;486;4;1;2;1;1;1
258272923958;258272950109;26151;-1;0;-1;0;1;1
258272950109;258272950782;673;4;1;2;1;1;1
258272950782;258272988006;37224;-1;0;-1;0;1;1
258272988006;258272988631;625;4;1;2;1;1;1
258272988631;258273011897;23266;-1;0;-1;0;1;1
258273011897;258273012338;441;4;1;2;1;1;1
258273012338;258273012455;117;4;1;2;1;1;1
258273012455;258273012863;408;4;1;2;1;1;1
258273012863;258273069187;56324;-1;0;-1;0;1;1
258273069187;258273069725;538;4;1;2;1;1;1
258273069725;258273114608;44883;-1;0;-1;0;1;1
258273114608;258273115213;605;4;1;2;1;1;1
258273115213;258273180863;65650;-1;0;-1;0;1;1
258273180863;258273181411;548;4;1;2;1;1;1
258273181411;258273184756;3345;-1;0;-1;0;1;1
258273184756;258273185347;591;4;1;2;1;1;1
258273185347;258273228121;42774;-1;0;-1;0;1;1
258273228121;258273228764;643;4;1;2;1;1;1
258273228764;258273275057;46293;-1;0;-1;0;1;1
258273275057;258273275869;812;4;1;2;1;1;1
258273275869;258273342127;66258;-1;0;-1;0;1;1
258273342127;258273342663;536;4;1;2;1;1;1
258273342663;258273379171;36508;-1;0;-1;0;1;1
258273379171;258273379806;635;4;1;2;1;1;1
258273379806;258273419851;40045;-1;0;-1;0;1;1
258273419851;258273420413;562;4;1;2;1;1;1
258273420413;258273653452;233039;-1;0;-1;0;1;1
258273653452;258273654231;779;4;1;2;1;1;1
258273654231;258273700158;45927;-1;0;-1;0;1;1
258273700158;258273701307;1149;4;1;2;1;1;1
258273701307;258273730225;28918;-1;0;-1;0;1;1
258273730225;258273731137;912;4;1;2;1;1;1
258273731137;258273766430;35293;-1;0;-1;0;1;1
258273766430;258273766984;554;4;1;2;1;1;1
258273766984;258273776627;9643;-1;0;-1;0;1;1
258273776627;258273777110;483;4;1;2;1;1;1
258273777110;258273823534;46424;-1;0;-1;0;1;1
258273823534;258273824248;714;4;1;2;1;1;1
258273824248;258273862031;37783;-1;0;-1;0;1;1
258273862031;258273862967;936;4;1;2;1;1;1
258273862967;258273889501;26534;-1;0;-1;0;1;1
258273889501;258273890427;926;4;1;2;1;1;1
258273890427;258273942262;51835;-1;0;-1;0;1;1
258273942262;258273942867;605;4;1;2;1;1;1
258273942867;258273962123;19256;-1;0;-1;0;1;1
258273962123;258273962687;564;4;1;2;1;1;1
258273962687;258274002485;39798;-1;0;-1;0;1;1
258274002485;258274002642;157;4;1;2;1;1;1
258274002642;258274003295;653;4;1;2;1;1;1
258274003295;258274003394;99;4;1;2;1;1;1
258274003394;258274054534;51140;-1;0;-1;0;1;1
258274054534;258274055302;768;4;1;2;1;1;1
258274055302;258274055910;608;-1;0;-1;0;1;1
258274055910;258274056439;529;4;1;2;1;1;1
258274056439;258274127822;71383;-1;0;-1;0;1;1
258274127822;258274128437;615;4;1;2;1;1;1
258274128437;258274161940;33503;-1;0;-1;0;1;1
258274161940;258274162735;795;4;1;2;1;1;1
258274162735;258274195940;33205;-1;0;-1;0;1;1
258274195940;258274196438;498;4;1;2;1;1;1
258274196438;258274266306;69868;-1;0;-1;0;1;1
258274266306;258274267018;712;4;1;2;1;1;1
258274267018;258274267513;495;4;1;2;1;1;1
258274267513;258274268225;712;4;1;2;1;1;1
258274268225;258274294210;25985;-1;0;-1;0;1;1
258274294210;258274294699;489;4;1;2;1;1;1
258274294699;258274334687;39988;-1;0;-1;0;1;1
258274334687;258274335318;631;4;1;2;1;1;1
258274335318;258274363358;28040;-1;0;-1;0;1;1
258274363358;258274363975;617;4;1;2;1;1;1
258274363975;258274483272;119297;-1;0;-1;0;1;1
258274483272;258274483900;628;4;1;2;1;1;1
258274483900;258274551459;67559;-1;0;-1;0;1;1
258274551459;258274552016;557;4;1;2;1;1;1
258274552016;258274553671;1655;-1;0;-1;0;1;1
258274553671;258274555211;1540;4;1;2;1;1;1
258274555211;258274600542;45331;-1;0;-1;0;1;1
258274600542;258274601010;468;4;1;2;1;1;1
258274601010;258274640217;39207;-1;0;-1;0;1;1
258274640217;258274640851;634;4;1;2;1;1;1
258274640851;258274640908;57;-1;0;-1;0;1;1
258274640908;258274641701;793;4;1;2;1;1;1
258274641701;258274684713;43012;-1;0;-1;0;1;1
258274684713;258274685278;565;4;1;2;1;1;1
258274685278;258274733965;48687;-1;0;-1;0;1;1
258274733965;258274734566;601;4;1;2;1;1;1
258274734566;258274797365;62799;-1;0;-1;0;1;1
258274797365;258274798005;640;4;1;2;1;1;1
258274798005;258274835446;37441;-1;0;-1;0;1;1
258274835446;258274836074;628;4;1;2;1;1;1
258274836074;258274880062;43988;-1;0;-1;0;1;1
258274880062;258274880627;565;4;1;2;1;1;1
258274880627;258274965434;84807;-1;0;-1;0;1;1
258274965434;258274966062;628;4;1;2;1;1;1
258274966062;258275017354;51292;-1;0;-1;0;1;1
258275017354;258275017873;519;4;1;2;1;1;1
258275017873;258275017902;29;-1;0;-1;0;1;1
258275017902;258275018600;698;4;1;2;1;1;1
258275018600;258275049404;30804;-1;0;-1;0;1;1
258275049404;258275050307;903;4;1;2;1;1;1
258275050307;258275094216;43909;-1;0;-1;0;1;1
258275094216;258275094765;549;4;1;2;1;1;1
258275094765;258275137621;42856;-1;0;-1;0;1;1
258275137621;258275138224;603;4;1;2;1;1;1
258275138224;258275221237;83013;-1;0;-1;0;1;1
258275221237;258275221779;542;4;1;2;1;1;1
258275221779;258275280115;58336;-1;0;-1;0;1;1
258275280115;258275280580;465;4;1;2;1;1;1
258275280580;258275347256;66676;-1;0;-1;0;1;1
258275347256;258275347873;617;4;1;2;1;1;1
258275347873;258275399615;51742;-1;0;-1;0;1;1
258275399615;258275400106;491;4;1;2;1;1;1
258275400106;258275444128;44022;-1;0;-1;0;1;1
258275444128;258275444680;552;4;1;2;1;1;1
258275444680;258275444986;306;-1;0;-1;0;1;1
258275444986;258275445629;643;4;1;2;1;1;1
258275445629;258275543271;97642;-1;0;-1;0;1;1
258275543271;258275544021;750;4;1;2;1;1;1
258275544021;258275585905;41884;-1;0;-1;0;1;1
258275585905;258275586216;311;4;1;2;1;1;1
258275586216;258275586432;216;4;1;2;1;1;1
258275586432;258275587020;588;4;1;2;1;1;1
258275587020;258275627936;40916;-1;0;-1;0;1;1
258275627936;258275628486;550;4;1;2;1;1;1
258275628486;258275672548;44062;-1;0;-1;0;1;1
258275672548;258275673017;469;4;1;2;1;1;1
258275673017;258275740522;67505;-1;0;-1;0;1;1
258275740522;258275741047;525;4;1;2;1;1;1
258275741047;258275777801;36754;-1;0;-1;0;1;1
258275777801;258275778428;627;4;1;2;1;1;1
258275778428;258275779900;1472;-1;0;-1;0;1;1
258275779900;258275780367;467;4;1;2;1;1;1
258275780367;258275821437;41070;-1;0;-1;0;1;1
258275821437;258275822056;619;4;1;2;1;1;1
258275822056;258275859329;37273;-1;0;-1;0;1;1
258275859329;258275859902;573;4;1;2;1;1;1
258275859902;258275902812;42910;-1;0;-1;0;1;1
258275902812;258275903275;463;4;1;2;1;1;1
258275903275;258275951171;47896;-1;0;-1;0;1;1
258275951171;258275951723;552;4;1;2;1;1;1
258275951723;258275996682;44959;-1;0;-1;0;1;1
258275996682;258275997311;629;4;1;2;1;1;1
258275997311;258276070558;73247;-1;0;-1;0;1;1
258276070558;258276071218;660;4;1;2;1;1;1
258276071218;258276117798;46580;-1;0;-1;0;1;1
258276117798;258276118427;629;4;1;2;1;1;1
258276118427;258276118553;126;4;1;2;1;1;1
258276118553;258276118774;221;4;1;2;1;1;1
258276118774;258276119133;359;4;1;2;1;1;1
258276119133;258276120070;937;4;1;2;1;1;1
258276120070;258276151610;31540;-1;0;-1;0;1;1
258276151610;258276152080;470;4;1;2;1;1;1
258276152080;258276212665;60585;-1;0;-1;0;1;1
258276212665;258276213273;608;4;1;2;1;1;1
258276213273;258276252471;39198;-1;0;-1;0;1;1
258276252471;258276253020;549;4;1;2;1;1;1
258276253020;258276294011;40991;-1;0;-1;0;1;1
258276294011;258276295240;1229;4;1;2;1;1;1
258276295240;258276371004;75764;-1;0;-1;0;1;1
258276371004;258276371559;555;4;1;2;1;1;1
258276371559;258276371781;222;-1;0;-1;0;1;1
258276371781;258276372381;600;4;1;2;1;1;1
258276372381;258276405418;33037;-1;0;-1;0;1;1
258276405418;258276406152;734;4;1;2;1;1;1
258276406152;258276485685;79533;-1;0;-1;0;1;1
258276485685;258276486773;1088;4;1;2;1;1;1
258276486773;258276529146;42373;-1;0;-1;0;1;1
258276529146;258276529636;490;4;1;2;1;1;1
258276529636;258276568163;38527;-1;0;-1;0;1;1
258276568163;258276568725;562;4;1;2;1;1;1
258276568725;258276643520;74795;-1;0;-1;0;1;1
258276643520;258276644083;563;4;1;2;1;1;1
258276644083;258276691256;47173;-1;0;-1;0;1;1
258276691256;258276691741;485;4;1;2;1;1;1
258276691741;258276747746;56005;-1;0;-1;0;1;1
258276747746;258276748359;613;4;1;2;1;1;1
258276748359;258276824155;75796;-1;0;-1;0;1;1
258276824155;258276824790;635;4;1;2;1;1;1
258276824790;258276890930;66140;-1;0;-1;0;1;1
258276890930;258276891507;577;4;1;2;1;1;1
258276891507;258276940728;49221;-1;0;-1;0;1;1
258276940728;258276941214;486;4;1;2;1;1;1
258276941214;258276982491;41277;-1;0;-1;0;1;1
258276982491;258276983014;523;4;1;2;1;1;1
258276983014;258277017938;34924;-1;0;-1;0;1;1
258277017938;258277018430;492;4;1;2;1;1;1
258277018430;258277054417;35987;-1;0;-1;0;1;1
258277054417;258277055016;599;4;1;2;1;1;1
258277055016;258277055530;514;-1;0;-1;0;1;1
258277055530;258277056081;551;4;1;2;1;1;1
258277056081;258277094338;38257;-1;0;-1;0;1;1
258277094338;258277097586;3248;4;1;2;1;1;1
258277097586;258277132801;35215;-1;0;-1;0;1;1
258277132801;258277133771;970;4;1;2;1;1;1
258277133771;258277169038;35267;-1;0;-1;0;1;1
258277169038;258277169311;273;4;1;2;1;1;1
258277169311;258277169802;491;4;1;2;1;1;1
258277169802;258277170635;833;4;1;2;1;1;1
258277170635;258277244016;73381;-1;0;-1;0;1;1
258277244016;258277244487;471;4;1;2;1;1;1
258277244487;258277389753;145266;-1;0;-1;0;1;1
258277389753;258277390278;525;4;1;2;1;1;1
258277390278;258277567241;176963;-1;0;-1;0;1;1
258277567241;258277568090;849;4;1;2;1;1;1
258277568090;258277568529;439;4;1;2;1;1;1
258277568529;258277570257;1728;4;1;2;1;1;1
258277570257;258277621573;51316;-1;0;-1;0;1;1
258277621573;258277622107;534;4;1;2;1;1;1
258277622107;258277732596;110489;-1;0;-1;0;1;1
258277732596;258277733085;489;4;1;2;1;1;1
258277733085;258277777346;44261;-1;0;-1;0;1;1
258277777346;258277777872;526;4;1;2;1;1;1
258277777872;258277814961;37089;-1;0;-1;0;1;1
258277814961;258277815458;497;4;1;2;1;1;1
258277815458;258277888415;72957;-1;0;-1;0;1;1
258277888415;258277889844;1429;4;1;2;1;1;1
258277889844;258277929276;39432;-1;0;-1;0;1;1
258277929276;258277929902;626;4;1;2;1;1;1
258277929902;258277971685;41783;-1;0;-1;0;1;1
258277971685;258277972299;614;4;1;2;1;1;1
258277972299;258278004940;32641;-1;0;-1;0;1;1
258278004940;258278005812;872;4;1;2;1;1;1
258278005812;258278006283;471;-1;0;-1;0;1;1
258278006283;258278006989;706;4;1;2;1;1;1
258278006989;258278059214;52225;-1;0;-1;0;1;1
258278059214;258278059999;785;4;1;2;1;1;1
258278059999;258278131193;71194;-1;0;-1;0;1;1
258278131193;258278131869;676;4;1;2;1;1;1
258278131869;258278191755;59886;-1;0;-1;0;1;1
258278191755;258278192934;1179;4;1;2;1;1;1
258278192934;258278194440;1506;-1;0;-1;0;1;1
258278194440;258278195045;605;4;1;2;1;1;1
258278195045;258278269657;74612;-1;0;-1;0;1;1
258278269657;258278270476;819;4;1;2;1;1;1
258278270476;258278325609;55133;-1;0;-1;0;1;1
258278325609;258278326065;456;4;1;2;1;1;1
258278326065;258278376758;50693;-1;0;-1;0;1;1
258278376758;258278377554;796;4;1;2;1;1;1
258278377554;258278419805;42251;-1;0;-1;0;1;1
258278419805;258278420451;646;4;1;2;1;1;1
258278420451;258278464502;44051;-1;0;-1;0;1;1
258278464502;258278464987;485;4;1;2;1;1;1
258278464987;258278503394;38407;-1;0;-1;0;1;1
258278503394;258278504018;624;4;1;2;1;1;1
258278504018;258278514901;10883;-1;0;-1;0;1;1
258278514901;258278521743;6842;4;1;2;1;1;1
258278521743;258278579350;57607;-1;0;-1;0;1;1
258278579350;258278579924;574;4;1;2;1;1;1
258278579924;258278612448;32524;-1;0;-1;0;1;1
258278612448;258278613014;566;4;1;2;1;1;1
258278613014;258278664931;51917;-1;0;-1;0;1;1
258278664931;258278665549;618;4;1;2;1;1;1
258278665549;258278665899;350;-1;0;-1;0;1;1
258278665899;258278666576;677;4;1;2;1;1;1
258278666576;258278704158;37582;-1;0;-1;0;1;1
258278704158;258278704716;558;4;1;2;1;1;1
258278704716;258278752658;47942;-1;0;-1;0;1;1
258278752658;258278753260;602;4;1;2;1;1;1
258278753260;258278808999;55739;-1;0;-1;0;1;1
258278808999;258278809561;562;4;1;2;1;1;1
258278809561;258278860819;51258;-1;0;-1;0;1;1
258278860819;258278861756;937;4;1;2;1;1;1
258278861756;258278868287;6531;-1;0;-1;0;1;1
258278868287;258278872780;4493;4;1;2;1;1;1
258278872780;258278911289;38509;-1;0;-1;0;1;1
258278911289;258278912483;1194;4;1;2;1;1;1
258278912483;258279005965;93482;-1;0;-1;0;1;1
258279005965;258279006596;631;4;1;2;1;1;1
258279006596;258279047976;41380;-1;0;-1;0;1;1
258279047976;258279048582;606;4;1;2;1;1;1
258279048582;258279085879;37297;-1;0;-1;0;1;1
258279085879;258279086877;998;4;1;2;1;1;1
258279086877;258279087057;180;-1;0;-1;0;1;1
258279087057;258279087611;554;4;1;2;1;1;1
258279087611;258279089193;1582;-1;0;-1;0;1;1
258279089193;258279089809;616;4;1;2;1;1;1
258279089809;258279125863;36054;-1;0;-1;0;1;1
258279125863;258279126474;611;4;1;2;1;1;1
258279126474;258279151937;25463;-1;0;-1;0;1;1
258279151937;258279152486;549;4;1;2;1;1;1
258279152486;258279192220;39734;-1;0;-1;0;1;1
258279192220;258279193010;790;4;1;2;1;1;1
258279193010;258279193491;481;4;1;2;1;1;1
258279193491;258279194303;812;4;1;2;1;1;1
258279194303;258279195406;1103;-1;0;-1;0;1;1
258279195406;258279196085;679;4;1;2;1;1;1
258279196085;258279219832;23747;-1;0;-1;0;1;1
258279219832;258279220473;641;4;1;2;1;1;1
258279220473;258279308844;88371;-1;0;-1;0;1;1
258279308844;258279309478;634;4;1;2;1;1;1
258279309478;258279372510;63032;-1;0;-1;0;1;1
258279372510;258279373064;554;4;1;2;1;1;1
258279373064;258279418690;45626;-1;0;-1;0;1;1
258279418690;258279419492;802;4;1;2;1;1;1
258279419492;258279420995;1503;-1;0;-1;0;1;1
258279420995;258279421490;495;4;1;2;1;1;1
258279421490;258279488821;67331;-1;0;-1;0;1;1
258279488821;258279489351;530;4;1;2;1;1;1
258279489351;258279542386;53035;-1;0;-1;0;1;1
258279542386;258279543314;928;4;1;2;1;1;1
258279543314;258279543661;347;-1;0;-1;0;1;1
258279543661;258279545379;1718;4;1;2;1;1;1
258279545379;258279612521;67142;-1;0;-1;0;1;1
258279612521;258279613150;629;4;1;2;1;1;1
258279613150;258279645983;32833;-1;0;-1;0;1;1
258279645983;258279646612;629;4;1;2;1;1;1
258279646612;258279681750;35138;-1;0;-1;0;1;1
258279681750;258279682304;554;4;1;2;1;1;1
258279682304;258279714953;32649;-1;0;-1;0;1;1
258279714953;258279715255;302;4;1;2;1;1;1
258279715255;258279715781;526;4;1;2;1;1;1
258279715781;258279717313;1532;4;1;2;1;1;1
258279717313;258279743404;26091;-1;0;-1;0;1;1
258279743404;258279745163;1759;4;1;2;1;1;1
258279745163;258279779342;34179;-1;0;-1;0;1;1
258279779342;258279779941;599;4;1;2;1;1;1
258279779941;258279809318;29377;-1;0;-1;0;1;1
258279809318;258279809950;632;4;1;2;1;1;1
258279809950;258279851536;41586;-1;0;-1;0;1;1
258279851536;258279851706;170;4;1;2;1;1;1
258279851706;258279852466;760;4;1;2;1;1;1
258279852466;258279853209;743;4;1;2;1;1;1
258279853209;258279853976;767;-1;0;-1;0;1;1
258279853976;258279854523;547;4;1;2;1;1;1
258279854523;258279891271;36748;-1;0;-1;0;1;1
258279891271;258279891933;662;4;1;2;1;1;1
258279891933;258279892118;185;4;1;2;1;1;1
258279892118;258279892657;539;4;1;2;1;1;1
258279892657;258279933769;41112;-1;0;-1;0;1;1
258279933769;258279934397;628;4;1;2;1;1;1
258279934397;258280002875;68478;-1;0;-1;0;1;1
258280002875;258280003091;216;4;1;2;1;1;1
258280003091;258280003308;217;4;1;2;1;1;1
258280003308;258280003760;452;4;1;2;1;1;1
258280003760;258280003886;126;4;1;2;1;1;1
258280003886;258280004545;659;4;1;2;1;1;1
258280004545;258280024287;19742;-1;0;-1;0;1;1
258280024287;258280024840;553;4;1;2;1;1;1
258280024840;258280089189;64349;-1;0;-1;0;1;1
258280089189;258280089741;552;4;1;2;1;1;1
258280089741;258280123910;34169;-1;0;-1;0;1;1
258280123910;258280124534;624;4;1;2;1;1;1
258280124534;258280194580;70046;-1;0;-1;0;1;1
258280194580;258280195115;535;4;1;2;1;1;1
258280195115;258280239294;44179;-1;0;-1;0;1;1
258280239294;258280240337;1043;4;1;2;1;1;1
258280240337;258280280500;40163;-1;0;-1;0;1;1
258280280500;258280281053;553;4;1;2;1;1;1
258280281053;258280363944;82891;-1;0;-1;0;1;1
258280363944;258280364475;531;4;1;2;1;1;1
258280364475;258280395682;31207;-1;0;-1;0;1;1
258280395682;258280396313;631;4;1;2;1;1;1
258280396313;258280438449;42136;-1;0;-1;0;1;1
258280438449;258280438994;545;4;1;2;1;1;1
258280438994;258280511337;72343;-1;0;-1;0;1;1
258280511337;258280511823;486;4;1;2;1;1;1
258280511823;258280561189;49366;-1;0;-1;0;1;1
258280561189;258280561732;543;4;1;2;1;1;1
258280561732;258280600493;38761;-1;0;-1;0;1;1
258280600493;258280601962;1469;4;1;2;1;1;1
258280601962;258280602560;598;-1;0;-1;0;1;1
258280602560;258280603111;551;4;1;2;1;1;1
258280603111;258280603153;42;-1;0;-1;0;1;1
258280603153;258280603804;651;4;1;2;1;1;1
258280603804;258280634179;30375;-1;0;-1;0;1;1
258280634179;258280634734;555;4;1;2;1;1;1
258280634734;258280709892;75158;-1;0;-1;0;1;1
258280709892;258280710447;555;4;1;2;1;1;1
258280710447;258280750635;40188;-1;0;-1;0;1;1
258280750635;258280750790;155;4;1;2;1;1;1
258280750790;258280751677;887;4;1;2;1;1;1
258280751677;258280751700;23;4;1;2;1;1;1
258280751700;258280786987;35287;-1;0;-1;0;1;1
258280786987;258280787454;467;4;1;2;1;1;1
258280787454;258280920795;133341;-1;0;-1;0;1;1
258280920795;258280921352;557;4;1;2;1;1;1
258280921352;258280961026;39674;-1;0;-1;0;1;1
258280961026;258280961555;529;4;1;2;1;1;1
258280961555;258281009735;48180;-1;0;-1;0;1;1
258281009735;258281010211;476;4;1;2;1;1;1
258281010211;258281133226;123015;-1;0;-1;0;1;1
258281133226;258281133759;533;4;1;2;1;1;1
258281133759;258281208242;74483;-1;0;-1;0;1;1
258281208242;258281208768;526;4;1;2;1;1;1
258281208768;258281303322;94554;-1;0;-1;0;1;1
258281303322;258281304997;1675;4;1;2;1;1;1
258281304997;258281305499;502;-1;0;-1;0;1;1
258281305499;258281308172;2673;4;1;2;1;1;1
258281308172;258281564854;256682;-1;0;-1;0;1;1
258281564854;258281565455;601;4;1;2;1;1;1
258281565455;258281594569;29114;-1;0;-1;0;1;1
258281594569;258281595482;913;4;1;2;1;1;1
258281595482;258281665859;70377;-1;0;-1;0;1;1
258281665859;258281666320;461;4;1;2;1;1;1
258281666320;258281674492;8172;-1;0;-1;0;1;1
258281674492;258281675700;1208;4;1;2;1;1;1
258281675700;258281723001;47301;-1;0;-1;0;1;1
258281723001;258281723475;474;4;1;2;1;1;1
258281723475;258281761599;38124;-1;0;-1;0;1;1
258281761599;258281762464;865;4;1;2;1;1;1
258281762464;258281834946;72482;-1;0;-1;0;1;1
258281834946;258281835471;525;4;1;2;1;1;1
258281835471;258281898793;63322;-1;0;-1;0;1;1
258281898793;258281900202;1409;4;1;2;1;1;1
258281900202;258281984192;83990;-1;0;-1;0;1;1
258281984192;258281985089;897;4;1;2;1;1;1
258281985089;258282089765;104676;-1;0;-1;0;1;1
258282089765;258282091056;1291;4;1;2;1;1;1
258282091056;258282145753;54697;-1;0;-1;0;1;1
258282145753;258282146380;627;4;1;2;1;1;1
258282146380;258282266375;119995;-1;0;-1;0;1;1
258282266375;258282267107;732;4;1;2;1;1;1
258282267107;258282323082;55975;-1;0;-1;0;1;1
258282323082;258282323956;874;4;1;2;1;1;1
258282323956;258282358279;34323;-1;0;-1;0;1;1
258282358279;258282359058;779;4;1;2;1;1;1
258282359058;258282403658;44600;-1;0;-1;0;1;1
258282403658;258282405571;1913;4;1;2;1;1;1
258282405571;258282456832;51261;-1;0;-1;0;1;1
258282456832;258282457433;601;4;1;2;1;1;1
258282457433;258282507779;50346;-1;0;-1;0;1;1
258282507779;258282508332;553;4;1;2;1;1;1
258282508332;258282530741;22409;-1;0;-1;0;1;1
258282530741;258282532107;1366;4;1;2;1;1;1
258282532107;258282542143;10036;-1;0;-1;0;1;1
258282542143;258282542905;762;4;1;2;1;1;1
258282542905;258282581714;38809;-1;0;-1;0;1;1
258282581714;258282582265;551;4;1;2;1;1;1
258282582265;258282618822;36557;-1;0;-1;0;1;1
258282618822;258282619381;559;4;1;2;1;1;1
258282619381;258282669215;49834;-1;0;-1;0;1;1
258282669215;258282669955;740;4;1;2;1;1;1
258282669955;258282737632;67677;-1;0;-1;0;1;1
258282737632;258282738275;643;4;1;2;1;1;1
258282738275;258282784136;45861;-1;0;-1;0;1;1
258282784136;258282784816;680;4;1;2;1;1;1
258282784816;258282820531;35715;-1;0;-1;0;1;1
258282820531;258282821147;616;4;1;2;1;1;1
258282821147;258282852933;31786;-1;0;-1;0;1;1
258282852933;258282853482;549;4;1;2;1;1;1
258282853482;258282898069;44587;-1;0;-1;0;1;1
258282898069;258282898694;625;4;1;2;1;1;1
258282898694;258282946379;47685;-1;0;-1;0;1;1
258282946379;258282946927;548;4;1;2;1;1;1
258282946927;258282986106;39179;-1;0;-1;0;1;1
258282986106;258282986676;570;4;1;2;1;1;1
258282986676;258282987262;586;-1;0;-1;0;1;1
258282987262;258282987889;627;4;1;2;1;1;1
258282987889;258283036571;48682;-1;0;-1;0;1;1
258283036571;258283037145;574;4;1;2;1;1;1
258283037145;258283077206;40061;-1;0;-1;0;1;1
258283077206;258283077746;540;4;1;2;1;1;1
258283077746;258283127170;49424;-1;0;-1;0;1;1
258283127170;258283127774;604;4;1;2;1;1;1
258283127774;258283173988;46214;-1;0;-1;0;1;1
258283173988;258283174593;605;4;1;2;1;1;1
258283174593;258283252777;78184;-1;0;-1;0;1;1
258283252777;258283253407;630;4;1;2;1;1;1
258283253407;258283325861;72454;-1;0;-1;0;1;1
258283325861;258283326534;673;4;1;2;1;1;1
258283326534;258283370697;44163;-1;0;-1;0;1;1
258283370697;258283371264;567;4;1;2;1;1;1
258283371264;258283418577;47313;-1;0;-1;0;1;1
258283418577;258283419099;522;4;1;2;1;1;1
258283419099;258283465993;46894;-1;0;-1;0;1;1
258283465993;258283466526;533;4;1;2;1;1;1
258283466526;258283508853;42327;-1;0;-1;0;1;1
258283508853;258283509401;548;4;1;2;1;1;1
258283509401;258283554407;45006;-1;0;-1;0;1;1
258283554407;258283555041;634;4;1;2;1;1;1
258283555041;258283681137;126096;-1;0;-1;0;1;1
258283681137;258283681777;640;4;1;2;1;1;1
258283681777;258283727634;45857;-1;0;-1;0;1;1
258283727634;258283728267;633;4;1;2;1;1;1
258283728267;258283820873;92606;-1;0;-1;0;1;1
258283820873;258283821526;653;4;1;2;1;1;1
258283821526;258283822403;877;4;1;2;1;1;1
258283822403;258283822439;36;4;1;2;1;1;1
258283822439;258283822543;104;4;1;2;1;1;1
258283822543;258283822884;341;4;1;2;1;1;1
258283822884;258283823524;640;-1;0;-1;0;1;1
258283823524;258283824208;684;4;1;2;1;1;1
258283824208;258283922393;98185;-1;0;-1;0;1;1
258283922393;258283922881;488;4;1;2;1;1;1
258283922881;258283966606;43725;-1;0;-1;0;1;1
258283966606;258283967158;552;4;1;2;1;1;1
258283967158;258283968120;962;-1;0;-1;0;1;1
258283968120;258283968671;551;4;1;2;1;1;1
258283968671;258283970556;1885;-1;0;-1;0;1;1
258283970556;258283971187;631;4;1;2;1;1;1
258283971187;258284009469;38282;-1;0;-1;0;1;1
258284009469;258284010569;1100;4;1;2;1;1;1
258284010569;258284012630;2061;-1;0;-1;0;1;1
258284012630;258284013429;799;4;1;2;1;1;1
258284013429;258284047618;34189;-1;0;-1;0;1;1
258284047618;258284049008;1390;4;1;2;1;1;1
258284049008;258284050501;1493;-1;0;-1;0;1;1
258284050501;258284051058;557;4;1;2;1;1;1
258284051058;258284087413;36355;-1;0;-1;0;1;1
258284087413;258284087966;553;4;1;2;1;1;1
258284087966;258284168082;80116;-1;0;-1;0;1;1
258284168082;258284168712;630;4;1;2;1;1;1
258284168712;258284198077;29365;-1;0;-1;0;1;1
258284198077;258284198707;630;4;1;2;1;1;1
258284198707;258284238317;39610;-1;0;-1;0;1;1
258284238317;258284238870;553;4;1;2;1;1;1
258284238870;258284281394;42524;-1;0;-1;0;1;1
258284281394;258284282023;629;4;1;2;1;1;1
258284282023;258284335537;53514;-1;0;-1;0;1;1
258284335537;258284336345;808;4;1;2;1;1;1
258284336345;258284364954;28609;-1;0;-1;0;1;1
258284364954;258284365578;624;4;1;2;1;1;1
258284365578;258284367604;2026;-1;0;-1;0;1;1
258284367604;258284368721;1117;4;1;2;1;1;1
258284368721;258284414105;45384;-1;0;-1;0;1;1
258284414105;258284414572;467;4;1;2;1;1;1
258284414572;258284451252;36680;-1;0;-1;0;1;1
258284451252;258284451805;553;4;1;2;1;1;1
258284451805;258284455864;4059;-1;0;-1;0;1;1
258284455864;258284456522;658;4;1;2;1;1;1
258284456522;258284497821;41299;-1;0;-1;0;1;1
258284497821;258284498282;461;4;1;2;1;1;1
258284498282;258284531691;33409;-1;0;-1;0;1;1
258284531691;258284532312;621;4;1;2;1;1;1
258284532312;258284620440;88128;-1;0;-1;0;1;1
258284620440;258284621083;643;4;1;2;1;1;1
258284621083;258284665282;44199;-1;0;-1;0;1;1
258284665282;258284665931;649;4;1;2;1;1;1
258284665931;258284721822;55891;-1;0;-1;0;1;1
258284721822;258284722367;545;4;1;2;1;1;1
258284722367;258284769290;46923;-1;0;-1;0;1;1
258284769290;258284770726;1436;4;1;2;1;1;1
258284770726;258284823186;52460;-1;0;-1;0;1;1
258284823186;258284823647;461;4;1;2;1;1;1
258284823647;258284868401;44754;-1;0;-1;0;1;1
258284868401;258284869022;621;4;1;2;1;1;1
258284869022;258284939448;70426;-1;0;-1;0;1;1
258284939448;258284939668;220;4;1;2;1;1;1
258284939668;258284940254;586;4;1;2;1;1;1
258284940254;258284940669;415;4;1;2;1;1;1
258284940669;258285066850;126181;-1;0;-1;0;1;1
258285066850;258285067479;629;4;1;2;1;1;1
258285067479;258285113626;46147;-1;0;-1;0;1;1
258285113626;258285114258;632;4;1;2;1;1;1
258285114258;258285158802;44544;-1;0;-1;0;1;1
258285158802;258285174498;15696;4;1;2;1;1;1
258285174498;258285208205;33707;-1;0;-1;0;1;1
258285208205;258285208674;469;4;1;2;1;1;1
258285208674;258285277087;68413;-1;0;-1;0;1;1
258285277087;258285278091;1004;4;1;2;1;1;1
258285278091;258285320050;41959;-1;0;-1;0;1;1
258285320050;258285320534;484;4;1;2;1;1;1
258285320534;258285361198;40664;-1;0;-1;0;1;1
258285361198;258285361716;518;4;1;2;1;1;1
258285361716;258285427401;65685;-1;0;-1;0;1;1
258285427401;258285427877;476;4;1;2;1;1;1
258285427877;258285540823;112946;-1;0;-1;0;1;1
258285540823;258285541357;534;4;1;2;1;1;1
258285541357;258285646521;105164;-1;0;-1;0;1;1
258285646521;258285647022;501;4;1;2;1;1;1
258285647022;258285687319;40297;-1;0;-1;0;1;1
258285687319;258285687501;182;4;1;2;1;1;1
258285687501;258285687922;421;4;1;2;1;1;1
258285687922;258285688914;992;4;1;2;1;1;1
258285688914;258285842477;153563;-1;0;-1;0;1;1
258285842477;258285843118;641;4;1;2;1;1;1
258285843118;258286094539;251421;-1;0;-1;0;1;1
258286094539;258286095029;490;4;1;2;1;1;1
258286095029;258286303181;208152;-1;0;-1;0;1;1
258286303181;258286303822;641;4;1;2;1;1;1
258286303822;258286350282;46460;-1;0;-1;0;1;1
258286350282;258286350817;535;4;1;2;1;1;1
258286350817;258286383841;33024;-1;0;-1;0;1;1
258286383841;258286384490;649;4;1;2;1;1;1
258286384490;258286384547;57;4;1;2;1;1;1
258286384547;258286385490;943;4;1;2;1;1;1
258286385490;258286460980;75490;-1;0;-1;0;1;1
258286460980;258286461611;631;4;1;2;1;1;1
258286461611;258286551071;89460;-1;0;-1;0;1;1
258286551071;258286552122;1051;4;1;2;1;1;1
258286552122;258286584837;32715;-1;0;-1;0;1;1
258286584837;258286585302;465;4;1;2;1;1;1
258286585302;258286633112;47810;-1;0;-1;0;1;1
258286633112;258286633638;526;4;1;2;1;1;1
258286633638;258286678057;44419;-1;0;-1;0;1;1
258286678057;258286679676;1619;4;1;2;1;1;1
258286679676;258286792185;112509;-1;0;-1;0;1;1
258286792185;258286792864;679;4;1;2;1;1;1
258286792864;258286861778;68914;-1;0;-1;0;1;1
258286861778;258286862691;913;4;1;2;1;1;1
258286862691;258286863850;1159;-1;0;-1;0;1;1
258286863850;258286864408;558;4;1;2;1;1;1
258286864408;258286881703;17295;-1;0;-1;0;1;1
258286881703;258286882724;1021;4;1;2;1;1;1
258286882724;258286929610;46886;-1;0;-1;0;1;1
258286929610;258286930281;671;4;1;2;1;1;1
258286930281;258286976864;46583;-1;0;-1;0;1;1
258286976864;258286977483;619;4;1;2;1;1;1
258286977483;258287050427;72944;-1;0;-1;0;1;1
258287050427;258287050984;557;4;1;2;1;1;1
258287050984;258287063923;12939;-1;0;-1;0;1;1
258287063923;258287064552;629;4;1;2;1;1;1
258287064552;258287101390;36838;-1;0;-1;0;1;1
258287101390;258287102027;637;4;1;2;1;1;1
258287102027;258287153168;51141;-1;0;-1;0;1;1
258287153168;258287154377;1209;4;1;2;1;1;1
258287154377;258287200754;46377;-1;0;-1;0;1;1
258287200754;258287201407;653;4;1;2;1;1;1
258287201407;258287241971;40564;-1;0;-1;0;1;1
258287241971;258287242524;553;4;1;2;1;1;1
258287242524;258287294748;52224;-1;0;-1;0;1;1
258287294748;258287295378;630;4;1;2;1;1;1
258287295378;258287402905;107527;-1;0;-1;0;1;1
258287402905;258287404070;1165;4;1;2;1;1;1
258287404070;258287433261;29191;-1;0;-1;0;1;1
258287433261;258287433874;613;4;1;2;1;1;1
258287433874;258287492801;58927;-1;0;-1;0;1;1
258287492801;258287493433;632;4;1;2;1;1;1
258287493433;258287529372;35939;-1;0;-1;0;1;1
258287529372;258287529980;608;4;1;2;1;1;1
258287529980;258287566381;36401;-1;0;-1;0;1;1
258287566381;258287566899;518;4;1;2;1;1;1
258287566899;258287597944;31045;-1;0;-1;0;1;1
258287597944;258287598496;552;4;1;2;1;1;1
258287598496;258287646441;47945;-1;0;-1;0;1;1
258287646441;258287647073;632;4;1;2;1;1;1
258287647073;258287690986;43913;-1;0;-1;0;1;1
258287690986;258287691553;567;4;1;2;1;1;1
258287691553;258287745215;53662;-1;0;-1;0;1;1
258287745215;258287745840;625;4;1;2;1;1;1
258287745840;258287756269;10429;-1;0;-1;0;1;1
258287756269;258287756948;679;4;1;2;1;1;1
258287756948;258287865913;108965;-1;0;-1;0;1;1
258287865913;258287866461;548;4;1;2;1;1;1
258287866461;258287909915;43454;-1;0;-1;0;1;1
258287909915;258287910542;627;4;1;2;1;1;1
258287910542;258287957650;47108;-1;0;-1;0;1;1
258287957650;258287957957;307;4;1;2;1;1;1
258287957957;258287958357;400;4;1;2;1;1;1
258287958357;258287958725;368;4;1;2;1;1;1
258287958725;258288047999;89274;-1;0;-1;0;1;1
258288047999;258288049147;1148;4;1;2;1;1;1
258288049147;258288165651;116504;-1;0;-1;0;1;1
258288165651;258288166354;703;4;1;2;1;1;1
258288166354;258288241893;75539;-1;0;-1;0;1;1
258288241893;258288242520;627;4;1;2;1;1;1
258288242520;258288257829;15309;-1;0;-1;0;1;1
258288257829;258288258499;670;4;1;2;1;1;1
258288258499;258288307352;48853;-1;0;-1;0;1;1
258288307352;258288308787;1435;4;1;2;1;1;1
258288308787;258288339752;30965;-1;0;-1;0;1;1
258288339752;258288340319;567;4;1;2;1;1;1
258288340319;258288410353;70034;-1;0;-1;0;1;1
258288410353;258288410987;634;4;1;2;1;1;1
258288410987;258288453848;42861;-1;0;-1;0;1;1
258288453848;258288454398;550;4;1;2;1;1;1
258288454398;258288503625;49227;-1;0;-1;0;1;1
258288503625;258288504832;1207;4;1;2;1;1;1
258288504832;258288582519;77687;-1;0;-1;0;1;1
258288582519;258288583994;1475;4;1;2;1;1;1
258288583994;258288619290;35296;-1;0;-1;0;1;1
258288619290;258288619774;484;4;1;2;1;1;1
258288619774;258288657001;37227;-1;0;-1;0;1;1
258288657001;258288657642;641;4;1;2;1;1;1
258288657642;258288733140;75498;-1;0;-1;0;1;1
258288733140;258288733729;589;4;1;2;1;1;1
258288733729;258288777335;43606;-1;0;-1;0;1;1
258288777335;258288777949;614;4;1;2;1;1;1
258288777949;258288778643;694;4;1;2;1;1;1
258288778643;258288778989;346;4;1;2;1;1;1
258288778989;258288865154;86165;-1;0;-1;0;1;1
258288865154;258288865700;546;4;1;2;1;1;1
258288865700;258288910058;44358;-1;0;-1;0;1;1
258288910058;258288910539;481;4;1;2;1;1;1
258288910539;258288912651;2112;-1;0;-1;0;1;1
258288912651;258288913279;628;4;1;2;1;1;1
258288913279;258288951322;38043;-1;0;-1;0;1;1
258288951322;258288951956;634;4;1;2;1;1;1
258288951956;258289211306;259350;-1;0;-1;0;1;1
258289211306;258289211856;550;4;1;2;1;1;1
258289211856;258289270399;58543;-1;0;-1;0;1;1
258289270399;258289270969;570;4;1;2;1;1;1
258289270969;258289311445;40476;-1;0;-1;0;1;1
258289311445;258289312063;618;4;1;2;1;1;1
258289312063;258289313320;1257;-1;0;-1;0;1;1
258289313320;258289313877;557;4;1;2;1;1;1
258289313877;258289357747;43870;-1;0;-1;0;1;1
258289357747;258289358443;696;4;1;2;1;1;1
258289358443;258289381088;22645;-1;0;-1;0;1;1
258289381088;258289381727;639;4;1;2;1;1;1
258289381727;258289456863;75136;-1;0;-1;0;1;1
258289456863;258289457500;637;4;1;2;1;1;1
258289457500;258289458252;752;-1;0;-1;0;1;1
258289458252;258289459907;1655;4;1;2;1;1;1
258289459907;258289460446;539;4;1;2;1;1;1
258289460446;258289465095;4649;4;1;2;1;1;1
258289465095;258289497952;32857;-1;0;-1;0;1;1
258289497952;258289498565;613;4;1;2;1;1;1
258289498565;258289539891;41326;-1;0;-1;0;1;1
258289539891;258289540941;1050;4;1;2;1;1;1
258289540941;258289615739;74798;-1;0;-1;0;1;1
258289615739;258289616376;637;4;1;2;1;1;1
258289616376;258289617525;1149;-1;0;-1;0;1;1
258289617525;258289618022;497;4;1;2;1;1;1
258289618022;258289655545;37523;-1;0;-1;0;1;1
258289655545;258289656130;585;4;1;2;1;1;1
258289656130;258289656939;809;-1;0;-1;0;1;1
258289656939;258289657573;634;4;1;2;1;1;1
258289657573;258289733363;75790;-1;0;-1;0;1;1
258289733363;258289733925;562;4;1;2;1;1;1
258289733925;258289787207;53282;-1;0;-1;0;1;1
258289787207;258289787813;606;4;1;2;1;1;1
258289787813;258289826881;39068;-1;0;-1;0;1;1
258289826881;258289827358;477;4;1;2;1;1;1
258289827358;258289925229;97871;-1;0;-1;0;1;1
258289925229;258289930669;5440;4;1;2;1;1;1
258289930669;258289984077;53408;-1;0;-1;0;1;1
258289984077;258289984626;549;4;1;2;1;1;1
258289984626;258290066181;81555;-1;0;-1;0;1;1
258290066181;258290066786;605;4;1;2;1;1;1
258290066786;258290084564;17778;-1;0;-1;0;1;1
258290084564;258290085177;613;4;1;2;1;1;1
258290085177;258290294403;209226;-1;0;-1;0;1;1
258290294403;258290295907;1504;4;1;2;1;1;1
258290295907;258290305753;9846;-1;0;-1;0;1;1
258290305753;258290306376;623;4;1;2;1;1;1
258290306376;258290343199;36823;-1;0;-1;0;1;1
258290343199;258290344033;834;4;1;2;1;1;1
258290344033;258290353303;9270;-1;0;-1;0;1;1
258290353303;258290353935;632;4;1;2;1;1;1
258290353935;258290391972;38037;-1;0;-1;0;1;1
258290391972;258290392598;626;4;1;2;1;1;1
258290392598;258290434569;41971;-1;0;-1;0;1;1
258290434569;258290435488;919;4;1;2;1;1;1
258290435488;258290569683;134195;-1;0;-1;0;1;1
258290569683;258290570165;482;4;1;2;1;1;1
258290570165;258290646306;76141;-1;0;-1;0;1;1
258290646306;258290646836;530;4;1;2;1;1;1
258290646836;258290693070;46234;-1;0;-1;0;1;1
258290693070;258290694296;1226;4;1;2;1;1;1
258290694296;258290727007;32711;-1;0;-1;0;1;1
258290727007;258290727872;865;4;1;2;1;1;1
258290727872;258290825049;97177;-1;0;-1;0;1;1
258290825049;258290830597;5548;4;1;2;1;1;1
258290830597;258290867732;37135;-1;0;-1;0;1;1
258290867732;258290868415;683;4;1;2;1;1;1
258290868415;258290997102;128687;-1;0;-1;0;1;1
258290997102;258290997728;626;4;1;2;1;1;1
258290997728;258291080561;82833;-1;0;-1;0;1;1
258291080561;258291082026;1465;4;1;2;1;1;1
258291082026;258291090478;8452;-1;0;-1;0;1;1
258291090478;258291091040;562;4;1;2;1;1;1
258291091040;258291138095;47055;-1;0;-1;0;1;1
258291138095;258291138893;798;4;1;2;1;1;1
258291138893;258291193661;54768;-1;0;-1;0;1;1
258291193661;258291194218;557;4;1;2;1;1;1
258291194218;258291237535;43317;-1;0;-1;0;1;1
258291237535;258291238162;627;4;1;2;1;1;1
258291238162;258291304890;66728;-1;0;-1;0;1;1
258291304890;258291305632;742;4;1;2;1;1;1
258291305632;258291360193;54561;-1;0;-1;0;1;1
258291360193;258291361017;824;4;1;2;1;1;1
258291361017;258291434450;73433;-1;0;-1;0;1;1
258291434450;258291435061;611;4;1;2;1;1;1
258291435061;258291471883;36822;-1;0;-1;0;1;1
258291471883;258291472575;692;4;1;2;1;1;1
258291472575;258291501612;29037;-1;0;-1;0;1;1
258291501612;258291502164;552;4;1;2;1;1;1
258291502164;258291540027;37863;-1;0;-1;0;1;1
258291540027;258291540599;572;4;1;2;1;1;1
258291540599;258291582561;41962;-1;0;-1;0;1;1
258291582561;258291583131;570;4;1;2;1;1;1
258291583131;258291583622;491;-1;0;-1;0;1;1
258291583622;258291584252;630;4;1;2;1;1;1
258291584252;258291656245;71993;-1;0;-1;0;1;1
258291656245;258291657123;878;4;1;2;1;1;1
258291657123;258291685692;28569;-1;0;-1;0;1;1
258291685692;258291686571;879;4;1;2;1;1;1
258291686571;258291696253;9682;-1;0;-1;0;1;1
258291696253;258291696896;643;4;1;2;1;1;1
258291696896;258291755759;58863;-1;0;-1;0;1;1
258291755759;258291756314;555;4;1;2;1;1;1
258291756314;258291797383;41069;-1;0;-1;0;1;1
258291797383;258291798205;822;4;1;2;1;1;1
258291798205;258291838332;40127;-1;0;-1;0;1;1
258291838332;258291839343;1011;4;1;2;1;1;1
258291839343;258291877619;38276;-1;0;-1;0;1;1
258291877619;258291878169;550;4;1;2;1;1;1
258291878169;258291897557;19388;-1;0;-1;0;1;1
258291897557;258291898172;615;4;1;2;1;1;1
258291898172;258291951816;53644;-1;0;-1;0;1;1
258291951816;258291952364;548;4;1;2;1;1;1
258291952364;258291994121;41757;-1;0;-1;0;1;1
258291994121;258291994748;627;4;1;2;1;1;1
258291994748;258292030983;36235;-1;0;-1;0;1;1
258292030983;258292031755;772;4;1;2;1;1;1
258292031755;258292066830;35075;-1;0;-1;0;1;1
258292066830;258292067450;620;4;1;2;1;1;1
258292067450;258292107185;39735;-1;0;-1;0;1;1
258292107185;258292107736;551;4;1;2;1;1;1
258292107736;258292149735;41999;-1;0;-1;0;1;1
258292149735;258292150289;554;4;1;2;1;1;1
258292150289;258292216527;66238;-1;0;-1;0;1;1
258292216527;258292217049;522;4;1;2;1;1;1
258292217049;258292258074;41025;-1;0;-1;0;1;1
258292258074;258292258564;490;4;1;2;1;1;1
258292258564;258292395335;136771;-1;0;-1;0;1;1
258292395335;258292399321;3986;4;1;2;1;1;1
258292399321;258292464553;65232;-1;0;-1;0;1;1
258292464553;258292465202;649;4;1;2;1;1;1
258292465202;258292506071;40869;-1;0;-1;0;1;1
258292506071;258292506708;637;4;1;2;1;1;1
258292506708;258292591030;84322;-1;0;-1;0;1;1
258292591030;258292591583;553;4;1;2;1;1;1
258292591583;258292632228;40645;-1;0;-1;0;1;1
258292632228;258292632869;641;4;1;2;1;1;1
258292632869;258292675401;42532;-1;0;-1;0;1;1
258292675401;258292676008;607;4;1;2;1;1;1
258292676008;258292747486;71478;-1;0;-1;0;1;1
258292747486;258292748298;812;4;1;2;1;1;1
258292748298;258292750703;2405;-1;0;-1;0;1;1
258292750703;258292751289;586;4;1;2;1;1;1
258292751289;258292751936;647;-1;0;-1;0;1;1
258292751936;258292752584;648;4;1;2;1;1;1
258292752584;258292785633;33049;-1;0;-1;0;1;1
258292785633;258292786172;539;4;1;2;1;1;1
258292786172;258292825464;39292;-1;0;-1;0;1;1
258292825464;258292826880;1416;4;1;2;1;1;1
258292826880;258292865173;38293;-1;0;-1;0;1;1
258292865173;258292865777;604;4;1;2;1;1;1
258292865777;258292883210;17433;-1;0;-1;0;1;1
258292883210;258292883736;526;4;1;2;1;1;1
258292883736;258292950496;66760;-1;0;-1;0;1;1
258292950496;258292951123;627;4;1;2;1;1;1
258292951123;258292991082;39959;-1;0;-1;0;1;1
258292991082;258292991544;462;4;1;2;1;1;1
258292991544;258293036585;45041;-1;0;-1;0;1;1
258293036585;258293037192;607;4;1;2;1;1;1
258293037192;258293072434;35242;-1;0;-1;0;1;1
258293072434;258293072989;555;4;1;2;1;1;1
258293072989;258293122646;49657;-1;0;-1;0;1;1
258293122646;258293123138;492;4;1;2;1;1;1
258293123138;258293163001;39863;-1;0;-1;0;1;1
258293163001;258293169774;6773;4;1;2;1;1;1
258293169774;258293202934;33160;-1;0;-1;0;1;1
258293202934;258293204176;1242;4;1;2;1;1;1
258293204176;258293239229;35053;-1;0;-1;0;1;1
258293239229;258293240380;1151;4;1;2;1;1;1
258293240380;258293276422;36042;-1;0;-1;0;1;1
258293276422;258293277065;643;4;1;2;1;1;1
258293277065;258293315258;38193;-1;0;-1;0;1;1
258293315258;258293315886;628;4;1;2;1;1;1
258293315886;258293390017;74131;-1;0;-1;0;1;1
258293390017;258293391077;1060;4;1;2;1;1;1
258293391077;258293435357;44280;-1;0;-1;0;1;1
258293435357;258293435911;554;4;1;2;1;1;1
258293435911;258293474160;38249;-1;0;-1;0;1;1
258293474160;258293474766;606;4;1;2;1;1;1
258293474766;258293529266;54500;-1;0;-1;0;1;1
258293529266;258293531683;2417;4;1;2;1;1;1
258293531683;258293576199;44516;-1;0;-1;0;1;1
258293576199;258293576878;679;4;1;2;1;1;1
258293576878;258293676804;99926;-1;0;-1;0;1;1
258293676804;258293678151;1347;4;1;2;1;1;1
258293678151;258293711102;32951;-1;0;-1;0;1;1
258293711102;258293713714;2612;4;1;2;1;1;1
258293713714;258293753467;39753;-1;0;-1;0;1;1
258293753467;258293754592;1125;4;1;2;1;1;1
258293754592;258293764528;9936;-1;0;-1;0;1;1
258293764528;258293765158;630;4;1;2;1;1;1
258293765158;258293816101;50943;-1;0;-1;0;1;1
258293816101;258293816734;633;4;1;2;1;1;1
258293816734;258293851146;34412;-1;0;-1;0;1;1
258293851146;258293851772;626;4;1;2;1;1;1
258293851772;258293909110;57338;-1;0;-1;0;1;1
258293909110;258293909514;404;4;1;2;1;1;1
258293909514;258293909642;128;4;1;2;1;1;1
258293909642;258293910347;705;4;1;2;1;1;1
258293910347;258293966523;56176;-1;0;-1;0;1;1
258293966523;258293968483;1960;4;1;2;1;1;1
258293968483;258293971690;3207;-1;0;-1;0;1;1
258293971690;258293972153;463;4;1;2;1;1;1
258293972153;258294031031;58878;-1;0;-1;0;1;1
258294031031;258294031607;576;4;1;2;1;1;1
258294031607;258294035269;3662;-1;0;-1;0;1;1
258294035269;258294035877;608;4;1;2;1;1;1
258294035877;258294064010;28133;-1;0;-1;0;1;1
258294064010;258294064476;466;4;1;2;1;1;1
258294064476;258294147930;83454;-1;0;-1;0;1;1
258294147930;258294148459;529;4;1;2;1;1;1
258294148459;258294186625;38166;-1;0;-1;0;1;1
258294186625;258294187188;563;4;1;2;1;1;1
258294187188;258294229627;42439;-1;0;-1;0;1;1
258294229627;258294230132;505;4;1;2;1;1;1
258294230132;258294261256;31124;-1;0;-1;0;1;1
258294261256;258294262072;816;4;1;2;1;1;1
258294262072;258294263057;985;-1;0;-1;0;1;1
258294263057;258294263603;546;4;1;2;1;1;1
258294263603;258294344069;80466;-1;0;-1;0;1;1
258294344069;258294344626;557;4;1;2;1;1;1
258294344626;258294355385;10759;-1;0;-1;0;1;1
258294355385;258294355915;530;4;1;2;1;1;1
258294355915;258294415616;59701;-1;0;-1;0;1;1
258294415616;258294417132;1516;4;1;2;1;1;1
258294417132;258294573895;156763;-1;0;-1;0;1;1
258294573895;258294575506;1611;4;1;2;1;1;1
258294575506;258294583264;7758;-1;0;-1;0;1;1
258294583264;258294585312;2048;4;1;2;1;1;1
258294585312;258294585873;561;4;1;2;1;1;1
258294585873;258294586312;439;4;1;2;1;1;1
258294586312;258294625830;39518;-1;0;-1;0;1;1
258294625830;258294626355;525;4;1;2;1;1;1
258294626355;258294665044;38689;-1;0;-1;0;1;1
258294665044;258294665692;648;4;1;2;1;1;1
258294665692;258294737626;71934;-1;0;-1;0;1;1
258294737626;258294738509;883;4;1;2;1;1;1
258294738509;258294811697;73188;-1;0;-1;0;1;1
258294811697;258294812166;469;4;1;2;1;1;1
258294812166;258294879266;67100;-1;0;-1;0;1;1
258294879266;258294879749;483;4;1;2;1;1;1
258294879749;258294961051;81302;-1;0;-1;0;1;1
258294961051;258294961449;398;4;1;2;1;1;1
258294961449;258294962003;554;4;1;2;1;1;1
258294962003;258294963099;1096;4;1;2;1;1;1
258294963099;258294993959;30860;-1;0;-1;0;1;1
258294993959;258294994506;547;4;1;2;1;1;1
258294994506;258295030545;36039;-1;0;-1;0;1;1
258295030545;258295031237;692;4;1;2;1;1;1
258295031237;258295075629;44392;-1;0;-1;0;1;1
258295075629;258295077659;2030;4;1;2;1;1;1
258295077659;258295166958;89299;-1;0;-1;0;1;1
258295166958;258295167562;604;4;1;2;1;1;1
258295167562;258295175421;7859;-1;0;-1;0;1;1
258295175421;258295176974;1553;4;1;2;1;1;1
258295176974;258295226032;49058;-1;0;-1;0;1;1
258295226032;258295226550;518;4;1;2;1;1;1
258295226550;258295274502;47952;-1;0;-1;0;1;1
258295274502;258295275025;523;4;1;2;1;1;1
258295275025;258295378960;103935;-1;0;-1;0;1;1
258295378960;258295379886;926;4;1;2;1;1;1
258295379886;258295417408;37522;-1;0;-1;0;1;1
258295417408;258295418121;713;4;1;2;1;1;1
258295418121;258295499154;81033;-1;0;-1;0;1;1
258295499154;258295500653;1499;4;1;2;1;1;1
258295500653;258295613747;113094;-1;0;-1;0;1;1
258295613747;258295614474;727;4;1;2;1;1;1
258295614474;258295637268;22794;-1;0;-1;0;1;1
258295637268;258295637828;560;4;1;2;1;1;1
258295637828;258295677289;39461;-1;0;-1;0;1;1
258295677289;258295678537;1248;4;1;2;1;1;1
258295678537;258295816029;137492;-1;0;-1;0;1;1
258295816029;258295816162;133;4;1;2;1;1;1
258295816162;258295816642;480;4;1;2;1;1;1
258295816642;258295816844;202;4;1;2;1;1;1
258295816844;258295817638;794;-1;0;-1;0;1;1
258295817638;258295818334;696;4;1;2;1;1;1
258295818334;258295858393;40059;-1;0;-1;0;1;1
258295858393;258295858954;561;4;1;2;1;1;1
258295858954;258295892389;33435;-1;0;-1;0;1;1
258295892389;258295893032;643;4;1;2;1;1;1
258295893032;258295929131;36099;-1;0;-1;0;1;1
258295929131;258295929987;856;4;1;2;1;1;1
258295929987;258295974354;44367;-1;0;-1;0;1;1
258295974354;258295975317;963;4;1;2;1;1;1
258295975317;258296004382;29065;-1;0;-1;0;1;1
258296004382;258296005010;628;4;1;2;1;1;1
258296005010;258296023425;18415;-1;0;-1;0;1;1
258296023425;258296024077;652;4;1;2;1;1;1
258296024077;258296071890;47813;-1;0;-1;0;1;1
258296071890;258296072523;633;4;1;2;1;1;1
258296072523;258296110729;38206;-1;0;-1;0;1;1
258296110729;258296111296;567;4;1;2;1;1;1
258296111296;258296159403;48107;-1;0;-1;0;1;1
258296159403;258296159956;553;4;1;2;1;1;1
258296159956;258296206980;47024;-1;0;-1;0;1;1
258296206980;258296207661;681;4;1;2;1;1;1
258296207661;258296252107;44446;-1;0;-1;0;1;1
258296252107;258296252713;606;4;1;2;1;1;1
258296252713;258296343661;90948;-1;0;-1;0;1;1
258296343661;258296344626;965;4;1;2;1;1;1
258296344626;258296374019;29393;-1;0;-1;0;1;1
258296374019;258296374641;622;4;1;2;1;1;1
258296374641;258296412628;37987;-1;0;-1;0;1;1
258296412628;258296413462;834;4;1;2;1;1;1
258296413462;258296415386;1924;-1;0;-1;0;1;1
258296415386;258296416894;1508;4;1;2;1;1;1
258296416894;258296456138;39244;-1;0;-1;0;1;1
258296456138;258296456691;553;4;1;2;1;1;1
258296456691;258296507025;50334;-1;0;-1;0;1;1
258296507025;258296507554;529;4;1;2;1;1;1
258296507554;258296571035;63481;-1;0;-1;0;1;1
258296571035;258296571673;638;4;1;2;1;1;1
258296571673;258296636888;65215;-1;0;-1;0;1;1
258296636888;258296637594;706;4;1;2;1;1;1
258296637594;258296687965;50371;-1;0;-1;0;1;1
258296687965;258296688519;554;4;1;2;1;1;1
258296688519;258296732651;44132;-1;0;-1;0;1;1
258296732651;258296733199;548;4;1;2;1;1;1
258296733199;258296799861;66662;-1;0;-1;0;1;1
258296799861;258296800501;640;4;1;2;1;1;1
258296800501;258296876107;75606;-1;0;-1;0;1;1
258296876107;258296876728;621;4;1;2;1;1;1
258296876728;258296954077;77349;-1;0;-1;0;1;1
258296954077;258296954715;638;4;1;2;1;1;1
258296954715;258296996317;41602;-1;0;-1;0;1;1
258296996317;258296996879;562;4;1;2;1;1;1
258296996879;258297043303;46424;-1;0;-1;0;1;1
258297043303;258297043993;690;4;1;2;1;1;1
258297043993;258297146974;102981;-1;0;-1;0;1;1
258297146974;258297147627;653;4;1;2;1;1;1
258297147627;258297197099;49472;-1;0;-1;0;1;1
258297197099;258297198279;1180;4;1;2;1;1;1
258297198279;258297213077;14798;-1;0;-1;0;1;1
258297213077;258297213792;715;4;1;2;1;1;1
258297213792;258297277421;63629;-1;0;-1;0;1;1
258297277421;258297278326;905;4;1;2;1;1;1
258297278326;258297325201;46875;-1;0;-1;0;1;1
258297325201;258297325713;512;4;1;2;1;1;1
258297325713;258297325889;176;4;1;2;1;1;1
258297325889;258297326299;410;4;1;2;1;1;1
258297326299;258297428462;102163;-1;0;-1;0;1;1
258297428462;258297429363;901;4;1;2;1;1;1
258297429363;258297486722;57359;-1;0;-1;0;1;1
258297486722;258297487899;1177;4;1;2;1;1;1
258297487899;258297560435;72536;-1;0;-1;0;1;1
258297560435;258297560966;531;4;1;2;1;1;1
258297560966;258297571318;10352;-1;0;-1;0;1;1
258297571318;258297571799;481;4;1;2;1;1;1
258297571799;258297726274;154475;-1;0;-1;0;1;1
258297726274;258297726805;531;4;1;2;1;1;1
258297726805;258297727206;401;-1;0;-1;0;1;1
258297727206;258297728049;843;4;1;2;1;1;1
258297728049;258297770585;42536;-1;0;-1;0;1;1
258297770585;258297771149;564;4;1;2;1;1;1
258297771149;258297823842;52693;-1;0;-1;0;1;1
258297823842;258297824477;635;4;1;2;1;1;1
258297824477;258297877062;52585;-1;0;-1;0;1;1
258297877062;258297877604;542;4;1;2;1;1;1
258297877604;258297975645;98041;-1;0;-1;0;1;1
258297975645;258297976115;470;4;1;2;1;1;1
258297976115;258298017221;41106;-1;0;-1;0;1;1
258298017221;258298017856;635;4;1;2;1;1;1
258298017856;258298053939;36083;-1;0;-1;0;1;1
258298053939;258298054545;606;4;1;2;1;1;1
258298054545;258298115744;61199;-1;0;-1;0;1;1
258298115744;258298116357;613;4;1;2;1;1;1
258298116357;258298160932;44575;-1;0;-1;0;1;1
258298160932;258298161430;498;4;1;2;1;1;1
258298161430;258298215167;53737;-1;0;-1;0;1;1
258298215167;258298215797;630;4;1;2;1;1;1
258298215797;258298258899;43102;-1;0;-1;0;1;1
258298258899;258298259539;640;4;1;2;1;1;1
258298259539;258298300869;41330;-1;0;-1;0;1;1
258298300869;258298301427;558;4;1;2;1;1;1
258298301427;258298340977;39550;-1;0;-1;0;1;1
258298340977;258298341501;524;4;1;2;1;1;1
258298341501;258298390121;48620;-1;0;-1;0;1;1
258298390121;258298390749;628;4;1;2;1;1;1
258298390749;258298435826;45077;-1;0;-1;0;1;1
258298435826;258298436287;461;4;1;2;1;1;1
258298436287;258298478994;42707;-1;0;-1;0;1;1
258298478994;258298479552;558;4;1;2;1;1;1
258298479552;258298522327;42775;-1;0;-1;0;1;1
258298522327;258298524219;1892;4;1;2;1;1;1
258298524219;258298573240;49021;-1;0;-1;0;1;1
258298573240;258298573763;523;4;1;2;1;1;1
258298573763;258298701885;128122;-1;0;-1;0;1;1
258298701885;258298702380;495;4;1;2;1;1;1
258298702380;258298714377;11997;-1;0;-1;0;1;1
258298714377;258298714895;518;4;1;2;1;1;1
258298714895;258298751451;36556;-1;0;-1;0;1;1
258298751451;258298752267;816;4;1;2;1;1;1
258298752267;258298829845;77578;-1;0;-1;0;1;1
258298829845;258298841855;12010;4;1;2;1;1;1
258298841855;258298856012;14157;-1;0;-1;0;1;1
258298856012;258298856627;615;4;1;2;1;1;1
258298856627;258298857485;858;-1;0;-1;0;1;1
258298857485;258298858054;569;4;1;2;1;1;1
258298858054;258298889160;31106;-1;0;-1;0;1;1
258298889160;258298890166;1006;4;1;2;1;1;1
258298890166;258298930352;40186;-1;0;-1;0;1;1
258298930352;258298931343;991;4;1;2;1;1;1
258298931343;258298996580;65237;-1;0;-1;0;1;1
258298996580;258298997085;505;4;1;2;1;1;1
258298997085;258299037396;40311;-1;0;-1;0;1;1
258299037396;258299037940;544;4;1;2;1;1;1
258299037940;258299084408;46468;-1;0;-1;0;1;1
258299084408;258299086910;2502;4;1;2;1;1;1
258299086910;258299109945;23035;-1;0;-1;0;1;1
258299109945;258299112212;2267;4;1;2;1;1;1
258299112212;258299145888;33676;-1;0;-1;0;1;1
258299145888;258299146379;491;4;1;2;1;1;1
258299146379;258299188180;41801;-1;0;-1;0;1;1
258299188180;258299188647;467;4;1;2;1;1;1
258299188647;258299220816;32169;-1;0;-1;0;1;1
258299220816;258299221309;493;4;1;2;1;1;1
258299221309;258299222142;833;-1;0;-1;0;1;1
258299222142;258299222770;628;4;1;2;1;1;1
258299222770;258299271028;48258;-1;0;-1;0;1;1
258299271028;258299272012;984;4;1;2;1;1;1
258299272012;258299309481;37469;-1;0;-1;0;1;1
258299309481;258299310143;662;4;1;2;1;1;1
258299310143;258299340869;30726;-1;0;-1;0;1;1
258299340869;258299345082;4213;4;1;2;1;1;1
258299345082;258299379718;34636;-1;0;-1;0;1;1
258299379718;258299388133;8415;4;1;2;1;1;1
258299388133;258299479951;91818;-1;0;-1;0;1;1
258299479951;258299481713;1762;4;1;2;1;1;1
258299481713;258299490683;8970;-1;0;-1;0;1;1
258299490683;258299492888;2205;4;1;2;1;1;1
258299492888;258299527595;34707;-1;0;-1;0;1;1
258299527595;258299528223;628;4;1;2;1;1;1
258299528223;258299566855;38632;-1;0;-1;0;1;1
258299566855;258299567750;895;4;1;2;1;1;1
258299567750;258299606096;38346;-1;0;-1;0;1;1
258299606096;258299606639;543;4;1;2;1;1;1
258299606639;258299666087;59448;-1;0;-1;0;1;1
258299666087;258299667230;1143;4;1;2;1;1;1
258299667230;258299729242;62012;-1;0;-1;0;1;1
258299729242;258299729827;585;4;1;2;1;1;1
258299729827;258299765290;35463;-1;0;-1;0;1;1
258299765290;258299765945;655;4;1;2;1;1;1
258299765945;258299766430;485;-1;0;-1;0;1;1
258299766430;258299767102;672;4;1;2;1;1;1
258299767102;258299808500;41398;-1;0;-1;0;1;1
258299808500;258299809069;569;4;1;2;1;1;1
258299809069;258299855765;46696;-1;0;-1;0;1;1
258299855765;258299856232;467;4;1;2;1;1;1
258299856232;258299897763;41531;-1;0;-1;0;1;1
258299897763;258299898270;507;4;1;2;1;1;1
258299898270;258299945678;47408;-1;0;-1;0;1;1
258299945678;258299946312;634;4;1;2;1;1;1
258299946312;258300052734;106422;-1;0;-1;0;1;1
258300052734;258300053221;487;4;1;2;1;1;1
258300053221;258300145204;91983;-1;0;-1;0;1;1
258300145204;258300145702;498;4;1;2;1;1;1
258300145702;258300156869;11167;-1;0;-1;0;1;1
258300156869;258300158291;1422;4;1;2;1;1;1
258300158291;258300203703;45412;-1;0;-1;0;1;1
258300203703;258300204356;653;4;1;2;1;1;1
258300204356;258300204488;132;-1;0;-1;0;1;1
258300204488;258300205305;817;4;1;2;1;1;1
258300205305;258300287614;82309;-1;0;-1;0;1;1
258300287614;258300288165;551;4;1;2;1;1;1
258300288165;258300318226;30061;-1;0;-1;0;1;1
258300318226;258300318514;288;4;1;2;1;1;1
258300318514;258300318911;397;4;1;2;1;1;1
258300318911;258300319721;810;4;1;2;1;1;1
258300319721;258300396005;76284;-1;0;-1;0;1;1
258300396005;258300396556;551;4;1;2;1;1;1
258300396556;258300466963;70407;-1;0;-1;0;1;1
258300466963;258300467493;530;4;1;2;1;1;1
258300467493;258300479237;11744;-1;0;-1;0;1;1
258300479237;258300480086;849;4;1;2;1;1;1
258300480086;258300481603;1517;-1;0;-1;0;1;1
258300481603;258300482308;705;4;1;2;1;1;1
258300482308;258300540716;58408;-1;0;-1;0;1;1
258300540716;258300541276;560;4;1;2;1;1;1
258300541276;258300588822;47546;-1;0;-1;0;1;1
258300588822;258300589450;628;4;1;2;1;1;1
258300589450;258300629778;40328;-1;0;-1;0;1;1
258300629778;258300630630;852;4;1;2;1;1;1
258300630630;258300643421;12791;-1;0;-1;0;1;1
258300643421;258300644051;630;4;1;2;1;1;1
258300644051;258300990556;346505;-1;0;-1;0;1;1
258300990556;258300991199;643;4;1;2;1;1;1
258300991199;258301063302;72103;-1;0;-1;0;1;1
258301063302;258301063795;493;4;1;2;1;1;1
258301063795;258301136315;72520;-1;0;-1;0;1;1
258301136315;258301136923;608;4;1;2;1;1;1
258301136923;258301230439;93516;-1;0;-1;0;1;1
258301230439;258301231098;659;4;1;2;1;1;1
258301231098;258301263209;32111;-1;0;-1;0;1;1
258301263209;258301263682;473;4;1;2;1;1;1
258301263682;258301305668;41986;-1;0;-1;0;1;1
258301305668;258301306312;644;4;1;2;1;1;1
258301306312;258301306681;369;-1;0;-1;0;1;1
258301306681;258301307330;649;4;1;2;1;1;1
258301307330;258301477461;170131;-1;0;-1;0;1;1
258301477461;258301478071;610;4;1;2;1;1;1
258301478071;258301539905;61834;-1;0;-1;0;1;1
258301539905;258301540442;537;4;1;2;1;1;1
258301540442;258301610857;70415;-1;0;-1;0;1;1
258301610857;258301611493;636;4;1;2;1;1;1
258301611493;258301655448;43955;-1;0;-1;0;1;1
258301655448;258301656420;972;4;1;2;1;1;1
258301656420;258301656999;579;-1;0;-1;0;1;1
258301656999;258301720570;63571;4;1;2;1;1;1
258301720570;258301721103;533;4;1;2;1;1;1
258301721103;258301742286;21183;4;1;2;1;1;1
258301742286;258301742846;560;4;1;2;1;1;1
258301742846;258301860095;117249;4;1;2;1;1;1
258301860095;258301860721;626;4;1;2;1;1;1
258301860721;258301906648;45927;4;1;2;1;1;1
258301906648;258301907212;564;4;1;2;1;1;1
258301907212;258301979422;72210;4;1;2;1;1;1
258301979422;258301980069;647;4;1;2;1;1;1
258301980069;258301995931;15862;4;1;2;1;1;1
258301995931;258301996567;636;4;1;2;1;1;1
258301996567;258302038311;41744;4;1;2;1;1;1
258302038311;258302038941;630;4;1;2;1;1;1
258302038941;258302042580;3639;4;1;2;1;1;1
258302042580;258302043135;555;4;1;2;1;1;1
258302043135;258302084647;41512;4;1;2;1;1;1
258302084647;258302085262;615;4;1;2;1;1;1
258302085262;258302116668;31406;4;1;2;1;1;1
258302116668;258302117142;474;4;1;2;1;1;1
258302117142;258302153086;35944;4;1;2;1;1;1
258302153086;258302155232;2146;4;1;2;1;1;1
258302155232;258302156191;959;4;1;2;1;1;1
258302156191;258302241849;85658;4;1;2;1;1;1
258302241849;258302242536;687;4;1;2;1;1;1
258302242536;258302299707;57171;4;1;2;1;1;1
258302299707;258302300557;850;4;1;2;1;1;1
258302300557;258302335141;34584;4;1;2;1;1;1
258302335141;258302335699;558;4;1;2;1;1;1
258302335699;258302411880;76181;4;1;2;1;1;1
258302411880;258302412888;1008;4;1;2;1;1;1
258302412888;258302450443;37555;4;1;2;1;1;1
258302450443;258302461793;11350;4;1;2;1;1;1
258302461793;258302462369;576;4;1;2;1;1;1
258302462369;258302463018;649;4;1;2;1;1;1
258302463018;258302463639;621;4;1;2;1;1;1
258302463639;258302510364;46725;4;1;2;1;1;1
258302510364;258302510990;626;4;1;2;1;1;1
258302510990;258302546706;35716;4;1;2;1;1;1
258302546706;258302547563;857;4;1;2;1;1;1
258302547563;258302700855;153292;4;1;2;1;1;1
258302700855;258302701777;922;4;1;2;1;1;1
258302701777;258302702495;718;4;1;2;1;1;1
258302702495;258302703742;1247;4;1;2;1;1;1
258302703742;258302747427;43685;4;1;2;1;1;1
258302747427;258302748056;629;4;1;2;1;1;1
258302748056;258302838381;90325;4;1;2;1;1;1
258302838381;258302839229;848;4;1;2;1;1;1
258302839229;258302929979;90750;4;1;2;1;1;1
258302929979;258302930779;800;4;1;2;1;1;1
258302930779;258302932200;1421;4;1;2;1;1;1
258302932200;258302932827;627;4;1;2;1;1;1
258302932827;258303000683;67856;4;1;2;1;1;1
258303000683;258303004311;3628;4;1;2;1;1;1
258303004311;258303073682;69371;4;1;2;1;1;1
258303073682;258303074320;638;4;1;2;1;1;1
258303074320;258303202295;127975;4;1;2;1;1;1
258303202295;258303203064;769;4;1;2;1;1;1
258303203064;258303281596;78532;4;1;2;1;1;1
258303281596;258303282612;1016;4;1;2;1;1;1
258303282612;258303314081;31469;4;1;2;1;1;1
258303314081;258303314638;557;4;1;2;1;1;1
258303314638;258303327003;12365;4;1;2;1;1;1
258303327003;258303327537;534;4;1;2;1;1;1
258303327537;258303408340;80803;4;1;2;1;1;1
258303408340;258303409569;1229;4;1;2;1;1;1
258303409569;258303410125;556;4;1;2;1;1;1
258303410125;258303410809;684;4;1;2;1;1;1
258303410809;258303449341;38532;4;1;2;1;1;1
258303449341;258303450259;918;4;1;2;1;1;1
258303450259;258303527152;76893;4;1;2;1;1;1
258303527152;258303527656;504;4;1;2;1;1;1
258303527656;258303615630;87974;4;1;2;1;1;1
258303615630;258303622854;7224;4;1;2;1;1;1
258303622854;258303677228;54374;4;1;2;1;1;1
258303677228;258303681211;3983;4;1;2;1;1;1
258303681211;258303710894;29683;4;1;2;1;1;1
258303710894;258303711362;468;4;1;2;1;1;1
258303711362;258303763537;52175;4;1;2;1;1;1
258303763537;258303764162;625;4;1;2;1;1;1
258303764162;258303810296;46134;4;1;2;1;1;1
258303810296;258303811534;1238;4;1;2;1;1;1
258303811534;258303890016;78482;4;1;2;1;1;1
258303890016;258303890577;561;4;1;2;1;1;1
258303890577;258303940418;49841;4;1;2;1;1;1
258303940418;258303941077;659;4;1;2;1;1;1
258303941077;258303996177;55100;4;1;2;1;1;1
258303996177;258303996746;569;4;1;2;1;1;1
258303996746;258304046273;49527;4;1;2;1;1;1
258304046273;258304049016;2743;4;1;2;1;1;1
258304049016;258304084459;35443;4;1;2;1;1;1
258304084459;258304085011;552;4;1;2;1;1;1
258304085011;258304085495;484;4;1;2;1;1;1
258304085495;258304086114;619;4;1;2;1;1;1
258304086114;258304134186;48072;4;1;2;1;1;1
258304134186;258304134818;632;4;1;2;1;1;1
258304134818;258304137265;2447;4;1;2;1;1;1
258304137265;258304137796;531;4;1;2;1;1;1
258304137796;258304168115;30319;4;1;2;1;1;1
258304168115;258304168598;483;4;1;2;1;1;1
258304168598;258304202928;34330;4;1;2;1;1;1
258304202928;258304204276;1348;4;1;2;1;1;1
258304204276;258304212531;8255;4;1;2;1;1;1
258304212531;258304212545;14;4;1;2;1;1;1
258304212545;258304213663;1118;4;1;2;1;1;1
258304213663;258304214215;552;4;1;2;1;1;1
258304214215;258304255551;41336;4;1;2;1;1;1
258304255551;258304256975;1424;4;1;2;1;1;1
258304256975;258304304856;47881;4;1;2;1;1;1
258304304856;258304305413;557;4;1;2;1;1;1
258304305413;258304332686;27273;4;1;2;1;1;1
258304332686;258304333438;752;4;1;2;1;1;1
258304333438;258304361011;27573;4;1;2;1;1;1
258304361011;258304371836;10825;-1;0;-1;0;1;1
258304371836;258304372484;648;4;1;2;1;1;1
258304372484;258304407318;34834;-1;0;-1;0;1;1
258304407318;258304407872;554;4;1;2;1;1;1
258304407872;258304408590;718;-1;0;-1;0;1;1
258304408590;258304409273;683;4;1;2;1;1;1
258304409273;258305862070;1452797;-1;0;-1;0;1;1
258305862070;258305862617;547;4;1;2;1;1;1
258305862617;258305864432;1815;-1;0;-1;0;1;1
258305864432;258305864998;566;4;1;2;1;1;1
258305864998;258305917273;52275;-1;0;-1;0;1;1
258305917273;258305917943;670;4;1;2;1;1;1
258305917943;258305954610;36667;-1;0;-1;0;1;1
258305954610;258305955210;600;4;1;2;1;1;1
258305955210;258305955227;17;4;1;2;1;1;1
258305955227;258305955244;17;4;1;2;1;1;1
258305955244;258305955761;517;4;1;2;1;1;1
258305955761;258305955859;98;4;1;2;1;1;1
258305955859;258305998369;42510;-1;0;-1;0;1;1
258305998369;258305998921;552;4;1;2;1;1;1
258305998921;258306041978;43057;-1;0;-1;0;1;1
258306041978;258306042556;578;4;1;2;1;1;1
258306042556;258306084265;41709;-1;0;-1;0;1;1
258306084265;258306084898;633;4;1;2;1;1;1
258306084898;258306140479;55581;-1;0;-1;0;1;1
258306140479;258306141122;643;4;1;2;1;1;1
258306141122;258306141138;16;-1;0;-1;0;1;1
258306141138;258306141304;166;4;1;2;1;1;1
258306141304;258306141666;362;4;1;2;1;1;1
258306141666;258306141950;284;4;1;2;1;1;1
258306141950;258306187301;45351;-1;0;-1;0;1;1
258306187301;258306187934;633;4;1;2;1;1;1
258306187934;258306333769;145835;-1;0;-1;0;1;1
258306333769;258306337329;3560;4;1;2;1;1;1
258306337329;258306375046;37717;-1;0;-1;0;1;1
258306375046;258306375604;558;4;1;2;1;1;1
258306375604;258306422174;46570;-1;0;-1;0;1;1
258306422174;258306422733;559;4;1;2;1;1;1
258306422733;258306441750;19017;-1;0;-1;0;1;1
258306441750;258306442588;838;4;1;2;1;1;1
258306442588;258306515540;72952;-1;0;-1;0;1;1
258306515540;258306516167;627;4;1;2;1;1;1
258306516167;258306557356;41189;-1;0;-1;0;1;1
258306557356;258306557890;534;4;1;2;1;1;1
258306557890;258306594067;36177;-1;0;-1;0;1;1
258306594067;258306594623;556;4;1;2;1;1;1
258306594623;258306668214;73591;-1;0;-1;0;1;1
258306668214;258306668893;679;4;1;2;1;1;1
258306668893;258306678995;10102;-1;0;-1;0;1;1
258306678995;258306679567;572;4;1;2;1;1;1
258306679567;258306766217;86650;-1;0;-1;0;1;1
258306766217;258306767291;1074;4;1;2;1;1;1
258306767291;258306800995;33704;-1;0;-1;0;1;1
258306800995;258306801555;560;4;1;2;1;1;1
258306801555;258307055494;253939;-1;0;-1;0;1;1
258307055494;258307056125;631;4;1;2;1;1;1
258307056125;258307119091;62966;-1;0;-1;0;1;1
258307119091;258307119741;650;4;1;2;1;1;1
258307119741;258307170352;50611;-1;0;-1;0;1;1
258307170352;258307170997;645;4;1;2;1;1;1
258307170997;258307181532;10535;-1;0;-1;0;1;1
258307181532;258307182278;746;4;1;2;1;1;1
258307182278;258307258452;76174;-1;0;-1;0;1;1
258307258452;258307259017;565;4;1;2;1;1;1
258307259017;258307330822;71805;-1;0;-1;0;1;1
258307330822;258307331718;896;4;1;2;1;1;1
258307331718;258307395017;63299;-1;0;-1;0;1;1
258307395017;258307395536;519;4;1;2;1;1;1
258307395536;258307395874;338;-1;0;-1;0;1;1
258307395874;258307396467;593;4;1;2;1;1;1
258307396467;258307444201;47734;-1;0;-1;0;1;1
258307444201;258307445390;1189;4;1;2;1;1;1
258307445390;258307445831;441;-1;0;-1;0;1;1
258307445831;258307446676;845;4;1;2;1;1;1
258307446676;258307489620;42944;-1;0;-1;0;1;1
258307489620;258307490273;653;4;1;2;1;1;1
258307490273;258307733409;243136;-1;0;-1;0;1;1
258307733409;258307733950;541;4;1;2;1;1;1
258307733950;258307783288;49338;-1;0;-1;0;1;1
258307783288;258307783808;520;4;1;2;1;1;1
258307783808;258307827313;43505;-1;0;-1;0;1;1
258307827313;258307827948;635;4;1;2;1;1;1
258307827948;258307864432;36484;-1;0;-1;0;1;1
258307864432;258307864965;533;4;1;2;1;1;1
258307864965;258307928995;64030;-1;0;-1;0;1;1
258307928995;258307931823;2828;4;1;2;1;1;1
258307931823;258307951676;19853;-1;0;-1;0;1;1
258307951676;258307953016;1340;4;1;2;1;1;1
258307953016;258307978067;25051;-1;0;-1;0;1;1
258307978067;258307978622;555;4;1;2;1;1;1
258307978622;258308011311;32689;-1;0;-1;0;1;1
258308011311;258308012347;1036;4;1;2;1;1;1
258308012347;258308061144;48797;-1;0;-1;0;1;1
258308061144;258308061762;618;4;1;2;1;1;1
258308061762;258308102614;40852;-1;0;-1;0;1;1
258308102614;258308104145;1531;4;1;2;1;1;1
258308104145;258308211901;107756;-1;0;-1;0;1;1
258308211901;258308212600;699;4;1;2;1;1;1
258308212600;258308306820;94220;-1;0;-1;0;1;1
258308306820;258308307632;812;4;1;2;1;1;1
258308307632;258308353246;45614;-1;0;-1;0;1;1
258308353246;258308354323;1077;4;1;2;1;1;1
258308354323;258308411961;57638;-1;0;-1;0;1;1
258308411961;258308412520;559;4;1;2;1;1;1
258308412520;258308461502;48982;-1;0;-1;0;1;1
258308461502;258308463130;1628;4;1;2;1;1;1
258308463130;258308471951;8821;-1;0;-1;0;1;1
258308471951;258308472929;978;4;1;2;1;1;1
258308472929;258308580742;107813;-1;0;-1;0;1;1
258308580742;258308581827;1085;4;1;2;1;1;1
258308581827;258308591098;9271;-1;0;-1;0;1;1
258308591098;258308592553;1455;4;1;2;1;1;1
258308592553;258308622220;29667;-1;0;-1;0;1;1
258308622220;258308622856;636;4;1;2;1;1;1
258308622856;258308664334;41478;-1;0;-1;0;1;1
258308664334;258308664945;611;4;1;2;1;1;1
258308664945;258308704775;39830;-1;0;-1;0;1;1
258308704775;258308705322;547;4;1;2;1;1;1
258308705322;258308745763;40441;-1;0;-1;0;1;1
258308745763;258308746486;723;4;1;2;1;1;1
258308746486;258308747258;772;4;1;2;1;1;1
258308747258;258308747468;210;4;1;2;1;1;1
258308747468;258308797987;50519;-1;0;-1;0;1;1
258308797987;258308798748;761;4;1;2;1;1;1
258308798748;258308837320;38572;-1;0;-1;0;1;1
258308837320;258308837852;532;4;1;2;1;1;1
258308837852;258308884640;46788;-1;0;-1;0;1;1
258308884640;258308885264;624;4;1;2;1;1;1
258308885264;258308895161;9897;-1;0;-1;0;1;1
258308895161;258308895712;551;4;1;2;1;1;1
258308895712;258308926664;30952;-1;0;-1;0;1;1
258308926664;258308927260;596;4;1;2;1;1;1
258308927260;258308962209;34949;-1;0;-1;0;1;1
258308962209;258308966579;4370;4;1;2;1;1;1
258308966579;258309007509;40930;-1;0;-1;0;1;1
258309007509;258309008145;636;4;1;2;1;1;1
258309008145;258309076098;67953;-1;0;-1;0;1;1
258309076098;258309076711;613;4;1;2;1;1;1
258309076711;258309079912;3201;-1;0;-1;0;1;1
258309079912;258309080467;555;4;1;2;1;1;1
258309080467;258309163060;82593;-1;0;-1;0;1;1
258309163060;258309163612;552;4;1;2;1;1;1
258309163612;258309193277;29665;-1;0;-1;0;1;1
258309193277;258309193733;456;4;1;2;1;1;1
258309193733;258309196803;3070;-1;0;-1;0;1;1
258309196803;258309197350;547;4;1;2;1;1;1
258309197350;258309197369;19;4;1;2;1;1;1
258309197369;258309198116;747;4;1;2;1;1;1
258309198116;258309206817;8701;-1;0;-1;0;1;1
258309206817;258309207449;632;4;1;2;1;1;1
258309207449;258309262878;55429;-1;0;-1;0;1;1
258309262878;258309263415;537;4;1;2;1;1;1
258309263415;258309281662;18247;-1;0;-1;0;1;1
258309281662;258309282524;862;4;1;2;1;1;1
258309282524;258309370095;87571;-1;0;-1;0;1;1
258309370095;258309370621;526;4;1;2;1;1;1
258309370621;258309371676;1055;-1;0;-1;0;1;1
258309371676;258309372302;626;4;1;2;1;1;1
258309372302;258309417277;44975;-1;0;-1;0;1;1
258309417277;258309417898;621;4;1;2;1;1;1
258309417898;258309476091;58193;-1;0;-1;0;1;1
258309476091;258309476714;623;4;1;2;1;1;1
258309476714;258309513658;36944;-1;0;-1;0;1;1
258309513658;258309514181;523;4;1;2;1;1;1
258309514181;258309582049;67868;-1;0;-1;0;1;1
258309582049;258309582436;387;4;1;2;1;1;1
258309582436;258309583095;659;4;1;2;1;1;1
258309583095;258309583642;547;4;1;2;1;1;1
258309583642;258309585141;1499;-1;0;-1;0;1;1
258309585141;258309585691;550;4;1;2;1;1;1
258309585691;258309638211;52520;-1;0;-1;0;1;1
258309638211;258309638833;622;4;1;2;1;1;1
258309638833;258309692335;53502;-1;0;-1;0;1;1
258309692335;258309692965;630;4;1;2;1;1;1
258309692965;258309741647;48682;-1;0;-1;0;1;1
258309741647;258309742272;625;4;1;2;1;1;1
258309742272;258309764497;22225;-1;0;-1;0;1;1
258309764497;258309765032;535;4;1;2;1;1;1
258309765032;258309794234;29202;-1;0;-1;0;1;1
258309794234;258309794756;522;4;1;2;1;1;1
258309794756;258309823713;28957;-1;0;-1;0;1;1
258309823713;258309824262;549;4;1;2;1;1;1
258309824262;258309884003;59741;-1;0;-1;0;1;1
258309884003;258309884530;527;4;1;2;1;1;1
258309884530;258309928879;44349;-1;0;-1;0;1;1
258309928879;258309929434;555;4;1;2;1;1;1
258309929434;258309974941;45507;-1;0;-1;0;1;1
258309974941;258309975489;548;4;1;2;1;1;1
258309975489;258310070935;95446;-1;0;-1;0;1;1
258310070935;258310071493;558;4;1;2;1;1;1
258310071493;258310109280;37787;-1;0;-1;0;1;1
258310109280;258310109815;535;4;1;2;1;1;1
258310109815;258310169491;59676;-1;0;-1;0;1;1
258310169491;258310176385;6894;4;1;2;1;1;1
258310176385;258310193572;17187;-1;0;-1;0;1;1
258310193572;258310194174;602;4;1;2;1;1;1
258310194174;258310239985;45811;-1;0;-1;0;1;1
258310239985;258310240661;676;4;1;2;1;1;1
258310240661;258310289825;49164;-1;0;-1;0;1;1
258310289825;258310290377;552;4;1;2;1;1;1
258310290377;258310377196;86819;-1;0;-1;0;1;1
258310377196;258310377267;71;4;1;2;1;1;1
258310377267;258310377840;573;4;1;2;1;1;1
258310377840;258310386859;9019;4;1;2;1;1;1
258310386859;258310387744;885;4;1;2;1;1;1
258310387744;258310388081;337;4;1;2;1;1;1
258310388081;258310388831;750;4;1;2;1;1;1
258310388831;258310394164;5333;4;1;2;1;1;1
258310394164;258310434043;39879;-1;0;-1;0;1;1
258310434043;258310434646;603;4;1;2;1;1;1
258310434646;258310448400;13754;-1;0;-1;0;1;1
258310448400;258310448911;511;4;1;2;1;1;1
258310448911;258310491307;42396;-1;0;-1;0;1;1
258310491307;258310491851;544;4;1;2;1;1;1
258310491851;258310536698;44847;-1;0;-1;0;1;1
258310536698;258310537278;580;4;1;2;1;1;1
258310537278;258310537657;379;-1;0;-1;0;1;1
258310537657;258310538478;821;4;1;2;1;1;1
258310538478;258310675144;136666;-1;0;-1;0;1;1
258310675144;258310675599;455;4;1;2;1;1;1
258310675599;258310721256;45657;-1;0;-1;0;1;1
258310721256;258310721743;487;4;1;2;1;1;1
258310721743;258310734237;12494;-1;0;-1;0;1;1
258310734237;258310734783;546;4;1;2;1;1;1
258310734783;258310860878;126095;-1;0;-1;0;1;1
258310860878;258310861538;660;4;1;2;1;1;1
258310861538;258310956518;94980;-1;0;-1;0;1;1
258310956518;258310957123;605;4;1;2;1;1;1
258310957123;258310974283;17160;-1;0;-1;0;1;1
258310974283;258310974823;540;4;1;2;1;1;1
258310974823;258311026169;51346;-1;0;-1;0;1;1
258311026169;258311026792;623;4;1;2;1;1;1
258311026792;258311092097;65305;-1;0;-1;0;1;1
258311092097;258311094144;2047;4;1;2;1;1;1
258311094144;258311123691;29547;-1;0;-1;0;1;1
258311123691;258311124295;604;4;1;2;1;1;1
258311124295;258311172057;47762;-1;0;-1;0;1;1
258311172057;258311173792;1735;4;1;2;1;1;1
258311173792;258311277341;103549;-1;0;-1;0;1;1
258311277341;258311278073;732;4;1;2;1;1;1
258311278073;258311278202;129;-1;0;-1;0;1;1
258311278202;258311279195;993;4;1;2;1;1;1
258311279195;258311325488;46293;-1;0;-1;0;1;1
258311325488;258311326345;857;4;1;2;1;1;1
258311326345;258311556963;230618;-1;0;-1;0;1;1
258311556963;258311559874;2911;4;1;2;1;1;1
258311559874;258311560591;717;-1;0;-1;0;1;1
258311560591;258311562421;1830;4;1;2;1;1;1
258311562421;258311627927;65506;-1;0;-1;0;1;1
258311627927;258311628475;548;4;1;2;1;1;1
258311628475;258311740429;111954;-1;0;-1;0;1;1
258311740429;258311744302;3873;4;1;2;1;1;1
258311744302;258311781765;37463;-1;0;-1;0;1;1
258311781765;258311782374;609;4;1;2;1;1;1
258311782374;258311794169;11795;-1;0;-1;0;1;1
258311794169;258311795131;962;4;1;2;1;1;1
258311795131;258311804403;9272;-1;0;-1;0;1;1
258311804403;258311805303;900;4;1;2;1;1;1
258311805303;258311826210;20907;-1;0;-1;0;1;1
258311826210;258311826670;460;4;1;2;1;1;1
258311826670;258311836779;10109;-1;0;-1;0;1;1
258311836779;258311837659;880;4;1;2;1;1;1
258311837659;258311903858;66199;-1;0;-1;0;1;1
258311903858;258311904943;1085;4;1;2;1;1;1
258311904943;258311905640;697;-1;0;-1;0;1;1
258311905640;258311907450;1810;4;1;2;1;1;1
258311907450;258311952983;45533;-1;0;-1;0;1;1
258311952983;258311953602;619;4;1;2;1;1;1
258311953602;258311963320;9718;-1;0;-1;0;1;1
258311963320;258311964019;699;4;1;2;1;1;1
258311964019;258312003827;39808;-1;0;-1;0;1;1
258312003827;258312004361;534;4;1;2;1;1;1
258312004361;258312045172;40811;-1;0;-1;0;1;1
258312045172;258312047462;2290;4;1;2;1;1;1
258312047462;258312052337;4875;-1;0;-1;0;1;1
258312052337;258312054401;2064;4;1;2;1;1;1
258312054401;258312061014;6613;-1;0;-1;0;1;1
258312061014;258312064771;3757;4;1;2;1;1;1
258312064771;258312195165;130394;-1;0;-1;0;1;1
258312195165;258312195776;611;4;1;2;1;1;1
258312195776;258312240104;44328;-1;0;-1;0;1;1
258312240104;258312241343;1239;4;1;2;1;1;1
258312241343;258312243731;2388;-1;0;-1;0;1;1
258312243731;258312244351;620;4;1;2;1;1;1
258312244351;258312324199;79848;-1;0;-1;0;1;1
258312324199;258312324922;723;4;1;2;1;1;1
258312324922;258312391375;66453;-1;0;-1;0;1;1
258312391375;258312391974;599;4;1;2;1;1;1
258312391974;258312437821;45847;-1;0;-1;0;1;1
258312437821;258312438680;859;4;1;2;1;1;1
258312438680;258312457094;18414;-1;0;-1;0;1;1
258312457094;258312457714;620;4;1;2;1;1;1
258312457714;258312495565;37851;-1;0;-1;0;1;1
258312495565;258312496098;533;4;1;2;1;1;1
258312496098;258312496482;384;-1;0;-1;0;1;1
258312496482;258312497146;664;4;1;2;1;1;1
258312497146;258312528056;30910;-1;0;-1;0;1;1
258312528056;258312528655;599;4;1;2;1;1;1
258312528655;258312594389;65734;-1;0;-1;0;1;1
258312594389;258312594848;459;4;1;2;1;1;1
258312594848;258312642672;47824;-1;0;-1;0;1;1
258312642672;258312643545;873;4;1;2;1;1;1
258312643545;258312698577;55032;-1;0;-1;0;1;1
258312698577;258312699512;935;4;1;2;1;1;1
258312699512;258312752062;52550;-1;0;-1;0;1;1
258312752062;258312752685;623;4;1;2;1;1;1
258312752685;258312798786;46101;-1;0;-1;0;1;1
258312798786;258312799382;596;4;1;2;1;1;1
258312799382;258312857286;57904;-1;0;-1;0;1;1
258312857286;258312857836;550;4;1;2;1;1;1
258312857836;258312920090;62254;-1;0;-1;0;1;1
258312920090;258312920728;638;4;1;2;1;1;1
258312920728;258312948856;28128;-1;0;-1;0;1;1
258312948856;258312950683;1827;4;1;2;1;1;1
258312950683;258312950790;107;-1;0;-1;0;1;1
258312950790;258312952051;1261;4;1;2;1;1;1
258312952051;258313000673;48622;-1;0;-1;0;1;1
258313000673;258313001316;643;4;1;2;1;1;1
258313001316;258313001503;187;-1;0;-1;0;1;1
258313001503;258313002173;670;4;1;2;1;1;1
258313002173;258313041603;39430;-1;0;-1;0;1;1
258313041603;258313042225;622;4;1;2;1;1;1
258313042225;258313091394;49169;-1;0;-1;0;1;1
258313091394;258313092041;647;4;1;2;1;1;1
258313092041;258313137419;45378;-1;0;-1;0;1;1
258313137419;258313138021;602;4;1;2;1;1;1
258313138021;258313180901;42880;-1;0;-1;0;1;1
258313180901;258313181514;613;4;1;2;1;1;1
258313181514;258313223475;41961;-1;0;-1;0;1;1
258313223475;258313224079;604;4;1;2;1;1;1
258313224079;258313273560;49481;-1;0;-1;0;1;1
258313273560;258313274180;620;4;1;2;1;1;1
258313274180;258313313639;39459;-1;0;-1;0;1;1
258313313639;258313314184;545;4;1;2;1;1;1
258313314184;258313358131;43947;-1;0;-1;0;1;1
258313358131;258313358750;619;4;1;2;1;1;1
258313358750;258313407181;48431;-1;0;-1;0;1;1
258313407181;258313407803;622;4;1;2;1;1;1
258313407803;258313489801;81998;-1;0;-1;0;1;1
258313489801;258313490418;617;4;1;2;1;1;1
258313490418;258313533275;42857;-1;0;-1;0;1;1
258313533275;258313533857;582;4;1;2;1;1;1
258313533857;258313588171;54314;-1;0;-1;0;1;1
258313588171;258313588790;619;4;1;2;1;1;1
258313588790;258313628371;39581;-1;0;-1;0;1;1
258313628371;258313629045;674;4;1;2;1;1;1
258313629045;258313629891;846;-1;0;-1;0;1;1
258313629891;258313630447;556;4;1;2;1;1;1
258313630447;258313660948;30501;-1;0;-1;0;1;1
258313660948;258313661555;607;4;1;2;1;1;1
258313661555;258313699198;37643;-1;0;-1;0;1;1
258313699198;258313699812;614;4;1;2;1;1;1
258313699812;258313700535;723;-1;0;-1;0;1;1
258313700535;258313701143;608;4;1;2;1;1;1
258313701143;258313745488;44345;-1;0;-1;0;1;1
258313745488;258313746088;600;4;1;2;1;1;1
258313746088;258313799968;53880;-1;0;-1;0;1;1
258313799968;258313800440;472;4;1;2;1;1;1
258313800440;258313806160;5720;-1;0;-1;0;1;1
258313806160;258313813344;7184;4;1;2;1;1;1
258313813344;258313862542;49198;-1;0;-1;0;1;1
258313862542;258313868560;6018;4;1;2;1;1;1
258313868560;258313896303;27743;-1;0;-1;0;1;1
258313896303;258313896917;614;4;1;2;1;1;1
258313896917;258313899231;2314;-1;0;-1;0;1;1
258313899231;258313899654;423;4;1;2;1;1;1
258313899654;258313899934;280;4;1;2;1;1;1
258313899934;258313900291;357;4;1;2;1;1;1
258313900291;258313934010;33719;-1;0;-1;0;1;1
258313934010;258313934501;491;4;1;2;1;1;1
258313934501;258313935869;1368;-1;0;-1;0;1;1
258313935869;258313936504;635;4;1;2;1;1;1
258313936504;258313994733;58229;-1;0;-1;0;1;1
258313994733;258313994856;123;4;1;2;1;1;1
258313994856;258313995255;399;4;1;2;1;1;1
258313995255;258313995448;193;4;1;2;1;1;1
258313995448;258314023232;27784;-1;0;-1;0;1;1
258314023232;258314024979;1747;4;1;2;1;1;1
258314024979;258314110593;85614;-1;0;-1;0;1;1
258314110593;258314111228;635;4;1;2;1;1;1
258314111228;258314120379;9151;-1;0;-1;0;1;1
258314120379;258314121419;1040;4;1;2;1;1;1
258314121419;258314160194;38775;-1;0;-1;0;1;1
258314160194;258314160755;561;4;1;2;1;1;1
258314160755;258314298284;137529;-1;0;-1;0;1;1
258314298284;258314299001;717;4;1;2;1;1;1
258314299001;258314300974;1973;-1;0;-1;0;1;1
258314300974;258314303569;2595;4;1;2;1;1;1
258314303569;258314309621;6052;-1;0;-1;0;1;1
258314309621;258314312411;2790;4;1;2;1;1;1
258314312411;258314340370;27959;-1;0;-1;0;1;1
258314340370;258314340838;468;4;1;2;1;1;1
258314340838;258314374345;33507;-1;0;-1;0;1;1
258314374345;258314374808;463;4;1;2;1;1;1
258314374808;258314411583;36775;-1;0;-1;0;1;1
258314411583;258314412110;527;4;1;2;1;1;1
258314412110;258314453176;41066;-1;0;-1;0;1;1
258314453176;258314454328;1152;4;1;2;1;1;1
258314454328;258314599350;145022;-1;0;-1;0;1;1
258314599350;258314599916;566;4;1;2;1;1;1
258314599916;258314644003;44087;-1;0;-1;0;1;1
258314644003;258314645987;1984;4;1;2;1;1;1
258314645987;258314725014;79027;-1;0;-1;0;1;1
258314725014;258314725711;697;4;1;2;1;1;1
258314725711;258314753128;27417;-1;0;-1;0;1;1
258314753128;258314754618;1490;4;1;2;1;1;1
258314754618;258314755504;886;-1;0;-1;0;1;1
258314755504;258314756331;827;4;1;2;1;1;1
258314756331;258314794903;38572;-1;0;-1;0;1;1
258314794903;258314795700;797;4;1;2;1;1;1
258314795700;258314869457;73757;-1;0;-1;0;1;1
258314869457;258314870014;557;4;1;2;1;1;1
258314870014;258314905605;35591;-1;0;-1;0;1;1
258314905605;258314906327;722;4;1;2;1;1;1
258314906327;258314907685;1358;-1;0;-1;0;1;1
258314907685;258314908576;891;4;1;2;1;1;1
258314908576;258314960657;52081;-1;0;-1;0;1;1
258314960657;258314961486;829;4;1;2;1;1;1
258314961486;258315007702;46216;-1;0;-1;0;1;1
258315007702;258315008461;759;4;1;2;1;1;1
258315008461;258315042573;34112;-1;0;-1;0;1;1
258315042573;258315043294;721;4;1;2;1;1;1
258315043294;258315083917;40623;-1;0;-1;0;1;1
258315083917;258315084455;538;4;1;2;1;1;1
258315084455;258315138509;54054;-1;0;-1;0;1;1
258315138509;258315139047;538;4;1;2;1;1;1
258315139047;258315188715;49668;-1;0;-1;0;1;1
258315188715;258315189345;630;4;1;2;1;1;1
258315189345;258315249262;59917;-1;0;-1;0;1;1
258315249262;258315250050;788;4;1;2;1;1;1
258315250050;258315316696;66646;-1;0;-1;0;1;1
258315316696;258315317318;622;4;1;2;1;1;1
258315317318;258315325070;7752;-1;0;-1;0;1;1
258315325070;258315325958;888;4;1;2;1;1;1
258315325958;258315387038;61080;-1;0;-1;0;1;1
258315387038;258315387574;536;4;1;2;1;1;1
258315387574;258315401207;13633;-1;0;-1;0;1;1
258315401207;258315401884;677;4;1;2;1;1;1
258315401884;258315402066;182;-1;0;-1;0;1;1
258315402066;258315402842;776;4;1;2;1;1;1
258315402842;258315403053;211;-1;0;-1;0;1;1
258315403053;258315403311;258;4;1;2;1;1;1
258315403311;258315403697;386;4;1;2;1;1;1
258315403697;258315404065;368;4;1;2;1;1;1
258315404065;258315438068;34003;-1;0;-1;0;1;1
258315438068;258315439125;1057;4;1;2;1;1;1
258315439125;258315519193;80068;-1;0;-1;0;1;1
258315519193;258315524397;5204;4;1;2;1;1;1
258315524397;258315541755;17358;-1;0;-1;0;1;1
258315541755;258315542837;1082;4;1;2;1;1;1
258315542837;258315575419;32582;-1;0;-1;0;1;1
258315575419;258315575974;555;4;1;2;1;1;1
258315575974;258315610999;35025;-1;0;-1;0;1;1
258315610999;258315611924;925;4;1;2;1;1;1
258315611924;258315662998;51074;-1;0;-1;0;1;1
258315662998;258315667104;4106;4;1;2;1;1;1
258315667104;258315695477;28373;-1;0;-1;0;1;1
258315695477;258315696176;699;4;1;2;1;1;1
258315696176;258315737021;40845;-1;0;-1;0;1;1
258315737021;258315738862;1841;4;1;2;1;1;1
258315738862;258315741559;2697;-1;0;-1;0;1;1
258315741559;258315743978;2419;4;1;2;1;1;1
258315743978;258315776347;32369;-1;0;-1;0;1;1
258315776347;258315777210;863;4;1;2;1;1;1
258315777210;258315822100;44890;-1;0;-1;0;1;1
258315822100;258315822632;532;4;1;2;1;1;1
258315822632;258315858729;36097;-1;0;-1;0;1;1
258315858729;258315860204;1475;4;1;2;1;1;1
258315860204;258315899846;39642;-1;0;-1;0;1;1
258315899846;258315900743;897;4;1;2;1;1;1
258315900743;258315901677;934;-1;0;-1;0;1;1
258315901677;258315902271;594;4;1;2;1;1;1
258315902271;258315975149;72878;-1;0;-1;0;1;1
258315975149;258315975751;602;4;1;2;1;1;1
258315975751;258316021287;45536;-1;0;-1;0;1;1
258316021287;258316021907;620;4;1;2;1;1;1
258316021907;258316082772;60865;-1;0;-1;0;1;1
258316082772;258316083391;619;4;1;2;1;1;1
258316083391;258316125766;42375;-1;0;-1;0;1;1
258316125766;258316126369;603;4;1;2;1;1;1
258316126369;258316180178;53809;-1;0;-1;0;1;1
258316180178;258316180740;562;4;1;2;1;1;1
258316180740;258316219079;38339;-1;0;-1;0;1;1
258316219079;258316219641;562;4;1;2;1;1;1
258316219641;258316267249;47608;-1;0;-1;0;1;1
258316267249;258316267847;598;4;1;2;1;1;1
258316267847;258316354875;87028;-1;0;-1;0;1;1
258316354875;258316356629;1754;4;1;2;1;1;1
258316356629;258316396401;39772;-1;0;-1;0;1;1
258316396401;258316396923;522;4;1;2;1;1;1
258316396923;258316429948;33025;-1;0;-1;0;1;1
258316429948;258316431901;1953;4;1;2;1;1;1
258316431901;258316467029;35128;-1;0;-1;0;1;1
258316467029;258316467544;515;4;1;2;1;1;1
258316467544;258316510694;43150;-1;0;-1;0;1;1
258316510694;258316511331;637;4;1;2;1;1;1
258316511331;258316612203;100872;-1;0;-1;0;1;1
258316612203;258316612671;468;4;1;2;1;1;1
258316612671;258316674620;61949;-1;0;-1;0;1;1
258316674620;258316675170;550;4;1;2;1;1;1
258316675170;258316719194;44024;-1;0;-1;0;1;1
258316719194;258316719750;556;4;1;2;1;1;1
258316719750;258316805918;86168;-1;0;-1;0;1;1
258316805918;258316806464;546;4;1;2;1;1;1
258316806464;258316844492;38028;-1;0;-1;0;1;1
258316844492;258316845880;1388;4;1;2;1;1;1
258316845880;258316894662;48782;-1;0;-1;0;1;1
258316894662;258316895187;525;4;1;2;1;1;1
258316895187;258316934107;38920;-1;0;-1;0;1;1
258316934107;258316934705;598;4;1;2;1;1;1
258316934705;258316934749;44;4;1;2;1;1;1
258316934749;258316935458;709;4;1;2;1;1;1
258316935458;258316976813;41355;-1;0;-1;0;1;1
258316976813;258316977367;554;4;1;2;1;1;1
258316977367;258317027307;49940;-1;0;-1;0;1;1
258317027307;258317027826;519;4;1;2;1;1;1
258317027826;258317101193;73367;-1;0;-1;0;1;1
258317101193;258317101796;603;4;1;2;1;1;1
258317101796;258317134393;32597;-1;0;-1;0;1;1
258317134393;258317135950;1557;4;1;2;1;1;1
258317135950;258317144256;8306;-1;0;-1;0;1;1
258317144256;258317144802;546;4;1;2;1;1;1
258317144802;258317178448;33646;-1;0;-1;0;1;1
258317178448;258317178900;452;4;1;2;1;1;1
258317178900;258317268567;89667;-1;0;-1;0;1;1
258317268567;258317269103;536;4;1;2;1;1;1
258317269103;258317341270;72167;-1;0;-1;0;1;1
258317341270;258317341791;521;4;1;2;1;1;1
258317341791;258317441215;99424;-1;0;-1;0;1;1
258317441215;258317441677;462;4;1;2;1;1;1
258317441677;258317474508;32831;-1;0;-1;0;1;1
258317474508;258317475047;539;4;1;2;1;1;1
258317475047;258317543545;68498;-1;0;-1;0;1;1
258317543545;258317544654;1109;4;1;2;1;1;1
258317544654;258317630159;85505;-1;0;-1;0;1;1
258317630159;258317630623;464;4;1;2;1;1;1
258317630623;258317631224;601;-1;0;-1;0;1;1
258317631224;258317631787;563;4;1;2;1;1;1
258317631787;258317679597;47810;-1;0;-1;0;1;1
258317679597;258317680319;722;4;1;2;1;1;1
258317680319;258317680947;628;-1;0;-1;0;1;1
258317680947;258317681779;832;4;1;2;1;1;1
258317681779;258317747133;65354;-1;0;-1;0;1;1
258317747133;258317749195;2062;4;1;2;1;1;1
258317749195;258317778114;28919;-1;0;-1;0;1;1
258317778114;258317779546;1432;4;1;2;1;1;1
258317779546;258317831811;52265;-1;0;-1;0;1;1
258317831811;258317832548;737;4;1;2;1;1;1
258317832548;258317842340;9792;-1;0;-1;0;1;1
258317842340;258317842883;543;4;1;2;1;1;1
258317842883;258317893462;50579;-1;0;-1;0;1;1
258317893462;258317894276;814;4;1;2;1;1;1
258317894276;258317973251;78975;-1;0;-1;0;1;1
258317973251;258317974143;892;4;1;2;1;1;1
258317974143;258317974971;828;-1;0;-1;0;1;1
258317974971;258317977000;2029;4;1;2;1;1;1
258317977000;258318018954;41954;-1;0;-1;0;1;1
258318018954;258318019412;458;4;1;2;1;1;1
258318019412;258318056821;37409;-1;0;-1;0;1;1
258318056821;258318058160;1339;4;1;2;1;1;1
258318058160;258318113954;55794;-1;0;-1;0;1;1
258318113954;258318114582;628;4;1;2;1;1;1
258318114582;258318160693;46111;-1;0;-1;0;1;1
258318160693;258318161451;758;4;1;2;1;1;1
258318161451;258318201273;39822;-1;0;-1;0;1;1
258318201273;258318201878;605;4;1;2;1;1;1
258318201878;258318264975;63097;-1;0;-1;0;1;1
258318264975;258318265570;595;4;1;2;1;1;1
258318265570;258318311947;46377;-1;0;-1;0;1;1
258318311947;258318312502;555;4;1;2;1;1;1
258318312502;258318357147;44645;-1;0;-1;0;1;1
258318357147;258318357658;511;4;1;2;1;1;1
258318357658;258318372948;15290;-1;0;-1;0;1;1
258318372948;258318373616;668;4;1;2;1;1;1
258318373616;258318425362;51746;-1;0;-1;0;1;1
258318425362;258318426631;1269;4;1;2;1;1;1
258318426631;258318471244;44613;-1;0;-1;0;1;1
258318471244;258318471790;546;4;1;2;1;1;1
258318471790;258318516895;45105;-1;0;-1;0;1;1
258318516895;258318517645;750;4;1;2;1;1;1
258318517645;258318567602;49957;-1;0;-1;0;1;1
258318567602;258318569547;1945;4;1;2;1;1;1
258318569547;258318628675;59128;-1;0;-1;0;1;1
258318628675;258318629299;624;4;1;2;1;1;1
258318629299;258318674729;45430;-1;0;-1;0;1;1
258318674729;258318675251;522;4;1;2;1;1;1
258318675251;258318704997;29746;-1;0;-1;0;1;1
258318704997;258318705629;632;4;1;2;1;1;1
258318705629;258318754917;49288;-1;0;-1;0;1;1
258318754917;258318755423;506;4;1;2;1;1;1
258318755423;258318828728;73305;-1;0;-1;0;1;1
258318828728;258318834468;5740;4;1;2;1;1;1
258318834468;258318835151;683;4;1;2;1;1;1
258318835151;258318835944;793;4;1;2;1;1;1
258318835944;258318863042;27098;-1;0;-1;0;1;1
258318863042;258318864179;1137;4;1;2;1;1;1
258318864179;258318864632;453;-1;0;-1;0;1;1
258318864632;258318866339;1707;4;1;2;1;1;1
258318866339;258318908094;41755;-1;0;-1;0;1;1
258318908094;258318909220;1126;4;1;2;1;1;1
258318909220;258318909318;98;-1;0;-1;0;1;1
258318909318;258318910054;736;4;1;2;1;1;1
258318910054;258318910354;300;4;1;2;1;1;1
258318910354;258318910806;452;4;1;2;1;1;1
258318910806;258318933795;22989;-1;0;-1;0;1;1
258318933795;258318934474;679;4;1;2;1;1;1
258318934474;258318953977;19503;-1;0;-1;0;1;1
258318953977;258318954604;627;4;1;2;1;1;1
258318954604;258318981245;26641;-1;0;-1;0;1;1
258318981245;258318981850;605;4;1;2;1;1;1
258318981850;258318982873;1023;-1;0;-1;0;1;1
258318982873;258318983423;550;4;1;2;1;1;1
258318983423;258319032280;48857;-1;0;-1;0;1;1
258319032280;258319033522;1242;4;1;2;1;1;1
258319033522;258319034859;1337;-1;0;-1;0;1;1
258319034859;258319037944;3085;4;1;2;1;1;1
258319037944;258319096258;58314;-1;0;-1;0;1;1
258319096258;258319096853;595;4;1;2;1;1;1
258319096853;258319181241;84388;-1;0;-1;0;1;1
258319181241;258319181775;534;4;1;2;1;1;1
258319181775;258319222559;40784;-1;0;-1;0;1;1
258319222559;258319223105;546;4;1;2;1;1;1
258319223105;258319320666;97561;-1;0;-1;0;1;1
258319320666;258319321577;911;4;1;2;1;1;1
258319321577;258319359556;37979;-1;0;-1;0;1;1
258319359556;258319360482;926;4;1;2;1;1;1
258319360482;258319389221;28739;-1;0;-1;0;1;1
258319389221;258319390137;916;4;1;2;1;1;1
258319390137;258319430673;40536;-1;0;-1;0;1;1
258319430673;258319431920;1247;4;1;2;1;1;1
258319431920;258319483651;51731;-1;0;-1;0;1;1
258319483651;258319484501;850;4;1;2;1;1;1
258319484501;258319525432;40931;-1;0;-1;0;1;1
258319525432;258319525956;524;4;1;2;1;1;1
258319525956;258319578915;52959;-1;0;-1;0;1;1
258319578915;258319580862;1947;4;1;2;1;1;1
258319580862;258319638231;57369;-1;0;-1;0;1;1
258319638231;258319638819;588;4;1;2;1;1;1
258319638819;258319639023;204;4;1;2;1;1;1
258319639023;258319639585;562;4;1;2;1;1;1
258319639585;258319679421;39836;-1;0;-1;0;1;1
258319679421;258319680270;849;4;1;2;1;1;1
258319680270;258319708170;27900;-1;0;-1;0;1;1
258319708170;258319708996;826;4;1;2;1;1;1
258319708996;258319766306;57310;-1;0;-1;0;1;1
258319766306;258319767258;952;4;1;2;1;1;1
258319767258;258319830935;63677;-1;0;-1;0;1;1
258319830935;258319832434;1499;4;1;2;1;1;1
258319832434;258319841487;9053;-1;0;-1;0;1;1
258319841487;258319842030;543;4;1;2;1;1;1
258319842030;258319941421;99391;-1;0;-1;0;1;1
258319941421;258319942234;813;4;1;2;1;1;1
258319942234;258319942398;164;-1;0;-1;0;1;1
258319942398;258319943416;1018;4;1;2;1;1;1
258319943416;258319991937;48521;-1;0;-1;0;1;1
258319991937;258319993142;1205;4;1;2;1;1;1
258319993142;258320024787;31645;-1;0;-1;0;1;1
258320024787;258320025410;623;4;1;2;1;1;1
258320025410;258320110817;85407;-1;0;-1;0;1;1
258320110817;258320111341;524;4;1;2;1;1;1
258320111341;258320167820;56479;-1;0;-1;0;1;1
258320167820;258320170095;2275;4;1;2;1;1;1
258320170095;258320270126;100031;-1;0;-1;0;1;1
258320270126;258320270622;496;4;1;2;1;1;1
258320270622;258320292762;22140;-1;0;-1;0;1;1
258320292762;258320293268;506;4;1;2;1;1;1
258320293268;258320294171;903;4;1;2;1;1;1
258320294171;258320294625;454;4;1;2;1;1;1
258320294625;258320295672;1047;-1;0;-1;0;1;1
258320295672;258320296564;892;4;1;2;1;1;1
258320296564;258320297819;1255;-1;0;-1;0;1;1
258320297819;258320299367;1548;4;1;2;1;1;1
258320299367;258320358193;58826;-1;0;-1;0;1;1
258320358193;258320358815;622;4;1;2;1;1;1
258320358815;258320401521;42706;-1;0;-1;0;1;1
258320401521;258320402051;530;4;1;2;1;1;1
258320402051;258320428943;26892;-1;0;-1;0;1;1
258320428943;258320429405;462;4;1;2;1;1;1
258320429405;258320466364;36959;-1;0;-1;0;1;1
258320466364;258320467364;1000;4;1;2;1;1;1
258320467364;258320535711;68347;-1;0;-1;0;1;1
258320535711;258320537064;1353;4;1;2;1;1;1
258320537064;258320639697;102633;-1;0;-1;0;1;1
258320639697;258320640364;667;4;1;2;1;1;1
258320640364;258320693349;52985;-1;0;-1;0;1;1
258320693349;258320694292;943;4;1;2;1;1;1
258320694292;258320703869;9577;-1;0;-1;0;1;1
258320703869;258320704393;524;4;1;2;1;1;1
258320704393;258320745970;41577;-1;0;-1;0;1;1
258320745970;258320746505;535;4;1;2;1;1;1
258320746505;258320805478;58973;-1;0;-1;0;1;1
258320805478;258320806023;545;4;1;2;1;1;1
258320806023;258320880748;74725;-1;0;-1;0;1;1
258320880748;258320883108;2360;4;1;2;1;1;1
258320883108;258320902395;19287;-1;0;-1;0;1;1
258320902395;258320903027;632;4;1;2;1;1;1
258320903027;258320951317;48290;-1;0;-1;0;1;1
258320951317;258320951844;527;4;1;2;1;1;1
258320951844;258321004898;53054;-1;0;-1;0;1;1
258321004898;258321005359;461;4;1;2;1;1;1
258321005359;258321075723;70364;-1;0;-1;0;1;1
258321075723;258321076276;553;4;1;2;1;1;1
258321076276;258321111392;35116;-1;0;-1;0;1;1
258321111392;258321112344;952;4;1;2;1;1;1
258321112344;258321161156;48812;-1;0;-1;0;1;1
258321161156;258321161803;647;4;1;2;1;1;1
258321161803;258321204043;42240;-1;0;-1;0;1;1
258321204043;258321204667;624;4;1;2;1;1;1
258321204667;258321243950;39283;-1;0;-1;0;1;1
258321243950;258321244574;624;4;1;2;1;1;1
258321244574;258321288393;43819;-1;0;-1;0;1;1
258321288393;258321288957;564;4;1;2;1;1;1
258321288957;258321337394;48437;-1;0;-1;0;1;1
258321337394;258321338067;673;4;1;2;1;1;1
258321338067;258321381451;43384;-1;0;-1;0;1;1
258321381451;258321381918;467;4;1;2;1;1;1
258321381918;258321480851;98933;-1;0;-1;0;1;1
258321480851;258321481511;660;4;1;2;1;1;1
258321481511;258321539345;57834;-1;0;-1;0;1;1
258321539345;258321539879;534;4;1;2;1;1;1
258321539879;258321600251;60372;-1;0;-1;0;1;1
258321600251;258321601256;1005;4;1;2;1;1;1
258321601256;258321660389;59133;-1;0;-1;0;1;1
258321660389;258321661004;615;4;1;2;1;1;1
258321661004;258321707271;46267;-1;0;-1;0;1;1
258321707271;258321707873;602;4;1;2;1;1;1
258321707873;258321778689;70816;-1;0;-1;0;1;1
258321778689;258321779308;619;4;1;2;1;1;1
258321779308;258321812793;33485;-1;0;-1;0;1;1
258321812793;258321813336;543;4;1;2;1;1;1
258321813336;258321893321;79985;-1;0;-1;0;1;1
258321893321;258321893782;461;4;1;2;1;1;1
258321893782;258321925455;31673;-1;0;-1;0;1;1
258321925455;258321926075;620;4;1;2;1;1;1
258321926075;258321971889;45814;-1;0;-1;0;1;1
258321971889;258321972443;554;4;1;2;1;1;1
258321972443;258322061326;88883;-1;0;-1;0;1;1
258322061326;258322061858;532;4;1;2;1;1;1
258322061858;258322099410;37552;-1;0;-1;0;1;1
258322099410;258322100157;747;4;1;2;1;1;1
258322100157;258322150664;50507;-1;0;-1;0;1;1
258322150664;258322159679;9015;4;1;2;1;1;1
258322159679;258322222041;62362;-1;0;-1;0;1;1
258322222041;258322222725;684;4;1;2;1;1;1
258322222725;258322223379;654;-1;0;-1;0;1;1
258322223379;258322223977;598;4;1;2;1;1;1
258322223977;258322254542;30565;-1;0;-1;0;1;1
258322254542;258322255003;461;4;1;2;1;1;1
258322255003;258322308890;53887;-1;0;-1;0;1;1
258322308890;258322309435;545;4;1;2;1;1;1
258322309435;258322349155;39720;-1;0;-1;0;1;1
258322349155;258322349687;532;4;1;2;1;1;1
258322349687;258322437548;87861;-1;0;-1;0;1;1
258322437548;258322438555;1007;4;1;2;1;1;1
258322438555;258322509055;70500;-1;0;-1;0;1;1
258322509055;258322509622;567;4;1;2;1;1;1
258322509622;258322553712;44090;-1;0;-1;0;1;1
258322553712;258322554178;466;4;1;2;1;1;1
258322554178;258322590983;36805;-1;0;-1;0;1;1
258322590983;258322592491;1508;4;1;2;1;1;1
258322592491;258322648033;55542;-1;0;-1;0;1;1
258322648033;258322648576;543;4;1;2;1;1;1
258322648576;258322689791;41215;-1;0;-1;0;1;1
258322689791;258322691206;1415;4;1;2;1;1;1
258322691206;258322752552;61346;-1;0;-1;0;1;1
258322752552;258322753951;1399;4;1;2;1;1;1
258322753951;258322754131;180;-1;0;-1;0;1;1
258322754131;258322754917;786;4;1;2;1;1;1
258322754917;258322802068;47151;-1;0;-1;0;1;1
258322802068;258322803614;1546;4;1;2;1;1;1
258322803614;258322858900;55286;-1;0;-1;0;1;1
258322858900;258322862045;3145;4;1;2;1;1;1
258322862045;258322900542;38497;-1;0;-1;0;1;1
258322900542;258322901305;763;4;1;2;1;1;1
258322901305;258322901687;382;-1;0;-1;0;1;1
258322901687;258322902602;915;4;1;2;1;1;1
258322902602;258322929562;26960;-1;0;-1;0;1;1
258322929562;258322930171;609;4;1;2;1;1;1
258322930171;258323019216;89045;-1;0;-1;0;1;1
258323019216;258323022764;3548;4;1;2;1;1;1
258323022764;258323022825;61;4;1;2;1;1;1
258323022825;258323023407;582;4;1;2;1;1;1
258323023407;258323053375;29968;-1;0;-1;0;1;1
258323053375;258323054228;853;4;1;2;1;1;1
258323054228;258323242877;188649;-1;0;-1;0;1;1
258323242877;258323244025;1148;4;1;2;1;1;1
258323244025;258323288791;44766;-1;0;-1;0;1;1
258323288791;258323289388;597;4;1;2;1;1;1
258323289388;258323346797;57409;-1;0;-1;0;1;1
258323346797;258323350009;3212;4;1;2;1;1;1
258323350009;258323401394;51385;-1;0;-1;0;1;1
258323401394;258323401963;569;4;1;2;1;1;1
258323401963;258323403840;1877;-1;0;-1;0;1;1
258323403840;258323404386;546;4;1;2;1;1;1
258323404386;258323463276;58890;-1;0;-1;0;1;1
258323463276;258323463774;498;4;1;2;1;1;1
258323463774;258323535255;71481;-1;0;-1;0;1;1
258323535255;258323535934;679;4;1;2;1;1;1
258323535934;258323557983;22049;-1;0;-1;0;1;1
258323557983;258323558625;642;4;1;2;1;1;1
258323558625;258323560823;2198;4;1;2;1;1;1
258323560823;258323566112;5289;4;1;2;1;1;1
258323566112;258323620930;54818;-1;0;-1;0;1;1
258323620930;258323621494;564;4;1;2;1;1;1
258323621494;258323670871;49377;-1;0;-1;0;1;1
258323670871;258323672053;1182;4;1;2;1;1;1
258323672053;258323714779;42726;-1;0;-1;0;1;1
258323714779;258323715480;701;4;1;2;1;1;1
258323715480;258323752974;37494;-1;0;-1;0;1;1
258323752974;258323753594;620;4;1;2;1;1;1
258323753594;258323765562;11968;-1;0;-1;0;1;1
258323765562;258323772913;7351;4;1;2;1;1;1
258323772913;258323786412;13499;-1;0;-1;0;1;1
258323786412;258323787635;1223;4;1;2;1;1;1
258323787635;258323817951;30316;-1;0;-1;0;1;1
258323817951;258323818570;619;4;1;2;1;1;1
258323818570;258323882439;63869;-1;0;-1;0;1;1
258323882439;258323882967;528;4;1;2;1;1;1
258323882967;258323903037;20070;-1;0;-1;0;1;1
258323903037;258323903660;623;4;1;2;1;1;1
258323903660;258323905454;1794;-1;0;-1;0;1;1
258323905454;258323906076;622;4;1;2;1;1;1
258323906076;258323906941;865;-1;0;-1;0;1;1
258323906941;258323907410;469;4;1;2;1;1;1
258323907410;258323976891;69481;-1;0;-1;0;1;1
258323976891;258323977483;592;4;1;2;1;1;1
258323977483;258323998746;21263;-1;0;-1;0;1;1
258323998746;258323999298;552;4;1;2;1;1;1
258323999298;258324072893;73595;-1;0;-1;0;1;1
258324072893;258324073458;565;4;1;2;1;1;1
258324073458;258324130813;57355;-1;0;-1;0;1;1
258324130813;258324131429;616;4;1;2;1;1;1
258324131429;258324156285;24856;-1;0;-1;0;1;1
258324156285;258324156822;537;4;1;2;1;1;1
258324156822;258324246181;89359;-1;0;-1;0;1;1
258324246181;258324246902;721;4;1;2;1;1;1
258324246902;258324291827;44925;-1;0;-1;0;1;1
258324291827;258324293564;1737;4;1;2;1;1;1
258324293564;258324330353;36789;-1;0;-1;0;1;1
258324330353;258324330979;626;4;1;2;1;1;1
258324330979;258324393953;62974;-1;0;-1;0;1;1
258324393953;258324394769;816;4;1;2;1;1;1
258324394769;258324432252;37483;-1;0;-1;0;1;1
258324432252;258324436401;4149;4;1;2;1;1;1
258324436401;258324495480;59079;-1;0;-1;0;1;1
258324495480;258324495982;502;4;1;2;1;1;1
258324495982;258324519489;23507;-1;0;-1;0;1;1
258324519489;258324520053;564;4;1;2;1;1;1
258324520053;258324532322;12269;-1;0;-1;0;1;1
258324532322;258324532815;493;4;1;2;1;1;1
258324532815;258324578850;46035;-1;0;-1;0;1;1
258324578850;258324579541;691;4;1;2;1;1;1
258324579541;258324725836;146295;-1;0;-1;0;1;1
258324725836;258324727222;1386;4;1;2;1;1;1
258324727222;258324768695;41473;-1;0;-1;0;1;1
258324768695;258324769558;863;4;1;2;1;1;1
258324769558;258324809361;39803;-1;0;-1;0;1;1
258324809361;258324810104;743;4;1;2;1;1;1
258324810104;258324872850;62746;-1;0;-1;0;1;1
258324872850;258324873324;474;4;1;2;1;1;1
258324873324;258324929753;56429;-1;0;-1;0;1;1
258324929753;258324930545;792;4;1;2;1;1;1
258324930545;258324971878;41333;-1;0;-1;0;1;1
258324971878;258324972751;873;4;1;2;1;1;1
258324972751;258325026049;53298;-1;0;-1;0;1;1
258325026049;258325026788;739;4;1;2;1;1;1
258325026788;258325195923;169135;-1;0;-1;0;1;1
258325195923;258325198632;2709;4;1;2;1;1;1
258325198632;258325199098;466;4;1;2;1;1;1
258325199098;258325202854;3756;4;1;2;1;1;1
258325202854;258325255696;52842;-1;0;-1;0;1;1
258325255696;258325256368;672;4;1;2;1;1;1
258325256368;258325305357;48989;-1;0;-1;0;1;1
258325305357;258325307170;1813;4;1;2;1;1;1
258325307170;258325330704;23534;-1;0;-1;0;1;1
258325330704;258325331391;687;4;1;2;1;1;1
258325331391;258325389978;58587;-1;0;-1;0;1;1
258325389978;258325391257;1279;4;1;2;1;1;1
258325391257;258325392787;1530;-1;0;-1;0;1;1
258325392787;258325394186;1399;4;1;2;1;1;1
258325394186;258325434155;39969;-1;0;-1;0;1;1
258325434155;258325434903;748;4;1;2;1;1;1
258325434903;258325443626;8723;-1;0;-1;0;1;1
258325443626;258325444993;1367;4;1;2;1;1;1
258325444993;258325446054;1061;-1;0;-1;0;1;1
258325446054;258325446661;607;4;1;2;1;1;1
258325446661;258325496435;49774;-1;0;-1;0;1;1
258325496435;258325496484;49;4;1;2;1;1;1
258325496484;258325497029;545;4;1;2;1;1;1
258325497029;258325497660;631;4;1;2;1;1;1
258325497660;258325541816;44156;-1;0;-1;0;1;1
258325541816;258325542350;534;4;1;2;1;1;1
258325542350;258325585372;43022;-1;0;-1;0;1;1
258325585372;258325585889;517;4;1;2;1;1;1
258325585889;258325595263;9374;-1;0;-1;0;1;1
258325595263;258325595758;495;4;1;2;1;1;1
258325595758;258325639574;43816;-1;0;-1;0;1;1
258325639574;258325640549;975;4;1;2;1;1;1
258325640549;258325697028;56479;-1;0;-1;0;1;1
258325697028;258325698517;1489;4;1;2;1;1;1
258325698517;258325739478;40961;-1;0;-1;0;1;1
258325739478;258325740047;569;4;1;2;1;1;1
258325740047;258325782515;42468;-1;0;-1;0;1;1
258325782515;258325782979;464;4;1;2;1;1;1
258325782979;258325828616;45637;-1;0;-1;0;1;1
258325828616;258325829169;553;4;1;2;1;1;1
258325829169;258325869717;40548;-1;0;-1;0;1;1
258325869717;258325870599;882;4;1;2;1;1;1
258325870599;258325913885;43286;-1;0;-1;0;1;1
258325913885;258325914356;471;4;1;2;1;1;1
258325914356;258325957166;42810;-1;0;-1;0;1;1
258325957166;258325963000;5834;4;1;2;1;1;1
258325963000;258326009152;46152;-1;0;-1;0;1;1
258326009152;258326009799;647;4;1;2;1;1;1
258326009799;258326020789;10990;-1;0;-1;0;1;1
258326020789;258326021436;647;4;1;2;1;1;1
258326021436;258326065430;43994;-1;0;-1;0;1;1
258326065430;258326065984;554;4;1;2;1;1;1
258326065984;258326091380;25396;-1;0;-1;0;1;1
258326091380;258326094848;3468;4;1;2;1;1;1
258326094848;258326130460;35612;-1;0;-1;0;1;1
258326130460;258326131087;627;4;1;2;1;1;1
258326131087;258326173445;42358;-1;0;-1;0;1;1
258326173445;258326174067;622;4;1;2;1;1;1
258326174067;258326215561;41494;-1;0;-1;0;1;1
258326215561;258326216189;628;4;1;2;1;1;1
258326216189;258326366718;150529;-1;0;-1;0;1;1
258326366718;258326369366;2648;4;1;2;1;1;1
258326369366;258326404739;35373;-1;0;-1;0;1;1
258326404739;258326405289;550;4;1;2;1;1;1
258326405289;258326440882;35593;-1;0;-1;0;1;1
258326440882;258326441424;542;4;1;2;1;1;1
258326441424;258326486753;45329;-1;0;-1;0;1;1
258326486753;258326487277;524;4;1;2;1;1;1
258326487277;258326521010;33733;-1;0;-1;0;1;1
258326521010;258326521565;555;4;1;2;1;1;1
258326521565;258326531441;9876;-1;0;-1;0;1;1
258326531441;258326532062;621;4;1;2;1;1;1
258326532062;258326598121;66059;-1;0;-1;0;1;1
258326598121;258326598689;568;4;1;2;1;1;1
258326598689;258326641541;42852;-1;0;-1;0;1;1
258326641541;258326642005;464;4;1;2;1;1;1
258326642005;258326721177;79172;-1;0;-1;0;1;1
258326721177;258326723095;1918;4;1;2;1;1;1
258326723095;258326866181;143086;-1;0;-1;0;1;1
258326866181;258326874137;7956;4;1;2;1;1;1
258326874137;258326910463;36326;-1;0;-1;0;1;1
258326910463;258326910936;473;4;1;2;1;1;1
258326910936;258326996443;85507;-1;0;-1;0;1;1
258326996443;258326997071;628;4;1;2;1;1;1
258326997071;258327033834;36763;-1;0;-1;0;1;1
258327033834;258327034555;721;4;1;2;1;1;1
258327034555;258327044630;10075;-1;0;-1;0;1;1
258327044630;258327045164;534;4;1;2;1;1;1
258327045164;258327106314;61150;-1;0;-1;0;1;1
258327106314;258327106987;673;4;1;2;1;1;1
258327106987;258327117306;10319;-1;0;-1;0;1;1
258327117306;258327117770;464;4;1;2;1;1;1
258327117770;258327235098;117328;-1;0;-1;0;1;1
258327235098;258327236544;1446;4;1;2;1;1;1
258327236544;258327263045;26501;-1;0;-1;0;1;1
258327263045;258327265064;2019;4;1;2;1;1;1
258327265064;258327384701;119637;-1;0;-1;0;1;1
258327384701;258327385322;621;4;1;2;1;1;1
258327385322;258327454659;69337;-1;0;-1;0;1;1
258327454659;258327455562;903;4;1;2;1;1;1
258327455562;258327468615;13053;-1;0;-1;0;1;1
258327468615;258327469858;1243;4;1;2;1;1;1
258327469858;258327484575;14717;-1;0;-1;0;1;1
258327484575;258327485381;806;4;1;2;1;1;1
258327485381;258327567158;81777;-1;0;-1;0;1;1
258327567158;258327567790;632;4;1;2;1;1;1
258327567790;258327579189;11399;-1;0;-1;0;1;1
258327579189;258327580210;1021;4;1;2;1;1;1
258327580210;258327638437;58227;-1;0;-1;0;1;1
258327638437;258327642136;3699;4;1;2;1;1;1
258327642136;258327720526;78390;-1;0;-1;0;1;1
258327720526;258327721170;644;4;1;2;1;1;1
258327721170;258327722864;1694;-1;0;-1;0;1;1
258327722864;258327727647;4783;4;1;2;1;1;1
258327727647;258327760683;33036;-1;0;-1;0;1;1
258327760683;258327761428;745;4;1;2;1;1;1
258327761428;258327841953;80525;-1;0;-1;0;1;1
258327841953;258327843888;1935;4;1;2;1;1;1
258327843888;258327881021;37133;-1;0;-1;0;1;1
258327881021;258327881579;558;4;1;2;1;1;1
258327881579;258327927490;45911;-1;0;-1;0;1;1
258327927490;258327928279;789;4;1;2;1;1;1
258327928279;258327928633;354;4;1;2;1;1;1
258327928633;258327930475;1842;4;1;2;1;1;1
258327930475;258327935998;5523;-1;0;-1;0;1;1
258327935998;258327936549;551;4;1;2;1;1;1
258327936549;258327948583;12034;-1;0;-1;0;1;1
258327948583;258327949125;542;4;1;2;1;1;1
258327949125;258327988117;38992;-1;0;-1;0;1;1
258327988117;258327988750;633;4;1;2;1;1;1
258327988750;258328019567;30817;-1;0;-1;0;1;1
258328019567;258328020122;555;4;1;2;1;1;1
258328020122;258328067548;47426;-1;0;-1;0;1;1
258328067548;258328068097;549;4;1;2;1;1;1
258328068097;258328117353;49256;-1;0;-1;0;1;1
258328117353;258328119146;1793;4;1;2;1;1;1
258328119146;258328155469;36323;-1;0;-1;0;1;1
258328155469;258328155970;501;4;1;2;1;1;1
258328155970;258328200608;44638;-1;0;-1;0;1;1
258328200608;258328200612;4;4;1;2;1;1;1
258328200612;258328201093;481;4;1;2;1;1;1
258328201093;258328201181;88;4;1;2;1;1;1
258328201181;258328253700;52519;-1;0;-1;0;1;1
258328253700;258328255307;1607;4;1;2;1;1;1
258328255307;258328261887;6580;-1;0;-1;0;1;1
258328261887;258328270172;8285;4;1;2;1;1;1
258328270172;258328336242;66070;-1;0;-1;0;1;1
258328336242;258328336763;521;4;1;2;1;1;1
258328336763;258328446843;110080;-1;0;-1;0;1;1
258328446843;258328449819;2976;4;1;2;1;1;1
258328449819;258328482471;32652;-1;0;-1;0;1;1
258328482471;258328484962;2491;4;1;2;1;1;1
258328484962;258328492293;7331;-1;0;-1;0;1;1
258328492293;258328494869;2576;4;1;2;1;1;1
258328494869;258328598806;103937;-1;0;-1;0;1;1
258328598806;258328599376;570;4;1;2;1;1;1
258328599376;258328648552;49176;-1;0;-1;0;1;1
258328648552;258328649048;496;4;1;2;1;1;1
258328649048;258328697886;48838;-1;0;-1;0;1;1
258328697886;258328698445;559;4;1;2;1;1;1
258328698445;258328753264;54819;-1;0;-1;0;1;1
258328753264;258328753724;460;4;1;2;1;1;1
258328753724;258328804830;51106;-1;0;-1;0;1;1
258328804830;258328805508;678;4;1;2;1;1;1
258328805508;258328879070;73562;-1;0;-1;0;1;1
258328879070;258328879603;533;4;1;2;1;1;1
258328879603;258328892174;12571;-1;0;-1;0;1;1
258328892174;258328893402;1228;4;1;2;1;1;1
258328893402;258328936517;43115;-1;0;-1;0;1;1
258328936517;258328937013;496;4;1;2;1;1;1
258328937013;258328949857;12844;-1;0;-1;0;1;1
258328949857;258328950484;627;4;1;2;1;1;1
258328950484;258328984244;33760;-1;0;-1;0;1;1
258328984244;258328984772;528;4;1;2;1;1;1
258328984772;258329011933;27161;-1;0;-1;0;1;1
258329011933;258329012464;531;4;1;2;1;1;1
258329012464;258329013259;795;-1;0;-1;0;1;1
258329013259;258329013814;555;4;1;2;1;1;1
258329013814;258329072501;58687;-1;0;-1;0;1;1
258329072501;258329073108;607;4;1;2;1;1;1
258329073108;258329132289;59181;-1;0;-1;0;1;1
258329132289;258329133681;1392;4;1;2;1;1;1
258329133681;258329201365;67684;-1;0;-1;0;1;1
258329201365;258329201984;619;4;1;2;1;1;1
258329201984;258329252994;51010;-1;0;-1;0;1;1
258329252994;258329253663;669;4;1;2;1;1;1
258329253663;258329253879;216;4;1;2;1;1;1
258329253879;258329254277;398;4;1;2;1;1;1
258329254277;258329307843;53566;-1;0;-1;0;1;1
258329307843;258329308603;760;4;1;2;1;1;1
258329308603;258329309391;788;-1;0;-1;0;1;1
258329309391;258329311554;2163;4;1;2;1;1;1
258329311554;258329311562;8;4;1;2;1;1;1
258329311562;258329313233;1671;4;1;2;1;1;1
258329313233;258329313767;534;-1;0;-1;0;1;1
258329313767;258329314361;594;4;1;2;1;1;1
258329314361;258329314494;133;-1;0;-1;0;1;1
258329314494;258329315230;736;4;1;2;1;1;1
258329315230;258329336156;20926;-1;0;-1;0;1;1
258329336156;258329337062;906;4;1;2;1;1;1
258329337062;258329407562;70500;-1;0;-1;0;1;1
258329407562;258329408501;939;4;1;2;1;1;1
258329408501;258329409290;789;-1;0;-1;0;1;1
258329409290;258329414469;5179;4;1;2;1;1;1
258329414469;258329436649;22180;-1;0;-1;0;1;1
258329436649;258329437096;447;4;1;2;1;1;1
258329437096;258329437204;108;4;1;2;1;1;1
258329437204;258329438248;1044;4;1;2;1;1;1
258329438248;258329475891;37643;-1;0;-1;0;1;1
258329475891;258329476713;822;4;1;2;1;1;1
258329476713;258329491295;14582;-1;0;-1;0;1;1
258329491295;258329491948;653;4;1;2;1;1;1
258329491948;258329557053;65105;-1;0;-1;0;1;1
258329557053;258329557655;602;4;1;2;1;1;1
258329557655;258329557737;82;-1;0;-1;0;1;1
258329557737;258329558586;849;4;1;2;1;1;1
258329558586;258329596494;37908;-1;0;-1;0;1;1
258329596494;258329597183;689;4;1;2;1;1;1
258329597183;258329649231;52048;-1;0;-1;0;1;1
258329649231;258329650152;921;4;1;2;1;1;1
258329650152;258329651328;1176;-1;0;-1;0;1;1
258329651328;258329651965;637;4;1;2;1;1;1
258329651965;258329678607;26642;-1;0;-1;0;1;1
258329678607;258329679173;566;4;1;2;1;1;1
258329679173;258329716219;37046;-1;0;-1;0;1;1
258329716219;258329716748;529;4;1;2;1;1;1
258329716748;258329748028;31280;-1;0;-1;0;1;1
258329748028;258329748579;551;4;1;2;1;1;1
258329748579;258329794398;45819;-1;0;-1;0;1;1
258329794398;258329795088;690;4;1;2;1;1;1
258329795088;258329845775;50687;-1;0;-1;0;1;1
258329845775;258329846303;528;4;1;2;1;1;1
258329846303;258329935854;89551;-1;0;-1;0;1;1
258329935854;258329936388;534;4;1;2;1;1;1
258329936388;258329976147;39759;-1;0;-1;0;1;1
258329976147;258329976764;617;4;1;2;1;1;1
258329976764;258330100529;123765;-1;0;-1;0;1;1
258330100529;258330101323;794;4;1;2;1;1;1
258330101323;258330184621;83298;-1;0;-1;0;1;1
258330184621;258330191150;6529;4;1;2;1;1;1
258330191150;258330211276;20126;-1;0;-1;0;1;1
258330211276;258330212292;1016;4;1;2;1;1;1
258330212292;258330213341;1049;-1;0;-1;0;1;1
258330213341;258330214102;761;4;1;2;1;1;1
258330214102;258330221736;7634;-1;0;-1;0;1;1
258330221736;258330222633;897;4;1;2;1;1;1
258330222633;258330267174;44541;-1;0;-1;0;1;1
258330267174;258330268729;1555;4;1;2;1;1;1
258330268729;258330301850;33121;-1;0;-1;0;1;1
258330301850;258330302347;497;4;1;2;1;1;1
258330302347;258330319128;16781;-1;0;-1;0;1;1
258330319128;258330319682;554;4;1;2;1;1;1
258330319682;258330354160;34478;-1;0;-1;0;1;1
258330354160;258330354704;544;4;1;2;1;1;1
258330354704;258330463038;108334;-1;0;-1;0;1;1
258330463038;258330464137;1099;4;1;2;1;1;1
258330464137;258330513585;49448;-1;0;-1;0;1;1
258330513585;258330514055;470;4;1;2;1;1;1
258330514055;258330601513;87458;-1;0;-1;0;1;1
258330601513;258330602037;524;4;1;2;1;1;1
258330602037;258330622417;20380;-1;0;-1;0;1;1
258330622417;258330623034;617;4;1;2;1;1;1
258330623034;258330708864;85830;-1;0;-1;0;1;1
258330708864;258330709495;631;4;1;2;1;1;1
258330709495;258330764085;54590;-1;0;-1;0;1;1
258330764085;258330764613;528;4;1;2;1;1;1
258330764613;258330800944;36331;-1;0;-1;0;1;1
258330800944;258330801475;531;4;1;2;1;1;1
258330801475;258330853318;51843;-1;0;-1;0;1;1
258330853318;258330854405;1087;4;1;2;1;1;1
258330854405;258330876071;21666;-1;0;-1;0;1;1
258330876071;258330876627;556;4;1;2;1;1;1
258330876627;258330923934;47307;-1;0;-1;0;1;1
258330923934;258330925049;1115;4;1;2;1;1;1
258330925049;258330959319;34270;-1;0;-1;0;1;1
258330959319;258330960876;1557;4;1;2;1;1;1
258330960876;258330961368;492;4;1;2;1;1;1
258330961368;258330961758;390;4;1;2;1;1;1
258330961758;258331005351;43593;-1;0;-1;0;1;1
258331005351;258331005883;532;4;1;2;1;1;1
258331005883;258331006330;447;-1;0;-1;0;1;1
258331006330;258331006886;556;4;1;2;1;1;1
258331006886;258331056695;49809;-1;0;-1;0;1;1
258331056695;258331057452;757;4;1;2;1;1;1
258331057452;258331105354;47902;-1;0;-1;0;1;1
258331105354;258331106138;784;4;1;2;1;1;1
258331106138;258331191208;85070;-1;0;-1;0;1;1
258331191208;258331191894;686;4;1;2;1;1;1
258331191894;258331249519;57625;-1;0;-1;0;1;1
258331249519;258331250151;632;4;1;2;1;1;1
258331250151;258331294374;44223;-1;0;-1;0;1;1
258331294374;258331294999;625;4;1;2;1;1;1
258331294999;258331309123;14124;-1;0;-1;0;1;1
258331309123;258331309960;837;4;1;2;1;1;1
258331309960;258331349557;39597;-1;0;-1;0;1;1
258331349557;258331350181;624;4;1;2;1;1;1
258331350181;258331410765;60584;-1;0;-1;0;1;1
258331410765;258331415973;5208;4;1;2;1;1;1
258331415973;258331432865;16892;-1;0;-1;0;1;1
258331432865;258331433410;545;4;1;2;1;1;1
258331433410;258331484732;51322;-1;0;-1;0;1;1
258331484732;258331485256;524;4;1;2;1;1;1
258331485256;258331610792;125536;-1;0;-1;0;1;1
258331610792;258331611331;539;4;1;2;1;1;1
258331611331;258331620692;9361;-1;0;-1;0;1;1
258331620692;258331621824;1132;4;1;2;1;1;1
258331621824;258331672951;51127;-1;0;-1;0;1;1
258331672951;258331673588;637;4;1;2;1;1;1
258331673588;258331712644;39056;-1;0;-1;0;1;1
258331712644;258331714517;1873;4;1;2;1;1;1
258331714517;258331760311;45794;-1;0;-1;0;1;1
258331760311;258331760943;632;4;1;2;1;1;1
258331760943;258331848297;87354;-1;0;-1;0;1;1
258331848297;258331849583;1286;4;1;2;1;1;1
258331849583;258331853830;4247;-1;0;-1;0;1;1
258331853830;258331855898;2068;4;1;2;1;1;1
258331855898;258331900873;44975;-1;0;-1;0;1;1
258331900873;258331901153;280;4;1;2;1;1;1
258331901153;258331901779;626;4;1;2;1;1;1
258331901779;258331902491;712;4;1;2;1;1;1
258331902491;258331915944;13453;-1;0;-1;0;1;1
258331915944;258331916441;497;4;1;2;1;1;1
258331916441;258331976831;60390;-1;0;-1;0;1;1
258331976831;258331977889;1058;4;1;2;1;1;1
258331977889;258332070559;92670;-1;0;-1;0;1;1
258332070559;258332071642;1083;4;1;2;1;1;1
258332071642;258332135076;63434;-1;0;-1;0;1;1
258332135076;258332137934;2858;4;1;2;1;1;1
258332137934;258332188787;50853;-1;0;-1;0;1;1
258332188787;258332193149;4362;4;1;2;1;1;1
258332193149;258332197729;4580;-1;0;-1;0;1;1
258332197729;258332198354;625;4;1;2;1;1;1
258332198354;258332262818;64464;-1;0;-1;0;1;1
258332262818;258332263278;460;4;1;2;1;1;1
258332263278;258332273914;10636;-1;0;-1;0;1;1
258332273914;258332274442;528;4;1;2;1;1;1
258332274442;258332320222;45780;-1;0;-1;0;1;1
258332320222;258332321070;848;4;1;2;1;1;1
258332321070;258332338620;17550;-1;0;-1;0;1;1
258332338620;258332343367;4747;4;1;2;1;1;1
258332343367;258332363393;20026;-1;0;-1;0;1;1
258332363393;258332363860;467;4;1;2;1;1;1
258332363860;258332422703;58843;-1;0;-1;0;1;1
258332422703;258332425876;3173;4;1;2;1;1;1
258332425876;258332436890;11014;-1;0;-1;0;1;1
258332436890;258332437671;781;4;1;2;1;1;1
258332437671;258332527809;90138;-1;0;-1;0;1;1
258332527809;258332528336;527;4;1;2;1;1;1
258332528336;258332529225;889;-1;0;-1;0;1;1
258332529225;258332529896;671;4;1;2;1;1;1
258332529896;258332577606;47710;-1;0;-1;0;1;1
258332577606;258332578225;619;4;1;2;1;1;1
258332578225;258332595715;17490;-1;0;-1;0;1;1
258332595715;258332596264;549;4;1;2;1;1;1
258332596264;258332642455;46191;-1;0;-1;0;1;1
258332642455;258332643081;626;4;1;2;1;1;1
258332643081;258332678925;35844;-1;0;-1;0;1;1
258332678925;258332679386;461;4;1;2;1;1;1
258332679386;258332698513;19127;-1;0;-1;0;1;1
258332698513;258332699143;630;4;1;2;1;1;1
258332699143;258332799992;100849;-1;0;-1;0;1;1
258332799992;258332800625;633;4;1;2;1;1;1
258332800625;258332821756;21131;-1;0;-1;0;1;1
258332821756;258332822589;833;4;1;2;1;1;1
258332822589;258332876690;54101;-1;0;-1;0;1;1
258332876690;258332877322;632;4;1;2;1;1;1
258332877322;258332921271;43949;-1;0;-1;0;1;1
258332921271;258332921807;536;4;1;2;1;1;1
258332921807;258332947437;25630;-1;0;-1;0;1;1
258332947437;258332948001;564;4;1;2;1;1;1
258332948001;258333010993;62992;-1;0;-1;0;1;1
258333010993;258333011536;543;4;1;2;1;1;1
258333011536;258333171108;159572;-1;0;-1;0;1;1
258333171108;258333171717;609;4;1;2;1;1;1
258333171717;258333213514;41797;-1;0;-1;0;1;1
258333213514;258333214149;635;4;1;2;1;1;1
258333214149;258333223685;9536;-1;0;-1;0;1;1
258333223685;258333224784;1099;4;1;2;1;1;1
258333224784;258333262228;37444;-1;0;-1;0;1;1
258333262228;258333262789;561;4;1;2;1;1;1
258333262789;258333311032;48243;-1;0;-1;0;1;1
258333311032;258333311672;640;4;1;2;1;1;1
258333311672;258333377674;66002;-1;0;-1;0;1;1
258333377674;258333381148;3474;4;1;2;1;1;1
258333381148;258333381413;265;4;1;2;1;1;1
258333381413;258333381900;487;4;1;2;1;1;1
258333381900;258333382899;999;-1;0;-1;0;1;1
258333382899;258333383574;675;4;1;2;1;1;1
258333383574;258333384130;556;-1;0;-1;0;1;1
258333384130;258333384600;470;4;1;2;1;1;1
258333384600;258333425261;40661;-1;0;-1;0;1;1
258333425261;258333425889;628;4;1;2;1;1;1
258333425889;258333485072;59183;-1;0;-1;0;1;1
258333485072;258333485619;547;4;1;2;1;1;1
258333485619;258333520603;34984;-1;0;-1;0;1;1
258333520603;258333521255;652;4;1;2;1;1;1
258333521255;258333537946;16691;-1;0;-1;0;1;1
258333537946;258333538480;534;4;1;2;1;1;1
258333538480;258333626337;87857;-1;0;-1;0;1;1
258333626337;258333626833;496;4;1;2;1;1;1
258333626833;258333639556;12723;-1;0;-1;0;1;1
258333639556;258333640083;527;4;1;2;1;1;1
258333640083;258333649223;9140;-1;0;-1;0;1;1
258333649223;258333649723;500;4;1;2;1;1;1
258333649723;258333687395;37672;-1;0;-1;0;1;1
258333687395;258333687943;548;4;1;2;1;1;1
258333687943;258333767635;79692;-1;0;-1;0;1;1
258333767635;258333768167;532;4;1;2;1;1;1
258333768167;258333808049;39882;-1;0;-1;0;1;1
258333808049;258333808574;525;4;1;2;1;1;1
258333808574;258333808886;312;-1;0;-1;0;1;1
258333808886;258333809461;575;4;1;2;1;1;1
258333809461;258333893453;83992;-1;0;-1;0;1;1
258333893453;258333894010;557;4;1;2;1;1;1
258333894010;258333932009;37999;-1;0;-1;0;1;1
258333932009;258333932640;631;4;1;2;1;1;1
258333932640;258333942689;10049;-1;0;-1;0;1;1
258333942689;258333943238;549;4;1;2;1;1;1
258333943238;258333981554;38316;-1;0;-1;0;1;1
258333981554;258333983179;1625;4;1;2;1;1;1
258333983179;258333984451;1272;-1;0;-1;0;1;1
258333984451;258333984976;525;4;1;2;1;1;1
258333984976;258334023355;38379;-1;0;-1;0;1;1
258334023355;258334023991;636;4;1;2;1;1;1
258334023991;258334060815;36824;-1;0;-1;0;1;1
258334060815;258334061488;673;4;1;2;1;1;1
258334061488;258334071333;9845;-1;0;-1;0;1;1
258334071333;258334071863;530;4;1;2;1;1;1
258334071863;258334110151;38288;-1;0;-1;0;1;1
258334110151;258334110713;562;4;1;2;1;1;1
258334110713;258334150534;39821;-1;0;-1;0;1;1
258334150534;258334151483;949;4;1;2;1;1;1
258334151483;258334184757;33274;-1;0;-1;0;1;1
258334184757;258334185364;607;4;1;2;1;1;1
258334185364;258334224693;39329;-1;0;-1;0;1;1
258334224693;258334225329;636;4;1;2;1;1;1
258334225329;258334246384;21055;-1;0;-1;0;1;1
258334246384;258334247062;678;4;1;2;1;1;1
258334247062;258334279336;32274;-1;0;-1;0;1;1
258334279336;258334279907;571;4;1;2;1;1;1
258334279907;258334291074;11167;-1;0;-1;0;1;1
258334291074;258334291630;556;4;1;2;1;1;1
258334291630;258334319810;28180;-1;0;-1;0;1;1
258334319810;258334320569;759;4;1;2;1;1;1
258334320569;258334354342;33773;-1;0;-1;0;1;1
258334354342;258334355790;1448;4;1;2;1;1;1
258334355790;258334452339;96549;-1;0;-1;0;1;1
258334452339;258334453452;1113;4;1;2;1;1;1
258334453452;258334497129;43677;-1;0;-1;0;1;1
258334497129;258334497677;548;4;1;2;1;1;1
258334497677;258334531100;33423;-1;0;-1;0;1;1
258334531100;258334531653;553;4;1;2;1;1;1
258334531653;258334575838;44185;-1;0;-1;0;1;1
258334575838;258334576473;635;4;1;2;1;1;1
258334576473;258334617234;40761;-1;0;-1;0;1;1
258334617234;258334617781;547;4;1;2;1;1;1
258334617781;258334656155;38374;-1;0;-1;0;1;1
258334656155;258334656838;683;4;1;2;1;1;1
258334656838;258334696805;39967;-1;0;-1;0;1;1
258334696805;258334697432;627;4;1;2;1;1;1
258334697432;258334744409;46977;-1;0;-1;0;1;1
258334744409;258334744937;528;4;1;2;1;1;1
258334744937;258334753007;8070;-1;0;-1;0;1;1
258334753007;258334754919;1912;4;1;2;1;1;1
258334754919;258334785447;30528;-1;0;-1;0;1;1
258334785447;258334786074;627;4;1;2;1;1;1
258334786074;258334819731;33657;-1;0;-1;0;1;1
258334819731;258334820197;466;4;1;2;1;1;1
258334820197;258334837494;17297;-1;0;-1;0;1;1
258334837494;258334838127;633;4;1;2;1;1;1
258334838127;258334887731;49604;-1;0;-1;0;1;1
258334887731;258334888370;639;4;1;2;1;1;1
258334888370;258334942840;54470;-1;0;-1;0;1;1
258334942840;258334943477;637;4;1;2;1;1;1
258334943477;258334977189;33712;-1;0;-1;0;1;1
258334977189;258334977820;631;4;1;2;1;1;1
258334977820;258334994952;17132;-1;0;-1;0;1;1
258334994952;258334995476;524;4;1;2;1;1;1
258334995476;258335006362;10886;-1;0;-1;0;1;1
258335006362;258335006987;625;4;1;2;1;1;1
258335006987;258335119099;112112;-1;0;-1;0;1;1
258335119099;258335119578;479;4;1;2;1;1;1
258335119578;258335240258;120680;-1;0;-1;0;1;1
258335240258;258335241414;1156;4;1;2;1;1;1
258335241414;258335264927;23513;-1;0;-1;0;1;1
258335264927;258335267626;2699;4;1;2;1;1;1
258335267626;258335268092;466;4;1;2;1;1;1
258335268092;258335268265;173;4;1;2;1;1;1
258335268265;258335394170;125905;-1;0;-1;0;1;1
258335394170;258335394724;554;4;1;2;1;1;1
258335394724;258335413159;18435;-1;0;-1;0;1;1
258335413159;258335413644;485;4;1;2;1;1;1
258335413644;258335420086;6442;-1;0;-1;0;1;1
258335420086;258335420700;614;4;1;2;1;1;1
258335420700;258335452091;31391;-1;0;-1;0;1;1
258335452091;258335452770;679;4;1;2;1;1;1
258335452770;258335461546;8776;-1;0;-1;0;1;1
258335461546;258335462095;549;4;1;2;1;1;1
258335462095;258335488278;26183;-1;0;-1;0;1;1
258335488278;258335488747;469;4;1;2;1;1;1
258335488747;258335499365;10618;-1;0;-1;0;1;1
258335499365;258335499834;469;4;1;2;1;1;1
258335499834;258335529841;30007;-1;0;-1;0;1;1
258335529841;258335530370;529;4;1;2;1;1;1
258335530370;258335577594;47224;-1;0;-1;0;1;1
258335577594;258335578053;459;4;1;2;1;1;1
258335578053;258335608903;30850;-1;0;-1;0;1;1
258335608903;258335609600;697;4;1;2;1;1;1
258335609600;258335685141;75541;-1;0;-1;0;1;1
258335685141;258335685995;854;4;1;2;1;1;1
258335685995;258335694076;8081;-1;0;-1;0;1;1
258335694076;258335697959;3883;4;1;2;1;1;1
258335697959;258335728864;30905;-1;0;-1;0;1;1
258335728864;258335729491;627;4;1;2;1;1;1
258335729491;258335840089;110598;-1;0;-1;0;1;1
258335840089;258335840620;531;4;1;2;1;1;1
258335840620;258335854578;13958;-1;0;-1;0;1;1
258335854578;258335855131;553;4;1;2;1;1;1
258335855131;258335895488;40357;-1;0;-1;0;1;1
258335895488;258335896013;525;4;1;2;1;1;1
258335896013;258335923592;27579;-1;0;-1;0;1;1
258335923592;258335924236;644;4;1;2;1;1;1
258335924236;258335934037;9801;-1;0;-1;0;1;1
258335934037;258335935127;1090;4;1;2;1;1;1
258335935127;258335972960;37833;-1;0;-1;0;1;1
258335972960;258335973517;557;4;1;2;1;1;1
258335973517;258336001626;28109;-1;0;-1;0;1;1
258336001626;258336002192;566;4;1;2;1;1;1
258336002192;258336017514;15322;-1;0;-1;0;1;1
258336017514;258336019209;1695;4;1;2;1;1;1
258336019209;258336019920;711;-1;0;-1;0;1;1
258336019920;258336020444;524;4;1;2;1;1;1
258336020444;258336055872;35428;-1;0;-1;0;1;1
258336055872;258336056363;491;4;1;2;1;1;1
258336056363;258336097143;40780;-1;0;-1;0;1;1
258336097143;258336097678;535;4;1;2;1;1;1
258336097678;258336155838;58160;-1;0;-1;0;1;1
258336155838;258336156468;630;4;1;2;1;1;1
258336156468;258336299506;143038;-1;0;-1;0;1;1
258336299506;258336299949;443;4;1;2;1;1;1
258336299949;258336338083;38134;-1;0;-1;0;1;1
258336338083;258336338718;635;4;1;2;1;1;1
258336338718;258336371185;32467;-1;0;-1;0;1;1
258336371185;258336372964;1779;4;1;2;1;1;1
258336372964;258336380788;7824;-1;0;-1;0;1;1
258336380788;258336381421;633;4;1;2;1;1;1
258336381421;258336402847;21426;-1;0;-1;0;1;1
258336402847;258336403410;563;4;1;2;1;1;1
258336403410;258336412439;9029;-1;0;-1;0;1;1
258336412439;258336414665;2226;4;1;2;1;1;1
258336414665;258336474151;59486;-1;0;-1;0;1;1
258336474151;258336474783;632;4;1;2;1;1;1
258336474783;258336509447;34664;-1;0;-1;0;1;1
258336509447;258336510061;614;4;1;2;1;1;1
258336510061;258336512028;1967;-1;0;-1;0;1;1
258336512028;258336513027;999;4;1;2;1;1;1
258336513027;258336513138;111;-1;0;-1;0;1;1
258336513138;258336514340;1202;4;1;2;1;1;1
258336514340;258336550415;36075;-1;0;-1;0;1;1
258336550415;258336551443;1028;4;1;2;1;1;1
258336551443;258336610458;59015;-1;0;-1;0;1;1
258336610458;258336611142;684;4;1;2;1;1;1
258336611142;258336683299;72157;-1;0;-1;0;1;1
258336683299;258336683848;549;4;1;2;1;1;1
258336683848;258336713558;29710;-1;0;-1;0;1;1
258336713558;258336714027;469;4;1;2;1;1;1
258336714027;258337082364;368337;-1;0;-1;0;1;1
258337082364;258337082867;503;4;1;2;1;1;1
258337082867;258337083854;987;-1;0;-1;0;1;1
258337083854;258337084480;626;4;1;2;1;1;1
258337084480;258337163760;79280;-1;0;-1;0;1;1
258337163760;258337163776;16;4;1;2;1;1;1
258337163776;258337164611;835;4;1;2;1;1;1
258337164611;258337165076;465;4;1;2;1;1;1
258337165076;258337221909;56833;-1;0;-1;0;1;1
258337221909;258337222373;464;4;1;2;1;1;1
258337222373;258337277177;54804;-1;0;-1;0;1;1
258337277177;258337278179;1002;4;1;2;1;1;1
258337278179;258337313734;35555;-1;0;-1;0;1;1
258337313734;258337316125;2391;4;1;2;1;1;1
258337316125;258337327493;11368;-1;0;-1;0;1;1
258337327493;258337330396;2903;4;1;2;1;1;1
258337330396;258337360577;30181;-1;0;-1;0;1;1
258337360577;258337361213;636;4;1;2;1;1;1
258337361213;258337407250;46037;-1;0;-1;0;1;1
258337407250;258337407742;492;4;1;2;1;1;1
258337407742;258337438141;30399;-1;0;-1;0;1;1
258337438141;258337438697;556;4;1;2;1;1;1
258337438697;258337454034;15337;-1;0;-1;0;1;1
258337454034;258337454661;627;4;1;2;1;1;1
258337454661;258337530319;75658;-1;0;-1;0;1;1
258337530319;258337530509;190;4;1;2;1;1;1
258337530509;258337530846;337;4;1;2;1;1;1
258337530846;258337531139;293;4;1;2;1;1;1
258337531139;258337569881;38742;-1;0;-1;0;1;1
258337569881;258337570706;825;4;1;2;1;1;1
258337570706;258337604974;34268;-1;0;-1;0;1;1
258337604974;258337605613;639;4;1;2;1;1;1
258337605613;258337686880;81267;-1;0;-1;0;1;1
258337686880;258337687374;494;4;1;2;1;1;1
258337687374;258337726076;38702;-1;0;-1;0;1;1
258337726076;258337726708;632;4;1;2;1;1;1
258337726708;258337738220;11512;-1;0;-1;0;1;1
258337738220;258337738859;639;4;1;2;1;1;1
258337738859;258337761848;22989;-1;0;-1;0;1;1
258337761848;258337765733;3885;4;1;2;1;1;1
258337765733;258337776434;10701;-1;0;-1;0;1;1
258337776434;258337776956;522;4;1;2;1;1;1
258337776956;258337818194;41238;-1;0;-1;0;1;1
258337818194;258337818885;691;4;1;2;1;1;1
258337818885;258337819039;154;4;1;2;1;1;1
258337819039;258337819978;939;4;1;2;1;1;1
258337819978;258337879480;59502;-1;0;-1;0;1;1
258337879480;258337880101;621;4;1;2;1;1;1
258337880101;258337880826;725;-1;0;-1;0;1;1
258337880826;258337881450;624;4;1;2;1;1;1
258337881450;258337938452;57002;-1;0;-1;0;1;1
258337938452;258337939165;713;4;1;2;1;1;1
258337939165;258337957390;18225;-1;0;-1;0;1;1
258337957390;258337957952;562;4;1;2;1;1;1
258337957952;258338094818;136866;-1;0;-1;0;1;1
258338094818;258338095446;628;4;1;2;1;1;1
258338095446;258338131913;36467;-1;0;-1;0;1;1
258338131913;258338132535;622;4;1;2;1;1;1
258338132535;258338138820;6285;-1;0;-1;0;1;1
258338138820;258338141280;2460;4;1;2;1;1;1
258338141280;258338174390;33110;-1;0;-1;0;1;1
258338174390;258338174887;497;4;1;2;1;1;1
258338174887;258338211670;36783;-1;0;-1;0;1;1
258338211670;258338212300;630;4;1;2;1;1;1
258338212300;258338231342;19042;-1;0;-1;0;1;1
258338231342;258338231958;616;4;1;2;1;1;1
258338231958;258338345261;113303;-1;0;-1;0;1;1
258338345261;258338346126;865;4;1;2;1;1;1
258338346126;258338347059;933;-1;0;-1;0;1;1
258338347059;258338350457;3398;4;1;2;1;1;1
258338350457;258338396541;46084;-1;0;-1;0;1;1
258338396541;258338397003;462;4;1;2;1;1;1
258338397003;258338397441;438;-1;0;-1;0;1;1
258338397441;258338397972;531;4;1;2;1;1;1
258338397972;258338437576;39604;-1;0;-1;0;1;1
258338437576;258338438162;586;4;1;2;1;1;1
258338438162;258338447835;9673;-1;0;-1;0;1;1
258338447835;258338448975;1140;4;1;2;1;1;1
258338448975;258338479883;30908;-1;0;-1;0;1;1
258338479883;258338480361;478;4;1;2;1;1;1
258338480361;258338489538;9177;-1;0;-1;0;1;1
258338489538;258338490156;618;4;1;2;1;1;1
258338490156;258338491586;1430;-1;0;-1;0;1;1
258338491586;258338492113;527;4;1;2;1;1;1
258338492113;258338493711;1598;-1;0;-1;0;1;1
258338493711;258338494248;537;4;1;2;1;1;1
258338494248;258338543217;48969;-1;0;-1;0;1;1
258338543217;258338543703;486;4;1;2;1;1;1
258338543703;258338582666;38963;-1;0;-1;0;1;1
258338582666;258338583664;998;4;1;2;1;1;1
258338583664;258338683671;100007;-1;0;-1;0;1;1
258338683671;258338684327;656;4;1;2;1;1;1
258338684327;258338719416;35089;-1;0;-1;0;1;1
258338719416;258338723679;4263;4;1;2;1;1;1
258338723679;258338729258;5579;-1;0;-1;0;1;1
258338729258;258338729894;636;4;1;2;1;1;1
258338729894;258338786372;56478;-1;0;-1;0;1;1
258338786372;258338786919;547;4;1;2;1;1;1
258338786919;258338812152;25233;-1;0;-1;0;1;1
258338812152;258338812887;735;4;1;2;1;1;1
258338812887;258338853936;41049;-1;0;-1;0;1;1
258338853936;258338854476;540;4;1;2;1;1;1
258338854476;258338870398;15922;-1;0;-1;0;1;1
258338870398;258338871094;696;4;1;2;1;1;1
258338871094;258338871729;635;-1;0;-1;0;1;1
258338871729;258338872368;639;4;1;2;1;1;1
258338872368;258338873116;748;-1;0;-1;0;1;1
258338873116;258338873743;627;4;1;2;1;1;1
258338873743;258338884482;10739;-1;0;-1;0;1;1
258338884482;258338892257;7775;4;1;2;1;1;1
258338892257;258338993919;101662;-1;0;-1;0;1;1
258338993919;258338994471;552;4;1;2;1;1;1
258338994471;258339051610;57139;-1;0;-1;0;1;1
258339051610;258339052489;879;4;1;2;1;1;1
258339052489;258339053189;700;-1;0;-1;0;1;1
258339053189;258339054846;1657;4;1;2;1;1;1
258339054846;258339068256;13410;-1;0;-1;0;1;1
258339068256;258339068879;623;4;1;2;1;1;1
258339068879;258339100308;31429;-1;0;-1;0;1;1
258339100308;258339100942;634;4;1;2;1;1;1
258339100942;258339101251;309;-1;0;-1;0;1;1
258339101251;258339101717;466;4;1;2;1;1;1
258339101717;258339119641;17924;-1;0;-1;0;1;1
258339119641;258339120631;990;4;1;2;1;1;1
258339120631;258339134957;14326;-1;0;-1;0;1;1
258339134957;258339135963;1006;4;1;2;1;1;1
258339135963;258339137552;1589;-1;0;-1;0;1;1
258339137552;258339138332;780;4;1;2;1;1;1
258339138332;258339221137;82805;-1;0;-1;0;1;1
258339221137;258339221589;452;4;1;2;1;1;1
258339221589;258339229509;7920;-1;0;-1;0;1;1
258339229509;258339233232;3723;4;1;2;1;1;1
258339233232;258339236800;3568;-1;0;-1;0;1;1
258339236800;258339237982;1182;4;1;2;1;1;1
258339237982;258339262426;24444;-1;0;-1;0;1;1
258339262426;258339266730;4304;4;1;2;1;1;1
258339266730;258339272290;5560;-1;0;-1;0;1;1
258339272290;258339272814;524;4;1;2;1;1;1
258339272814;258339279301;6487;-1;0;-1;0;1;1
258339279301;258339281501;2200;4;1;2;1;1;1
258339281501;258339333928;52427;-1;0;-1;0;1;1
258339333928;258339345227;11299;4;1;2;1;1;1
258339345227;258339345830;603;4;1;2;1;1;1
258339345830;258339345996;166;4;1;2;1;1;1
258339345996;258339346809;813;4;1;2;1;1;1
258339346809;258339350496;3687;4;1;2;1;1;1
258339350496;258339396306;45810;-1;0;-1;0;1;1
258339396306;258339396769;463;4;1;2;1;1;1
258339396769;258339418149;21380;-1;0;-1;0;1;1
258339418149;258339418681;532;4;1;2;1;1;1
258339418681;258339420702;2021;4;1;2;1;1;1
258339420702;258339432686;11984;4;1;2;1;1;1
258339432686;258339438779;6093;4;1;2;1;1;1
258339438779;258339453215;14436;4;1;2;1;1;1
258339453215;258457559852;118106637;-1;0;-1;0;1;1
258457559852;258508445810;50885958;1;1;0;1;1;1
258508445810;258538549043;30103233;-1;0;-1;0;1;1
258538549043;258615967409;77418366;0;1;7;1;1;1
258615967409;258779767176;163799767;-1;0;-1;0;1;1
258779767176;258788453866;8686690;0;1;1;1;1;1
258788453866;258812249650;23795784;0;1;1,8;2;1;1
258812249650;258814211978;1962328;0;1;1,4,8;3;1;1
258814211978;258814283876;71898;0;1;4,8;2;1;1
258814283876;258859722022;45438146;0;1;4;1;1;1
258859722022;259114809668;255087646;-1;0;-1;0;1;1
259114809668;259176146629;61336961;1;1;10;1;1;1
259176146629;259506038879;329892250;-1;0;-1;0;1;1
259506038879;259546984259;40945380;1;1;4;1;1;1
259546984259;259556667121;9682862;0,1;2;4,7;2;1;1
259556667121;259624419159;67752038;0;1;7;1;1;1
259624419159;260556844179;932425020;-1;0;-1;0;1;1
260556844179;260634047663;77203484;0;1;7;1;1;1
260634047663;260735258712;101211049;-1;0;-1;0;1;1
260735258712;260778737586;43478874;1;1;8;1;1;1
260778737586;261202488151;423750565;-1;0;-1;0;1;1
261202488151;261202489250;1099;4;1;11;1;1;1
261202489250;261202491866;2616;-1;0;-1;0;1;1
261202491866;261202495204;3338;1;1;11;1;1;1
261202495204;261202764139;268935;-1;0;-1;0;1;1
261202764139;261230973977;28209838;8;1;11;1;1;1
261230973977;261564190620;333216643;-1;0;-1;0;1;1
261564190620;261641620618;77429998;0;1;7;1;1;1
261641620618;262296170660;654550042;-1;0;-1;0;1;1
262296170660;262354571012;58400352;1;1;1;1;1;1
262354571012;262773352176;418781164;-1;0;-1;0;1;1
262773352176;262773353270;1094;4;1;11;1;1;1
262773353270;262773355587;2317;-1;0;-1;0;1;1
262773355587;262773358863;3276;1;1;11;1;1;1
262773358863;262773658921;300058;-1;0;-1;0;1;1
262773658921;262802693632;29034711;8;1;11;1;1;1
