start;end;duration;phases;nphases;jobs;njobs;days;ndays
3763;3771;8;0,1;2;0;1;1;1
3771;3776;5;0,1,2,3;4;0,1;2;1;1
3776;3781;5;0,1,3;3;0,1;2;1;1
3781;3786;5;1,3;2;0,1;2;1;1
3786;3796;10;1,4,5,6;4;0,1;2;1;1
3796;3801;5;1,6;2;0,1;2;1;1
3801;3811;10;6;1;1;1;1;1
3811;3902;91;-1;0;-1;0;1;1
3902;3905;3;0,1,2,3;4;0,1;2;1;1
3905;3919;14;0,1,2,3,7;5;0,1;2;1;1
3919;3930;11;2,3,7;3;1;1;1;1
3930;3935;5;3,7;2;1;1;1;1
3935;3940;5;3;1;1;1;1;1
