start;end;duration;jobs;njobs;days;ndays
258076315092;258076471280;156188;2,9;2;1;1
258076471280;258076477640;6360;2,9;2;1;1
258076477640;258076478560;920;2,9;2;1;1
258076478560;258076488487;9927;2,9;2;1;1
258076488487;258076489141;654;2,9;2;1;1
258076489141;258076491009;1868;2,9;2;1;1
258076491009;258076496214;5205;2,9;2;1;1
258076496214;258076512102;15888;2,9;2;1;1
258076512102;258076521833;9731;2,9;2;1;1
258076521833;258076521922;89;2,9;2;1;1
258076521922;258076538172;16250;2,9;2;1;1
258076538172;258076543139;4967;2,9;2;1;1
258076543139;258076552291;9152;2,9;2;1;1
258076552291;258076571287;18996;2,9;2;1;1
258076571287;258076623060;51773;2,9;2;1;1
258076623060;258076624678;1618;2,9;2;1;1
258076624678;258076629470;4792;2,9;2;1;1
258076629470;258076635743;6273;2,9;2;1;1
258076635743;258076637221;1478;2,9;2;1;1
258076637221;258076650662;13441;2,9;2;1;1
258076650662;258076652008;1346;2,9;2;1;1
258076652008;258076660761;8753;2,9;2;1;1
258076660761;258076663472;2711;2,9;2;1;1
258076663472;258076664036;564;2,9;2;1;1
258076664036;258076669006;4970;2,9;2;1;1
258076669006;258076669080;74;2,9;2;1;1
258076669080;258076670329;1249;2,9;2;1;1
258076670329;258076670733;404;2,9;2;1;1
258076670733;258076671520;787;2,9;2;1;1
258076671520;258076713430;41910;2,9;2;1;1
258076713430;258076720107;6677;2,9;2;1;1
258076720107;258076720674;567;2,9;2;1;1
258076720674;258076734323;13649;2,9;2;1;1
258076734323;258076734975;652;2,9;2;1;1
258076734975;258076749051;14076;2,9;2;1;1
258076749051;258076767303;18252;2,9;2;1;1
258076767303;258076775950;8647;2,9;2;1;1
258076775950;258076786230;10280;2,9;2;1;1
258076786230;258076801643;15413;2,9;2;1;1
258076801643;258076821542;19899;2,9;2;1;1
258076821542;258076822028;486;2,9;2;1;1
258076822028;258076823620;1592;2,9;2;1;1
258076823620;258076829556;5936;2,9;2;1;1
258076829556;258076830042;486;2,9;2;1;1
258076830042;258076852354;22312;2,9;2;1;1
258076852354;258076855072;2718;2,9;2;1;1
258076855072;258076855561;489;2,9;2;1;1
258076855561;258076889594;34033;2,9;2;1;1
258076889594;258076901113;11519;2,9;2;1;1
258076901113;258076908297;7184;2,9;2;1;1
258076908297;258076908981;684;2,9;2;1;1
258076908981;258076967056;58075;2,9;2;1;1
258076967056;258076997379;30323;2,9;2;1;1
258076997379;258077008032;10653;2,9;2;1;1
258077008032;258077021264;13232;2,9;2;1;1
258077021264;258077053838;32574;2,9;2;1;1
258077053838;258077056427;2589;2,9;2;1;1
258077056427;258077056925;498;2,9;2;1;1
258077056925;258077074302;17377;2,9;2;1;1
258077074302;258077074782;480;2,9;2;1;1
258077074782;258077074913;131;2,9;2;1;1
258077074913;258077086167;11254;2,9;2;1;1
258077086167;258077098836;12669;2,9;2;1;1
258077098836;258077112303;13467;2,9;2;1;1
258077112303;258077113011;708;2,9;2;1;1
258077113011;258077127690;14679;2,9;2;1;1
258077127690;258077128171;481;2,9;2;1;1
258077128171;258077133431;5260;2,9;2;1;1
258077133431;258077138502;5071;2,9;2;1;1
258077138502;258077180794;42292;2,9;2;1;1
258077180794;258077197642;16848;2,9;2;1;1
258077197642;258077198271;629;2,9;2;1;1
258077198271;258077205863;7592;2,9;2;1;1
258077205863;258077225806;19943;2,9;2;1;1
258077225806;258077246518;20712;2,9;2;1;1
258077246518;258077250828;4310;2,9;2;1;1
258077250828;258077260863;10035;2,9;2;1;1
258077260863;258077261344;481;2,9;2;1;1
258077261344;258077273023;11679;2,9;2;1;1
258077273023;258077302833;29810;2,9;2;1;1
258077302833;258077303457;624;2,9;2;1;1
258077303457;258077305933;2476;2,9;2;1;1
258077305933;258077309913;3980;2,9;2;1;1
258077309913;258077310403;490;2,9;2;1;1
258077310403;258077311409;1006;2,9;2;1;1
258077311409;258077321510;10101;2,9;2;1;1
258077321510;258077346217;24707;2,9;2;1;1
258077346217;258077359236;13019;2,9;2;1;1
258077359236;258077388708;29472;2,9;2;1;1
258077388708;258077405121;16413;2,9;2;1;1
258077405121;258077405922;801;2,9;2;1;1
258077405922;258077409207;3285;2,9;2;1;1
258077409207;258077413165;3958;2,9;2;1;1
258077413165;258077413556;391;2,9;2;1;1
258077413556;258077413673;117;2,9;2;1;1
258077413673;258077414034;361;2,9;2;1;1
258077414034;258077430940;16906;2,9;2;1;1
258077430940;258077442555;11615;2,9;2;1;1
258077442555;258077463460;20905;2,9;2;1;1
258077463460;258077463946;486;2,9;2;1;1
258077463946;258077472772;8826;2,9;2;1;1
258077472772;258077485621;12849;2,9;2;1;1
258077485621;258077496314;10693;2,9;2;1;1
258077496314;258077496830;516;2,9;2;1;1
258077496830;258077497711;881;2,9;2;1;1
258077497711;258077498205;494;2,9;2;1;1
258077498205;258077505524;7319;2,9;2;1;1
258077505524;258077527043;21519;2,9;2;1;1
258077527043;258077556947;29904;2,9;2;1;1
258077556947;258077579941;22994;2,9;2;1;1
258077579941;258077582605;2664;2,9;2;1;1
258077582605;258077583093;488;2,9;2;1;1
258077583093;258077614904;31811;2,9;2;1;1
258077614904;258077636317;21413;2,9;2;1;1
258077636317;258077638710;2393;2,9;2;1;1
258077638710;258077639191;481;2,9;2;1;1
258077639191;258077661834;22643;2,9;2;1;1
258077661834;258077689139;27305;2,9;2;1;1
258077689139;258077696472;7333;2,9;2;1;1
258077696472;258077710303;13831;2,9;2;1;1
258077710303;258077711151;848;2,9;2;1;1
258077711151;258077715881;4730;2,9;2;1;1
258077715881;258077744077;28196;2,9;2;1;1
258077744077;258077758516;14439;2,9;2;1;1
258077758516;258077759169;653;2,9;2;1;1
258077759169;258077770138;10969;2,9;2;1;1
258077770138;258077770622;484;2,9;2;1;1
258077770622;258077771917;1295;2,9;2;1;1
258077771917;258077791778;19861;2,9;2;1;1
258077791778;258077815418;23640;2,9;2;1;1
258077815418;258077835982;20564;2,9;2;1;1
258077835982;258077836738;756;2,9;2;1;1
258077836738;258077837389;651;2,9;2;1;1
258077837389;258077846952;9563;2,9;2;1;1
258077846952;258077872917;25965;2,9;2;1;1
258077872917;258077873400;483;2,9;2;1;1
258077873400;258077887071;13671;2,9;2;1;1
258077887071;258077899465;12394;2,9;2;1;1
258077899465;258077904520;5055;2,9;2;1;1
258077904520;258077905171;651;2,9;2;1;1
258077905171;258077910705;5534;2,9;2;1;1
258077910705;258077911188;483;2,9;2;1;1
258077911188;258077928585;17397;2,9;2;1;1
258077928585;258077949767;21182;2,9;2;1;1
258077949767;258077966487;16720;2,9;2;1;1
258077966487;258077977423;10936;2,9;2;1;1
258077977423;258078004745;27322;2,9;2;1;1
258078004745;258078005224;479;2,9;2;1;1
258078005224;258078008214;2990;2,9;2;1;1
258078008214;258078038572;30358;2,9;2;1;1
258078038572;258078039142;570;2,9;2;1;1
258078039142;258078039632;490;2,9;2;1;1
258078039632;258078044648;5016;2,9;2;1;1
258078044648;258078065112;20464;2,9;2;1;1
258078065112;258078085431;20319;2,9;2;1;1
258078085431;258078091748;6317;2,9;2;1;1
258078091748;258078094164;2416;2,9;2;1;1
258078094164;258078094642;478;2,9;2;1;1
258078094642;258078122446;27804;2,9;2;1;1
258078122446;258078122934;488;2,9;2;1;1
258078122934;258078126751;3817;2,9;2;1;1
258078126751;258078140278;13527;2,9;2;1;1
258078140278;258078160567;20289;2,9;2;1;1
258078160567;258078161219;652;2,9;2;1;1
258078161219;258078166393;5174;2,9;2;1;1
258078166393;258078183081;16688;2,9;2;1;1
258078183081;258078198298;15217;2,9;2;1;1
258078198298;258078198948;650;2,9;2;1;1
258078198948;258078199202;254;2,9;2;1;1
258078199202;258078199851;649;2,9;2;1;1
258078199851;258078212444;12593;2,9;2;1;1
258078212444;258078217563;5119;2,9;2;1;1
258078217563;258078252608;35045;2,9;2;1;1
258078252608;258078273068;20460;2,9;2;1;1
258078273068;258078276136;3068;2,9;2;1;1
258078276136;258078276789;653;2,9;2;1;1
258078276789;258078285168;8379;2,9;2;1;1
258078285168;258078296246;11078;2,9;2;1;1
258078296246;258078326312;30066;2,9;2;1;1
258078326312;258078326802;490;2,9;2;1;1
258078326802;258078335179;8377;2,9;2;1;1
258078335179;258078352869;17690;2,9;2;1;1
258078352869;258078353366;497;2,9;2;1;1
258078353366;258078359837;6471;2,9;2;1;1
258078359837;258078384232;24395;2,9;2;1;1
258078384232;258078396091;11859;2,9;2;1;1
258078396091;258078406218;10127;2,9;2;1;1
258078406218;258078406698;480;2,9;2;1;1
258078406698;258078417049;10351;2,9;2;1;1
258078417049;258078417534;485;2,9;2;1;1
258078417534;258078425221;7687;2,9;2;1;1
258078425221;258078446406;21185;2,9;2;1;1
258078446406;258078467678;21272;2,9;2;1;1
258078467678;258078498371;30693;2,9;2;1;1
258078498371;258078508806;10435;2,9;2;1;1
258078508806;258078514209;5403;2,9;2;1;1
258078514209;258078514857;648;2,9;2;1;1
258078514857;258078530364;15507;2,9;2;1;1
258078530364;258078553120;22756;2,9;2;1;1
258078553120;258078566049;12929;2,9;2;1;1
258078566049;258078566702;653;2,9;2;1;1
258078566702;258078571739;5037;2,9;2;1;1
258078571739;258078582382;10643;2,9;2;1;1
258078582382;258078582876;494;2,9;2;1;1
258078582876;258078585201;2325;2,9;2;1;1
258078585201;258078585687;486;2,9;2;1;1
258078585687;258078591619;5932;2,9;2;1;1
258078591619;258078616903;25284;2,9;2;1;1
258078616903;258078628972;12069;2,9;2;1;1
258078628972;258078629478;506;2,9;2;1;1
258078629478;258078630128;650;2,9;2;1;1
258078630128;258078639906;9778;2,9;2;1;1
258078639906;258078670017;30111;2,9;2;1;1
258078670017;258078684301;14284;2,9;2;1;1
258078684301;258078693354;9053;2,9;2;1;1
258078693354;258078693844;490;2,9;2;1;1
258078693844;258078710385;16541;2,9;2;1;1
258078710385;258078735540;25155;2,9;2;1;1
258078735540;258078741559;6019;2,9;2;1;1
258078741559;258078742047;488;2,9;2;1;1
258078742047;258078764098;22051;2,9;2;1;1
258078764098;258078787486;23388;2,9;2;1;1
258078787486;258078790428;2942;2,9;2;1;1
258078790428;258078790913;485;2,9;2;1;1
258078790913;258078800770;9857;2,9;2;1;1
258078800770;258078801505;735;2,9;2;1;1
258078801505;258078805867;4362;2,9;2;1;1
258078805867;258078818332;12465;2,9;2;1;1
258078818332;258078832273;13941;2,9;2;1;1
258078832273;258078832938;665;2,9;2;1;1
258078832938;258078907752;74814;2,9;2;1;1
258078907752;258078934954;27202;2,9;2;1;1
258078934954;258078945517;10563;2,9;2;1;1
258078945517;258078945997;480;2,9;2;1;1
258078945997;258078947081;1084;2,9;2;1;1
258078947081;258078973245;26164;2,9;2;1;1
258078973245;258078989161;15916;2,9;2;1;1
258078989161;258079027815;38654;2,9;2;1;1
258079027815;258079028305;490;2,9;2;1;1
258079028305;258079033523;5218;2,9;2;1;1
258079033523;258079038792;5269;2,9;2;1;1
258079038792;258079074487;35695;2,9;2;1;1
258079074487;258079085072;10585;2,9;2;1;1
258079085072;258079085558;486;2,9;2;1;1
258079085558;258079089639;4081;2,9;2;1;1
258079089639;258079090120;481;2,9;2;1;1
258079090120;258079102041;11921;2,9;2;1;1
258079102041;258079139532;37491;2,9;2;1;1
258079139532;258079152170;12638;2,9;2;1;1
258079152170;258079153855;1685;2,9;2;1;1
258079153855;258079154504;649;2,9;2;1;1
258079154504;258079168035;13531;2,9;2;1;1
258079168035;258079178128;10093;2,9;2;1;1
258079178128;258079178735;607;2,9;2;1;1
258079178735;258079218058;39323;2,9;2;1;1
258079218058;258079240629;22571;2,9;2;1;1
258079240629;258079250779;10150;2,9;2;1;1
258079250779;258079251258;479;2,9;2;1;1
258079251258;258079271110;19852;2,9;2;1;1
258079271110;258079296361;25251;2,9;2;1;1
258079296361;258079306885;10524;2,9;2;1;1
258079306885;258079308034;1149;2,9;2;1;1
258079308034;258079312796;4762;2,9;2;1;1
258079312796;258079333673;20877;2,9;2;1;1
258079333673;258079359377;25704;2,9;2;1;1
258079359377;258079369581;10204;2,9;2;1;1
258079369581;258079392179;22598;2,9;2;1;1
258079392179;258079392831;652;2,9;2;1;1
258079392831;258079421294;28463;2,9;2;1;1
258079421294;258079445877;24583;2,9;2;1;1
258079445877;258079458563;12686;2,9;2;1;1
258079458563;258079459328;765;2,9;2;1;1
258079459328;258079473555;14227;2,9;2;1;1
258079473555;258079491118;17563;2,9;2;1;1
258079491118;258079513958;22840;2,9;2;1;1
258079513958;258079539480;25522;2,9;2;1;1
258079539480;258079545181;5701;2,9;2;1;1
258079545181;258079545664;483;2,9;2;1;1
258079545664;258079550226;4562;2,9;2;1;1
258079550226;258079550709;483;2,9;2;1;1
258079550709;258079559120;8411;2,9;2;1;1
258079559120;258079583025;23905;2,9;2;1;1
258079583025;258079593761;10736;2,9;2;1;1
258079593761;258079594236;475;2,9;2;1;1
258079594236;258079603408;9172;2,9;2;1;1
258079603408;258079628273;24865;2,9;2;1;1
258079628273;258079638430;10157;2,9;2;1;1
258079638430;258079638909;479;2,9;2;1;1
258079638909;258079645844;6935;2,9;2;1;1
258079645844;258079687174;41330;2,9;2;1;1
258079687174;258079714316;27142;2,9;2;1;1
258079714316;258079725987;11671;2,9;2;1;1
258079725987;258079726467;480;2,9;2;1;1
258079726467;258079729702;3235;2,9;2;1;1
258079729702;258079771094;41392;2,9;2;1;1
258079771094;258079773942;2848;2,9;2;1;1
258079773942;258079781065;7123;2,9;2;1;1
258079781065;258079784418;3353;2,9;2;1;1
258079784418;258079784900;482;2,9;2;1;1
258079784900;258079792558;7658;2,9;2;1;1
258079792558;258079793179;621;2,9;2;1;1
258079793179;258079794171;992;2,9;2;1;1
258079794171;258079806783;12612;2,9;2;1;1
258079806783;258079807462;679;2,9;2;1;1
258079807462;258079828780;21318;2,9;2;1;1
258079828780;258079844361;15581;2,9;2;1;1
258079844361;258079903176;58815;2,9;2;1;1
258079903176;258079903945;769;2,9;2;1;1
258079903945;258079906829;2884;2,9;2;1;1
258079906829;258079911548;4719;2,9;2;1;1
258079911548;258079937434;25886;2,9;2;1;1
258079937434;258079973448;36014;2,9;2;1;1
258079973448;258079973935;487;2,9;2;1;1
258079973935;258079976577;2642;2,9;2;1;1
258079976577;258079980674;4097;2,9;2;1;1
258079980674;258079989437;8763;2,9;2;1;1
258079989437;258079990087;650;2,9;2;1;1
258079990087;258080000218;10131;2,9;2;1;1
258080000218;258080011012;10794;2,9;2;1;1
258080011012;258080011490;478;2,9;2;1;1
258080011490;258080021788;10298;2,9;2;1;1
258080021788;258080030841;9053;2,9;2;1;1
258080030841;258080063439;32598;2,9;2;1;1
258080063439;258080067520;4081;2,9;2;1;1
258080067520;258080110459;42939;2,9;2;1;1
258080110459;258080143440;32981;2,9;2;1;1
258080143440;258080153756;10316;2,9;2;1;1
258080153756;258080157170;3414;2,9;2;1;1
258080157170;258080157821;651;2,9;2;1;1
258080157821;258080168847;11026;2,9;2;1;1
258080168847;258080179938;11091;2,9;2;1;1
258080179938;258080180417;479;2,9;2;1;1
258080180417;258080203704;23287;2,9;2;1;1
258080203704;258080219298;15594;2,9;2;1;1
258080219298;258080230785;11487;2,9;2;1;1
258080230785;258080231275;490;2,9;2;1;1
258080231275;258080261301;30026;2,9;2;1;1
258080261301;258080322073;60772;2,9;2;1;1
258080322073;258080363704;41631;2,9;2;1;1
258080363704;258080372151;8447;2,9;2;1;1
258080372151;258080373944;1793;2,9;2;1;1
258080373944;258080374434;490;2,9;2;1;1
258080374434;258080378311;3877;2,9;2;1;1
258080378311;258080391445;13134;2,9;2;1;1
258080391445;258080392097;652;2,9;2;1;1
258080392097;258080393710;1613;2,9;2;1;1
258080393710;258080407153;13443;2,9;2;1;1
258080407153;258080407805;652;2,9;2;1;1
258080407805;258080420106;12301;2,9;2;1;1
258080420106;258080444655;24549;2,9;2;1;1
258080444655;258080455558;10903;2,9;2;1;1
258080455558;258080456038;480;2,9;2;1;1
258080456038;258080462474;6436;2,9;2;1;1
258080462474;258080481485;19011;2,9;2;1;1
258080481485;258080512596;31111;2,9;2;1;1
258080512596;258080533030;20434;2,9;2;1;1
258080533030;258080544176;11146;2,9;2;1;1
258080544176;258080544661;485;2,9;2;1;1
258080544661;258080554166;9505;2,9;2;1;1
258080554166;258080556501;2335;2,9;2;1;1
258080556501;258080585714;29213;2,9;2;1;1
258080585714;258080594813;9099;2,9;2;1;1
258080594813;258080622418;27605;2,9;2;1;1
258080622418;258080630822;8404;2,9;2;1;1
258080630822;258080654961;24139;2,9;2;1;1
258080654961;258080700605;45644;2,9;2;1;1
258080700605;258080721444;20839;2,9;2;1;1
258080721444;258080725467;4023;2,9;2;1;1
258080725467;258080736056;10589;2,9;2;1;1
258080736056;258080736738;682;2,9;2;1;1
258080736738;258080738264;1526;2,9;2;1;1
258080738264;258080738752;488;2,9;2;1;1
258080738752;258080746897;8145;2,9;2;1;1
258080746897;258080755996;9099;2,9;2;1;1
258080755996;258080787299;31303;2,9;2;1;1
258080787299;258080811507;24208;2,9;2;1;1
258080811507;258080823122;11615;2,9;2;1;1
258080823122;258080823603;481;2,9;2;1;1
258080823603;258080831434;7831;2,9;2;1;1
258080831434;258080858735;27301;2,9;2;1;1
258080858735;258080870287;11552;2,9;2;1;1
258080870287;258080870778;491;2,9;2;1;1
258080870778;258080912214;41436;2,9;2;1;1
258080912214;258080924311;12097;2,9;2;1;1
258080924311;258080935163;10852;2,9;2;1;1
258080935163;258080935809;646;2,9;2;1;1
258080935809;258080954229;18420;2,9;2;1;1
258080954229;258080974353;20124;2,9;2;1;1
258080974353;258080987691;13338;2,9;2;1;1
258080987691;258080988341;650;2,9;2;1;1
258080988341;258081034258;45917;2,9;2;1;1
258081034258;258081036655;2397;2,9;2;1;1
258081036655;258081077573;40918;2,9;2;1;1
258081077573;258081098795;21222;2,9;2;1;1
258081098795;258081109788;10993;2,9;2;1;1
258081109788;258081110275;487;2,9;2;1;1
258081110275;258081113611;3336;2,9;2;1;1
258081113611;258081121863;8252;2,9;2;1;1
258081121863;258081155278;33415;2,9;2;1;1
258081155278;258081168717;13439;2,9;2;1;1
258081168717;258081180097;11380;2,9;2;1;1
258081180097;258081180631;534;2,9;2;1;1
258081180631;258081197506;16875;2,9;2;1;1
258081197506;258081199607;2101;2,9;2;1;1
258081199607;258081245296;45689;2,9;2;1;1
258081245296;258081266567;21271;2,9;2;1;1
258081266567;258081279492;12925;2,9;2;1;1
258081279492;258081279978;486;2,9;2;1;1
258081279978;258081304089;24111;2,9;2;1;1
258081304089;258081313326;9237;2,9;2;1;1
258081313326;258081347848;34522;2,9;2;1;1
258081347848;258081368163;20315;2,9;2;1;1
258081368163;258081378968;10805;2,9;2;1;1
258081378968;258081379446;478;2,9;2;1;1
258081379446;258081391708;12262;2,9;2;1;1
258081391708;258081426023;34315;2,9;2;1;1
258081426023;258081434814;8791;2,9;2;1;1
258081434814;258081436632;1818;2,9;2;1;1
258081436632;258081437112;480;2,9;2;1;1
258081437112;258081465746;28634;2,9;2;1;1
258081465746;258081476215;10469;2,9;2;1;1
258081476215;258081476703;488;2,9;2;1;1
258081476703;258081486684;9981;2,9;2;1;1
258081486684;258081495667;8983;2,9;2;1;1
258081495667;258081520241;24574;2,9;2;1;1
258081520241;258081541533;21292;2,9;2;1;1
258081541533;258081552859;11326;2,9;2;1;1
258081552859;258081553348;489;2,9;2;1;1
258081553348;258081567768;14420;2,9;2;1;1
258081567768;258081577002;9234;2,9;2;1;1
258081577002;258081608362;31360;2,9;2;1;1
258081608362;258081640990;32628;2,9;2;1;1
258081640990;258081659537;18547;2,9;2;1;1
258081659537;258081661882;2345;2,9;2;1;1
258081661882;258081697480;35598;2,9;2;1;1
258081697480;258081731154;33674;2,9;2;1;1
258081731154;258081733977;2823;2,9;2;1;1
258081733977;258081745429;11452;2,9;2;1;1
258081745429;258081746079;650;2,9;2;1;1
258081746079;258081754629;8550;2,9;2;1;1
258081754629;258081765298;10669;2,9;2;1;1
258081765298;258081765784;486;2,9;2;1;1
258081765784;258081786674;20890;2,9;2;1;1
258081786674;258081811448;24774;2,9;2;1;1
258081811448;258081835611;24163;2,9;2;1;1
258081835611;258081858184;22573;2,9;2;1;1
258081858184;258081870075;11891;2,9;2;1;1
258081870075;258081870560;485;2,9;2;1;1
258081870560;258081878708;8148;2,9;2;1;1
258081878708;258081892656;13948;2,9;2;1;1
258081892656;258081903926;11270;2,9;2;1;1
258081903926;258081904414;488;2,9;2;1;1
258081904414;258081909947;5533;2,9;2;1;1
258081909947;258081918734;8787;2,9;2;1;1
258081918734;258081953509;34775;2,9;2;1;1
258081953509;258081977329;23820;2,9;2;1;1
258081977329;258081988131;10802;2,9;2;1;1
258081988131;258081988621;490;2,9;2;1;1
258081988621;258081991529;2908;2,9;2;1;1
258081991529;258082002297;10768;2,9;2;1;1
258082002297;258082028421;26124;2,9;2;1;1
258082028421;258082036923;8502;2,9;2;1;1
258082036923;258082070335;33412;2,9;2;1;1
258082070335;258082096475;26140;2,9;2;1;1
258082096475;258082141530;45055;2,9;2;1;1
258082141530;258082161962;20432;2,9;2;1;1
258082161962;258082180314;18352;2,9;2;1;1
258082180314;258082213367;33053;2,9;2;1;1
258082213367;258082216589;3222;2,9;2;1;1
258082216589;258082235935;19346;2,9;2;1;1
258082235935;258082246434;10499;2,9;2;1;1
258082246434;258082246955;521;2,9;2;1;1
258082246955;258082263178;16223;2,9;2;1;1
258082263178;258082290611;27433;2,9;2;1;1
258082290611;258082301127;10516;2,9;2;1;1
258082301127;258082309125;7998;2,9;2;1;1
258082309125;258082342980;33855;2,9;2;1;1
258082342980;258082361939;18959;2,9;2;1;1
258082361939;258082366504;4565;2,9;2;1;1
258082366504;258082369094;2590;2,9;2;1;1
258082369094;258082415812;46718;2,9;2;1;1
258082415812;258082423563;7751;2,9;2;1;1
258082423563;258082457358;33795;2,9;2;1;1
258082457358;258082470515;13157;2,9;2;1;1
258082470515;258082499619;29104;2,9;2;1;1
258082499619;258082520162;20543;2,9;2;1;1
258082520162;258082531496;11334;2,9;2;1;1
258082531496;258082531986;490;2,9;2;1;1
258082531986;258082541600;9614;2,9;2;1;1
258082541600;258082571758;30158;2,9;2;1;1
258082571758;258082585069;13311;2,9;2;1;1
258082585069;258082593187;8118;2,9;2;1;1
258082593187;258082619498;26311;2,9;2;1;1
258082619498;258082627677;8179;2,9;2;1;1
258082627677;258082674852;47175;2,9;2;1;1
258082674852;258082676992;2140;2,9;2;1;1
258082676992;258082714913;37921;2,9;2;1;1
258082714913;258082722869;7956;2,9;2;1;1
258082722869;258082756371;33502;2,9;2;1;1
258082756371;258082778692;22321;2,9;2;1;1
258082778692;258082830337;51645;2,9;2;1;1
258082830337;258082834543;4206;2,9;2;1;1
258082834543;258082863155;28612;2,9;2;1;1
258082863155;258082865223;2068;2,9;2;1;1
258082865223;258082899477;34254;2,9;2;1;1
258082899477;258082920306;20829;2,9;2;1;1
258082920306;258082932687;12381;2,9;2;1;1
258082932687;258082951700;19013;2,9;2;1;1
258082951700;258082973868;22168;2,9;2;1;1
258082973868;258082998655;24787;2,9;2;1;1
258082998655;258083007126;8471;2,9;2;1;1
258083007126;258083007555;429;2,9;2;1;1
258083007555;258083038737;31182;2,9;2;1;1
258083038737;258083040816;2079;2,9;2;1;1
258083040816;258083070842;30026;2,9;2;1;1
258083070842;258083078938;8096;2,9;2;1;1
258083078938;258083102805;23867;2,9;2;1;1
258083102805;258083110755;7950;2,9;2;1;1
258083110755;258083148373;37618;2,9;2;1;1
258083148373;258083160920;12547;2,9;2;1;1
258083160920;258083172446;11526;2,9;2;1;1
258083172446;258083175080;2634;2,9;2;1;1
258083175080;258083197518;22438;2,9;2;1;1
258083197518;258083205695;8177;2,9;2;1;1
258083205695;258083214274;8579;2,9;2;1;1
258083214274;258083216338;2064;2,9;2;1;1
258083216338;258083255358;39020;2,9;2;1;1
258083255358;258083263292;7934;2,9;2;1;1
258083263292;258083297919;34627;2,9;2;1;1
258083297919;258083305598;7679;2,9;2;1;1
258083305598;258083331881;26283;2,9;2;1;1
258083331881;258083353136;21255;2,9;2;1;1
258083353136;258083371459;18323;2,9;2;1;1
258083371459;258083380809;9350;2,9;2;1;1
258083380809;258083430746;49937;2,9;2;1;1
258083430746;258083433420;2674;2,9;2;1;1
258083433420;258083434346;926;2,9;2;1;1
258083434346;258083441471;7125;2,9;2;1;1
258083441471;258083445438;3967;2,9;2;1;1
258083445438;258083445729;291;2,9;2;1;1
258083445729;258083449810;4081;2,9;2;1;1
258083449810;258083451682;1872;2,9;2;1;1
258083451682;258083463363;11681;2,9;2;1;1
258083463363;258083464018;655;2,9;2;1;1
258083464018;258083492581;28563;2,9;2;1;1
258083492581;258083496768;4187;2,9;2;1;1
258083496768;258083614374;117606;2,9;2;1;1
258083614374;258083658761;44387;2,9;2;1;1
258083658761;258083670619;11858;2,9;2;1;1
258083670619;258083682961;12342;2,9;2;1;1
258083682961;258083690009;7048;2,9;2;1;1
258083690009;258083690660;651;2,9;2;1;1
258083690660;258083701571;10911;2,9;2;1;1
258083701571;258083739932;38361;2,9;2;1;1
258083739932;258083751643;11711;2,9;2;1;1
258083751643;258083768641;16998;2,9;2;1;1
258083768641;258083769126;485;2,9;2;1;1
258083769126;258083788695;19569;2,9;2;1;1
258083788695;258083801255;12560;2,9;2;1;1
258083801255;258083820303;19048;2,9;2;1;1
258083820303;258083820953;650;2,9;2;1;1
258083820953;258083829564;8611;2,9;2;1;1
258083829564;258083845269;15705;2,9;2;1;1
258083845269;258083845749;480;2,9;2;1;1
258083845749;258083846802;1053;2,9;2;1;1
258083846802;258083870526;23724;2,9;2;1;1
258083870526;258083890687;20161;2,9;2;1;1
258083890687;258083891336;649;2,9;2;1;1
258083891336;258083891488;152;2,9;2;1;1
258083891488;258083908765;17277;2,9;2;1;1
258083908765;258083924749;15984;2,9;2;1;1
258083924749;258083925228;479;2,9;2;1;1
258083925228;258083932530;7302;2,9;2;1;1
258083932530;258083942335;9805;2,9;2;1;1
258083942335;258083960088;17753;2,9;2;1;1
258083960088;258083960584;496;2,9;2;1;1
258083960584;258083979208;18624;2,9;2;1;1
258083979208;258083988774;9566;2,9;2;1;1
258083988774;258084004756;15982;2,9;2;1;1
258084004756;258084005238;482;2,9;2;1;1
258084005238;258084033373;28135;2,9;2;1;1
258084033373;258084037178;3805;2,9;2;1;1
258084037178;258084055020;17842;2,9;2;1;1
258084055020;258084055503;483;2,9;2;1;1
258084055503;258084078262;22759;2,9;2;1;1
258084078262;258084083391;5129;2,9;2;1;1
258084083391;258084101286;17895;2,9;2;1;1
258084101286;258084101911;625;2,9;2;1;1
258084101911;258084120967;19056;2,9;2;1;1
258084120967;258084125120;4153;2,9;2;1;1
258084125120;258084144611;19491;2,9;2;1;1
258084144611;258084145088;477;2,9;2;1;1
258084145088;258084162844;17756;2,9;2;1;1
258084162844;258084172935;10091;2,9;2;1;1
258084172935;258084193193;20258;2,9;2;1;1
258084193193;258084193840;647;2,9;2;1;1
258084193840;258084213178;19338;2,9;2;1;1
258084213178;258084222953;9775;2,9;2;1;1
258084222953;258084238952;15999;2,9;2;1;1
258084238952;258084239431;479;2,9;2;1;1
258084239431;258084260023;20592;2,9;2;1;1
258084260023;258084280673;20650;2,9;2;1;1
258084280673;258084287551;6878;2,9;2;1;1
258084287551;258084298147;10596;2,9;2;1;1
258084298147;258084298625;478;2,9;2;1;1
258084298625;258084326411;27786;2,9;2;1;1
258084326411;258084345612;19201;2,9;2;1;1
258084345612;258084346774;1162;2,9;2;1;1
258084346774;258084347423;649;2,9;2;1;1
258084347423;258084376447;29024;2,9;2;1;1
258084376447;258084394644;18197;2,9;2;1;1
258084394644;258084395295;651;2,9;2;1;1
258084395295;258084423395;28100;2,9;2;1;1
258084423395;258084428139;4744;2,9;2;1;1
258084428139;258084444582;16443;2,9;2;1;1
258084444582;258084445062;480;2,9;2;1;1
258084445062;258084482360;37298;2,9;2;1;1
258084482360;258084486184;3824;2,9;2;1;1
258084486184;258084502836;16652;2,9;2;1;1
258084502836;258084503319;483;2,9;2;1;1
258084503319;258084531471;28152;2,9;2;1;1
258084531471;258084536347;4876;2,9;2;1;1
258084536347;258084552104;15757;2,9;2;1;1
258084552104;258084552602;498;2,9;2;1;1
258084552602;258084581609;29007;2,9;2;1;1
258084581609;258084591502;9893;2,9;2;1;1
258084591502;258084607689;16187;2,9;2;1;1
258084607689;258084608239;550;2,9;2;1;1
258084608239;258084623695;15456;2,9;2;1;1
258084623695;258084634044;10349;2,9;2;1;1
258084634044;258084652478;18434;2,9;2;1;1
258084652478;258084653055;577;2,9;2;1;1
258084653055;258084665513;12458;2,9;2;1;1
258084665513;258084676223;10710;2,9;2;1;1
258084676223;258084693406;17183;2,9;2;1;1
258084693406;258084694147;741;2,9;2;1;1
258084694147;258084706356;12209;2,9;2;1;1
258084706356;258084725723;19367;2,9;2;1;1
258084725723;258084743737;18014;2,9;2;1;1
258084743737;258084744342;605;2,9;2;1;1
258084744342;258084744991;649;2,9;2;1;1
258084744991;258084771844;26853;2,9;2;1;1
258084771844;258084785024;13180;2,9;2;1;1
258084785024;258084788695;3671;2,9;2;1;1
258084788695;258084788929;234;2,9;2;1;1
258084788929;258084789180;251;2,9;2;1;1
258084789180;258084808977;19797;2,9;2;1;1
258084808977;258084809942;965;2,9;2;1;1
258084809942;258084826784;16842;2,9;2;1;1
258084826784;258084831711;4927;2,9;2;1;1
258084831711;258084847966;16255;2,9;2;1;1
258084847966;258084848553;587;2,9;2;1;1
258084848553;258084870147;21594;2,9;2;1;1
258084870147;258084880582;10435;2,9;2;1;1
258084880582;258084896313;15731;2,9;2;1;1
258084896313;258084896791;478;2,9;2;1;1
258084896791;258084917120;20329;2,9;2;1;1
258084917120;258084922110;4990;2,9;2;1;1
258084922110;258084937901;15791;2,9;2;1;1
258084937901;258084938450;549;2,9;2;1;1
258084938450;258084958634;20184;2,9;2;1;1
258084958634;258084969007;10373;2,9;2;1;1
258084969007;258084985308;16301;2,9;2;1;1
258084985308;258084985794;486;2,9;2;1;1
258084985794;258084989059;3265;2,9;2;1;1
258084989059;258084999452;10393;2,9;2;1;1
258084999452;258085021367;21915;2,9;2;1;1
258085021367;258085022588;1221;2,9;2;1;1
258085022588;258085024772;2184;2,9;2;1;1
258085024772;258085035604;10832;2,9;2;1;1
258085035604;258085058063;22459;2,9;2;1;1
258085058063;258085058715;652;2,9;2;1;1
258085058715;258085061752;3037;2,9;2;1;1
258085061752;258085071788;10036;2,9;2;1;1
258085071788;258085091197;19409;2,9;2;1;1
258085091197;258085091843;646;2,9;2;1;1
258085091843;258085102676;10833;2,9;2;1;1
258085102676;258085107824;5148;2,9;2;1;1
258085107824;258085126630;18806;2,9;2;1;1
258085126630;258085127282;652;2,9;2;1;1
258085127282;258085155371;28089;2,9;2;1;1
258085155371;258085165991;10620;2,9;2;1;1
258085165991;258085182342;16351;2,9;2;1;1
258085182342;258085182834;492;2,9;2;1;1
258085182834;258085205445;22611;2,9;2;1;1
258085205445;258085210304;4859;2,9;2;1;1
258085210304;258085225683;15379;2,9;2;1;1
258085225683;258085226252;569;2,9;2;1;1
258085226252;258085255492;29240;2,9;2;1;1
258085255492;258085295068;39576;2,9;2;1;1
258085295068;258085314172;19104;2,9;2;1;1
258085314172;258085314802;630;2,9;2;1;1
258085314802;258085315455;653;2,9;2;1;1
258085315455;258085322943;7488;2,9;2;1;1
258085322943;258085358105;35162;2,9;2;1;1
258085358105;258085386575;28470;2,9;2;1;1
258085386575;258085403246;16671;2,9;2;1;1
258085403246;258085403727;481;2,9;2;1;1
258085403727;258085404941;1214;2,9;2;1;1
258085404941;258085429489;24548;2,9;2;1;1
258085429489;258085437178;7689;2,9;2;1;1
258085437178;258085448297;11119;2,9;2;1;1
258085448297;258085448948;651;2,9;2;1;1
258085448948;258085478845;29897;2,9;2;1;1
258085478845;258085485422;6577;2,9;2;1;1
258085485422;258085495490;10068;2,9;2;1;1
258085495490;258085495979;489;2,9;2;1;1
258085495979;258085496146;167;2,9;2;1;1
258085496146;258085515345;19199;2,9;2;1;1
258085515345;258085515996;651;2,9;2;1;1
258085515996;258085531128;15132;2,9;2;1;1
258085531128;258085534754;3626;2,9;2;1;1
258085534754;258085572385;37631;2,9;2;1;1
258085572385;258085577549;5164;2,9;2;1;1
258085577549;258085595045;17496;2,9;2;1;1
258085595045;258085595695;650;2,9;2;1;1
258085595695;258085623483;27788;2,9;2;1;1
258085623483;258085632229;8746;2,9;2;1;1
258085632229;258085665402;33173;2,9;2;1;1
258085665402;258085675526;10124;2,9;2;1;1
258085675526;258085695018;19492;2,9;2;1;1
258085695018;258085695669;651;2,9;2;1;1
258085695669;258085712608;16939;2,9;2;1;1
258085712608;258085722779;10171;2,9;2;1;1
258085722779;258085742295;19516;2,9;2;1;1
258085742295;258085742954;659;2,9;2;1;1
258085742954;258085752952;9998;2,9;2;1;1
258085752952;258085792753;39801;2,9;2;1;1
258085792753;258085804252;11499;2,9;2;1;1
258085804252;258085804806;554;2,9;2;1;1
258085804806;258085823916;19110;2,9;2;1;1
258085823916;258085824566;650;2,9;2;1;1
258085824566;258085830789;6223;2,9;2;1;1
258085830789;258085831312;523;2,9;2;1;1
258085831312;258085855792;24480;2,9;2;1;1
258085855792;258085859771;3979;2,9;2;1;1
258085859771;258085875161;15390;2,9;2;1;1
258085875161;258085875648;487;2,9;2;1;1
258085875648;258085896307;20659;2,9;2;1;1
258085896307;258085898893;2586;2,9;2;1;1
258085898893;258085939200;40307;2,9;2;1;1
258085939200;258085948215;9015;2,9;2;1;1
258085948215;258085969958;21743;2,9;2;1;1
258085969958;258085980376;10418;2,9;2;1;1
258085980376;258085996108;15732;2,9;2;1;1
258085996108;258085996647;539;2,9;2;1;1
258085996647;258086027477;30830;2,9;2;1;1
258086027477;258086052868;25391;2,9;2;1;1
258086052868;258086070388;17520;2,9;2;1;1
258086070388;258086070877;489;2,9;2;1;1
258086070877;258086101446;30569;2,9;2;1;1
258086101446;258086107061;5615;2,9;2;1;1
258086107061;258086123287;16226;2,9;2;1;1
258086123287;258086128120;4833;2,9;2;1;1
258086128120;258086128959;839;2,9;2;1;1
258086128959;258086129330;371;2,9;2;1;1
258086129330;258086150091;20761;2,9;2;1;1
258086150091;258086150328;237;2,9;2;1;1
258086150328;258086150978;650;2,9;2;1;1
258086150978;258086160087;9109;2,9;2;1;1
258086160087;258086177686;17599;2,9;2;1;1
258086177686;258086178347;661;2,9;2;1;1
258086178347;258086188482;10135;2,9;2;1;1
258086188482;258086191078;2596;2,9;2;1;1
258086191078;258086220614;29536;2,9;2;1;1
258086220614;258086235771;15157;2,9;2;1;1
258086235771;258086261700;25929;2,9;2;1;1
258086261700;258086271045;9345;2,9;2;1;1
258086271045;258086303701;32656;2,9;2;1;1
258086303701;258086313728;10027;2,9;2;1;1
258086313728;258086333109;19381;2,9;2;1;1
258086333109;258086333761;652;2,9;2;1;1
258086333761;258086354139;20378;2,9;2;1;1
258086354139;258086379436;25297;2,9;2;1;1
258086379436;258086400092;20656;2,9;2;1;1
258086400092;258086400856;764;2,9;2;1;1
258086400856;258086407960;7104;2,9;2;1;1
258086407960;258086419214;11254;2,9;2;1;1
258086419214;258086449815;30601;2,9;2;1;1
258086449815;258086453879;4064;2,9;2;1;1
258086453879;258086474240;20361;2,9;2;1;1
258086474240;258086474896;656;2,9;2;1;1
258086474896;258086481063;6167;2,9;2;1;1
258086481063;258086489727;8664;2,9;2;1;1
258086489727;258086554609;64882;2,9;2;1;1
258086554609;258086564137;9528;2,9;2;1;1
258086564137;258086596519;32382;2,9;2;1;1
258086596519;258086598928;2409;2,9;2;1;1
258086598928;258086645939;47011;2,9;2;1;1
258086645939;258086658069;12130;2,9;2;1;1
258086658069;258086689806;31737;2,9;2;1;1
258086689806;258086698782;8976;2,9;2;1;1
258086698782;258086731820;33038;2,9;2;1;1
258086731820;258086751899;20079;2,9;2;1;1
258086751899;258086767724;15825;2,9;2;1;1
258086767724;258086770035;2311;2,9;2;1;1
258086770035;258086808015;37980;2,9;2;1;1
258086808015;258086816280;8265;2,9;2;1;1
258086816280;258086855825;39545;2,9;2;1;1
258086855825;258086864028;8203;2,9;2;1;1
258086864028;258086899708;35680;2,9;2;1;1
258086899708;258086902082;2374;2,9;2;1;1
258086902082;258086939493;37411;2,9;2;1;1
258086939493;258086942119;2626;2,9;2;1;1
258086942119;258086994782;52663;2,9;2;1;1
258086994782;258087034146;39364;2,9;2;1;1
258087034146;258087040626;6480;2,9;2;1;1
258087040626;258087042957;2331;2,9;2;1;1
258087042957;258087057426;14469;2,9;2;1;1
258087057426;258087057919;493;2,9;2;1;1
258087057919;258087084627;26708;2,9;2;1;1
258087084627;258087094147;9520;2,9;2;1;1
258087094147;258087125190;31043;2,9;2;1;1
258087125190;258087134484;9294;2,9;2;1;1
258087134484;258087165448;30964;2,9;2;1;1
258087165448;258087191472;26024;2,9;2;1;1
258087191472;258087205764;14292;2,9;2;1;1
258087205764;258087207979;2215;2,9;2;1;1
258087207979;258087210798;2819;2,9;2;1;1
258087210798;258087211448;650;2,9;2;1;1
258087211448;258087266803;55355;2,9;2;1;1
258087266803;258087291108;24305;2,9;2;1;1
258087291108;258087320075;28967;2,9;2;1;1
258087320075;258087322541;2466;2,9;2;1;1
258087322541;258087352442;29901;2,9;2;1;1
258087352442;258087393056;40614;2,9;2;1;1
258087393056;258087394657;1601;2,9;2;1;1
258087394657;258087402642;7985;2,9;2;1;1
258087402642;258087411290;8648;2,9;2;1;1
258087411290;258087411940;650;2,9;2;1;1
258087411940;258087451087;39147;2,9;2;1;1
258087451087;258087475567;24480;2,9;2;1;1
258087475567;258087484391;8824;2,9;2;1;1
258087484391;258087485557;1166;2,9;2;1;1
258087485557;258087512917;27360;2,9;2;1;1
258087512917;258087537475;24558;2,9;2;1;1
258087537475;258087555593;18118;2,9;2;1;1
258087555593;258087556074;481;2,9;2;1;1
258087556074;258087556209;135;2,9;2;1;1
258087556209;258087565136;8927;2,9;2;1;1
258087565136;258087611545;46409;2,9;2;1;1
258087611545;258087620143;8598;2,9;2;1;1
258087620143;258087653982;33839;2,9;2;1;1
258087653982;258087662128;8146;2,9;2;1;1
258087662128;258087716109;53981;2,9;2;1;1
258087716109;258087718770;2661;2,9;2;1;1
258087718770;258087748754;29984;2,9;2;1;1
258087748754;258087750971;2217;2,9;2;1;1
258087750971;258087789099;38128;2,9;2;1;1
258087789099;258087800489;11390;2,9;2;1;1
258087800489;258087819757;19268;2,9;2;1;1
258087819757;258087820573;816;2,9;2;1;1
258087820573;258087841920;21347;2,9;2;1;1
258087841920;258087850520;8600;2,9;2;1;1
258087850520;258087883697;33177;2,9;2;1;1
258087883697;258087892329;8632;2,9;2;1;1
258087892329;258087924874;32545;2,9;2;1;1
258087924874;258087934102;9228;2,9;2;1;1
258087934102;258087965836;31734;2,9;2;1;1
258087965836;258087974226;8390;2,9;2;1;1
258087974226;258087997593;23367;2,9;2;1;1
258087997593;258088005748;8155;2,9;2;1;1
258088005748;258088040776;35028;2,9;2;1;1
258088040776;258088062860;22084;2,9;2;1;1
258088062860;258088079494;16634;2,9;2;1;1
258088079494;258088079982;488;2,9;2;1;1
258088079982;258088081396;1414;2,9;2;1;1
258088081396;258088089488;8092;2,9;2;1;1
258088089488;258088104675;15187;2,9;2;1;1
258088104675;258088105156;481;2,9;2;1;1
258088105156;258088122986;17830;2,9;2;1;1
258088122986;258088131337;8351;2,9;2;1;1
258088131337;258088251742;120405;2,9;2;1;1
258088251742;258088254127;2385;2,9;2;1;1
258088254127;258088295743;41616;2,9;2;1;1
258088295743;258088298205;2462;2,9;2;1;1
258088298205;258088341785;43580;2,9;2;1;1
258088341785;258088344285;2500;2,9;2;1;1
258088344285;258088372617;28332;2,9;2;1;1
258088372617;258088377925;5308;2,9;2;1;1
258088377925;258088392981;15056;2,9;2;1;1
258088392981;258088393471;490;2,9;2;1;1
258088393471;258088418252;24781;2,9;2;1;1
258088418252;258088448164;29912;2,9;2;1;1
258088448164;258088458502;10338;2,9;2;1;1
258088458502;258088466589;8087;2,9;2;1;1
258088466589;258088466921;332;2,9;2;1;1
258088466921;258088467571;650;2,9;2;1;1
258088467571;258088497674;30103;2,9;2;1;1
258088497674;258088505958;8284;2,9;2;1;1
258088505958;258088546710;40752;2,9;2;1;1
258088546710;258088549913;3203;2,9;2;1;1
258088549913;258088589556;39643;2,9;2;1;1
258088589556;258088597913;8357;2,9;2;1;1
258088597913;258088629588;31675;2,9;2;1;1
258088629588;258088638526;8938;2,9;2;1;1
258088638526;258088670817;32291;2,9;2;1;1
258088670817;258088674334;3517;2,9;2;1;1
258088674334;258088690176;15842;2,9;2;1;1
258088690176;258088690655;479;2,9;2;1;1
258088690655;258088728321;37666;2,9;2;1;1
258088728321;258088737331;9010;2,9;2;1;1
258088737331;258088756527;19196;2,9;2;1;1
258088756527;258088757286;759;2,9;2;1;1
258088757286;258088766327;9041;2,9;2;1;1
258088766327;258088791210;24883;2,9;2;1;1
258088791210;258088806151;14941;2,9;2;1;1
258088806151;258088814387;8236;2,9;2;1;1
258088814387;258088849376;34989;2,9;2;1;1
258088849376;258088851571;2195;2,9;2;1;1
258088851571;258088880633;29062;2,9;2;1;1
258088880633;258088891474;10841;2,9;2;1;1
258088891474;258088908609;17135;2,9;2;1;1
258088908609;258088909094;485;2,9;2;1;1
258088909094;258088927846;18752;2,9;2;1;1
258088927846;258088940072;12226;2,9;2;1;1
258088940072;258088958321;18249;2,9;2;1;1
258088958321;258088958972;651;2,9;2;1;1
258088958972;258088961846;2874;2,9;2;1;1
258088961846;258088971665;9819;2,9;2;1;1
258088971665;258088991149;19484;2,9;2;1;1
258088991149;258088991914;765;2,9;2;1;1
258088991914;258088996198;4284;2,9;2;1;1
258088996198;258089018713;22515;2,9;2;1;1
258089018713;258089033838;15125;2,9;2;1;1
258089033838;258089034317;479;2,9;2;1;1
258089034317;258089035378;1061;2,9;2;1;1
258089035378;258089059040;23662;2,9;2;1;1
258089059040;258089070671;11631;2,9;2;1;1
258089070671;258089079570;8899;2,9;2;1;1
258089079570;258089108762;29192;2,9;2;1;1
258089108762;258089111401;2639;2,9;2;1;1
258089111401;258089147442;36041;2,9;2;1;1
258089147442;258089149888;2446;2,9;2;1;1
258089149888;258089197165;47277;2,9;2;1;1
258089197165;258089210961;13796;2,9;2;1;1
258089210961;258089226703;15742;2,9;2;1;1
258089226703;258089227183;480;2,9;2;1;1
258089227183;258089245285;18102;2,9;2;1;1
258089245285;258089256614;11329;2,9;2;1;1
258089256614;258089271979;15365;2,9;2;1;1
258089271979;258089272462;483;2,9;2;1;1
258089272462;258089283633;11171;2,9;2;1;1
258089283633;258089311053;27420;2,9;2;1;1
258089311053;258089329379;18326;2,9;2;1;1
258089329379;258089330380;1001;2,9;2;1;1
258089330380;258089331027;647;2,9;2;1;1
258089331027;258089341164;10137;2,9;2;1;1
258089341164;258089356729;15565;2,9;2;1;1
258089356729;258089357205;476;2,9;2;1;1
258089357205;258089370895;13690;2,9;2;1;1
258089370895;258089392082;21187;2,9;2;1;1
258089392082;258089406667;14585;2,9;2;1;1
258089406667;258089407149;482;2,9;2;1;1
258089407149;258089431442;24293;2,9;2;1;1
258089431442;258089437713;6271;2,9;2;1;1
258089437713;258089455706;17993;2,9;2;1;1
258089455706;258089456357;651;2,9;2;1;1
258089456357;258089485081;28724;2,9;2;1;1
258089485081;258089494702;9621;2,9;2;1;1
258089494702;258089519114;24412;2,9;2;1;1
258089519114;258089544594;25480;2,9;2;1;1
258089544594;258089563293;18699;2,9;2;1;1
258089563293;258089563895;602;2,9;2;1;1
258089563895;258089563940;45;2,9;2;1;1
258089563940;258089589591;25651;2,9;2;1;1
258089589591;258089607688;18097;2,9;2;1;1
258089607688;258089608173;485;2,9;2;1;1
258089608173;258089615393;7220;2,9;2;1;1
258089615393;258089646962;31569;2,9;2;1;1
258089646962;258089648499;1537;2,9;2;1;1
258089648499;258089660676;12177;2,9;2;1;1
258089660676;258089664695;4019;2,9;2;1;1
258089664695;258089665345;650;2,9;2;1;1
258089665345;258089679903;14558;2,9;2;1;1
258089679903;258089680553;650;2,9;2;1;1
258089680553;258089689632;9079;2,9;2;1;1
258089689632;258089692165;2533;2,9;2;1;1
258089692165;258090039834;347669;2,9;2;1;1
258090039834;258090042061;2227;2,9;2;1;1
258090042061;258090087165;45104;2,9;2;1;1
258090087165;258090095667;8502;2,9;2;1;1
258090095667;258090142044;46377;2,9;2;1;1
258090142044;258090147579;5535;2,9;2;1;1
258090147579;258090163211;15632;2,9;2;1;1
258090163211;258090163704;493;2,9;2;1;1
258090163704;258090178472;14768;2,9;2;1;1
258090178472;258090199276;20804;2,9;2;1;1
258090199276;258090215388;16112;2,9;2;1;1
258090215388;258090215893;505;2,9;2;1;1
258090215893;258090217134;1241;2,9;2;1;1
258090217134;258090219740;2606;2,9;2;1;1
258090219740;258090284358;64618;2,9;2;1;1
258090284358;258090296303;11945;2,9;2;1;1
258090296303;258090314760;18457;2,9;2;1;1
258090314760;258090315574;814;2,9;2;1;1
258090315574;258090320525;4951;2,9;2;1;1
258090320525;258090357673;37148;2,9;2;1;1
258090357673;258090379934;22261;2,9;2;1;1
258090379934;258090382067;2133;2,9;2;1;1
258090382067;258090394578;12511;2,9;2;1;1
258090394578;258090395058;480;2,9;2;1;1
258090395058;258090397715;2657;2,9;2;1;1
258090397715;258090398201;486;2,9;2;1;1
258090398201;258090407999;9798;2,9;2;1;1
258090407999;258090410731;2732;2,9;2;1;1
258090410731;258090439323;28592;2,9;2;1;1
258090439323;258090448112;8789;2,9;2;1;1
258090448112;258090477105;28993;2,9;2;1;1
258090477105;258090479309;2204;2,9;2;1;1
258090479309;258090509803;30494;2,9;2;1;1
258090509803;258090514096;4293;2,9;2;1;1
258090514096;258090533447;19351;2,9;2;1;1
258090533447;258090534098;651;2,9;2;1;1
258090534098;258090551076;16978;2,9;2;1;1
258090551076;258090577086;26010;2,9;2;1;1
258090577086;258090592379;15293;2,9;2;1;1
258090592379;258090593055;676;2,9;2;1;1
258090593055;258090597944;4889;2,9;2;1;1
258090597944;258090600814;2870;2,9;2;1;1
258090600814;258090639810;38996;2,9;2;1;1
258090639810;258090642476;2666;2,9;2;1;1
258090642476;258090672145;29669;2,9;2;1;1
258090672145;258090699999;27854;2,9;2;1;1
258090699999;258090718742;18743;2,9;2;1;1
258090718742;258090719001;259;2,9;2;1;1
258090719001;258090719650;649;2,9;2;1;1
258090719650;258090754830;35180;2,9;2;1;1
258090754830;258090757194;2364;2,9;2;1;1
258090757194;258090775202;18008;2,9;2;1;1
258090775202;258090775689;487;2,9;2;1;1
258090775689;258090784051;8362;2,9;2;1;1
258090784051;258090791717;7666;2,9;2;1;1
258090791717;258090806693;14976;2,9;2;1;1
258090806693;258090807172;479;2,9;2;1;1
258090807172;258090814390;7218;2,9;2;1;1
258090814390;258090824790;10400;2,9;2;1;1
258090824790;258090830328;5538;2,9;2;1;1
258090830328;258090830816;488;2,9;2;1;1
258090830816;258090867496;36680;2,9;2;1;1
258090867496;258090879661;12165;2,9;2;1;1
258090879661;258090882196;2535;2,9;2;1;1
258090882196;258090882676;480;2,9;2;1;1
258090882676;258090907830;25154;2,9;2;1;1
258090907830;258090919166;11336;2,9;2;1;1
258090919166;258090924950;5784;2,9;2;1;1
258090924950;258090925427;477;2,9;2;1;1
258090925427;258090958824;33397;2,9;2;1;1
258090958824;258090960865;2041;2,9;2;1;1
258090960865;258090961344;479;2,9;2;1;1
258090961344;258090975762;14418;2,9;2;1;1
258090975762;258090976247;485;2,9;2;1;1
258090976247;258090999018;22771;2,9;2;1;1
258090999018;258091045088;46070;2,9;2;1;1
258091045088;258091046463;1375;2,9;2;1;1
258091046463;258091064880;18417;2,9;2;1;1
258091064880;258091065532;652;2,9;2;1;1
258091065532;258091079011;13479;2,9;2;1;1
258091079011;258091094340;15329;2,9;2;1;1
258091094340;258091094825;485;2,9;2;1;1
258091094825;258091096621;1796;2,9;2;1;1
258091096621;258091119358;22737;2,9;2;1;1
258091119358;258091135118;15760;2,9;2;1;1
258091135118;258091135603;485;2,9;2;1;1
258091135603;258091140193;4590;2,9;2;1;1
258091140193;258091165599;25406;2,9;2;1;1
258091165599;258091186708;21109;2,9;2;1;1
258091186708;258091247094;60386;2,9;2;1;1
258091247094;258091253664;6570;2,9;2;1;1
258091253664;258091271943;18279;2,9;2;1;1
258091271943;258091272753;810;2,9;2;1;1
258091272753;258091287442;14689;2,9;2;1;1
258091287442;258091301392;13950;2,9;2;1;1
258091301392;258091319968;18576;2,9;2;1;1
258091319968;258091320618;650;2,9;2;1;1
258091320618;258091329900;9282;2,9;2;1;1
258091329900;258091330299;399;2,9;2;1;1
258091330299;258091345574;15275;2,9;2;1;1
258091345574;258091346057;483;2,9;2;1;1
258091346057;258091374403;28346;2,9;2;1;1
258091374403;258091386412;12009;2,9;2;1;1
258091386412;258091401887;15475;2,9;2;1;1
258091401887;258091405229;3342;2,9;2;1;1
258091405229;258091405879;650;2,9;2;1;1
258091405879;258091414971;9092;2,9;2;1;1
258091414971;258091416783;1812;2,9;2;1;1
258091416783;258091417270;487;2,9;2;1;1
258091417270;258091425562;8292;2,9;2;1;1
258091425562;258091448060;22498;2,9;2;1;1
258091448060;258091456873;8813;2,9;2;1;1
258091456873;258091488333;31460;2,9;2;1;1
258091488333;258091537369;49036;2,9;2;1;1
258091537369;258091540162;2793;2,9;2;1;1
258091540162;258091547796;7634;2,9;2;1;1
258091547796;258091563994;16198;2,9;2;1;1
258091563994;258091564477;483;2,9;2;1;1
258091564477;258091578049;13572;2,9;2;1;1
258091578049;258091604665;26616;2,9;2;1;1
258091604665;258091623737;19072;2,9;2;1;1
258091623737;258091624559;822;2,9;2;1;1
258091624559;258091632829;8270;2,9;2;1;1
258091632829;258091641289;8460;2,9;2;1;1
258091641289;258091674553;33264;2,9;2;1;1
258091674553;258091677472;2919;2,9;2;1;1
258091677472;258091715547;38075;2,9;2;1;1
258091715547;258091725209;9662;2,9;2;1;1
258091725209;258091759439;34230;2,9;2;1;1
258091759439;258091768025;8586;2,9;2;1;1
258091768025;258091821248;53223;2,9;2;1;1
258091821248;258091845637;24389;2,9;2;1;1
258091845637;258091861055;15418;2,9;2;1;1
258091861055;258091861647;592;2,9;2;1;1
258091861647;258091863309;1662;2,9;2;1;1
258091863309;258091872095;8786;2,9;2;1;1
258091872095;258091903906;31811;2,9;2;1;1
258091903906;258091913775;9869;2,9;2;1;1
258091913775;258091945156;31381;2,9;2;1;1
258091945156;258091962840;17684;2,9;2;1;1
258091962840;258091986373;23533;2,9;2;1;1
258091986373;258091995186;8813;2,9;2;1;1
258091995186;258092027298;32112;2,9;2;1;1
258092027298;258092030374;3076;2,9;2;1;1
258092030374;258092072128;41754;2,9;2;1;1
258092072128;258092080732;8604;2,9;2;1;1
258092080732;258092121367;40635;2,9;2;1;1
258092121367;258092154594;33227;2,9;2;1;1
258092154594;258092170005;15411;2,9;2;1;1
258092170005;258092170690;685;2,9;2;1;1
258092170690;258092171302;612;2,9;2;1;1
258092171302;258092180510;9208;2,9;2;1;1
258092180510;258092229358;48848;2,9;2;1;1
258092229358;258092231912;2554;2,9;2;1;1
258092231912;258092266854;34942;2,9;2;1;1
258092266854;258092286537;19683;2,9;2;1;1
258092286537;258092309852;23315;2,9;2;1;1
258092309852;258092319274;9422;2,9;2;1;1
258092319274;258092344250;24976;2,9;2;1;1
258092344250;258092352770;8520;2,9;2;1;1
258092352770;258092405914;53144;2,9;2;1;1
258092405914;258092424142;18228;2,9;2;1;1
258092424142;258092447516;23374;2,9;2;1;1
258092447516;258092483308;35792;2,9;2;1;1
258092483308;258092489885;6577;2,9;2;1;1
258092489885;258092498338;8453;2,9;2;1;1
258092498338;258092498819;481;2,9;2;1;1
258092498819;258092499123;304;2,9;2;1;1
258092499123;258092576048;76925;2,9;2;1;1
258092576048;258092584208;8160;2,9;2;1;1
258092584208;258092683784;99576;2,9;2;1;1
258092683784;258092686611;2827;2,9;2;1;1
258092686611;258092724776;38165;2,9;2;1;1
258092724776;258092733056;8280;2,9;2;1;1
258092733056;258092773409;40353;2,9;2;1;1
258092773409;258092776985;3576;2,9;2;1;1
258092776985;258092792973;15988;2,9;2;1;1
258092792973;258092793460;487;2,9;2;1;1
258092793460;258092814232;20772;2,9;2;1;1
258092814232;258092823615;9383;2,9;2;1;1
258092823615;258092846858;23243;2,9;2;1;1
258092846858;258092855346;8488;2,9;2;1;1
258092855346;258092891265;35919;2,9;2;1;1
258092891265;258092900036;8771;2,9;2;1;1
258092900036;258092936027;35991;2,9;2;1;1
258092936027;258092944770;8743;2,9;2;1;1
258092944770;258092974129;29359;2,9;2;1;1
258092974129;258092983453;9324;2,9;2;1;1
258092983453;258093014085;30632;2,9;2;1;1
258093014085;258093017996;3911;2,9;2;1;1
258093017996;258093036079;18083;2,9;2;1;1
258093036079;258093036569;490;2,9;2;1;1
258093036569;258093047047;10478;2,9;2;1;1
258093047047;258093049788;2741;2,9;2;1;1
258093049788;258093087160;37372;2,9;2;1;1
258093087160;258093095870;8710;2,9;2;1;1
258093095870;258093128425;32555;2,9;2;1;1
258093128425;258093137802;9377;2,9;2;1;1
258093137802;258093172638;34836;2,9;2;1;1
258093172638;258093172674;36;2,9;2;1;1
258093172674;258093183577;10903;2,9;2;1;1
258093183577;258093183756;179;2,9;2;1;1
258093183756;258093183783;27;2,9;2;1;1
258093183783;258093184344;561;2,9;2;1;1
258093184344;258093184405;61;2,9;2;1;1
258093184405;258093184697;292;2,9;2;1;1
258093184697;258093185540;843;2,9;2;1;1
258093185540;258093185976;436;2,9;2;1;1
258093185976;258093187138;1162;2,9;2;1;1
258093187138;258093192227;5089;2,9;2;1;1
258093192227;258093193624;1397;2,9;2;1;1
258093193624;258093198703;5079;2,9;2;1;1
258093198703;258093201068;2365;2,9;2;1;1
258093201068;258093201533;465;2,9;2;1;1
258093201533;258093253858;52325;2,9;2;1;1
258093253858;258093262661;8803;2,9;2;1;1
258093262661;258093286787;24126;2,9;2;1;1
258093286787;258093295339;8552;2,9;2;1;1
258093295339;258093326143;30804;2,9;2;1;1
258093326143;258093328652;2509;2,9;2;1;1
258093328652;258093344888;16236;2,9;2;1;1
258093344888;258093384304;39416;2,9;2;1;1
258093384304;258093423282;38978;2,9;2;1;1
258093423282;258093469510;46228;2,9;2;1;1
258093469510;258093518417;48907;2,9;2;1;1
258093518417;258093561730;43313;2,9;2;1;1
258093561730;258093602502;40772;2,9;2;1;1
258093602502;258093633536;31034;2,9;2;1;1
258093633536;258093666929;33393;2,9;2;1;1
258093666929;258093707520;40591;2,9;2;1;1
258093707520;258093752066;44546;2,9;2;1;1
258093752066;258093795546;43480;2,9;2;1;1
258093795546;258093836371;40825;2,9;2;1;1
258093836371;258093873819;37448;2,9;2;1;1
258093873819;258093914976;41157;2,9;2;1;1
258093914976;258093939197;24221;2,9;2;1;1
258093939197;258093980434;41237;2,9;2;1;1
258093980434;258094023119;42685;2,9;2;1;1
258094023119;258094058572;35453;2,9;2;1;1
258094058572;258094107228;48656;2,9;2;1;1
258094107228;258094148398;41170;2,9;2;1;1
258094148398;258094202711;54313;2,9;2;1;1
258094202711;258094249246;46535;2,9;2;1;1
258094249246;258094296623;47377;2,9;2;1;1
258094296623;258094343208;46585;2,9;2;1;1
258094343208;258094375501;32293;2,9;2;1;1
258094375501;258094438432;62931;2,9;2;1;1
258094438432;258094494185;55753;2,9;2;1;1
258094494185;258094532697;38512;2,9;2;1;1
258094532697;258094590669;57972;2,9;2;1;1
258094590669;258094638913;48244;2,9;2;1;1
258094638913;258094679442;40529;2,9;2;1;1
258094679442;258094728252;48810;2,9;2;1;1
258094728252;258094760853;32601;2,9;2;1;1
258094760853;258094846510;85657;2,9;2;1;1
258094846510;258094887233;40723;2,9;2;1;1
258094887233;258094932210;44977;2,9;2;1;1
258094932210;258094975576;43366;2,9;2;1;1
258094975576;258095012916;37340;2,9;2;1;1
258095012916;258095044207;31291;2,9;2;1;1
258095044207;258095085155;40948;2,9;2;1;1
258095085155;258095126567;41412;2,9;2;1;1
258095126567;258095161913;35346;2,9;2;1;1
258095161913;258095208858;46945;2,9;2;1;1
258095208858;258095442959;234101;2,9;2;1;1
258095442959;258095489366;46407;2,9;2;1;1
258095489366;258095536551;47185;2,9;2;1;1
258095536551;258095569995;33444;2,9;2;1;1
258095569995;258095612267;42272;2,9;2;1;1
258095612267;258095648141;35874;2,9;2;1;1
258095648141;258095690398;42257;2,9;2;1;1
258095690398;258095729742;39344;2,9;2;1;1
258095729742;258095753912;24170;2,9;2;1;1
258095753912;258095794023;40111;2,9;2;1;1
258095794023;258095809130;15107;2,9;2;1;1
258095813853;258095813864;11;2,9;2;1;1
258095814313;258095830897;16584;2,9;2;1;1
258111040047;258111043088;3041;9;1;1;1
258111043088;258111061874;18786;9;1;1;1
258111061874;258111068434;6560;9;1;1;1
258111068434;258111072210;3776;9;1;1;1
258111072210;258111072864;654;9;1;1;1
258111123195;258111140208;17013;9;1;1;1
258111140208;258111185656;45448;9;1;1;1
258111185656;258111185795;139;9;1;1;1
258111223658;258111223764;106;9;1;1;1
258111231287;258111261215;29928;9;1;1;1
258111261215;258111261501;286;9;1;1;1
258111344682;258111363535;18853;9;1;1;1
258111363535;258111373587;10052;9;1;1;1
258111373587;258111376888;3301;9;1;1;1
258111376888;258111379080;2192;9;1;1;1
258111379080;258111379763;683;9;1;1;1
258111379763;258111380113;350;9;1;1;1
258111380113;258111382869;2756;9;1;1;1
258111503943;258111510255;6312;9;1;1;1
258111510255;258111514208;3953;9;1;1;1
258111514208;258111516910;2702;9;1;1;1
258111517091;258111517129;38;9;1;1;1
258111517260;258111518910;1650;9;1;1;1
258111520701;258111575438;54737;9;1;1;1
258111575438;258111584404;8966;9;1;1;1
258111584648;258111584731;83;9;1;1;1
258111584978;258111591607;6629;9;1;1;1
258111643696;258111665459;21763;9;1;1;1
258111665459;258111668813;3354;9;1;1;1
258111832721;258111833533;812;9;1;1;1
258111833533;258111844027;10494;9;1;1;1
258111845105;258111876235;31130;9;1;1;1
258111910950;258111978608;67658;9;1;1;1
258112005764;258112070973;65209;9;1;1;1
258112122961;258112125705;2744;9;1;1;1
258112128973;258112129760;787;9;1;1;1
258112130510;258112167062;36552;9;1;1;1
258112168121;258112170134;2013;9;1;1;1
258112172987;258112175641;2654;9;1;1;1
258112179749;258112180605;856;9;1;1;1
258112200489;258112203807;3318;9;1;1;1
258112204356;258112242912;38556;9;1;1;1
258112247126;258112273166;26040;9;1;1;1
258112273166;258112273509;343;9;1;1;1
258112273509;258112277163;3654;9;1;1;1
258112277376;258112277725;349;9;1;1;1
258112278525;258112278561;36;9;1;1;1
258112278695;258112290574;11879;9;1;1;1
258112291195;258112320782;29587;9;1;1;1
258112320782;258112324638;3856;9;1;1;1
258112329529;258112331751;2222;9;1;1;1
258112331968;258112332009;41;9;1;1;1
258112332234;258112338812;6578;9;1;1;1
258112338812;258112359941;21129;9;1;1;1
258112360497;258112363149;2652;9;1;1;1
258112363149;258112406171;43022;9;1;1;1
258112406171;258112407081;910;9;1;1;1
258112407924;258112416503;8579;9;1;1;1
258112417075;258112438533;21458;9;1;1;1
258112550907;258112558507;7600;9;1;1;1
258112689720;258112689801;81;9;1;1;1
258112689801;258112695302;5501;9;1;1;1
258113023356;258113025066;1710;9;1;1;1
258113025066;258113036849;11783;9;1;1;1
258113036849;258113057956;21107;9;1;1;1
258113471223;258113472129;906;9;1;1;1
258113473057;258113474477;1420;9;1;1;1
258113474477;258113480144;5667;9;1;1;1
258113480144;258113541220;61076;9;1;1;1
258113544419;258113548514;4095;9;1;1;1
258113548514;258113549435;921;9;1;1;1
258113555835;258113557364;1529;9;1;1;1
258113558501;258113559231;730;9;1;1;1
258113564178;258113564664;486;9;1;1;1
258113565432;258113569601;4169;9;1;1;1
258113571781;258113602109;30328;9;1;1;1
258113602109;258113610779;8670;9;1;1;1
258113610779;258113619992;9213;9;1;1;1
258113672493;258113702018;29525;9;1;1;1
258113702018;258113704954;2936;9;1;1;1
258113704954;258113728123;23169;9;1;1;1
258113756786;258113792518;35732;9;1;1;1
258113795085;258113796658;1573;9;1;1;1
258113797875;258113797878;3;9;1;1;1
258113799496;258113799922;426;9;1;1;1
258113807589;258113810119;2530;9;1;1;1
258113810119;258113812856;2737;9;1;1;1
258113812856;258113841523;28667;9;1;1;1
258113842064;258113846419;4355;9;1;1;1
258113846419;258113855105;8686;9;1;1;1
258113855105;258113871998;16893;9;1;1;1
258113873323;258113876533;3210;9;1;1;1
258113879096;258113879280;184;9;1;1;1
258113884290;258113884865;575;9;1;1;1
258113886269;258113886776;507;9;1;1;1
258113890072;258113891874;1802;9;1;1;1
258113899701;258113901312;1611;9;1;1;1
258113902714;258113933746;31032;9;1;1;1
258113933746;258113943230;9484;9;1;1;1
258113943230;258113944464;1234;9;1;1;1
258113944464;258113944540;76;9;1;1;1
258113944540;258113946337;1797;9;1;1;1
258113946337;258113946392;55;9;1;1;1
258113946392;258113946570;178;9;1;1;1
258113946570;258113955275;8705;9;1;1;1
258114002157;258114018014;15857;9;1;1;1
258114018014;258114026738;8724;9;1;1;1
258114026738;258114059916;33178;9;1;1;1
258114063188;258114065451;2263;9;1;1;1
258114067114;258114069052;1938;9;1;1;1
258114071058;258114071573;515;9;1;1;1
258114077243;258114078353;1110;9;1;1;1
258114089857;258114090657;800;9;1;1;1
258114093260;258114093725;465;9;1;1;1
258114098072;258114145136;47064;9;1;1;1
258114145136;258114148211;3075;9;1;1;1
258114192188;258114193636;1448;9;1;1;1
258114193636;258114204521;10885;9;1;1;1
258114204521;258114213445;8924;9;1;1;1
258114213445;258114237479;24034;9;1;1;1
258114237479;258114237785;306;9;1;1;1
258114238427;258114246355;7928;9;1;1;1
258114246355;258114288517;42162;9;1;1;1
258114289147;258114325230;36083;9;1;1;1
258114325230;258114328218;2988;9;1;1;1
258114328218;258114361934;33716;9;1;1;1
258114411820;258114413761;1941;9;1;1;1
258114413761;258114454538;40777;9;1;1;1
258114455169;258114458671;3502;9;1;1;1
258114458671;258114467377;8706;9;1;1;1
258114467377;258114494321;26944;9;1;1;1
258114496396;258114498673;2277;9;1;1;1
258114498673;258114501091;2418;9;1;1;1
258114504146;258114507435;3289;9;1;1;1
258114507435;258114507972;537;9;1;1;1
258114509072;258114509509;437;9;1;1;1
258114521411;258114523915;2504;9;1;1;1
258114524564;258114525441;877;9;1;1;1
258114525981;258114570979;44998;9;1;1;1
258114618716;258114654632;35916;9;1;1;1
258114654632;258114663305;8673;9;1;1;1
258114663305;258114674766;11461;9;1;1;1
258114726369;258114778435;52066;9;1;1;1
258114778435;258114781048;2613;9;1;1;1
258114781048;258114791065;10017;9;1;1;1
258114791692;258114797055;5363;9;1;1;1
258114797055;258114805802;8747;9;1;1;1
258114805802;258114823181;17379;9;1;1;1
258114824470;258114827679;3209;9;1;1;1
258114832134;258114832166;32;9;1;1;1
258114836004;258114837322;1318;9;1;1;1
258114857225;258114898267;41042;9;1;1;1
258114929568;258114930401;833;9;1;1;1
258114930401;258114932908;2507;9;1;1;1
258114948573;258114984187;35614;9;1;1;1
258114984187;258114996592;12405;9;1;1;1
258114996592;258115021086;24494;9;1;1;1
258115021633;258115031002;9369;9;1;1;1
258115031002;258115039591;8589;9;1;1;1
258115039591;258115060396;20805;9;1;1;1
258115061550;258115065676;4126;9;1;1;1
258115069709;258115070688;979;9;1;1;1
258115078829;258115079735;906;9;1;1;1
258115079735;258115080724;989;9;1;1;1
258115093743;258115096647;2904;9;1;1;1
258115097525;258115098430;905;9;1;1;1
258115098976;258115137422;38446;9;1;1;1
258115137422;258115144228;6806;9;1;1;1
258115195056;258115214086;19030;9;1;1;1
258115214086;258115216915;2829;9;1;1;1
258115216915;258115217281;366;9;1;1;1
258115217281;258115217474;193;9;1;1;1
258115217474;258115219908;2434;9;1;1;1
258115219908;258115221412;1504;9;1;1;1
258115221412;258115242618;21206;9;1;1;1
258115242618;258115245272;2654;9;1;1;1
258115245272;258115264596;19324;9;1;1;1
258115323139;258115326603;3464;9;1;1;1
258115326603;258115335476;8873;9;1;1;1
258115335476;258115360150;24674;9;1;1;1
258115360711;258115362629;1918;9;1;1;1
258115362629;258115371507;8878;9;1;1;1
258115371507;258115397996;26489;9;1;1;1
258115399079;258115400036;957;9;1;1;1
258115401294;258115403559;2265;9;1;1;1
258115403559;258115405344;1785;9;1;1;1
258115409173;258115409689;516;9;1;1;1
258115411818;258115412474;656;9;1;1;1
258115412474;258115415440;2966;9;1;1;1
258115415440;258115418061;2621;9;1;1;1
258115419004;258115420553;1549;9;1;1;1
258115422818;258115431885;9067;9;1;1;1
258115441535;258115442179;644;9;1;1;1
258115443535;258115452666;9131;9;1;1;1
258115452666;258115454295;1629;9;1;1;1
258115454295;258115456365;2070;9;1;1;1
258115456365;258115464757;8392;9;1;1;1
258115464757;258115465761;1004;9;1;1;1
258115465761;258115465917;156;9;1;1;1
258115465917;258115466153;236;9;1;1;1
258115466153;258115467749;1596;9;1;1;1
258115467749;258115475829;8080;9;1;1;1
258115475829;258115476180;351;9;1;1;1
258115476180;258115477803;1623;9;1;1;1
258115531263;258115533658;2395;9;1;1;1
258115533658;258115564333;30675;9;1;1;1
258115564333;258115566090;1757;9;1;1;1
258115566090;258115573436;7346;9;1;1;1
258115573436;258115574443;1007;9;1;1;1
258115574443;258115575055;612;9;1;1;1
258115575055;258115582862;7807;9;1;1;1
258115582862;258115629905;47043;9;1;1;1
258115634595;258115642513;7918;9;1;1;1
258115642513;258115642784;271;9;1;1;1
258115642784;258115651733;8949;9;1;1;1
258115651733;258115652304;571;9;1;1;1
258115652304;258115652582;278;9;1;1;1
258115652582;258115661079;8497;9;1;1;1
258115661079;258115686507;25428;9;1;1;1
258115687128;258115702231;15103;9;1;1;1
258115702231;258115707419;5188;9;1;1;1
258115707419;258115765983;58564;9;1;1;1
258115766598;258115771370;4772;9;1;1;1
258115771370;258115780082;8712;9;1;1;1
258115780082;258115809593;29511;9;1;1;1
258115809593;258115812793;3200;9;1;1;1
258115816850;258115818929;2079;9;1;1;1
258115818929;258115851544;32615;9;1;1;1
258115851544;258115854335;2791;9;1;1;1
258115854335;258115891413;37078;9;1;1;1
258115891413;258115895241;3828;9;1;1;1
258115895241;258115896013;772;9;1;1;1
258115896013;258115896248;235;9;1;1;1
258115896248;258115896430;182;9;1;1;1
258115898011;258115899101;1090;9;1;1;1
258115899101;258115899489;388;9;1;1;1
258115902333;258115902444;111;9;1;1;1
258115902444;258115903192;748;9;1;1;1
258115903192;258115903530;338;9;1;1;1
258115903530;258115903554;24;9;1;1;1
258115904830;258115906038;1208;9;1;1;1
258115907204;258115907887;683;9;1;1;1
258115907887;258115910070;2183;9;1;1;1
258115910070;258115910181;111;9;1;1;1
258115912970;258115913746;776;9;1;1;1
258115922115;258115922459;344;9;1;1;1
258115933641;258115936485;2844;9;1;1;1
258115938176;258115944357;6181;9;1;1;1
258115946037;258115947271;1234;9;1;1;1
258115947271;258115983190;35919;9;1;1;1
258116044250;258116079157;34907;9;1;1;1
258116079157;258116080299;1142;9;1;1;1
258116080299;258116082213;1914;9;1;1;1
258116082213;258116084611;2398;9;1;1;1
258116084611;258116089806;5195;9;1;1;1
258116089806;258116089947;141;9;1;1;1
258116089947;258116090770;823;9;1;1;1
258116090770;258116091223;453;9;1;1;1
258116091223;258116091633;410;9;1;1;1
258116091633;258116092935;1302;9;1;1;1
258116092935;258116097979;5044;9;1;1;1
258116148087;258116152184;4097;9;1;1;1
258116152184;258116153291;1107;9;1;1;1
258116153291;258116167231;13940;9;1;1;1
258116167231;258116175532;8301;9;1;1;1
258116175532;258116208650;33118;9;1;1;1
258116247661;258116248393;732;9;1;1;1
258116252927;258116274111;21184;9;1;1;1
258116274111;258116276745;2634;9;1;1;1
258116276745;258116320766;44021;9;1;1;1
258116320766;258116329549;8783;9;1;1;1
258116329549;258116356447;26898;9;1;1;1
258116358623;258116358774;151;9;1;1;1
258116359799;258116362496;2697;9;1;1;1
258116362496;258116362938;442;9;1;1;1
258116369693;258116370332;639;9;1;1;1
258116377464;258116381634;4170;9;1;1;1
258116386627;258116386887;260;9;1;1;1
258116387536;258116398424;10888;9;1;1;1
258116402655;258116433573;30918;9;1;1;1
258116433573;258116436308;2735;9;1;1;1
258116436308;258116453743;17435;9;1;1;1
258116494869;258116495634;765;9;1;1;1
258116496178;258116498590;2412;9;1;1;1
258116498590;258116499559;969;9;1;1;1
258116499559;258116499939;380;9;1;1;1
258116499939;258116538155;38216;9;1;1;1
258116538155;258116546808;8653;9;1;1;1
258116546808;258116561832;15024;9;1;1;1
258116610803;258116614903;4100;9;1;1;1
258116614903;258116617782;2879;9;1;1;1
258116617782;258116659890;42108;9;1;1;1
258116659890;258116669593;9703;9;1;1;1
258116669593;258116681581;11988;9;1;1;1
258116726566;258116774260;47694;9;1;1;1
258116775408;258116824630;49222;9;1;1;1
258116825510;258116872684;47174;9;1;1;1
258116872684;258116877319;4635;9;1;1;1
258116877319;258116878101;782;9;1;1;1
258116878101;258116884304;6203;9;1;1;1
258116884304;258116884377;73;9;1;1;1
258116884377;258116884663;286;9;1;1;1
258116884663;258116884697;34;9;1;1;1
258116884697;258116885717;1020;9;1;1;1
258116885717;258116894513;8796;9;1;1;1
258116894513;258116897117;2604;9;1;1;1
258116897117;258116902524;5407;9;1;1;1
258116903131;258116904197;1066;9;1;1;1
258116904197;258116915943;11746;9;1;1;1
258116915943;258116917166;1223;9;1;1;1
258116917166;258116917731;565;9;1;1;1
258116917731;258116917749;18;9;1;1;1
258116917749;258116949049;31300;9;1;1;1
258116949610;258116986167;36557;9;1;1;1
258116987712;258116988516;804;9;1;1;1
258116989799;258116992399;2600;9;1;1;1
258116992399;258116993419;1020;9;1;1;1
258116998753;258116999593;840;9;1;1;1
258117001196;258117007924;6728;9;1;1;1
258117009607;258117010548;941;9;1;1;1
258117011170;258117018769;7599;9;1;1;1
258117018769;258117028179;9410;9;1;1;1
258117028179;258117059003;30824;9;1;1;1
258117113927;258117148430;34503;9;1;1;1
258117148430;258117151487;3057;9;1;1;1
258117151487;258117158760;7273;9;1;1;1
258117211707;258117230306;18599;9;1;1;1
258117230306;258117239745;9439;9;1;1;1
258117239745;258117257893;18148;9;1;1;1
258117258505;258117268927;10422;9;1;1;1
258117268927;258117277988;9061;9;1;1;1
258117277988;258117290763;12775;9;1;1;1
258117292084;258117300465;8381;9;1;1;1
258117300465;258117301522;1057;9;1;1;1
258117301522;258117302218;696;9;1;1;1
258117302218;258117303332;1114;9;1;1;1
258117303332;258117311377;8045;9;1;1;1
258117311377;258117311770;393;9;1;1;1
258117311770;258117330745;18975;9;1;1;1
258117330745;258117332227;1482;9;1;1;1
258117332227;258117340394;8167;9;1;1;1
258117340394;258117340798;404;9;1;1;1
258117340798;258117370601;29803;9;1;1;1
258117371252;258117419147;47895;9;1;1;1
258117419716;258117456995;37279;9;1;1;1
258117457558;258117492998;35440;9;1;1;1
258117493728;258117618787;125059;9;1;1;1
258117620564;258117620798;234;9;1;1;1
258117622790;258117623620;830;9;1;1;1
258117624884;258117626279;1395;9;1;1;1
258117629096;258117631446;2350;9;1;1;1
258117650024;258117653296;3272;9;1;1;1
258117653939;258117713111;59172;9;1;1;1
258117716630;258117763139;46509;9;1;1;1
258117763139;258117772057;8918;9;1;1;1
258117772057;258117793820;21763;9;1;1;1
258117799148;258117800267;1119;9;1;1;1
258117803373;258117806860;3487;9;1;1;1
258117806860;258117815186;8326;9;1;1;1
258117815186;258117860911;45725;9;1;1;1
258117860911;258117863772;2861;9;1;1;1
258117863772;258117891450;27678;9;1;1;1
258117925422;258117954338;28916;9;1;1;1
258117954338;258117955173;835;9;1;1;1
258117955173;258117963917;8744;9;1;1;1
258117963917;258117964568;651;9;1;1;1
258117964568;258117975617;11049;9;1;1;1
258117975617;258117978601;2984;9;1;1;1
258117978601;258118017801;39200;9;1;1;1
258118017801;258118018724;923;9;1;1;1
258118018724;258118024182;5458;9;1;1;1
258118024182;258118029097;4915;9;1;1;1
258118029097;258118035963;6866;9;1;1;1
258118035963;258118036160;197;9;1;1;1
258118036160;258118037061;901;9;1;1;1
258118037061;258118045648;8587;9;1;1;1
258118045648;258118108616;62968;9;1;1;1
258118108616;258118111395;2779;9;1;1;1
258118111395;258118147618;36223;9;1;1;1
258118147618;258118156477;8859;9;1;1;1
258118156477;258118216618;60141;9;1;1;1
258118216618;258118223856;7238;9;1;1;1
258118223856;258118224457;601;9;1;1;1
258118224457;258118226240;1783;9;1;1;1
258118226240;258118227158;918;9;1;1;1
258118227158;258118233850;6692;9;1;1;1
258118233850;258118262685;28835;9;1;1;1
258118262685;258118271891;9206;9;1;1;1
258118271891;258118288783;16892;9;1;1;1
258118288783;258118291513;2730;9;1;1;1
258118291513;258118363664;72151;9;1;1;1
258118363664;258118372587;8923;9;1;1;1
258118372587;258118420280;47693;9;1;1;1
258118420280;258118428972;8692;9;1;1;1
258118428972;258118469723;40751;9;1;1;1
258118469723;258118479113;9390;9;1;1;1
258118479113;258118482435;3322;9;1;1;1
258118482435;258118482731;296;9;1;1;1
258118482731;258118492063;9332;9;1;1;1
258118492063;258118492670;607;9;1;1;1
258118492670;258118496308;3638;9;1;1;1
258118496308;258118499247;2939;9;1;1;1
258118499247;258118534757;35510;9;1;1;1
258118534757;258118543294;8537;9;1;1;1
258118543294;258118587619;44325;9;1;1;1
258118587619;258118596256;8637;9;1;1;1
258118596256;258118618128;21872;9;1;1;1
258118618128;258118621461;3333;9;1;1;1
258118621461;258118660250;38789;9;1;1;1
258118660250;258118660923;673;9;1;1;1
258118660923;258118670120;9197;9;1;1;1
258118670120;258118671176;1056;9;1;1;1
258118671176;258118671998;822;9;1;1;1
258118671998;258118677126;5128;9;1;1;1
258118677126;258118679734;2608;9;1;1;1
258118679734;258118686408;6674;9;1;1;1
258118686408;258118708091;21683;9;1;1;1
258118708091;258118710977;2886;9;1;1;1
258118710977;258118748314;37337;9;1;1;1
258118748314;258118757581;9267;9;1;1;1
258118757581;258118788575;30994;9;1;1;1
258118788575;258118793161;4586;9;1;1;1
258118793161;258118793838;677;9;1;1;1
258118793838;258118796350;2512;9;1;1;1
258118796350;258118838420;42070;9;1;1;1
258118838420;258118847617;9197;9;1;1;1
258118847617;258118881773;34156;9;1;1;1
258118881773;258118890323;8550;9;1;1;1
258118890323;258118917526;27203;9;1;1;1
258118917526;258118920334;2808;9;1;1;1
258118920334;258118957440;37106;9;1;1;1
258118957440;258118966273;8833;9;1;1;1
258118966273;258118999129;32856;9;1;1;1
258118999129;258119000533;1404;9;1;1;1
258119000533;258119002487;1954;9;1;1;1
258119002487;258119003847;1360;9;1;1;1
258119003847;258119018655;14808;9;1;1;1
258119018655;258119023019;4364;9;1;1;1
258119023019;258119095033;72014;9;1;1;1
258119095033;258119103914;8881;9;1;1;1
258119103914;258119135636;31722;9;1;1;1
258119135636;258119144391;8755;9;1;1;1
258119144391;258119184875;40484;9;1;1;1
258119184875;258119188634;3759;9;1;1;1
258119188634;258119188813;179;9;1;1;1
258119188813;258119193092;4279;9;1;1;1
258119193092;258119193644;552;9;1;1;1
258119193644;258119194132;488;9;1;1;1
258119194132;258119195898;1766;9;1;1;1
258119195898;258119196457;559;9;1;1;1
258119196457;258119197781;1324;9;1;1;1
258119197781;258119205038;7257;9;1;1;1
258119205038;258119234939;29901;9;1;1;1
258119234939;258119243282;8343;9;1;1;1
258119243282;258119292236;48954;9;1;1;1
258119292236;258119301683;9447;9;1;1;1
258119301683;258119338580;36897;9;1;1;1
258119338580;258119341480;2900;9;1;1;1
258119341480;258119379385;37905;9;1;1;1
258119379385;258119388425;9040;9;1;1;1
258119388425;258119390963;2538;9;1;1;1
258119390963;258119393225;2262;9;1;1;1
258119393225;258119394281;1056;9;1;1;1
258119394281;258119396202;1921;9;1;1;1
258119396202;258119430824;34622;9;1;1;1
258119430824;258119432987;2163;9;1;1;1
258119432987;258119439728;6741;9;1;1;1
258119439728;258119440102;374;9;1;1;1
258119440102;258119467146;27044;9;1;1;1
258119467146;258119470116;2970;9;1;1;1
258119470116;258119518677;48561;9;1;1;1
258119518677;258119527236;8559;9;1;1;1
258119527236;258119560734;33498;9;1;1;1
258119560734;258119570222;9488;9;1;1;1
258119570222;258119598669;28447;9;1;1;1
258119598669;258119606108;7439;9;1;1;1
258119606108;258119607420;1312;9;1;1;1
258119607420;258119616304;8884;9;1;1;1
258119616304;258119793826;177522;9;1;1;1
258119793826;258119799486;5660;9;1;1;1
258119799486;258119801670;2184;9;1;1;1
258119801670;258119802937;1267;9;1;1;1
258119802937;258119857678;54741;9;1;1;1
258119857678;258119858198;520;9;1;1;1
258119858198;258119858818;620;9;1;1;1
258119858818;258119860522;1704;9;1;1;1
258119860522;258119861408;886;9;1;1;1
258119861408;258119861531;123;9;1;1;1
258119861531;258119899491;37960;9;1;1;1
258119899491;258119900213;722;9;1;1;1
258119900213;258119908083;7870;9;1;1;1
258119908083;258119909035;952;9;1;1;1
258119909035;258119937578;28543;9;1;1;1
258119937578;258119940469;2891;9;1;1;1
258119940469;258119941779;1310;9;1;1;1
258119941779;258119942263;484;9;1;1;1
258119942263;258119950863;8600;9;1;1;1
258119950863;258119951524;661;9;1;1;1
258119951524;258119979629;28105;9;1;1;1
258119979629;258119989109;9480;9;1;1;1
258119989109;258120010695;21586;9;1;1;1
258120018012;258120020287;2275;9;1;1;1
258120020287;258120027214;6927;9;1;1;1
258120027214;258120027816;602;9;1;1;1
258120027816;258120102938;75122;9;1;1;1
258120103596;258120143986;40390;9;1;1;1
258120144621;258120190169;45548;9;1;1;1
258120191068;258120196439;5371;9;1;1;1
258120196439;258120199383;2944;9;1;1;1
258120199383;258120206270;6887;9;1;1;1
258120206270;258120209277;3007;9;1;1;1
258120209277;258120241464;32187;9;1;1;1
258120242023;258120248039;6016;9;1;1;1
258120248039;258120256355;8316;9;1;1;1
258120256355;258120257864;1509;9;1;1;1
258120257864;258120266795;8931;9;1;1;1
258120266795;258120267323;528;9;1;1;1
258120267323;258120269523;2200;9;1;1;1
258120269523;258120270597;1074;9;1;1;1
258120270597;258120272707;2110;9;1;1;1
258120272707;258120308113;35406;9;1;1;1
258120308113;258120316932;8819;9;1;1;1
258120316932;258120334833;17901;9;1;1;1
258120334833;258120344053;9220;9;1;1;1
258120344053;258120359150;15097;9;1;1;1
258120360757;258120377599;16842;9;1;1;1
258120377599;258120386400;8801;9;1;1;1
258120386400;258120417032;30632;9;1;1;1
258120417663;258120498244;80581;9;1;1;1
258120498244;258120499238;994;9;1;1;1
258120499238;258120503218;3980;9;1;1;1
258120503218;258120504074;856;9;1;1;1
258120504074;258120504588;514;9;1;1;1
258120504588;258120504995;407;9;1;1;1
258120504995;258120507216;2221;9;1;1;1
258120507216;258120513428;6212;9;1;1;1
258120513428;258120545797;32369;9;1;1;1
258120545797;258120548511;2714;9;1;1;1
258120548511;258120599322;50811;9;1;1;1
258120599322;258120608481;9159;9;1;1;1
258120608481;258120608669;188;9;1;1;1
258120608669;258120618802;10133;9;1;1;1
258120618802;258120621480;2678;9;1;1;1
258120621480;258120630934;9454;9;1;1;1
258120630934;258120634146;3212;9;1;1;1
258120634146;258120643000;8854;9;1;1;1
258120643000;258120652821;9821;9;1;1;1
258120653432;258120676861;23429;9;1;1;1
258120676861;258120679808;2947;9;1;1;1
258120679808;258120709758;29950;9;1;1;1
258120711369;258120721763;10394;9;1;1;1
258120721763;258120724751;2988;9;1;1;1
258120724751;258120756385;31634;9;1;1;1
258120761368;258120800179;38811;9;1;1;1
258120800179;258120800381;202;9;1;1;1
258120800381;258120805374;4993;9;1;1;1
258120809685;258120815139;5454;9;1;1;1
258120815139;258120828016;12877;9;1;1;1
258120828016;258120837181;9165;9;1;1;1
258120837181;258120858953;21772;9;1;1;1
258120858953;258120867921;8968;9;1;1;1
258120867921;258120936632;68711;9;1;1;1
258120936632;258120939354;2722;9;1;1;1
258120939354;258120976636;37282;9;1;1;1
258120976636;258120979611;2975;9;1;1;1
258120979611;258121008612;29001;9;1;1;1
258121009332;258121027946;18614;9;1;1;1
258121027946;258121037670;9724;9;1;1;1
258121037670;258121047799;10129;9;1;1;1
258121047799;258121056434;8635;9;1;1;1
258121056434;258121061114;4680;9;1;1;1
258121061114;258121063959;2845;9;1;1;1
258121063959;258121086883;22924;9;1;1;1
258121091752;258121092267;515;9;1;1;1
258121092865;258121099650;6785;9;1;1;1
258121099650;258121124219;24569;9;1;1;1
258121124806;258121128895;4089;9;1;1;1
258121128895;258121137405;8510;9;1;1;1
258121137405;258121174482;37077;9;1;1;1
258121175031;258121204766;29735;9;1;1;1
258121204766;258121213536;8770;9;1;1;1
258121213536;258121234019;20483;9;1;1;1
258121234646;258121241888;7242;9;1;1;1
258121241888;258121251253;9365;9;1;1;1
258121251253;258121281247;29994;9;1;1;1
258121281247;258121284278;3031;9;1;1;1
258121284278;258121291181;6903;9;1;1;1
258121291181;258121293929;2748;9;1;1;1
258121293929;258121330451;36522;9;1;1;1
258121331616;258121353767;22151;9;1;1;1
258121353767;258121358759;4992;9;1;1;1
258121358759;258121359391;632;9;1;1;1
258121359391;258121360942;1551;9;1;1;1
258121360942;258121362492;1550;9;1;1;1
258121362492;258121364805;2313;9;1;1;1
258121364805;258121365768;963;9;1;1;1
258121365768;258121366836;1068;9;1;1;1
258121366836;258121366873;37;9;1;1;1
258121366873;258121376599;9726;9;1;1;1
258121376599;258121377659;1060;9;1;1;1
258121377659;258121381085;3426;9;1;1;1
258121381085;258121382823;1738;9;1;1;1
258121382823;258121389299;6476;9;1;1;1
258121390210;258121391517;1307;9;1;1;1
258121391517;258121432787;41270;9;1;1;1
258121432787;258121433738;951;9;1;1;1
258121469762;258121473223;3461;9;1;1;1
258121473223;258121481703;8480;9;1;1;1
258121481703;258121497755;16052;9;1;1;1
258121498380;258121552157;53777;9;1;1;1
258121552157;258121561231;9074;9;1;1;1
258121561231;258121562523;1292;9;1;1;1
258121562523;258121572446;9923;9;1;1;1
258121572446;258121600848;28402;9;1;1;1
258121602845;258121604546;1701;9;1;1;1
258121604546;258121605098;552;9;1;1;1
258121605098;258121608292;3194;9;1;1;1
258121608292;258121644392;36100;9;1;1;1
258121645046;258121682813;37767;9;1;1;1
258121682813;258121686123;3310;9;1;1;1
258121686123;258121694055;7932;9;1;1;1
258121695187;258121722627;27440;9;1;1;1
258121722627;258121732134;9507;9;1;1;1
258121732134;258121760039;27905;9;1;1;1
258121760039;258121760825;786;9;1;1;1
258121760825;258121763809;2984;9;1;1;1
258121764373;258121768874;4501;9;1;1;1
258121768874;258121775947;7073;9;1;1;1
258121775947;258121787950;12003;9;1;1;1
258121787950;258121796498;8548;9;1;1;1
258121796498;258121811376;14878;9;1;1;1
258121812051;258121824093;12042;9;1;1;1
258121824093;258121824826;733;9;1;1;1
258121824826;258121826971;2145;9;1;1;1
258121826971;258121833605;6634;9;1;1;1
258121833605;258121835841;2236;9;1;1;1
258121835841;258121844260;8419;9;1;1;1
258121844260;258121871060;26800;9;1;1;1
258121871060;258121881146;10086;9;1;1;1
258121881146;258121899318;18172;9;1;1;1
258121900151;258121954070;53919;9;1;1;1
258121954756;258121982331;27575;9;1;1;1
258121982331;258121984858;2527;9;1;1;1
258121984858;258121985367;509;9;1;1;1
258121985367;258121986224;857;9;1;1;1
258121986224;258121988312;2088;9;1;1;1
258121988312;258121989234;922;9;1;1;1
258121989234;258122070243;81009;9;1;1;1
258122070243;258122073401;3158;9;1;1;1
258122074528;258122077827;3299;9;1;1;1
258122078423;258122078504;81;9;1;1;1
258122079340;258122111509;32169;9;1;1;1
258122111509;258122120140;8631;9;1;1;1
258122120140;258122122442;2302;9;1;1;1
258122122442;258122131606;9164;9;1;1;1
258122131606;258122134136;2530;9;1;1;1
258122135059;258122169517;34458;9;1;1;1
258122169517;258122172328;2811;9;1;1;1
258122172328;258122184408;12080;9;1;1;1
258122213418;258122233244;19826;9;1;1;1
258122233244;258122236752;3508;9;1;1;1
258122237390;258122242727;5337;9;1;1;1
258122242727;258122277339;34612;9;1;1;1
258122277339;258122280053;2714;9;1;1;1
258122280053;258122310496;30443;9;1;1;1
258122310496;258122313119;2623;9;1;1;1
258122313119;258122319958;6839;9;1;1;1
258122320526;258122341649;21123;9;1;1;1
258122341649;258122350439;8790;9;1;1;1
258122350439;258122382242;31803;9;1;1;1
258122383447;258122432005;48558;9;1;1;1
258122432005;258122440766;8761;9;1;1;1
258122440766;258122458614;17848;9;1;1;1
258122459247;258122472664;13417;9;1;1;1
258122472664;258122474917;2253;9;1;1;1
258122474917;258122481305;6388;9;1;1;1
258122481305;258122482969;1664;9;1;1;1
258122482969;258122483864;895;9;1;1;1
258122483864;258122485108;1244;9;1;1;1
258122485108;258122493227;8119;9;1;1;1
258122493227;258122494302;1075;9;1;1;1
258122494302;258122501496;7194;9;1;1;1
258122501496;258122503427;1931;9;1;1;1
258122503427;258122525581;22154;9;1;1;1
258122526228;258122533895;7667;9;1;1;1
258122533895;258122536028;2133;9;1;1;1
258122536028;258122537285;1257;9;1;1;1
258122537285;258122538887;1602;9;1;1;1
258122538887;258122553190;14303;9;1;1;1
258122553727;258122572433;18706;9;1;1;1
258122572433;258122581219;8786;9;1;1;1
258122581219;258122601573;20354;9;1;1;1
258122601573;258122604604;3031;9;1;1;1
258122604604;258122609784;5180;9;1;1;1
258122610703;258122659482;48779;9;1;1;1
258122660102;258122666672;6570;9;1;1;1
258122666672;258122675250;8578;9;1;1;1
258122675250;258122707397;32147;9;1;1;1
258122707397;258122710462;3065;9;1;1;1
258122710462;258122722326;11864;9;1;1;1
258122722873;258122768999;46126;9;1;1;1
258122769800;258122779171;9371;9;1;1;1
258122779171;258122788752;9581;9;1;1;1
258122788752;258122809195;20443;9;1;1;1
258122809195;258122817559;8364;9;1;1;1
258122817559;258122821196;3637;9;1;1;1
258122821196;258122824802;3606;9;1;1;1
258122824802;258122824833;31;9;1;1;1
258122824833;258122827748;2915;9;1;1;1
258122827748;258122832071;4323;9;1;1;1
258122832071;258122841529;9458;9;1;1;1
258122841529;258122857597;16068;9;1;1;1
258122858492;258122882389;23897;9;1;1;1
258122882389;258122891088;8699;9;1;1;1
258122891088;258122905612;14524;9;1;1;1
258122906249;258122911810;5561;9;1;1;1
258122911810;258122914443;2633;9;1;1;1
258122914443;258122986243;71800;9;1;1;1
258122987297;258123009716;22419;9;1;1;1
258123010276;258123061226;50950;9;1;1;1
258123061226;258123069777;8551;9;1;1;1
258123069777;258123100702;30925;9;1;1;1
258123100702;258123102637;1935;9;1;1;1
258123102637;258123103915;1278;9;1;1;1
258123103915;258123105873;1958;9;1;1;1
258123105873;258123117454;11581;9;1;1;1
258123118006;258123173216;55210;9;1;1;1
258123173216;258123182488;9272;9;1;1;1
258123182488;258123185108;2620;9;1;1;1
258123185108;258123194138;9030;9;1;1;1
258123194138;258123195766;1628;9;1;1;1
258123195766;258123199106;3340;9;1;1;1
258123199106;258123199680;574;9;1;1;1
258123199680;258123203452;3772;9;1;1;1
258123203452;258123203601;149;9;1;1;1
258123203601;258123204846;1245;9;1;1;1
258123204846;258123207040;2194;9;1;1;1
258123207040;258123207621;581;9;1;1;1
258123207621;258123208375;754;9;1;1;1
258123208375;258123209849;1474;9;1;1;1
258123209849;258123210415;566;9;1;1;1
258123211206;258123246744;35538;9;1;1;1
258123246744;258123255983;9239;9;1;1;1
258123255983;258123285537;29554;9;1;1;1
258123285537;258123294446;8909;9;1;1;1
258123294446;258123322682;28236;9;1;1;1
258123322682;258123324783;2101;9;1;1;1
258123324783;258123326044;1261;9;1;1;1
258123326044;258123328027;1983;9;1;1;1
258123328027;258123363294;35267;9;1;1;1
258123363294;258123371895;8601;9;1;1;1
258123371895;258123372420;525;9;1;1;1
258123373215;258123402899;29684;9;1;1;1
258123402899;258123411665;8766;9;1;1;1
258123411665;258123421950;10285;9;1;1;1
258123422701;258123433833;11132;9;1;1;1
258123433833;258123442422;8589;9;1;1;1
258123442422;258123476164;33742;9;1;1;1
258123480945;258123522498;41553;9;1;1;1
258123557193;258123567789;10596;9;1;1;1
258123567789;258123568137;348;9;1;1;1
258123568137;258123570429;2292;9;1;1;1
258123570429;258123578281;7852;9;1;1;1
258123578281;258123597756;19475;9;1;1;1
258123598305;258123606772;8467;9;1;1;1
258123606772;258123608942;2170;9;1;1;1
258123608942;258123610424;1482;9;1;1;1
258123610424;258123612051;1627;9;1;1;1
258123612051;258123616793;4742;9;1;1;1
258123616793;258123626669;9876;9;1;1;1
258123626669;258123658007;31338;9;1;1;1
258123658007;258123666532;8525;9;1;1;1
258123666532;258123696799;30267;9;1;1;1
258123696799;258123698178;1379;9;1;1;1
258123698178;258123706206;8028;9;1;1;1
258123706206;258123706898;692;9;1;1;1
258123706898;258123707836;938;9;1;1;1
258123707836;258123711151;3315;9;1;1;1
258123713168;258123714801;1633;9;1;1;1
258123714801;258123739287;24486;9;1;1;1
258123739860;258123813477;73617;9;1;1;1
258123814034;258123831093;17059;9;1;1;1
258123831093;258123840429;9336;9;1;1;1
258123840429;258123890797;50368;9;1;1;1
258123891344;258123929171;37827;9;1;1;1
258123929171;258123937993;8822;9;1;1;1
258123937993;258123953835;15842;9;1;1;1
258123955239;258123968267;13028;9;1;1;1
258123968267;258123970746;2479;9;1;1;1
258123970746;258123971056;310;9;1;1;1
258123971056;258123974116;3060;9;1;1;1
258123974116;258123982551;8435;9;1;1;1
258123982551;258123985227;2676;9;1;1;1
258123985227;258124022998;37771;9;1;1;1
258124022998;258124023701;703;9;1;1;1
258124023701;258124032058;8357;9;1;1;1
258124032058;258124039233;7175;9;1;1;1
258124039233;258124042809;3576;9;1;1;1
258124043390;258124096515;53125;9;1;1;1
258124097173;258124198446;101273;9;1;1;1
258124199076;258124248709;49633;9;1;1;1
258124249353;258124333372;84019;9;1;1;1
258124333998;258124356489;22491;9;1;1;1
258124356489;258124365388;8899;9;1;1;1
258124365388;258124380222;14834;9;1;1;1
258124380844;258124412167;31323;9;1;1;1
258124412167;258124413063;896;9;1;1;1
258124413063;258124421103;8040;9;1;1;1
258124421103;258124421490;387;9;1;1;1
258124421490;258124487175;65685;9;1;1;1
258124487175;258124496736;9561;9;1;1;1
258124496736;258124515836;19100;9;1;1;1
258124516444;258124527268;10824;9;1;1;1
258124527268;258124530346;3078;9;1;1;1
258124530346;258124543507;13161;9;1;1;1
258124543507;258124544142;635;9;1;1;1
258124544142;258124552842;8700;9;1;1;1
258124552842;258124553305;463;9;1;1;1
258124553305;258124558974;5669;9;1;1;1
258124610208;258124640907;30699;9;1;1;1
258124640907;258124643901;2994;9;1;1;1
258124643901;258124670264;26363;9;1;1;1
258124670906;258124677628;6722;9;1;1;1
258124677628;258124687334;9706;9;1;1;1
258124687334;258124721650;34316;9;1;1;1
258124721650;258124724499;2849;9;1;1;1
258124724499;258124731537;7038;9;1;1;1
258124731537;258124740416;8879;9;1;1;1
258124740416;258124745076;4660;9;1;1;1
258124745731;258124751586;5855;9;1;1;1
258124751586;258124759814;8228;9;1;1;1
258124759814;258124789194;29380;9;1;1;1
258124789823;258124823248;33425;9;1;1;1
258124823248;258124826183;2935;9;1;1;1
258124826183;258124846518;20335;9;1;1;1
258124847644;258124861610;13966;9;1;1;1
258124861610;258124871074;9464;9;1;1;1
258124871074;258124894174;23100;9;1;1;1
258124894174;258124894313;139;9;1;1;1
258124894313;258124902866;8553;9;1;1;1
258124902866;258124903923;1057;9;1;1;1
258124903923;258124938920;34997;9;1;1;1
258124939616;258124956686;17070;9;1;1;1
258124956686;258124965735;9049;9;1;1;1
258124965735;258125013593;47858;9;1;1;1
258125014152;258125021826;7674;9;1;1;1
258125021826;258125024602;2776;9;1;1;1
258125024602;258125032507;7905;9;1;1;1
258125032507;258125035439;2932;9;1;1;1
258125035439;258125044047;8608;9;1;1;1
258125044047;258125052404;8357;9;1;1;1
258125052404;258125084938;32534;9;1;1;1
258125084938;258125087972;3034;9;1;1;1
258125088615;258125094208;5593;9;1;1;1
258125094208;258125135375;41167;9;1;1;1
258125135375;258125144292;8917;9;1;1;1
258125144292;258125172938;28646;9;1;1;1
258125172938;258125175640;2702;9;1;1;1
258125175640;258125178321;2681;9;1;1;1
258125178973;258125246141;67168;9;1;1;1
258125246141;258125247311;1170;9;1;1;1
258125248612;258125254730;6118;9;1;1;1
258125254730;258125301891;47161;9;1;1;1
258125302488;258125309914;7426;9;1;1;1
258125309914;258125318719;8805;9;1;1;1
258125318719;258125350687;31968;9;1;1;1
258125351236;258125352195;959;9;1;1;1
258125352195;258125354843;2648;9;1;1;1
258125354843;258125364982;10139;9;1;1;1
258125364982;258125366976;1994;9;1;1;1
258125366976;258125368870;1894;9;1;1;1
258125368870;258125369447;577;9;1;1;1
258125369447;258125370383;936;9;1;1;1
258125370383;258125372205;1822;9;1;1;1
258125372205;258125400446;28241;9;1;1;1
258125407966;258125423196;15230;9;1;1;1
258125423196;258125431955;8759;9;1;1;1
258125431955;258125454256;22301;9;1;1;1
258125454889;258125465620;10731;9;1;1;1
258125465620;258125474537;8917;9;1;1;1
258125474537;258125502280;27743;9;1;1;1
258125502280;258125508895;6615;9;1;1;1
258125509454;258125511723;2269;9;1;1;1
258125511723;258125555142;43419;9;1;1;1
258125555142;258125558074;2932;9;1;1;1
258125558074;258125604711;46637;9;1;1;1
258125604711;258125613278;8567;9;1;1;1
258125613278;258125625963;12685;9;1;1;1
258125626520;258125647482;20962;9;1;1;1
258125647482;258125656214;8732;9;1;1;1
258125656214;258125656845;631;9;1;1;1
258125656845;258125665525;8680;9;1;1;1
258125665525;258125696272;30747;9;1;1;1
258125697421;258125732710;35289;9;1;1;1
258125732710;258125735457;2747;9;1;1;1
258125735457;258125760680;25223;9;1;1;1
258125761753;258125777698;15945;9;1;1;1
258125777698;258125782380;4682;9;1;1;1
258125782380;258125783925;1545;9;1;1;1
258125783925;258125786019;2094;9;1;1;1
258125786019;258125808771;22752;9;1;1;1
258125808771;258125810498;1727;9;1;1;1
258125811130;258125817954;6824;9;1;1;1
258125817954;258125818064;110;9;1;1;1
258125818064;258125826827;8763;9;1;1;1
258125826827;258125851995;25168;9;1;1;1
258125851995;258125861283;9288;9;1;1;1
258125861283;258125882018;20735;9;1;1;1
258125883513;258125885278;1765;9;1;1;1
258125885920;258125893671;7751;9;1;1;1
258125893671;258125900656;6985;9;1;1;1
258125900656;258125901168;512;9;1;1;1
258125901168;258125902654;1486;9;1;1;1
258125902654;258125903643;989;9;1;1;1
258125903643;258125910443;6800;9;1;1;1
258125910443;258125933327;22884;9;1;1;1
258125933870;258125951168;17298;9;1;1;1
258125951168;258125960024;8856;9;1;1;1
258125960024;258125981550;21526;9;1;1;1
258125981550;258125984510;2960;9;1;1;1
258125984510;258126021082;36572;9;1;1;1
258126021082;258126029605;8523;9;1;1;1
258126029605;258126030812;1207;9;1;1;1
258126031757;258126077876;46119;9;1;1;1
258126078693;258126098431;19738;9;1;1;1
258126098431;258126101082;2651;9;1;1;1
258126101082;258126135244;34162;9;1;1;1
258126135757;258126182065;46308;9;1;1;1
258126182065;258126182787;722;9;1;1;1
258126182787;258126188972;6185;9;1;1;1
258126188972;258126191170;2198;9;1;1;1
258126191170;258126192356;1186;9;1;1;1
258126192356;258126192966;610;9;1;1;1
258126192966;258126198455;5489;9;1;1;1
258126198455;258126199555;1100;9;1;1;1
258126199555;258126201679;2124;9;1;1;1
258126201679;258126208327;6648;9;1;1;1
258126208327;258126210414;2087;9;1;1;1
258126210414;258126212576;2162;9;1;1;1
258126212576;258126214044;1468;9;1;1;1
258126214044;258126216337;2293;9;1;1;1
258126216337;258126230572;14235;9;1;1;1
258126231191;258126242071;10880;9;1;1;1
258126242071;258126244713;2642;9;1;1;1
258126244713;258126272057;27344;9;1;1;1
258126272601;258126280446;7845;9;1;1;1
258126280446;258126288984;8538;9;1;1;1
258126288984;258126319951;30967;9;1;1;1
258126319951;258126328246;8295;9;1;1;1
258126328246;258126348920;20674;9;1;1;1
258126349616;258126389386;39770;9;1;1;1
258126389386;258126393081;3695;9;1;1;1
258126393081;258126395489;2408;9;1;1;1
258126395489;258126396191;702;9;1;1;1
258126396191;258126399134;2943;9;1;1;1
258126399134;258126400484;1350;9;1;1;1
258126400484;258126421680;21196;9;1;1;1
258126421680;258126431247;9567;9;1;1;1
258126431247;258126472866;41619;9;1;1;1
258126473335;258126515054;41719;9;1;1;1
258126515054;258126524696;9642;9;1;1;1
258126525193;258126551193;26000;9;1;1;1
258126551193;258126551992;799;9;1;1;1
258126551992;258126554518;2526;9;1;1;1
258126554518;258126561127;6609;9;1;1;1
258126561127;258126566566;5439;9;1;1;1
258126567043;258126595474;28431;9;1;1;1
258126595474;258126604445;8971;9;1;1;1
258126604445;258126606854;2409;9;1;1;1
258126607395;258126656124;48729;9;1;1;1
258126656124;258126657887;1763;9;1;1;1
258126657887;258126658883;996;9;1;1;1
258126658883;258126660740;1857;9;1;1;1
258126660740;258126678190;17450;9;1;1;1
258126678190;258126680333;2143;9;1;1;1
258126680333;258126688583;8250;9;1;1;1
258126688583;258126689251;668;9;1;1;1
258126689251;258126701367;12116;9;1;1;1
258126701367;258126710659;9292;9;1;1;1
258126710659;258126720032;9373;9;1;1;1
258126720562;258126745276;24714;9;1;1;1
258126745276;258126748258;2982;9;1;1;1
258126748258;258126789629;41371;9;1;1;1
258126790118;258126790352;234;9;1;1;1
258126790352;258126801431;11079;9;1;1;1
258126801431;258126822959;21528;9;1;1;1
258126822959;258126826989;4030;9;1;1;1
258126831049;258126831445;396;9;1;1;1
258126831445;258126832767;1322;9;1;1;1
258126832767;258126840104;7337;9;1;1;1
258126840104;258126864547;24443;9;1;1;1
258126864547;258126873784;9237;9;1;1;1
258126873784;258126917802;44018;9;1;1;1
258126918274;258126924994;6720;9;1;1;1
258126924994;258126928490;3496;9;1;1;1
258126928490;258126980695;52205;9;1;1;1
258126980695;258126983739;3044;9;1;1;1
258126983739;258126997327;13588;9;1;1;1
258126997327;258127006889;9562;9;1;1;1
258127006889;258127041834;34945;9;1;1;1
258127041834;258127045383;3549;9;1;1;1
258127045383;258127055421;10038;9;1;1;1
258127059697;258127081840;22143;9;1;1;1
258127081840;258127090215;8375;9;1;1;1
258127090215;258127091236;1021;9;1;1;1
258127091236;258127100862;9626;9;1;1;1
258127100862;258127163603;62741;9;1;1;1
258127164634;258127194475;29841;9;1;1;1
258127194475;258127194781;306;9;1;1;1
258127194781;258127197252;2471;9;1;1;1
258127197252;258127203769;6517;9;1;1;1
258127203769;258127205510;1741;9;1;1;1
258127205510;258127215097;9587;9;1;1;1
258127215097;258127226887;11790;9;1;1;1
258127227368;258127247022;19654;9;1;1;1
258127247022;258127255729;8707;9;1;1;1
258127255729;258127324509;68780;9;1;1;1
258127324509;258127327507;2998;9;1;1;1
258127327507;258127335032;7525;9;1;1;1
258127335032;258127336902;1870;9;1;1;1
258127336902;258127337938;1036;9;1;1;1
258127337938;258127339867;1929;9;1;1;1
258127339867;258127340885;1018;9;1;1;1
258127341376;258127344234;2858;9;1;1;1
258127344724;258127345214;490;9;1;1;1
258127345807;258127379497;33690;9;1;1;1
258127379965;258127384597;4632;9;1;1;1
258127384597;258127393341;8744;9;1;1;1
258127393341;258127418879;25538;9;1;1;1
258127419461;258127442090;22629;9;1;1;1
258127442090;258127444885;2795;9;1;1;1
258127444885;258127481258;36373;9;1;1;1
258127481258;258127481533;275;9;1;1;1
258127481533;258127489867;8334;9;1;1;1
258127489867;258127496726;6859;9;1;1;1
258127496726;258127541362;44636;9;1;1;1
258127541842;258127585124;43282;9;1;1;1
258127585734;258127617887;32153;9;1;1;1
258127617887;258127627230;9343;9;1;1;1
258127627230;258127640028;12798;9;1;1;1
258127640659;258127649941;9282;9;1;1;1
258127649941;258127660077;10136;9;1;1;1
258127660077;258127660221;144;9;1;1;1
258127660221;258127661205;984;9;1;1;1
258127661205;258127663964;2759;9;1;1;1
258127663964;258127664137;173;9;1;1;1
258127664137;258127665051;914;9;1;1;1
258127665051;258127665212;161;9;1;1;1
258127665212;258127668394;3182;9;1;1;1
258127668394;258127669256;862;9;1;1;1
258127669256;258127692981;23725;9;1;1;1
258127692981;258127695776;2795;9;1;1;1
258127695776;258127704779;9003;9;1;1;1
258127705310;258127731810;26500;9;1;1;1
258127731810;258127738227;6417;9;1;1;1
258127738227;258127740297;2070;9;1;1;1
258127740297;258127741831;1534;9;1;1;1
258127741831;258127744189;2358;9;1;1;1
258127744678;258127747263;2585;9;1;1;1
258127747263;258127748891;1628;9;1;1;1
258127748891;258127789028;40137;9;1;1;1
258127789028;258127798527;9499;9;1;1;1
258127798527;258127799840;1313;9;1;1;1
258127799840;258127809427;9587;9;1;1;1
258127809427;258127845507;36080;9;1;1;1
258127845507;258127848161;2654;9;1;1;1
258127848161;258127854745;6584;9;1;1;1
258127855209;258127887398;32189;9;1;1;1
258127887398;258127890049;2651;9;1;1;1
258127890049;258127897779;7730;9;1;1;1
258127897779;258127907310;9531;9;1;1;1
258127907310;258127922448;15138;9;1;1;1
258127923005;258127967625;44620;9;1;1;1
258127968092;258128046564;78472;9;1;1;1
258128047587;258128131656;84069;9;1;1;1
258128132153;258128197196;65043;9;1;1;1
258128197660;258128232723;35063;9;1;1;1
258128233325;258128244229;10904;9;1;1;1
258128244229;258128247536;3307;9;1;1;1
258128247536;258128247958;422;9;1;1;1
258128247958;258128251142;3184;9;1;1;1
258128251142;258128313131;61989;9;1;1;1
258128313852;258128333820;19968;9;1;1;1
258128333820;258128342382;8562;9;1;1;1
258128342382;258128380097;37715;9;1;1;1
258128380097;258128383247;3150;9;1;1;1
258128383711;258128388452;4741;9;1;1;1
258128388452;258128391430;2978;9;1;1;1
258128391430;258128393127;1697;9;1;1;1
258128393127;258128400477;7350;9;1;1;1
258128400477;258128400901;424;9;1;1;1
258128400901;258128402887;1986;9;1;1;1
258128402887;258128403230;343;9;1;1;1
258128403230;258128404956;1726;9;1;1;1
258128404956;258128406057;1101;9;1;1;1
258128406057;258128408221;2164;9;1;1;1
258128408221;258128410944;2723;9;1;1;1
258128410944;258128444376;33432;9;1;1;1
258128444376;258128445106;730;9;1;1;1
258128445106;258128447450;2344;9;1;1;1
258128447450;258128448575;1125;9;1;1;1
258128448575;258128463921;15346;9;1;1;1
258128464396;258128554319;89923;9;1;1;1
258128554319;258128554381;62;9;1;1;1
258128555025;258128557019;1994;9;1;1;1
258128557019;258128600656;43637;9;1;1;1
258128600656;258128609603;8947;9;1;1;1
258128609603;258128611764;2161;9;1;1;1
258128611764;258128614030;2266;9;1;1;1
258128614834;258128620970;6136;9;1;1;1
258128620970;258128623975;3005;9;1;1;1
258128623975;258128632723;8748;9;1;1;1
258128632723;258128669026;36303;9;1;1;1
258128669026;258128671787;2761;9;1;1;1
258128671787;258128692270;20483;9;1;1;1
258128692897;258128752449;59552;9;1;1;1
258128752449;258128755141;2692;9;1;1;1
258128755141;258128756067;926;9;1;1;1
258128756067;258128756384;317;9;1;1;1
258128756384;258128765889;9505;9;1;1;1
258128765889;258128771599;5710;9;1;1;1
258128771599;258128773411;1812;9;1;1;1
258128773878;258128804538;30660;9;1;1;1
258128804538;258128812672;8134;9;1;1;1
258128812672;258128814145;1473;9;1;1;1
258128814145;258128815987;1842;9;1;1;1
258128815987;258128822058;6071;9;1;1;1
258128822058;258128824457;2399;9;1;1;1
258128824457;258128829920;5463;9;1;1;1
258128830549;258128859636;29087;9;1;1;1
258128859636;258128862309;2673;9;1;1;1
258128862309;258128875316;13007;9;1;1;1
258128875815;258128953867;78052;9;1;1;1
258128954342;258128957121;2779;9;1;1;1
258128957121;258128958960;1839;9;1;1;1
258128958960;258128960337;1377;9;1;1;1
258128960337;258128961789;1452;9;1;1;1
258128961789;258128966958;5169;9;1;1;1
258128966958;258128976188;9230;9;1;1;1
258128976188;258129006700;30512;9;1;1;1
258129006700;258129015844;9144;9;1;1;1
258129016396;258129016491;95;9;1;1;1
258129016491;258129016681;190;9;1;1;1
258129016681;258129019962;3281;9;1;1;1
258129019962;258129064240;44278;9;1;1;1
258129064704;258129078685;13981;9;1;1;1
258129078685;258129081435;2750;9;1;1;1
258129081435;258129096856;15421;9;1;1;1
258129097368;258129118236;20868;9;1;1;1
258129118236;258129121053;2817;9;1;1;1
258129121053;258129159165;38112;9;1;1;1
258129159165;258129159851;686;9;1;1;1
258129159851;258129161779;1928;9;1;1;1
258129161779;258129167723;5944;9;1;1;1
258129167723;258129170273;2550;9;1;1;1
258129170273;258129170671;398;9;1;1;1
258129170671;258129173290;2619;9;1;1;1
258129173742;258129213192;39450;9;1;1;1
258129213645;258129231286;17641;9;1;1;1
258129231286;258129240005;8719;9;1;1;1
258129240005;258129242671;2666;9;1;1;1
258129242671;258129252067;9396;9;1;1;1
258129252067;258129277187;25120;9;1;1;1
258129277753;258129298683;20930;9;1;1;1
258129298683;258129307569;8886;9;1;1;1
258129307569;258129311566;3997;9;1;1;1
258129311566;258129313130;1564;9;1;1;1
258129313130;258129313274;144;9;1;1;1
258129313274;258129321229;7955;9;1;1;1
258129321229;258129322377;1148;9;1;1;1
258129322377;258129323751;1374;9;1;1;1
258129323751;258129349977;26226;9;1;1;1
258129354035;258129369385;15350;9;1;1;1
258129369385;258129378056;8671;9;1;1;1
258129378056;258129381452;3396;9;1;1;1
258129381452;258129391446;9994;9;1;1;1
258129391446;258129411668;20222;9;1;1;1
258129411668;258129421557;9889;9;1;1;1
258129421557;258129451592;30035;9;1;1;1
258129451592;258129460338;8746;9;1;1;1
258129460338;258129493137;32799;9;1;1;1
258129493137;258129493441;304;9;1;1;1
258129493441;258129503016;9575;9;1;1;1
258129503016;258129503481;465;9;1;1;1
258129503481;258129507069;3588;9;1;1;1
258129507572;258129526388;18816;9;1;1;1
258129526388;258129535675;9287;9;1;1;1
258129535675;258129567577;31902;9;1;1;1
258129567577;258129576423;8846;9;1;1;1
258129576423;258129595636;19213;9;1;1;1
258129595636;258129604199;8563;9;1;1;1
258129604199;258129612083;7884;9;1;1;1
258129613070;258129634986;21916;9;1;1;1
258129634986;258129635316;330;9;1;1;1
258129635316;258129643946;8630;9;1;1;1
258129643946;258129644330;384;9;1;1;1
258129644330;258129711919;67589;9;1;1;1
258129712904;258129716400;3496;9;1;1;1
258129716951;258129725692;8741;9;1;1;1
258129725692;258129782346;56654;9;1;1;1
258129782346;258129782884;538;9;1;1;1
258129782884;258129795631;12747;9;1;1;1
258129795631;258129799042;3411;9;1;1;1
258129799042;258129799855;813;9;1;1;1
258129799855;258129803466;3611;9;1;1;1
258129803466;258129815112;11646;9;1;1;1
258129815112;258129830457;15345;9;1;1;1
258129830457;258129848001;17544;9;1;1;1
258129848001;258129851314;3313;9;1;1;1
258129851314;258129860412;9098;9;1;1;1
258129860412;258129862144;1732;9;1;1;1
258129862144;258129872008;9864;9;1;1;1
258129872008;258129872883;875;9;1;1;1
258129872883;258129887445;14562;9;1;1;1
258129887445;258129888258;813;9;1;1;1
258129888258;258129891001;2743;9;1;1;1
258129891001;258129891804;803;9;1;1;1
258129891804;258129928737;36933;9;1;1;1
258129928737;258129934781;6044;9;1;1;1
258129934781;258129944500;9719;9;1;1;1
258129944500;258129953910;9410;9;1;1;1
258129953910;258129957167;3257;9;1;1;1
258129957167;258129957481;314;9;1;1;1
258129957481;258129958906;1425;9;1;1;1
258129958906;258129962821;3915;9;1;1;1
258129962821;258129963645;824;9;1;1;1
258129963645;258129964787;1142;9;1;1;1
258129965417;258129967051;1634;9;1;1;1
258129967051;258129969442;2391;9;1;1;1
258129969442;258129974018;4576;9;1;1;1
258129974018;258129974950;932;9;1;1;1
258129974950;258129976852;1902;9;1;1;1
258129976852;258129977677;825;9;1;1;1
258129977677;258129980433;2756;9;1;1;1
258129980433;258129981236;803;9;1;1;1
258129981236;258129987752;6516;9;1;1;1
258129987752;258129990802;3050;9;1;1;1
258129990802;258129999992;9190;9;1;1;1
258129999992;258130002152;2160;9;1;1;1
258130002152;258130009028;6876;9;1;1;1
258130009028;258130009989;961;9;1;1;1
258130009989;258130014082;4093;9;1;1;1
258130014082;258130014321;239;9;1;1;1
258130014321;258130014992;671;9;1;1;1
258130014992;258130015229;237;9;1;1;1
258130015229;258130032323;17094;9;1;1;1
258130032323;258130033219;896;9;1;1;1
258130033219;258130038938;5719;9;1;1;1
258130039481;258130042081;2600;9;1;1;1
258130042081;258130047344;5263;9;1;1;1
258130047344;258130049542;2198;9;1;1;1
258130049542;258130049652;110;9;1;1;1
258130049652;258130050454;802;9;1;1;1
258130050454;258130051725;1271;9;1;1;1
258130051725;258130053709;1984;9;1;1;1
258130053709;258130054513;804;9;1;1;1
258130054513;258130058651;4138;9;1;1;1
258130058651;258130060505;1854;9;1;1;1
258130060505;258130064896;4391;9;1;1;1
258130064896;258130066073;1177;9;1;1;1
258130066073;258130066678;605;9;1;1;1
258130066678;258130066777;99;9;1;1;1
258130066777;258130070255;3478;9;1;1;1
258130070255;258130077715;7460;9;1;1;1
258130077715;258130078658;943;9;1;1;1
258130078658;258130078912;254;9;1;1;1
258130078912;258130087758;8846;9;1;1;1
258130087758;258130088584;826;9;1;1;1
258130088584;258130088654;70;9;1;1;1
258130088654;258130089722;1068;9;1;1;1
258130089722;258130096459;6737;9;1;1;1
258130096459;258130104607;8148;9;1;1;1
258130104607;258130114535;9928;9;1;1;1
258130114535;258130114933;398;9;1;1;1
258130114933;258130115755;822;9;1;1;1
258130115755;258130117751;1996;9;1;1;1
258130118237;258130124688;6451;9;1;1;1
258130124688;258130125005;317;9;1;1;1
258130125005;258130125402;397;9;1;1;1
258130125402;258130127805;2403;9;1;1;1
258130127805;258130128868;1063;9;1;1;1
258130128868;258130132920;4052;9;1;1;1
258130132920;258130134164;1244;9;1;1;1
258130134164;258130149904;15740;9;1;1;1
258130149904;258130158455;8551;9;1;1;1
258130158455;258130160127;1672;9;1;1;1
258130160127;258130162304;2177;9;1;1;1
258130162304;258130165145;2841;9;1;1;1
258130165145;258130165671;526;9;1;1;1
258130165671;258130165907;236;9;1;1;1
258130165907;258130166249;342;9;1;1;1
258130166249;258130171449;5200;9;1;1;1
258130171449;258130179209;7760;9;1;1;1
258130179209;258130180388;1179;9;1;1;1
258130180388;258130182599;2211;9;1;1;1
258130182599;258130185423;2824;9;1;1;1
258130185423;258130187111;1688;9;1;1;1
258130187111;258130187987;876;9;1;1;1
258130187987;258130190120;2133;9;1;1;1
258130190120;258130207238;17118;9;1;1;1
258130207238;258130207767;529;9;1;1;1
258130207767;258130207994;227;9;1;1;1
258130207994;258130208828;834;9;1;1;1
258130208828;258130211962;3134;9;1;1;1
258130211962;258130212878;916;9;1;1;1
258130212878;258130212894;16;9;1;1;1
258130212894;258130214479;1585;9;1;1;1
258130214479;258130215520;1041;9;1;1;1
258130215520;258130224064;8544;9;1;1;1
258130224064;258130230968;6904;9;1;1;1
258130230968;258130232050;1082;9;1;1;1
258130232050;258130246075;14025;9;1;1;1
258130246075;258130247313;1238;9;1;1;1
258130247313;258130251359;4046;9;1;1;1
258130251359;258130256654;5295;9;1;1;1
258130257288;258130259370;2082;9;1;1;1
258130259370;258130260851;1481;9;1;1;1
258130260851;258130261941;1090;9;1;1;1
258130261941;258130263095;1154;9;1;1;1
258130263095;258130263652;557;9;1;1;1
258130263652;258130264207;555;9;1;1;1
258130264207;258130266594;2387;9;1;1;1
258130266594;258130267507;913;9;1;1;1
258130267507;258130272440;4933;9;1;1;1
258130272440;258130277054;4614;9;1;1;1
258130277054;258130278529;1475;9;1;1;1
258130278529;258130279940;1411;9;1;1;1
258130279940;258130282248;2308;9;1;1;1
258130282248;258130288967;6719;9;1;1;1
258130288967;258130293776;4809;9;1;1;1
258130293776;258130294893;1117;9;1;1;1
258130294893;258130299266;4373;9;1;1;1
258130299266;258130300988;1722;9;1;1;1
258130300988;258130308042;7054;9;1;1;1
258130308042;258130311219;3177;9;1;1;1
258130311219;258130311668;449;9;1;1;1
258130311668;258130313433;1765;9;1;1;1
258130313433;258130315150;1717;9;1;1;1
258130315150;258130323807;8657;9;1;1;1
258130323807;258130331721;7914;9;1;1;1
258130331721;258130332502;781;9;1;1;1
258130332502;258130332676;174;9;1;1;1
258130332676;258130339977;7301;9;1;1;1
258130340638;258130343327;2689;9;1;1;1
258130343327;258130344436;1109;9;1;1;1
258130344436;258130348185;3749;9;1;1;1
258130348185;258130348481;296;9;1;1;1
258130348481;258130349094;613;9;1;1;1
258130349094;258130349796;702;9;1;1;1
258130349796;258130354577;4781;9;1;1;1
258130354577;258130355820;1243;9;1;1;1
258130355820;258130360703;4883;9;1;1;1
258130360703;258130364015;3312;9;1;1;1
258130364015;258130371497;7482;9;1;1;1
258130371497;258130373992;2495;9;1;1;1
258130373992;258130381635;7643;9;1;1;1
258130381635;258130382898;1263;9;1;1;1
258130382898;258130383395;497;9;1;1;1
258130383395;258130385179;1784;9;1;1;1
258130385179;258130386928;1749;9;1;1;1
258130386928;258130387850;922;9;1;1;1
258130387850;258130388789;939;9;1;1;1
258130388789;258130397506;8717;9;1;1;1
258130397506;258130398330;824;9;1;1;1
258130398330;258130399057;727;9;1;1;1
258130399057;258130402752;3695;9;1;1;1
258130402752;258130403029;277;9;1;1;1
258130403029;258130404095;1066;9;1;1;1
258130404095;258130407146;3051;9;1;1;1
258130407146;258130410544;3398;9;1;1;1
258130410544;258130411520;976;9;1;1;1
258130411520;258130415389;3869;9;1;1;1
258130415389;258130416228;839;9;1;1;1
258130416228;258130419396;3168;9;1;1;1
258130419396;258130420371;975;9;1;1;1
258130420371;258130444813;24442;9;1;1;1
258130445452;258130450728;5276;9;1;1;1
258130450728;258130451645;917;9;1;1;1
258130451645;258130456326;4681;9;1;1;1
258130456326;258130456714;388;9;1;1;1
258130456714;258130457263;549;9;1;1;1
258130457263;258130457917;654;9;1;1;1
258130457917;258130469112;11195;9;1;1;1
258130469112;258130471269;2157;9;1;1;1
258130471269;258130488323;17054;9;1;1;1
258130488323;258130491260;2937;9;1;1;1
258130491260;258130492068;808;9;1;1;1
258130492068;258130499969;7901;9;1;1;1
258130500516;258130505281;4765;9;1;1;1
258130505281;258130508786;3505;9;1;1;1
258130508786;258130509494;708;9;1;1;1
258130509494;258130512189;2695;9;1;1;1
258130512189;258130513501;1312;9;1;1;1
258130513501;258130514358;857;9;1;1;1
258130514358;258130515345;987;9;1;1;1
258130515345;258130515350;5;9;1;1;1
258130515350;258130519549;4199;9;1;1;1
258130519549;258130541131;21582;9;1;1;1
258130541696;258130548209;6513;9;1;1;1
258130548209;258130548313;104;9;1;1;1
258130548313;258130549684;1371;9;1;1;1
258130549684;258130550551;867;9;1;1;1
258130550551;258130551810;1259;9;1;1;1
258130551810;258130552789;979;9;1;1;1
258130552789;258130553006;217;9;1;1;1
258130553006;258130554230;1224;9;1;1;1
258130554230;258130554599;369;9;1;1;1
258130554599;258130560108;5509;9;1;1;1
258130560108;258130562420;2312;9;1;1;1
258130562420;258130562871;451;9;1;1;1
258130562871;258130563805;934;9;1;1;1
258130563805;258130566609;2804;9;1;1;1
258130566609;258130570716;4107;9;1;1;1
258130570716;258130573948;3232;9;1;1;1
258130573948;258130574187;239;9;1;1;1
258130574187;258130576202;2015;9;1;1;1
258130576202;258130576842;640;9;1;1;1
258130576842;258130577724;882;9;1;1;1
258130577724;258130578242;518;9;1;1;1
258130578242;258130579369;1127;9;1;1;1
258130579369;258130579691;322;9;1;1;1
258130579691;258130579847;156;9;1;1;1
258130579847;258130581478;1631;9;1;1;1
258130581478;258130585021;3543;9;1;1;1
258130585021;258130586048;1027;9;1;1;1
258130586048;258130586451;403;9;1;1;1
258130586451;258130586723;272;9;1;1;1
258130586723;258130589327;2604;9;1;1;1
258130589327;258130590452;1125;9;1;1;1
258130590452;258130593033;2581;9;1;1;1
258130593033;258130596629;3596;9;1;1;1
258130596629;258130602102;5473;9;1;1;1
258130602102;258130603538;1436;9;1;1;1
258130603538;258130604290;752;9;1;1;1
258130604290;258130610847;6557;9;1;1;1
258130610847;258130612066;1219;9;1;1;1
258130612066;258130614936;2870;9;1;1;1
258130614936;258130616338;1402;9;1;1;1
258130616338;258130616847;509;9;1;1;1
258130616847;258130618116;1269;9;1;1;1
258130618116;258130618615;499;9;1;1;1
258130619576;258130621072;1496;9;1;1;1
258130621072;258130622503;1431;9;1;1;1
258130622503;258130623309;806;9;1;1;1
258130623309;258130626378;3069;9;1;1;1
258130626378;258130628003;1625;9;1;1;1
258130628003;258130631383;3380;9;1;1;1
258130631383;258130640859;9476;9;1;1;1
258130640859;258130664364;23505;9;1;1;1
258130664364;258130664647;283;9;1;1;1
258130664647;258130666713;2066;9;1;1;1
258130666713;258130667538;825;9;1;1;1
258130667538;258130676356;8818;9;1;1;1
258130676356;258130677259;903;9;1;1;1
258130677259;258130684635;7376;9;1;1;1
258130684635;258130701152;16517;9;1;1;1
258130701683;258130715176;13493;9;1;1;1
258130715176;258130719859;4683;9;1;1;1
258130719859;258130726040;6181;9;1;1;1
258130726040;258130730539;4499;9;1;1;1
258130730539;258130732504;1965;9;1;1;1
258130732504;258130732732;228;9;1;1;1
258130732732;258130733508;776;9;1;1;1
258130733508;258130733590;82;9;1;1;1
258130733590;258130733680;90;9;1;1;1
258130733680;258130733865;185;9;1;1;1
258130733865;258130736318;2453;9;1;1;1
258130736318;258130737123;805;9;1;1;1
258130737123;258130737430;307;9;1;1;1
258130737430;258130737566;136;9;1;1;1
258130737566;258130738251;685;9;1;1;1
258130738251;258130738382;131;9;1;1;1
258130738382;258130738912;530;9;1;1;1
258130738912;258130739312;400;9;1;1;1
258130739312;258130739520;208;9;1;1;1
258130739520;258130742949;3429;9;1;1;1
258130742949;258130745570;2621;9;1;1;1
258130745570;258130746456;886;9;1;1;1
258130746456;258130748819;2363;9;1;1;1
258130748819;258130752693;3874;9;1;1;1
258130752693;258130753253;560;9;1;1;1
258130753253;258130753401;148;9;1;1;1
258130753401;258130754247;846;9;1;1;1
258130754247;258130755157;910;9;1;1;1
258130755157;258130755414;257;9;1;1;1
258130755414;258130755586;172;9;1;1;1
258130755586;258130756535;949;9;1;1;1
258130756535;258130758541;2006;9;1;1;1
258130758541;258130765609;7068;9;1;1;1
258130765609;258130772746;7137;9;1;1;1
258130772746;258130773864;1118;9;1;1;1
258130773864;258130780231;6367;9;1;1;1
258130780231;258130780495;264;9;1;1;1
258130780495;258130781407;912;9;1;1;1
258130781407;258130786447;5040;9;1;1;1
258130787008;258130788561;1553;9;1;1;1
258130788561;258130788796;235;9;1;1;1
258130788796;258130788905;109;9;1;1;1
258130788905;258130789833;928;9;1;1;1
258130789833;258130791532;1699;9;1;1;1
258130791532;258130792555;1023;9;1;1;1
258130792555;258130797890;5335;9;1;1;1
258130797890;258130798882;992;9;1;1;1
258130798882;258130802318;3436;9;1;1;1
258130802318;258130802508;190;9;1;1;1
258130802508;258130803609;1101;9;1;1;1
258130803609;258130829062;25453;9;1;1;1
258130829062;258130829481;419;9;1;1;1
258130829481;258130829657;176;9;1;1;1
258130830206;258130831028;822;9;1;1;1
258130831028;258130832042;1014;9;1;1;1
258130832042;258130832222;180;9;1;1;1
258130832222;258130834481;2259;9;1;1;1
258130834481;258130838061;3580;9;1;1;1
258130838061;258130838084;23;9;1;1;1
258130838084;258130838293;209;9;1;1;1
258130838293;258130838997;704;9;1;1;1
258130838997;258130839437;440;9;1;1;1
258130839437;258130840715;1278;9;1;1;1
258130840715;258130840757;42;9;1;1;1
258130840757;258130843372;2615;9;1;1;1
258130843372;258130843863;491;9;1;1;1
258130843863;258130844596;733;9;1;1;1
258130844596;258130844895;299;9;1;1;1
258130844895;258130845619;724;9;1;1;1
258130845619;258130847357;1738;9;1;1;1
258130847357;258130851202;3845;9;1;1;1
258130851202;258130851657;455;9;1;1;1
258130851657;258130856828;5171;9;1;1;1
258130856828;258130857329;501;9;1;1;1
258130857329;258130860653;3324;9;1;1;1
258130860653;258130861257;604;9;1;1;1
258130861257;258130865576;4319;9;1;1;1
258130865576;258130865940;364;9;1;1;1
258130865940;258130866680;740;9;1;1;1
258130867220;258130867461;241;9;1;1;1
258130867461;258130867508;47;9;1;1;1
258130867508;258130868612;1104;9;1;1;1
258130868612;258130870386;1774;9;1;1;1
258130870386;258130872247;1861;9;1;1;1
258130872247;258130873016;769;9;1;1;1
258130873016;258130876483;3467;9;1;1;1
258130876483;258130880824;4341;9;1;1;1
258130880824;258130881018;194;9;1;1;1
258130881018;258130881975;957;9;1;1;1
258130881975;258130883326;1351;9;1;1;1
258130883326;258130883768;442;9;1;1;1
258130883768;258130887460;3692;9;1;1;1
258130887460;258130888146;686;9;1;1;1
258130888146;258130891417;3271;9;1;1;1
258130891417;258130891434;17;9;1;1;1
258130891434;258130892365;931;9;1;1;1
258130892365;258130892387;22;9;1;1;1
258130892387;258130893241;854;9;1;1;1
258130893241;258130896408;3167;9;1;1;1
258130896408;258130900081;3673;9;1;1;1
258130900081;258130900292;211;9;1;1;1
258130900292;258130900628;336;9;1;1;1
258130900628;258130907295;6667;9;1;1;1
258130907295;258130926643;19348;9;1;1;1
258130926643;258130931002;4359;9;1;1;1
258130931002;258130933267;2265;9;1;1;1
258130933267;258130934136;869;9;1;1;1
258130934136;258130936474;2338;9;1;1;1
258130936944;258130940037;3093;9;1;1;1
258130940037;258130941640;1603;9;1;1;1
258130941640;258130941834;194;9;1;1;1
258130941834;258130951071;9237;9;1;1;1
258130951071;258130953181;2110;9;1;1;1
258130953181;258130954038;857;9;1;1;1
258130954038;258130958470;4432;9;1;1;1
258130958470;258130960566;2096;9;1;1;1
258130960566;258130961672;1106;9;1;1;1
258130961672;258130967102;5430;9;1;1;1
258130967102;258130972171;5069;9;1;1;1
258130972171;258130974016;1845;9;1;1;1
258130974016;258130978314;4298;9;1;1;1
258130978314;258130982771;4457;9;1;1;1
258130982771;258130985355;2584;9;1;1;1
258130985355;258130985407;52;9;1;1;1
258130985407;258130986599;1192;9;1;1;1
258130986599;258130986840;241;9;1;1;1
258130986840;258130987274;434;9;1;1;1
258130987274;258130987751;477;9;1;1;1
258130987751;258130988370;619;9;1;1;1
258130988370;258130988540;170;9;1;1;1
258130988540;258130988550;10;9;1;1;1
258130988550;258130988612;62;9;1;1;1
258130988612;258130990761;2149;9;1;1;1
258130990761;258130991836;1075;9;1;1;1
258130991836;258130991895;59;9;1;1;1
258130991895;258130991931;36;9;1;1;1
258130991931;258130992710;779;9;1;1;1
258130992710;258130993920;1210;9;1;1;1
258130993920;258130994596;676;9;1;1;1
258130994596;258130994599;3;9;1;1;1
258130994599;258130994913;314;9;1;1;1
258130994913;258130994994;81;9;1;1;1
258130994994;258130995226;232;9;1;1;1
258130995226;258130995376;150;9;1;1;1
258130995376;258130995573;197;9;1;1;1
258130995573;258130996674;1101;9;1;1;1
258130996674;258130997458;784;9;1;1;1
258130997458;258130997904;446;9;1;1;1
258130997904;258130998414;510;9;1;1;1
258130998414;258130998536;122;9;1;1;1
258130998536;258130999283;747;9;1;1;1
258130999283;258131002210;2927;9;1;1;1
258131002210;258131002262;52;9;1;1;1
258131002262;258131002547;285;9;1;1;1
258131002547;258131002736;189;9;1;1;1
258131002736;258131003920;1184;9;1;1;1
258131003920;258131004225;305;9;1;1;1
258131004225;258131004368;143;9;1;1;1
258131004368;258131004693;325;9;1;1;1
258131004693;258131004941;248;9;1;1;1
258131004941;258131006830;1889;9;1;1;1
258131006830;258131007652;822;9;1;1;1
258131007652;258131007808;156;9;1;1;1
258131007808;258131011490;3682;9;1;1;1
258131011490;258131012577;1087;9;1;1;1
258131012577;258131013156;579;9;1;1;1
258131013156;258131013588;432;9;1;1;1
258131013588;258131014512;924;9;1;1;1
258131015037;258131019622;4585;9;1;1;1
258131019622;258131020995;1373;9;1;1;1
258131020995;258131021272;277;9;1;1;1
258131021272;258131021826;554;9;1;1;1
258131021826;258131023609;1783;9;1;1;1
258131023609;258131024252;643;9;1;1;1
258131024252;258131027393;3141;9;1;1;1
258131027393;258131032765;5372;9;1;1;1
258131032765;258131045300;12535;9;1;1;1
258131045300;258131046389;1089;9;1;1;1
258131046389;258131047849;1460;9;1;1;1
258131047849;258131048111;262;9;1;1;1
258131048111;258131050814;2703;9;1;1;1
258131050814;258131053089;2275;9;1;1;1
258131053089;258131058277;5188;9;1;1;1
258131058277;258131061781;3504;9;1;1;1
258131061781;258131063450;1669;9;1;1;1
258131063450;258131064343;893;9;1;1;1
258131064343;258131068311;3968;9;1;1;1
258131068311;258131071230;2919;9;1;1;1
258131071230;258131074577;3347;9;1;1;1
258131074577;258131076297;1720;9;1;1;1
258131076297;258131076967;670;9;1;1;1
258131076967;258131077320;353;9;1;1;1
258131077320;258131078865;1545;9;1;1;1
258131078865;258131082518;3653;9;1;1;1
258131082518;258131084480;1962;9;1;1;1
258131084480;258131084543;63;9;1;1;1
258131084543;258131085419;876;9;1;1;1
258131085419;258131086039;620;9;1;1;1
258131086039;258131087541;1502;9;1;1;1
258131087541;258131094473;6932;9;1;1;1
258131094473;258131097860;3387;9;1;1;1
258131097860;258131099110;1250;9;1;1;1
258131099110;258131100195;1085;9;1;1;1
258131100195;258131104077;3882;9;1;1;1
258131104691;258131106058;1367;9;1;1;1
258131106058;258131107545;1487;9;1;1;1
258131107545;258131108372;827;9;1;1;1
258131108372;258131112585;4213;9;1;1;1
258131112585;258131113787;1202;9;1;1;1
258131113787;258131120619;6832;9;1;1;1
258131120619;258131128286;7667;9;1;1;1
258131128286;258131138755;10469;9;1;1;1
258131138755;258131140126;1371;9;1;1;1
258131140126;258131144215;4089;9;1;1;1
258131144215;258131145313;1098;9;1;1;1
258131145313;258131160519;15206;9;1;1;1
258131160519;258131165607;5088;9;1;1;1
258131165607;258131166945;1338;9;1;1;1
258131166945;258131168270;1325;9;1;1;1
258131168270;258131169234;964;9;1;1;1
258131169234;258131173038;3804;9;1;1;1
258131174010;258131176237;2227;9;1;1;1
258131176237;258131178584;2347;9;1;1;1
258131178584;258131179182;598;9;1;1;1
258131179182;258131189839;10657;9;1;1;1
258131189839;258131190680;841;9;1;1;1
258131190680;258131190997;317;9;1;1;1
258131190997;258131196031;5034;9;1;1;1
258131196031;258131205943;9912;9;1;1;1
258131205943;258131206937;994;9;1;1;1
258131206937;258131210802;3865;9;1;1;1
258131210802;258131211810;1008;9;1;1;1
258131211810;258131214426;2616;9;1;1;1
258131214426;258131229140;14714;9;1;1;1
258131229140;258131230573;1433;9;1;1;1
258131230573;258131231423;850;9;1;1;1
258131231423;258131239260;7837;9;1;1;1
258131239260;258131240011;751;9;1;1;1
258131240547;258131241796;1249;9;1;1;1
258131241796;258131242641;845;9;1;1;1
258131242641;258131243052;411;9;1;1;1
258131243052;258131245471;2419;9;1;1;1
258131245471;258131246157;686;9;1;1;1
258131246157;258131247208;1051;9;1;1;1
258131247208;258131248289;1081;9;1;1;1
258131248289;258131248303;14;9;1;1;1
258131248303;258131249547;1244;9;1;1;1
258131249547;258131249945;398;9;1;1;1
258131249945;258131252734;2789;9;1;1;1
258131252734;258131252782;48;9;1;1;1
258131252782;258131252790;8;9;1;1;1
258131252790;258131253350;560;9;1;1;1
258131253350;258131253608;258;9;1;1;1
258131253608;258131255443;1835;9;1;1;1
258131255443;258131257336;1893;9;1;1;1
258131257336;258131257718;382;9;1;1;1
258131257718;258131259009;1291;9;1;1;1
258131259009;258131259435;426;9;1;1;1
258131259435;258131261638;2203;9;1;1;1
258131261638;258131263366;1728;9;1;1;1
258131263366;258131264012;646;9;1;1;1
258131264012;258131264613;601;9;1;1;1
258131264613;258131264907;294;9;1;1;1
258131264907;258131267169;2262;9;1;1;1
258131267169;258131268506;1337;9;1;1;1
258131268506;258131269269;763;9;1;1;1
258131269269;258131271266;1997;9;1;1;1
258131271266;258131271587;321;9;1;1;1
258131271587;258131272422;835;9;1;1;1
258131272422;258131275842;3420;9;1;1;1
258131275842;258131285654;9812;9;1;1;1
258131285654;258131298758;13104;9;1;1;1
258131298758;258131299036;278;9;1;1;1
258131299036;258131299117;81;9;1;1;1
258131299117;258131299313;196;9;1;1;1
258131299313;258131299391;78;9;1;1;1
258131299391;258131300222;831;9;1;1;1
258131300222;258131300232;10;9;1;1;1
258131300232;258131300595;363;9;1;1;1
258131300595;258131301320;725;9;1;1;1
258131301320;258131303889;2569;9;1;1;1
258131303889;258131304546;657;9;1;1;1
258131304546;258131306252;1706;9;1;1;1
258131306252;258131310506;4254;9;1;1;1
258131310506;258131314632;4126;9;1;1;1
258131314632;258131317207;2575;9;1;1;1
258131317838;258131319330;1492;9;1;1;1
258131319330;258131319952;622;9;1;1;1
258131319952;258131327249;7297;9;1;1;1
258131327249;258131329274;2025;9;1;1;1
258131329274;258131330683;1409;9;1;1;1
258131330683;258131335775;5092;9;1;1;1
258131335775;258131340374;4599;9;1;1;1
258131340374;258131347033;6659;9;1;1;1
258131347033;258131352390;5357;9;1;1;1
258131352390;258131362502;10112;9;1;1;1
258131362502;258131365941;3439;9;1;1;1
258131365941;258131369094;3153;9;1;1;1
258131369094;258131372119;3025;9;1;1;1
258131372119;258131375132;3013;9;1;1;1
258131375132;258131383016;7884;9;1;1;1
258131383016;258131385045;2029;9;1;1;1
258131385045;258131385647;602;9;1;1;1
258131385647;258131386764;1117;9;1;1;1
258131386764;258131390420;3656;9;1;1;1
258131390420;258131390735;315;9;1;1;1
258131391203;258131393400;2197;9;1;1;1
258131393400;258131393878;478;9;1;1;1
258131393878;258131394260;382;9;1;1;1
258131394260;258131395507;1247;9;1;1;1
258131395507;258131395554;47;9;1;1;1
258131395554;258131397154;1600;9;1;1;1
258131397154;258131398922;1768;9;1;1;1
258131398922;258131399020;98;9;1;1;1
258131399020;258131399378;358;9;1;1;1
258131399378;258131399627;249;9;1;1;1
258131399627;258131399653;26;9;1;1;1
258131399653;258131400604;951;9;1;1;1
258131400604;258131401534;930;9;1;1;1
258131401534;258131402817;1283;9;1;1;1
258131402817;258131404590;1773;9;1;1;1
258131404590;258131404713;123;9;1;1;1
258131404713;258131405668;955;9;1;1;1
258131405668;258131405782;114;9;1;1;1
258131405782;258131407563;1781;9;1;1;1
258131407563;258131407982;419;9;1;1;1
258131407982;258131408770;788;9;1;1;1
258131408770;258131409213;443;9;1;1;1
258131409213;258131410511;1298;9;1;1;1
258131410511;258131410784;273;9;1;1;1
258131410784;258131411297;513;9;1;1;1
258131411297;258131411532;235;9;1;1;1
258131411532;258131412608;1076;9;1;1;1
258131412608;258131413060;452;9;1;1;1
258131413060;258131415392;2332;9;1;1;1
258131415392;258131415502;110;9;1;1;1
258131415502;258131418048;2546;9;1;1;1
258131418048;258131420276;2228;9;1;1;1
258131420276;258131420973;697;9;1;1;1
258131420973;258131424433;3460;9;1;1;1
258131424433;258131425138;705;9;1;1;1
258131425138;258131425286;148;9;1;1;1
258131425286;258131427229;1943;9;1;1;1
258131427229;258131433570;6341;9;1;1;1
258131433570;258131433644;74;9;1;1;1
258131433644;258131433923;279;9;1;1;1
258131433923;258131435048;1125;9;1;1;1
258131435048;258131437510;2462;9;1;1;1
258131437510;258131438695;1185;9;1;1;1
258131438695;258131440139;1444;9;1;1;1
258131440139;258131441183;1044;9;1;1;1
258131441183;258131443374;2191;9;1;1;1
258131443374;258131445977;2603;9;1;1;1
258131445977;258131447450;1473;9;1;1;1
258131447450;258131453927;6477;9;1;1;1
258131453927;258131455099;1172;9;1;1;1
258131455099;258131455717;618;9;1;1;1
258131455717;258131455724;7;9;1;1;1
258131456362;258131460807;4445;9;1;1;1
258131460807;258131462350;1543;9;1;1;1
258131462350;258131464266;1916;9;1;1;1
258131464266;258131465491;1225;9;1;1;1
258131465491;258131466075;584;9;1;1;1
258131466075;258131469443;3368;9;1;1;1
258131469443;258131472971;3528;9;1;1;1
258131472971;258131474419;1448;9;1;1;1
258131474419;258131475351;932;9;1;1;1
258131475351;258131477354;2003;9;1;1;1
258131477354;258131479020;1666;9;1;1;1
258131479020;258131479280;260;9;1;1;1
258131479280;258131486783;7503;9;1;1;1
258131486783;258131488552;1769;9;1;1;1
258131488552;258131489943;1391;9;1;1;1
258131489943;258131491611;1668;9;1;1;1
258131491611;258131493071;1460;9;1;1;1
258131493071;258131493441;370;9;1;1;1
258131493441;258131497091;3650;9;1;1;1
258131497091;258131497901;810;9;1;1;1
258131497901;258131502116;4215;9;1;1;1
258131502116;258131503063;947;9;1;1;1
258131503063;258131504141;1078;9;1;1;1
258131504141;258131505273;1132;9;1;1;1
258131505273;258131505375;102;9;1;1;1
258131505375;258131513959;8584;9;1;1;1
258131514490;258131517449;2959;9;1;1;1
258131517449;258131518975;1526;9;1;1;1
258131518975;258131521730;2755;9;1;1;1
258131521730;258131534450;12720;9;1;1;1
258131534450;258131536507;2057;9;1;1;1
258131536507;258131551182;14675;9;1;1;1
258131551182;258131551250;68;9;1;1;1
258131551250;258131551815;565;9;1;1;1
258131551815;258131552638;823;9;1;1;1
258131552638;258131553414;776;9;1;1;1
258131553414;258131558404;4990;9;1;1;1
258131558404;258131565050;6646;9;1;1;1
258131565050;258131574953;9903;9;1;1;1
258131574953;258131575021;68;9;1;1;1
258131575021;258131580592;5571;9;1;1;1
258131580592;258131586793;6201;9;1;1;1
258131586793;258131586930;137;9;1;1;1
258131586930;258131587859;929;9;1;1;1
258131587859;258131592774;4915;9;1;1;1
258131592774;258131593718;944;9;1;1;1
258131593718;258131594028;310;9;1;1;1
258131594028;258131597238;3210;9;1;1;1
258131597753;258131598216;463;9;1;1;1
258131598216;258131599979;1763;9;1;1;1
258131599979;258131601399;1420;9;1;1;1
258131601399;258131607858;6459;9;1;1;1
258131607858;258131607946;88;9;1;1;1
258131607946;258131608647;701;9;1;1;1
258131608647;258131618143;9496;9;1;1;1
258131618143;258131619872;1729;9;1;1;1
258131619872;258131619909;37;9;1;1;1
258131619909;258131622053;2144;9;1;1;1
258131622053;258131622226;173;9;1;1;1
258131622226;258131622500;274;9;1;1;1
258131622500;258131622779;279;9;1;1;1
258131622779;258131626246;3467;9;1;1;1
258131626246;258131627372;1126;9;1;1;1
258131627372;258131627419;47;9;1;1;1
258131627419;258131633469;6050;9;1;1;1
258131633469;258131634520;1051;9;1;1;1
258131634520;258131635322;802;9;1;1;1
258131635322;258131635495;173;9;1;1;1
258131635495;258131640024;4529;9;1;1;1
258131640024;258131643976;3952;9;1;1;1
258131643976;258131644217;241;9;1;1;1
258131644217;258131645949;1732;9;1;1;1
258131645949;258131646140;191;9;1;1;1
258131646140;258131649268;3128;9;1;1;1
258131649268;258131650139;871;9;1;1;1
258131650139;258131659288;9149;9;1;1;1
258131659288;258131662260;2972;9;1;1;1
258131662789;258131667403;4614;9;1;1;1
258131667403;258131669430;2027;9;1;1;1
258131669430;258131674858;5428;9;1;1;1
258131674858;258131675968;1110;9;1;1;1
258131675968;258131678755;2787;9;1;1;1
258131678755;258131679981;1226;9;1;1;1
258131679981;258131680232;251;9;1;1;1
258131680232;258131681166;934;9;1;1;1
258131681166;258131681429;263;9;1;1;1
258131681429;258131681820;391;9;1;1;1
258131681820;258131690948;9128;9;1;1;1
258131690948;258131693160;2212;9;1;1;1
258131693160;258131695256;2096;9;1;1;1
258131695256;258131697053;1797;9;1;1;1
258131697053;258131699312;2259;9;1;1;1
258131699312;258131700356;1044;9;1;1;1
258131700356;258131703166;2810;9;1;1;1
258131703166;258131709120;5954;9;1;1;1
258131709120;258131711663;2543;9;1;1;1
258131711663;258131715067;3404;9;1;1;1
258131715067;258131718170;3103;9;1;1;1
258131718170;258131718952;782;9;1;1;1
258131718952;258131719192;240;9;1;1;1
258131719192;258131720544;1352;9;1;1;1
258131720544;258131721778;1234;9;1;1;1
258131721778;258131722956;1178;9;1;1;1
258131722956;258131723345;389;9;1;1;1
258131723345;258131727396;4051;9;1;1;1
258131727396;258131731349;3953;9;1;1;1
258131731349;258131733879;2530;9;1;1;1
258131733879;258131734304;425;9;1;1;1
258131734921;258131739670;4749;9;1;1;1
258131739670;258131754779;15109;9;1;1;1
258131754779;258131758857;4078;9;1;1;1
258131758857;258131759801;944;9;1;1;1
258131759801;258131767774;7973;9;1;1;1
258131767774;258131769600;1826;9;1;1;1
258131770142;258131773486;3344;9;1;1;1
258131773486;258131774371;885;9;1;1;1
258131774371;258131775546;1175;9;1;1;1
258131775546;258131775610;64;9;1;1;1
258131775610;258131776475;865;9;1;1;1
258131776475;258131777031;556;9;1;1;1
258131777031;258131788159;11128;9;1;1;1
258131788159;258131788691;532;9;1;1;1
258131788691;258131790702;2011;9;1;1;1
258131790702;258131792798;2096;9;1;1;1
258131792798;258131794102;1304;9;1;1;1
258131794102;258131794484;382;9;1;1;1
258131794484;258131794943;459;9;1;1;1
258131794943;258131795381;438;9;1;1;1
258131795381;258131795852;471;9;1;1;1
258131795852;258131798329;2477;9;1;1;1
258131798329;258131801783;3454;9;1;1;1
258131801783;258131802088;305;9;1;1;1
258131802088;258131802763;675;9;1;1;1
258131802763;258131823674;20911;9;1;1;1
258131823674;258131838577;14903;9;1;1;1
258131838577;258131838583;6;9;1;1;1
258131838583;258131840172;1589;9;1;1;1
258131840172;258131840664;492;9;1;1;1
258131840664;258131844212;3548;9;1;1;1
258131844212;258131854698;10486;9;1;1;1
258131854698;258131856585;1887;9;1;1;1
258131856585;258131857527;942;9;1;1;1
258131857527;258131857615;88;9;1;1;1
258131857615;258131858348;733;9;1;1;1
258131858348;258131860367;2019;9;1;1;1
258131860367;258131860618;251;9;1;1;1
258131860618;258131861625;1007;9;1;1;1
258131861625;258131862398;773;9;1;1;1
258131862398;258131863208;810;9;1;1;1
258131863208;258131864161;953;9;1;1;1
258131864161;258131865108;947;9;1;1;1
258131865108;258131865296;188;9;1;1;1
258131865296;258131865882;586;9;1;1;1
258131865882;258131865994;112;9;1;1;1
258131865994;258131866714;720;9;1;1;1
258131866714;258131866899;185;9;1;1;1
258131866899;258131866994;95;9;1;1;1
258131866994;258131867290;296;9;1;1;1
258131867290;258131868909;1619;9;1;1;1
258131868909;258131869860;951;9;1;1;1
258131869860;258131872807;2947;9;1;1;1
258131872807;258131873351;544;9;1;1;1
258131873351;258131873648;297;9;1;1;1
258131873648;258131874849;1201;9;1;1;1
258131874849;258131876485;1636;9;1;1;1
258131876485;258131877198;713;9;1;1;1
258131877198;258131880672;3474;9;1;1;1
258131880672;258131881671;999;9;1;1;1
258131881671;258131884315;2644;9;1;1;1
258131884315;258131884583;268;9;1;1;1
258131884583;258131892483;7900;9;1;1;1
258131892483;258131892850;367;9;1;1;1
258131892850;258131895109;2259;9;1;1;1
258131895109;258131896010;901;9;1;1;1
258131896010;258131897182;1172;9;1;1;1
258131897182;258131897477;295;9;1;1;1
258131897477;258131898226;749;9;1;1;1
258131898226;258131902759;4533;9;1;1;1
258131902759;258131903202;443;9;1;1;1
258131903202;258131904478;1276;9;1;1;1
258131904478;258131908310;3832;9;1;1;1
258131908310;258131913156;4846;9;1;1;1
258131913156;258131914821;1665;9;1;1;1
258131914821;258131915003;182;9;1;1;1
258131915003;258131919679;4676;9;1;1;1
258131919679;258131920462;783;9;1;1;1
258131920462;258131923084;2622;9;1;1;1
258131923084;258131924413;1329;9;1;1;1
258131924413;258131925862;1449;9;1;1;1
258131925862;258131926202;340;9;1;1;1
258131926202;258131929385;3183;9;1;1;1
258131930505;258131953789;23284;9;1;1;1
258131953789;258131958301;4512;9;1;1;1
258131958301;258131962759;4458;9;1;1;1
258131962759;258131964488;1729;9;1;1;1
258131964488;258131969326;4838;9;1;1;1
258131969326;258131975859;6533;9;1;1;1
258131975859;258131976187;328;9;1;1;1
258131976187;258131979992;3805;9;1;1;1
258131980459;258131983883;3424;9;1;1;1
258131983883;258131986311;2428;9;1;1;1
258131986311;258131992435;6124;9;1;1;1
258131992435;258131997062;4627;9;1;1;1
258131997062;258131998730;1668;9;1;1;1
258131998730;258131999124;394;9;1;1;1
258131999124;258132001133;2009;9;1;1;1
258132001133;258132001787;654;9;1;1;1
258132001787;258132002929;1142;9;1;1;1
258132002929;258132005149;2220;9;1;1;1
258132005149;258132005796;647;9;1;1;1
258132005796;258132012050;6254;9;1;1;1
258132012050;258132013248;1198;9;1;1;1
258132013248;258132013800;552;9;1;1;1
258132013800;258132015331;1531;9;1;1;1
258132015331;258132016084;753;9;1;1;1
258132016084;258132016861;777;9;1;1;1
258132016861;258132023154;6293;9;1;1;1
258132023154;258132023697;543;9;1;1;1
258132023697;258132026347;2650;9;1;1;1
258132026347;258132035410;9063;9;1;1;1
258132035410;258132036643;1233;9;1;1;1
258132036643;258132037676;1033;9;1;1;1
258132037676;258132038730;1054;9;1;1;1
258132038730;258132047410;8680;9;1;1;1
258132047410;258132048895;1485;9;1;1;1
258132048895;258132053946;5051;9;1;1;1
258132054601;258132060615;6014;9;1;1;1
258132060615;258132071178;10563;9;1;1;1
258132071178;258132073632;2454;9;1;1;1
258132073632;258132075878;2246;9;1;1;1
258132075878;258132092485;16607;9;1;1;1
258132092485;258132096418;3933;9;1;1;1
258132096418;258132097085;667;9;1;1;1
258132097085;258132108539;11454;9;1;1;1
258132108539;258132109283;744;9;1;1;1
258132109283;258132111511;2228;9;1;1;1
258132111511;258132114060;2549;9;1;1;1
258132114060;258132116541;2481;9;1;1;1
258132116541;258132117139;598;9;1;1;1
258132117139;258132117917;778;9;1;1;1
258132117917;258132118298;381;9;1;1;1
258132118298;258132118972;674;9;1;1;1
258132118972;258132119725;753;9;1;1;1
258132119725;258132120022;297;9;1;1;1
258132120022;258132121492;1470;9;1;1;1
258132121492;258132123877;2385;9;1;1;1
258132123877;258132125481;1604;9;1;1;1
258132125481;258132127547;2066;9;1;1;1
258132127547;258132128966;1419;9;1;1;1
258132128966;258132135918;6952;9;1;1;1
258132135918;258132139720;3802;9;1;1;1
258132139720;258132140087;367;9;1;1;1
258132140087;258132140232;145;9;1;1;1
258132140232;258132140260;28;9;1;1;1
258132140260;258132140536;276;9;1;1;1
258132140536;258132140916;380;9;1;1;1
258132140916;258132142636;1720;9;1;1;1
258132142636;258132144649;2013;9;1;1;1
258132144649;258132150435;5786;9;1;1;1
258132150435;258132151161;726;9;1;1;1
258132151161;258132152017;856;9;1;1;1
258132152017;258132152234;217;9;1;1;1
258132152234;258132153159;925;9;1;1;1
258132153159;258132154999;1840;9;1;1;1
258132154999;258132156006;1007;9;1;1;1
258132156006;258132156835;829;9;1;1;1
258132156835;258132173987;17152;9;1;1;1
258132173987;258132174041;54;9;1;1;1
258132174041;258132179079;5038;9;1;1;1
258132179079;258132180270;1191;9;1;1;1
258132180270;258132181640;1370;9;1;1;1
258132181640;258132185792;4152;9;1;1;1
258132185792;258132186493;701;9;1;1;1
258132186493;258132188171;1678;9;1;1;1
258132188171;258132188710;539;9;1;1;1
258132188710;258132190182;1472;9;1;1;1
258132190182;258132198198;8016;9;1;1;1
258132198198;258132202102;3904;9;1;1;1
258132202102;258132202310;208;9;1;1;1
258132202310;258132203587;1277;9;1;1;1
258132203587;258132204068;481;9;1;1;1
258132204068;258132205483;1415;9;1;1;1
258132205483;258132207338;1855;9;1;1;1
258132207338;258132208173;835;9;1;1;1
258132208173;258132210215;2042;9;1;1;1
258132210215;258132210245;30;9;1;1;1
258132210245;258132210808;563;9;1;1;1
258132210808;258132211346;538;9;1;1;1
258132211346;258132211649;303;9;1;1;1
258132211649;258132211979;330;9;1;1;1
258132211979;258132212345;366;9;1;1;1
258132212345;258132220684;8339;9;1;1;1
258132220684;258132230514;9830;9;1;1;1
258132230514;258132232185;1671;9;1;1;1
258132232797;258132235523;2726;9;1;1;1
258132235523;258132236479;956;9;1;1;1
258132236479;258132236598;119;9;1;1;1
258132236598;258132237848;1250;9;1;1;1
258132237848;258132238514;666;9;1;1;1
258132238514;258132239848;1334;9;1;1;1
258132239848;258132240522;674;9;1;1;1
258132240522;258132240572;50;9;1;1;1
258132240572;258132242415;1843;9;1;1;1
258132242415;258132244561;2146;9;1;1;1
258132244561;258132246726;2165;9;1;1;1
258132246726;258132247077;351;9;1;1;1
258132247077;258132247202;125;9;1;1;1
258132247202;258132247378;176;9;1;1;1
258132247378;258132250950;3572;9;1;1;1
258132250950;258132251643;693;9;1;1;1
258132251643;258132252602;959;9;1;1;1
258132252602;258132252693;91;9;1;1;1
258132252693;258132252906;213;9;1;1;1
258132252906;258132253442;536;9;1;1;1
258132253442;258132255590;2148;9;1;1;1
258132255590;258132258708;3118;9;1;1;1
258132258708;258132261265;2557;9;1;1;1
258132261265;258132262676;1411;9;1;1;1
258132262676;258132262899;223;9;1;1;1
258132262899;258132263900;1001;9;1;1;1
258132263900;258132264974;1074;9;1;1;1
258132264974;258132266213;1239;9;1;1;1
258132266213;258132266744;531;9;1;1;1
258132266744;258132268675;1931;9;1;1;1
258132268675;258132269128;453;9;1;1;1
258132269128;258132269536;408;9;1;1;1
258132269536;258132284671;15135;9;1;1;1
258132284671;258132287139;2468;9;1;1;1
258132287139;258132287696;557;9;1;1;1
258132287696;258132290005;2309;9;1;1;1
258132290005;258132291652;1647;9;1;1;1
258132291652;258132296537;4885;9;1;1;1
258132296537;258132297064;527;9;1;1;1
258132297064;258132307468;10404;9;1;1;1
258132307468;258132324525;17057;9;1;1;1
258132324525;258132327822;3297;9;1;1;1
258132327822;258132336625;8803;9;1;1;1
258132336625;258132339000;2375;9;1;1;1
258132339000;258132339835;835;9;1;1;1
258132339835;258132340683;848;9;1;1;1
258132340683;258132344111;3428;9;1;1;1
258132344111;258132349439;5328;9;1;1;1
258132349439;258132349455;16;9;1;1;1
258132349455;258132349713;258;9;1;1;1
258132349713;258132350775;1062;9;1;1;1
258132350775;258132351420;645;9;1;1;1
258132351420;258132351902;482;9;1;1;1
258132351902;258132352730;828;9;1;1;1
258132352730;258132353475;745;9;1;1;1
258132353960;258132354152;192;9;1;1;1
258132354152;258132355087;935;9;1;1;1
258132355087;258132355819;732;9;1;1;1
258132355819;258132365824;10005;9;1;1;1
258132365824;258132370585;4761;9;1;1;1
258132370585;258132371696;1111;9;1;1;1
258132371696;258132394111;22415;9;1;1;1
258132394111;258132394932;821;9;1;1;1
258132394932;258132401594;6662;9;1;1;1
258132401594;258132402794;1200;9;1;1;1
258132402794;258132420620;17826;9;1;1;1
258132420620;258132422094;1474;9;1;1;1
258132422094;258132425351;3257;9;1;1;1
258132425351;258132438120;12769;9;1;1;1
258132438120;258132438594;474;9;1;1;1
258132438594;258132448761;10167;9;1;1;1
258132448761;258132455466;6705;9;1;1;1
258132455466;258132457800;2334;9;1;1;1
258132457800;258132466316;8516;9;1;1;1
258132467811;258132469891;2080;9;1;1;1
258132469891;258132470228;337;9;1;1;1
258132470228;258132470745;517;9;1;1;1
258132470745;258132471352;607;9;1;1;1
258132471352;258132471688;336;9;1;1;1
258132471688;258132473378;1690;9;1;1;1
258132473378;258132475690;2312;9;1;1;1
258132475690;258132475873;183;9;1;1;1
258132475873;258132477246;1373;9;1;1;1
258132477246;258132480583;3337;9;1;1;1
258132480583;258132483622;3039;9;1;1;1
258132483622;258132483964;342;9;1;1;1
258132483964;258132542961;58997;9;1;1;1
258132542961;258132546781;3820;9;1;1;1
258132546781;258132548430;1649;9;1;1;1
258132548430;258132548578;148;9;1;1;1
258132548578;258132549224;646;9;1;1;1
258132549224;258132550402;1178;9;1;1;1
258132550402;258132555097;4695;9;1;1;1
258132555097;258132560453;5356;9;1;1;1
258132561005;258132569108;8103;9;1;1;1
258132569108;258132573379;4271;9;1;1;1
258132573379;258132594555;21176;9;1;1;1
258132595008;258132605896;10888;9;1;1;1
258132605896;258132607292;1396;9;1;1;1
258132607292;258132618122;10830;9;1;1;1
258132618122;258132631594;13472;9;1;1;1
258132631594;258132632640;1046;9;1;1;1
258132632640;258132634678;2038;9;1;1;1
258132634678;258132635095;417;9;1;1;1
258132635621;258132637756;2135;9;1;1;1
258132637756;258132638196;440;9;1;1;1
258132638196;258132638970;774;9;1;1;1
258132638970;258132643365;4395;9;1;1;1
258132643365;258132646889;3524;9;1;1;1
258132646889;258132648374;1485;9;1;1;1
258132648374;258132650749;2375;9;1;1;1
258132650749;258132653319;2570;9;1;1;1
258132653319;258132654303;984;9;1;1;1
258132654303;258132654488;185;9;1;1;1
258132654488;258132655419;931;9;1;1;1
258132655419;258132656072;653;9;1;1;1
258132656072;258132657056;984;9;1;1;1
258132657056;258132660560;3504;9;1;1;1
258132660560;258132664323;3763;9;1;1;1
258132664323;258132664370;47;9;1;1;1
258132664370;258132667339;2969;9;1;1;1
258132667339;258132672166;4827;9;1;1;1
258132672166;258132674946;2780;9;1;1;1
258132674946;258132677911;2965;9;1;1;1
258132677911;258132679167;1256;9;1;1;1
258132679167;258132679237;70;9;1;1;1
258132679237;258132680196;959;9;1;1;1
258132680196;258132680564;368;9;1;1;1
258132680564;258132680832;268;9;1;1;1
258132680832;258132680941;109;9;1;1;1
258132680941;258132681272;331;9;1;1;1
258132681272;258132681430;158;9;1;1;1
258132681430;258132681622;192;9;1;1;1
258132682088;258132682962;874;9;1;1;1
258132682962;258132683894;932;9;1;1;1
258132683894;258132684001;107;9;1;1;1
258132684001;258132685406;1405;9;1;1;1
258132685406;258132688686;3280;9;1;1;1
258132688686;258132693347;4661;9;1;1;1
258132693347;258132695506;2159;9;1;1;1
258132695506;258132701917;6411;9;1;1;1
258132701917;258132704504;2587;9;1;1;1
258132704504;258132714964;10460;9;1;1;1
258132714964;258132717188;2224;9;1;1;1
258132717188;258132718129;941;9;1;1;1
258132718129;258132723558;5429;9;1;1;1
258132725126;258132725746;620;9;1;1;1
258132726785;258132727284;499;9;1;1;1
258132727284;258132728091;807;9;1;1;1
258132728717;258132742547;13830;9;1;1;1
258132742547;258132751230;8683;9;1;1;1
258132751230;258132753445;2215;9;1;1;1
258132753445;258132757709;4264;9;1;1;1
258132757709;258132762096;4387;9;1;1;1
258132762096;258132773855;11759;9;1;1;1
258132773855;258132785373;11518;9;1;1;1
258132785373;258132786653;1280;9;1;1;1
258132786653;258132793912;7259;9;1;1;1
258132793912;258132811279;17367;9;1;1;1
258132811279;258132835820;24541;9;1;1;1
258132835820;258132838347;2527;9;1;1;1
258132838347;258132848298;9951;9;1;1;1
258132848298;258132848416;118;9;1;1;1
258132848416;258132849882;1466;9;1;1;1
258132849882;258132850692;810;9;1;1;1
258132850692;258132852565;1873;9;1;1;1
258132852565;258132852588;23;9;1;1;1
258132852588;258132857440;4852;9;1;1;1
258132857440;258132862639;5199;9;1;1;1
258132862639;258132872502;9863;9;1;1;1
258132872502;258132897306;24804;9;1;1;1
258132897306;258132921843;24537;9;1;1;1
258132921843;258132925950;4107;9;1;1;1
258132925950;258132927170;1220;9;1;1;1
258132927170;258132928400;1230;9;1;1;1
258132928400;258132928619;219;9;1;1;1
258132928619;258132928841;222;9;1;1;1
258132928841;258132929724;883;9;1;1;1
258132929724;258132929875;151;9;1;1;1
258132930534;258132930882;348;9;1;1;1
258132930882;258132931421;539;9;1;1;1
258132931421;258132931949;528;9;1;1;1
258132931949;258132932203;254;9;1;1;1
258132932203;258132932435;232;9;1;1;1
258132932435;258132933251;816;9;1;1;1
258132933251;258132934748;1497;9;1;1;1
258132934748;258132936132;1384;9;1;1;1
258132936132;258132936232;100;9;1;1;1
258132936232;258132936776;544;9;1;1;1
258132936776;258132938207;1431;9;1;1;1
258132938207;258132938458;251;9;1;1;1
258132938458;258132939282;824;9;1;1;1
258132939282;258132949451;10169;9;1;1;1
258132949451;258132949487;36;9;1;1;1
258132949487;258132949856;369;9;1;1;1
258132949856;258132949897;41;9;1;1;1
258132949897;258132952907;3010;9;1;1;1
258132952907;258132953411;504;9;1;1;1
258132953411;258132954687;1276;9;1;1;1
258132954687;258132954958;271;9;1;1;1
258132954958;258132955945;987;9;1;1;1
258132955945;258132957960;2015;9;1;1;1
258132957960;258132958323;363;9;1;1;1
258132958323;258132958700;377;9;1;1;1
258132958700;258132959092;392;9;1;1;1
258132959092;258132959206;114;9;1;1;1
258132959206;258132959770;564;9;1;1;1
258132959770;258132960538;768;9;1;1;1
258132960538;258132961052;514;9;1;1;1
258132961052;258132961555;503;9;1;1;1
258132961555;258132962055;500;9;1;1;1
258132962055;258132962700;645;9;1;1;1
258132962700;258132962904;204;9;1;1;1
258132962904;258132963969;1065;9;1;1;1
258132963969;258132964006;37;9;1;1;1
258132964006;258132964232;226;9;1;1;1
258132964232;258132965422;1190;9;1;1;1
258132965422;258132965535;113;9;1;1;1
258132965535;258132965615;80;9;1;1;1
258132965615;258132966542;927;9;1;1;1
258132966542;258132966795;253;9;1;1;1
258132966795;258132967086;291;9;1;1;1
258132967086;258132967312;226;9;1;1;1
258132967312;258132968786;1474;9;1;1;1
258132968786;258132969595;809;9;1;1;1
258132969595;258132969937;342;9;1;1;1
258132969937;258132970187;250;9;1;1;1
258132970187;258132970314;127;9;1;1;1
258132970314;258132971989;1675;9;1;1;1
258132971989;258132973364;1375;9;1;1;1
258132973364;258132974291;927;9;1;1;1
258132974291;258132974366;75;9;1;1;1
258132974366;258132975044;678;9;1;1;1
258132975044;258132979933;4889;9;1;1;1
258132979933;258132983172;3239;9;1;1;1
258132983172;258132983903;731;9;1;1;1
258132983903;258132984833;930;9;1;1;1
258132984833;258132985243;410;9;1;1;1
258132985243;258132988237;2994;9;1;1;1
258132988237;258133003578;15341;9;1;1;1
258133004228;258133005905;1677;9;1;1;1
258133005905;258133013268;7363;9;1;1;1
258133013268;258133033372;20104;9;1;1;1
258133033372;258133045243;11871;9;1;1;1
258133045243;258133050489;5246;9;1;1;1
258133050489;258133052025;1536;9;1;1;1
258133052025;258133063432;11407;9;1;1;1
258133063432;258133075056;11624;9;1;1;1
258133075056;258133080844;5788;9;1;1;1
258133081414;258133146183;64769;9;1;1;1
258133207057;258133207278;221;9;1;1;1
258133207278;258133207339;61;9;1;1;1
258133208367;258133209207;840;9;1;1;1
258133209207;258133209588;381;9;1;1;1
258133210145;258133211874;1729;9;1;1;1
258133211874;258133211897;23;9;1;1;1
258133211897;258133212874;977;9;1;1;1
258133212874;258133213079;205;9;1;1;1
258133213079;258133216877;3798;9;1;1;1
258133216877;258133217312;435;9;1;1;1
258133217312;258133218606;1294;9;1;1;1
258133218606;258133218942;336;9;1;1;1
258133218942;258133220769;1827;9;1;1;1
258133220769;258133222118;1349;9;1;1;1
258133222118;258133222596;478;9;1;1;1
258133222596;258133224187;1591;9;1;1;1
258133224187;258133227092;2905;9;1;1;1
258133227092;258133237438;10346;9;1;1;1
258133237913;258133255408;17495;9;1;1;1
258133255408;258133255637;229;9;1;1;1
258133255637;258133267176;11539;9;1;1;1
258133267176;258133270380;3204;9;1;1;1
258133270380;258133272591;2211;9;1;1;1
258133272591;258133280150;7559;9;1;1;1
258133280150;258133329426;49276;9;1;1;1
258133330363;258133331578;1215;9;1;1;1
258133332549;258133333859;1310;9;1;1;1
258133334525;258133335801;1276;9;1;1;1
258133335801;258133352567;16766;9;1;1;1
258133352567;258133355628;3061;9;1;1;1
258133355628;258133361194;5566;9;1;1;1
258133361194;258133362292;1098;9;1;1;1
258133362292;258133363033;741;9;1;1;1
258133363033;258133363322;289;9;1;1;1
258133363322;258133363341;19;9;1;1;1
258133363341;258133364840;1499;9;1;1;1
258133364840;258133365343;503;9;1;1;1
258133365343;258133368131;2788;9;1;1;1
258133368131;258133381901;13770;9;1;1;1
258133381901;258133389052;7151;9;1;1;1
258133389052;258133389107;55;9;1;1;1
258133389107;258133400722;11615;9;1;1;1
258133400722;258133400750;28;9;1;1;1
258133400750;258133401137;387;9;1;1;1
258133401137;258133403092;1955;9;1;1;1
258133403092;258133403965;873;9;1;1;1
258133404593;258133409538;4945;9;1;1;1
258133409538;258133410039;501;9;1;1;1
258133410039;258133412872;2833;9;1;1;1
258133412872;258133413300;428;9;1;1;1
258133413300;258133414127;827;9;1;1;1
258133414127;258133416064;1937;9;1;1;1
258133416064;258133416512;448;9;1;1;1
258133416512;258133416972;460;9;1;1;1
258133416972;258133417992;1020;9;1;1;1
258133417992;258133419260;1268;9;1;1;1
258133419260;258133420966;1706;9;1;1;1
258133420966;258133423312;2346;9;1;1;1
258133423312;258133429198;5886;9;1;1;1
258133429198;258133429256;58;9;1;1;1
258133429256;258133431745;2489;9;1;1;1
258133431745;258133431931;186;9;1;1;1
258133431931;258133432870;939;9;1;1;1
258133432870;258133433551;681;9;1;1;1
258133433551;258133433758;207;9;1;1;1
258133433758;258133434931;1173;9;1;1;1
258133434931;258133435431;500;9;1;1;1
258133435431;258133436200;769;9;1;1;1
258133436200;258133436704;504;9;1;1;1
258133436704;258133438318;1614;9;1;1;1
258133438318;258133449306;10988;9;1;1;1
258133449306;258133458113;8807;9;1;1;1
258133458113;258133479173;21060;9;1;1;1
258133479173;258133479724;551;9;1;1;1
258133479724;258133486085;6361;9;1;1;1
258133486719;258133486925;206;9;1;1;1
