start;end;duration;jobs;njobs;days;ndays
223076382203;223076385509;3306;11;1;1;1
226930029764;226930033217;3453;11;1;1;1
230406957335;230406960613;3278;11;1;1;1
233873858752;233873862104;3352;11;1;1;1
237728219166;237728222525;3359;11;1;1;1
241761630179;241761633456;3277;11;1;1;1
245945410519;245945413974;3455;11;1;1;1
249710955171;249710958486;3315;11;1;1;1
258133515298;258133524398;9100;9;1;1;1
258133526480;258133526830;350;9;1;1;1
258133527684;258133528732;1048;9;1;1;1
258133529369;258133582749;53380;9;1;1;1
258133654326;258133666592;12266;9;1;1;1
258133667234;258133707912;40678;9;1;1;1
258133840914;258133867528;26614;9;1;1;1
258133868150;258133871894;3744;9;1;1;1
258133872596;258133917492;44896;9;1;1;1
258133917970;258133950420;32450;9;1;1;1
258133954317;258134007875;53558;9;1;1;1
258134011861;258134091065;79204;9;1;1;1
258134091700;258134149317;57617;9;1;1;1
258134149912;258134150091;179;9;1;1;1
258134151073;258134275378;124305;9;1;1;1
258134275969;258134278526;2557;9;1;1;1
258134279082;258134279643;561;9;1;1;1
258134280294;258134338704;58410;9;1;1;1
258134339253;258134339810;557;9;1;1;1
258134343745;258134424020;80275;9;1;1;1
258134424670;258134505053;80383;9;1;1;1
258134505582;258134579756;74174;9;1;1;1
258134580394;258134626158;45764;9;1;1;1
258134626698;258134704739;78041;9;1;1;1
258134705380;258134745040;39660;9;1;1;1
258134745596;258134790203;44607;9;1;1;1
258134790768;258134871448;80680;9;1;1;1
258134872723;258134873219;496;9;1;1;1
258134874502;258134945610;71108;9;1;1;1
258134946380;258134946954;574;9;1;1;1
258134947495;258134995430;47935;9;1;1;1
258134996330;258134997298;968;9;1;1;1
258134997862;258135066801;68939;9;1;1;1
258135067317;258135151039;83722;9;1;1;1
258135151697;258135224329;72632;9;1;1;1
258135227819;258135228566;747;9;1;1;1
258135229204;258135229562;358;9;1;1;1
258135230716;258135310796;80080;9;1;1;1
258135311430;258135378946;67516;9;1;1;1
258135379638;258135462604;82966;9;1;1;1
258135466071;258135468954;2883;9;1;1;1
258135475284;258135476621;1337;9;1;1;1
258135477918;258135534594;56676;9;1;1;1
258135535162;258135536071;909;9;1;1;1
258135537224;258135574887;37663;9;1;1;1
258135574887;258135585110;10223;9;1;1;1
258135585110;258135585113;3;9;1;1;1
258135585113;258135585119;6;9;1;1;1
258135585119;258135585120;1;9;1;1;1
258135585120;258135585124;4;9;1;1;1
258135585124;258135585126;2;9;1;1;1
258135585126;258135585128;2;9;1;1;1
258135585128;258135585141;13;9;1;1;1
258135585141;258135585142;1;9;1;1;1
258135585142;258135585148;6;9;1;1;1
258135585148;258135585150;2;9;1;1;1
258135585150;258135585153;3;9;1;1;1
258135585153;258135585161;8;9;1;1;1
258135585161;258135585165;4;9;1;1;1
258135585165;258135585174;9;9;1;1;1
258135585174;258135585201;27;9;1;1;1
258135585201;258135585217;16;9;1;1;1
258135585217;258135585219;2;9;1;1;1
258135585219;258135585229;10;9;1;1;1
258135585229;258135585240;11;9;1;1;1
258135585240;258135585247;7;9;1;1;1
258135585247;258135585260;13;9;1;1;1
258135585260;258135585287;27;9;1;1;1
258135585287;258135585295;8;9;1;1;1
258135585295;258135585297;2;9;1;1;1
258135585297;258135585303;6;9;1;1;1
258135585303;258135585312;9;9;1;1;1
258135585312;258135585331;19;9;1;1;1
258135585331;258135585338;7;9;1;1;1
258135585338;258135585343;5;9;1;1;1
258135585343;258135585360;17;9;1;1;1
258135585360;258135585370;10;9;1;1;1
258135585370;258135585371;1;9;1;1;1
258135585371;258135585381;10;9;1;1;1
258135585381;258135585391;10;9;1;1;1
258135585391;258135585412;21;9;1;1;1
258135585412;258135585440;28;9;1;1;1
258135585440;258135585444;4;9;1;1;1
258135585444;258135585453;9;9;1;1;1
258135585453;258135585463;10;9;1;1;1
258135585463;258135585480;17;9;1;1;1
258135585480;258135585487;7;9;1;1;1
258135585487;258135585494;7;9;1;1;1
258135585494;258135585497;3;9;1;1;1
258135585497;258135585498;1;9;1;1;1
258135585498;258135585528;30;9;1;1;1
258135585528;258135585539;11;9;1;1;1
258135585539;258135585558;19;9;1;1;1
258135585558;258135585561;3;9;1;1;1
258135585561;258135585571;10;9;1;1;1
258135585571;258135585573;2;9;1;1;1
258135585573;258135585603;30;9;1;1;1
258135585603;258135585614;11;9;1;1;1
258135585614;258135585615;1;9;1;1;1
258135585615;258135585622;7;9;1;1;1
258135585622;258135585638;16;9;1;1;1
258135585638;258135585667;29;9;1;1;1
258135585667;258135585720;53;9;1;1;1
258135585720;258135585723;3;9;1;1;1
258135585723;258135585730;7;9;1;1;1
258135585730;258135585744;14;9;1;1;1
258135585744;258135585745;1;9;1;1;1
258135585745;258135585760;15;9;1;1;1
258135585760;258135585763;3;9;1;1;1
258135585763;258135585771;8;9;1;1;1
258135585771;258135585829;58;9;1;1;1
258135585829;258135585851;22;9;1;1;1
258135585851;258135585852;1;9;1;1;1
258135585852;258135585853;1;9;1;1;1
258135585853;258135585862;9;9;1;1;1
258135585862;258135585880;18;9;1;1;1
258135585880;258135585882;2;9;1;1;1
258135585882;258135585887;5;9;1;1;1
258135585887;258135585902;15;9;1;1;1
258135585902;258135585907;5;9;1;1;1
258135585907;258135585929;22;9;1;1;1
258135585929;258135585948;19;9;1;1;1
258135585948;258135585953;5;9;1;1;1
258135585953;258135585954;1;9;1;1;1
258135585954;258135585961;7;9;1;1;1
258135585961;258135585963;2;9;1;1;1
258135585963;258135585968;5;9;1;1;1
258135585968;258135586006;38;9;1;1;1
258135586006;258135586010;4;9;1;1;1
258135586010;258135586025;15;9;1;1;1
258135586025;258135586031;6;9;1;1;1
258135586031;258135586080;49;9;1;1;1
258135586080;258135586094;14;9;1;1;1
258135586094;258135586100;6;9;1;1;1
258135586100;258135586106;6;9;1;1;1
258135586106;258135586108;2;9;1;1;1
258135586108;258135586111;3;9;1;1;1
258135586111;258135586121;10;9;1;1;1
258135586121;258135586133;12;9;1;1;1
258135586133;258135586166;33;9;1;1;1
258135586166;258135586171;5;9;1;1;1
258135586171;258135586174;3;9;1;1;1
258135586174;258135586177;3;9;1;1;1
258135586177;258135586183;6;9;1;1;1
258135586183;258135586192;9;9;1;1;1
258135586192;258135586197;5;9;1;1;1
258135586197;258135586199;2;9;1;1;1
258135586199;258135586207;8;9;1;1;1
258135586207;258135586221;14;9;1;1;1
258135586221;258135586226;5;9;1;1;1
258135586226;258135586234;8;9;1;1;1
258135586234;258135586262;28;9;1;1;1
258135586262;258135586269;7;9;1;1;1
258135586269;258135586275;6;9;1;1;1
258135586275;258135586276;1;9;1;1;1
258135586276;258135586279;3;9;1;1;1
258135586279;258135586289;10;9;1;1;1
258135586289;258135586311;22;9;1;1;1
258135586311;258135586318;7;9;1;1;1
258135586318;258135586323;5;9;1;1;1
258135586323;258135586325;2;9;1;1;1
258135586325;258135586339;14;9;1;1;1
258135586339;258135586352;13;9;1;1;1
258135586352;258135586370;18;9;1;1;1
258135586370;258135586382;12;9;1;1;1
258135586382;258135586392;10;9;1;1;1
258135586392;258135586393;1;9;1;1;1
258135586393;258135586409;16;9;1;1;1
258135586409;258135586415;6;9;1;1;1
258135586415;258135586419;4;9;1;1;1
258135586419;258135586422;3;9;1;1;1
258135586422;258135586444;22;9;1;1;1
258135586444;258135586456;12;9;1;1;1
258135586456;258135586470;14;9;1;1;1
258135586470;258135586471;1;9;1;1;1
258135586471;258135586476;5;9;1;1;1
258135586476;258135586479;3;9;1;1;1
258135586479;258135586492;13;9;1;1;1
258135586492;258135586505;13;9;1;1;1
258135586505;258135586536;31;9;1;1;1
258135586536;258135586559;23;9;1;1;1
258135586559;258135586565;6;9;1;1;1
258135586565;258135586583;18;9;1;1;1
258135586583;258135586605;22;9;1;1;1
258135586605;258135586617;12;9;1;1;1
258135586617;258135586622;5;9;1;1;1
258135586622;258135586624;2;9;1;1;1
258135586624;258135586628;4;9;1;1;1
258135586628;258135586638;10;9;1;1;1
258135586638;258135586647;9;9;1;1;1
258135586647;258135586650;3;9;1;1;1
258135586650;258135586658;8;9;1;1;1
258135586658;258135586662;4;9;1;1;1
258135586662;258135586680;18;9;1;1;1
258135586680;258135586684;4;9;1;1;1
258135586684;258135586699;15;9;1;1;1
258135586699;258135586703;4;9;1;1;1
258135586703;258135586716;13;9;1;1;1
258135586716;258135586740;24;9;1;1;1
258135586740;258135586742;2;9;1;1;1
258135586742;258135586747;5;9;1;1;1
258135586747;258135586749;2;9;1;1;1
258135586749;258135586752;3;9;1;1;1
258135586752;258135586765;13;9;1;1;1
258135586765;258135586769;4;9;1;1;1
258135586769;258135586771;2;9;1;1;1
258135586771;258135586774;3;9;1;1;1
258135586774;258135586785;11;9;1;1;1
258135586785;258135586796;11;9;1;1;1
258135586796;258135586797;1;9;1;1;1
258135586797;258135586808;11;9;1;1;1
258135586808;258135586838;30;9;1;1;1
258135586838;258135586882;44;9;1;1;1
258135586882;258135586883;1;9;1;1;1
258135586883;258135586885;2;9;1;1;1
258135586885;258135586897;12;9;1;1;1
258135586897;258135586918;21;9;1;1;1
258135586918;258135586919;1;9;1;1;1
258135586919;258135586939;20;9;1;1;1
258135586939;258135586950;11;9;1;1;1
258135586950;258135586956;6;9;1;1;1
258135586956;258135586964;8;9;1;1;1
258135586964;258135586980;16;9;1;1;1
258135586980;258135586996;16;9;1;1;1
258135586996;258135587005;9;9;1;1;1
258135587005;258135587012;7;9;1;1;1
258135587012;258135587019;7;9;1;1;1
258135587019;258135587026;7;9;1;1;1
258135587026;258135587031;5;9;1;1;1
258135587031;258135587047;16;9;1;1;1
258135587047;258135587063;16;9;1;1;1
258135587063;258135587068;5;9;1;1;1
258135587068;258135587079;11;9;1;1;1
258135587079;258135587092;13;9;1;1;1
258135587092;258135587094;2;9;1;1;1
258135587094;258135587103;9;9;1;1;1
258135587103;258135587112;9;9;1;1;1
258135587112;258135587119;7;9;1;1;1
258135587119;258135587122;3;9;1;1;1
258135587122;258135587130;8;9;1;1;1
258135587130;258135587133;3;9;1;1;1
258135587133;258135587144;11;9;1;1;1
258135587144;258135587168;24;9;1;1;1
258135587168;258135587170;2;9;1;1;1
258135587170;258135587175;5;9;1;1;1
258135587175;258135587189;14;9;1;1;1
258135587189;258135587211;22;9;1;1;1
258135587211;258135587214;3;9;1;1;1
258135587214;258135587215;1;9;1;1;1
258135587215;258135587259;44;9;1;1;1
258135587259;258135587262;3;9;1;1;1
258135587262;258135587285;23;9;1;1;1
258135587285;258135587293;8;9;1;1;1
258135587293;258135587299;6;9;1;1;1
258135587299;258135587308;9;9;1;1;1
258135587308;258135587311;3;9;1;1;1
258135587311;258135587313;2;9;1;1;1
258135587313;258135587314;1;9;1;1;1
258135587314;258135587327;13;9;1;1;1
258135587327;258135587340;13;9;1;1;1
258135587340;258135587347;7;9;1;1;1
258135587347;258135587383;36;9;1;1;1
258135587383;258135587400;17;9;1;1;1
258135587400;258135587412;12;9;1;1;1
258135587412;258135587413;1;9;1;1;1
258135587413;258135587434;21;9;1;1;1
258135587434;258135587441;7;9;1;1;1
258135587441;258135587448;7;9;1;1;1
258135587448;258135587477;29;9;1;1;1
258135587477;258135587484;7;9;1;1;1
258135587484;258135587485;1;9;1;1;1
258135587485;258135587494;9;9;1;1;1
258135587494;258135587523;29;9;1;1;1
258135587523;258135587528;5;9;1;1;1
258135587528;258135587537;9;9;1;1;1
258135587537;258135587543;6;9;1;1;1
258135587543;258135587547;4;9;1;1;1
258135587547;258135587566;19;9;1;1;1
258135587566;258135587568;2;9;1;1;1
258135587568;258135587569;1;9;1;1;1
258135587569;258135587571;2;9;1;1;1
258135587571;258135587589;18;9;1;1;1
258135587589;258135587607;18;9;1;1;1
258135587607;258135587611;4;9;1;1;1
258135587611;258135587633;22;9;1;1;1
258135587633;258135587641;8;9;1;1;1
258135587641;258135587662;21;9;1;1;1
258135587662;258135587676;14;9;1;1;1
258135587676;258135587686;10;9;1;1;1
258135587686;258135587692;6;9;1;1;1
258135587692;258135587714;22;9;1;1;1
258135587714;258135587724;10;9;1;1;1
258135587724;258135587726;2;9;1;1;1
258135587726;258135587738;12;9;1;1;1
258135587738;258135587741;3;9;1;1;1
258135587741;258135587742;1;9;1;1;1
258135587742;258135587758;16;9;1;1;1
258135587758;258135587763;5;9;1;1;1
258135587763;258135587774;11;9;1;1;1
258135587774;258135587777;3;9;1;1;1
258135587777;258135587787;10;9;1;1;1
258135587787;258135587792;5;9;1;1;1
258135587792;258135587814;22;9;1;1;1
258135587814;258135587815;1;9;1;1;1
258135587815;258135587839;24;9;1;1;1
258135587839;258135587848;9;9;1;1;1
258135587848;258135587858;10;9;1;1;1
258135587858;258135587872;14;9;1;1;1
258135587872;258135587874;2;9;1;1;1
258135587874;258135587883;9;9;1;1;1
258135587883;258135587891;8;9;1;1;1
258135587891;258135587897;6;9;1;1;1
258135587897;258135587911;14;9;1;1;1
258135587911;258135587912;1;9;1;1;1
258135587912;258135587934;22;9;1;1;1
258135587934;258135587935;1;9;1;1;1
258135587935;258135587957;22;9;1;1;1
258135587957;258135587963;6;9;1;1;1
258135587963;258135587966;3;9;1;1;1
258135587966;258135587980;14;9;1;1;1
258135587980;258135587993;13;9;1;1;1
258135587993;258135588026;33;9;1;1;1
258135588026;258135588037;11;9;1;1;1
258135588037;258135588048;11;9;1;1;1
258135588048;258135588067;19;9;1;1;1
258135588067;258135588069;2;9;1;1;1
258135588069;258135588078;9;9;1;1;1
258135588078;258135588083;5;9;1;1;1
258135588083;258135588091;8;9;1;1;1
258135588091;258135588105;14;9;1;1;1
258135588105;258135588110;5;9;1;1;1
258135588110;258135588120;10;9;1;1;1
258135588120;258135588135;15;9;1;1;1
258135588135;258135588139;4;9;1;1;1
258135588139;258135588145;6;9;1;1;1
258135588145;258135588150;5;9;1;1;1
258135588150;258135588166;16;9;1;1;1
258135588166;258135588167;1;9;1;1;1
258135588167;258135588188;21;9;1;1;1
258135588188;258135588195;7;9;1;1;1
258135588195;258135588203;8;9;1;1;1
258135588203;258135588207;4;9;1;1;1
258135588207;258135588218;11;9;1;1;1
258135588218;258135588230;12;9;1;1;1
258135588230;258135588231;1;9;1;1;1
258135588231;258135588233;2;9;1;1;1
258135588233;258135588242;9;9;1;1;1
258135588242;258135588255;13;9;1;1;1
258135588255;258135588261;6;9;1;1;1
258135588261;258135588268;7;9;1;1;1
258135588268;258135588273;5;9;1;1;1
258135588273;258135588284;11;9;1;1;1
258135588284;258135588287;3;9;1;1;1
258135588287;258135588290;3;9;1;1;1
258135588290;258135588296;6;9;1;1;1
258135588296;258135588329;33;9;1;1;1
258135588329;258135588330;1;9;1;1;1
258135588330;258135588339;9;9;1;1;1
258135588339;258135588384;45;9;1;1;1
258135588384;258135588387;3;9;1;1;1
258135588387;258135588407;20;9;1;1;1
258135588407;258135588413;6;9;1;1;1
258135588413;258135588434;21;9;1;1;1
258135588434;258135588435;1;9;1;1;1
258135588435;258135588442;7;9;1;1;1
258135588442;258135588446;4;9;1;1;1
258135588446;258135588456;10;9;1;1;1
258135588456;258135588461;5;9;1;1;1
258135588461;258135588470;9;9;1;1;1
258135588470;258135588477;7;9;1;1;1
258135588477;258135588499;22;9;1;1;1
258135588499;258135588529;30;9;1;1;1
258135588529;258135588559;30;9;1;1;1
258135588559;258135588563;4;9;1;1;1
258135588563;258135588571;8;9;1;1;1
258135588571;258135588578;7;9;1;1;1
258135588578;258135588584;6;9;1;1;1
258135588584;258135588591;7;9;1;1;1
258135588591;258135588603;12;9;1;1;1
258135588603;258135588605;2;9;1;1;1
258135588605;258135588633;28;9;1;1;1
258135588633;258135588640;7;9;1;1;1
258135588640;258135588649;9;9;1;1;1
258135588649;258135588652;3;9;1;1;1
258135588652;258135588661;9;9;1;1;1
258135588661;258135588679;18;9;1;1;1
258135588679;258135588713;34;9;1;1;1
258135588713;258135588720;7;9;1;1;1
258135588720;258135588738;18;9;1;1;1
258135588738;258135588749;11;9;1;1;1
258135588749;258135588760;11;9;1;1;1
258135588760;258135588761;1;9;1;1;1
258135588761;258135588816;55;9;1;1;1
258135588816;258135588819;3;9;1;1;1
258135588819;258135588845;26;9;1;1;1
258135588845;258135588863;18;9;1;1;1
258135588863;258135588874;11;9;1;1;1
258135588874;258135588910;36;9;1;1;1
258135588910;258135588939;29;9;1;1;1
258135588939;258135588973;34;9;1;1;1
258135588973;258135589008;35;9;1;1;1
258135589008;258135589010;2;9;1;1;1
258135589010;258135589029;19;9;1;1;1
258135589029;258135589055;26;9;1;1;1
258135589055;258135589075;20;9;1;1;1
258135589075;258135589083;8;9;1;1;1
258135589083;258135589106;23;9;1;1;1
258135589106;258135589149;43;9;1;1;1
258135589149;258135589174;25;9;1;1;1
258135589174;258135589178;4;9;1;1;1
258135589178;258135589204;26;9;1;1;1
258135589204;258135589208;4;9;1;1;1
258135589208;258135589220;12;9;1;1;1
258135589220;258135589242;22;9;1;1;1
258135589242;258135589271;29;9;1;1;1
258135589271;258135589306;35;9;1;1;1
258135589306;258135589329;23;9;1;1;1
258135589329;258135589364;35;9;1;1;1
258135589364;258135589367;3;9;1;1;1
258135589367;258135589421;54;9;1;1;1
258135589421;258135589480;59;9;1;1;1
258135589480;258135589579;99;9;1;1;1
258135589579;258135589599;20;9;1;1;1
258135589599;258135589631;32;9;1;1;1
258135589631;258135589693;62;9;1;1;1
258135589693;258135589713;20;9;1;1;1
258135589713;258135589740;27;9;1;1;1
258135589740;258135589749;9;9;1;1;1
258135589749;258135589768;19;9;1;1;1
258135589768;258135589771;3;9;1;1;1
258135589771;258135589801;30;9;1;1;1
258135589801;258135589821;20;9;1;1;1
258135589821;258135589868;47;9;1;1;1
258135589868;258135589897;29;9;1;1;1
258135589897;258135589920;23;9;1;1;1
258135589920;258135590014;94;9;1;1;1
258135590014;258135590082;68;9;1;1;1
258135590082;258135590119;37;9;1;1;1
258135590119;258135590149;30;9;1;1;1
258135590149;258135590181;32;9;1;1;1
258135590181;258135590275;94;9;1;1;1
258135590275;258135590285;10;9;1;1;1
258135590285;258135590447;162;9;1;1;1
258135590447;258135590534;87;9;1;1;1
258135590534;258135590552;18;9;1;1;1
258135590552;258135590555;3;9;1;1;1
258135590555;258135590623;68;9;1;1;1
258135590623;258135590667;44;9;1;1;1
258135590667;258135590794;127;9;1;1;1
258135590794;258135590938;144;9;1;1;1
258135590938;258135590973;35;9;1;1;1
258135590973;258135591019;46;9;1;1;1
258135591019;258135591070;51;9;1;1;1
258135591070;258135591111;41;9;1;1;1
258135591111;258135591498;387;9;1;1;1
258135591498;258135591819;321;9;1;1;1
258135591819;258135592088;269;9;1;1;1
258135592088;258135592122;34;9;1;1;1
258135592122;258135592170;48;9;1;1;1
258135592170;258135592221;51;9;1;1;1
258135592221;258135592274;53;9;1;1;1
258135592274;258135592318;44;9;1;1;1
258135592318;258135592402;84;9;1;1;1
258135592402;258135592515;113;9;1;1;1
258135592515;258135592520;5;9;1;1;1
258135592520;258135592678;158;9;1;1;1
258135592678;258135592707;29;9;1;1;1
258135592707;258135592754;47;9;1;1;1
258135592754;258135592798;44;9;1;1;1
258135592798;258135592826;28;9;1;1;1
258135592826;258135592889;63;9;1;1;1
258135592889;258135593098;209;9;1;1;1
258135593098;258135593102;4;9;1;1;1
258135593102;258135593161;59;9;1;1;1
258135593161;258135593262;101;9;1;1;1
258135593262;258135593306;44;9;1;1;1
258135593306;258135593349;43;9;1;1;1
258135593349;258135593370;21;9;1;1;1
258135593370;258135593448;78;9;1;1;1
258135593448;258135593468;20;9;1;1;1
258135593468;258135593566;98;9;1;1;1
258135593566;258135593640;74;9;1;1;1
258135593640;258135593693;53;9;1;1;1
258135593693;258135593727;34;9;1;1;1
258135593727;258135593873;146;9;1;1;1
258135593873;258135594219;346;9;1;1;1
258135594219;258135594265;46;9;1;1;1
258135594265;258135594384;119;9;1;1;1
258135594384;258135595141;757;9;1;1;1
258135595141;258135595170;29;9;1;1;1
258135595170;258135595200;30;9;1;1;1
258135595200;258135595236;36;9;1;1;1
258135595236;258135595538;302;9;1;1;1
258135595538;258135595610;72;9;1;1;1
258135595610;258135595677;67;9;1;1;1
258135595677;258135595724;47;9;1;1;1
258135595724;258135595796;72;9;1;1;1
258135595796;258135595851;55;9;1;1;1
258135595851;258135595922;71;9;1;1;1
258135595922;258135596046;124;9;1;1;1
258135596046;258135596223;177;9;1;1;1
258135596223;258135596481;258;9;1;1;1
258135596481;258135596681;200;9;1;1;1
258135596681;258135598148;1467;9;1;1;1
258135598148;258135598684;536;9;1;1;1
258135598684;258135598696;12;9;1;1;1
258135598696;258135598836;140;9;1;1;1
258135598836;258135598869;33;9;1;1;1
258135598869;258135598967;98;9;1;1;1
258135598967;258135599693;726;9;1;1;1
258135599693;258135600451;758;9;1;1;1
258135600451;258135600512;61;9;1;1;1
258135600512;258135600630;118;9;1;1;1
258135600630;258135601747;1117;9;1;1;1
258135601747;258135603360;1613;9;1;1;1
258135603360;258135605276;1916;9;1;1;1
258135605276;258135608040;2764;9;1;1;1
258457559852;258508445810;50885958;0;1;1;1
259114809668;259176146629;61336961;10;1;1;1
259506038879;259546984259;40945380;4;1;1;1
260735258712;260778737586;43478874;8;1;1;1
261202491866;261202495204;3338;11;1;1;1
262296170660;262354571012;58400352;1;1;1;1
262773355587;262773358863;3276;11;1;1;1
