start;end;duration;jobs;njobs;days;ndays
223076378280;223076379378;1098;11;1;1;1
226930023403;226930024634;1231;11;1;1;1
230406953277;230406954409;1132;11;1;1;1
233873854347;233873855559;1212;11;1;1;1
237728213169;237728214316;1147;11;1;1;1
241761626811;241761627870;1059;11;1;1;1
245945404652;245945405896;1244;11;1;1;1
249710951784;249710952895;1111;11;1;1;1
258135608976;258135609445;469;2;1;1;1
258135659165;258135659836;671;2;1;1;1
258135659836;258135659898;62;2;1;1;1
258135659898;258135660886;988;2;1;1;1
258135731581;258135732127;546;2;1;1;1
258135800837;258135801444;607;2;1;1;1
258135884941;258135885489;548;2;1;1;1
258135953007;258135953829;822;2;1;1;1
258135954605;258135955060;455;2;1;1;1
258135955060;258135955262;202;2;1;1;1
258135955262;258135955943;681;2;1;1;1
258136045357;258136045820;463;2;1;1;1
258136141873;258136142429;556;2;1;1;1
258136205593;258136206116;523;2;1;1;1
258136278570;258136279109;539;2;1;1;1
258136279355;258136279970;615;2;1;1;1
258136363079;258136365700;2621;2;1;1;1
258136367830;258136368459;629;2;1;1;1
258136441888;258136442481;593;2;1;1;1
258136442918;258136443585;667;2;1;1;1
258136519287;258136519931;644;2;1;1;1
258136554160;258136554795;635;2;1;1;1
258136627926;258136628509;583;2;1;1;1
258136629418;258136629976;558;2;1;1;1
258136758710;258136760661;1951;2;1;1;1
258136762123;258136762627;504;2;1;1;1
258136762627;258136762919;292;2;1;1;1
258136762919;258136763382;463;2;1;1;1
258136832279;258136832748;469;2;1;1;1
258136832748;258136832876;128;2;1;1;1
258136832876;258136833472;596;2;1;1;1
258136958306;258136958841;535;2;1;1;1
258137036235;258137036774;539;2;1;1;1
258137117335;258137117805;470;2;1;1;1
258137167376;258137167916;540;2;1;1;1
258137243660;258137244247;587;2;1;1;1
258137244324;258137244942;618;2;1;1;1
258137244942;258137245974;1032;2;1;1;1
258137245974;258137246476;502;2;1;1;1
258137323614;258137324073;459;2;1;1;1
258137388547;258137388779;232;2;1;1;1
258137388779;258137389195;416;2;1;1;1
258137389195;258137389544;349;2;1;1;1
258137470228;258137470865;637;2;1;1;1
258137545296;258137545967;671;2;1;1;1
258137611663;258137612212;549;2;1;1;1
258137646013;258137646553;540;2;1;1;1
258137646908;258137647505;597;2;1;1;1
258137723781;258137725059;1278;2;1;1;1
258137725878;258137726179;301;2;1;1;1
258137726179;258137726593;414;2;1;1;1
258137726593;258137726994;401;2;1;1;1
258137766417;258137766965;548;2;1;1;1
258137816289;258137816924;635;2;1;1;1
258137871170;258137871923;753;2;1;1;1
258137872900;258137873530;630;2;1;1;1
258137947935;258137948557;622;2;1;1;1
258138020653;258138021219;566;2;1;1;1
258138048976;258138049617;641;2;1;1;1
258138092729;258138093001;272;2;1;1;1
258138093001;258138093329;328;2;1;1;1
258138093329;258138093706;377;2;1;1;1
258138181939;258138182230;291;2;1;1;1
258138182230;258138182682;452;2;1;1;1
258138182682;258138182865;183;2;1;1;1
258138257115;258138257529;414;2;1;1;1
258138257529;258138257812;283;2;1;1;1
258138257812;258138258176;364;2;1;1;1
258138329843;258138330720;877;2;1;1;1
258138330720;258138331253;533;2;1;1;1
258138331253;258138332647;1394;2;1;1;1
258138333741;258138334382;641;2;1;1;1
258138334716;258138335473;757;2;1;1;1
258138409291;258138411630;2339;2;1;1;1
258138412148;258138413897;1749;2;1;1;1
258138414229;258138414858;629;2;1;1;1
258138415931;258138416611;680;2;1;1;1
258138483831;258138484508;677;2;1;1;1
258138553177;258138553791;614;2;1;1;1
258138630213;258138630389;176;2;1;1;1
258138630389;258138630805;416;2;1;1;1
258138630805;258138630851;46;2;1;1;1
258138630851;258138631701;850;2;1;1;1
258138631701;258138632299;598;2;1;1;1
258138632299;258138633258;959;2;1;1;1
258138633258;258138633666;408;2;1;1;1
258138707840;258138708474;634;2;1;1;1
258138798052;258138798591;539;2;1;1;1
258138865166;258138865641;475;2;1;1;1
258138893008;258138893713;705;2;1;1;1
258139085176;258139087161;1985;2;1;1;1
258139462382;258139463059;677;2;1;1;1
258139496299;258139496796;497;2;1;1;1
258139558740;258139559733;993;2;1;1;1
258139560881;258139561424;543;2;1;1;1
258139561771;258139562321;550;2;1;1;1
258139702557;258139703111;554;2;1;1;1
258139835726;258139836369;643;2;1;1;1
258139876928;258139877500;572;2;1;1;1
258139878162;258139878185;23;2;1;1;1
258139878185;258139879008;823;2;1;1;1
258139879008;258139879022;14;2;1;1;1
258140002042;258140002590;548;2;1;1;1
258140076307;258140076867;560;2;1;1;1
258140157798;258140158341;543;2;1;1;1
258140301197;258140301749;552;2;1;1;1
258140434487;258140435117;630;2;1;1;1
258140485552;258140486183;631;2;1;1;1
258140545182;258140545776;594;2;1;1;1
258140589979;258140590585;606;2;1;1;1
258140662346;258140662978;632;2;1;1;1
258140775369;258140776048;679;2;1;1;1
258140824321;258140825123;802;2;1;1;1
258140825421;258140825974;553;2;1;1;1
258140899909;258140900556;647;2;1;1;1
258140952474;258140952937;463;2;1;1;1
258141066191;258141066841;650;2;1;1;1
258141067100;258141067836;736;2;1;1;1
258141168786;258141169391;605;2;1;1;1
258141260519;258141261901;1382;2;1;1;1
258141261901;258141262200;299;2;1;1;1
258141262200;258141263970;1770;2;1;1;1
258141264283;258141264711;428;2;1;1;1
258141264711;258141265091;380;2;1;1;1
258141265091;258141265944;853;2;1;1;1
258141333596;258141334244;648;2;1;1;1
258141416176;258141416731;555;2;1;1;1
258141495164;258141495710;546;2;1;1;1
258141495918;258141496636;718;2;1;1;1
258141568877;258141569889;1012;2;1;1;1
258141570388;258141571140;752;2;1;1;1
258141571405;258141572156;751;2;1;1;1
258141616807;258141617361;554;2;1;1;1
258141795178;258141795810;632;2;1;1;1
258142210291;258142211344;1053;2;1;1;1
258142221631;258142222180;549;2;1;1;1
258142299754;258142300367;613;2;1;1;1
258142442252;258142442799;547;2;1;1;1
258142476653;258142476919;266;2;1;1;1
258142476919;258142477345;426;2;1;1;1
258142477345;258142477744;399;2;1;1;1
258142612432;258142614057;1625;2;1;1;1
258142614712;258142616522;1810;2;1;1;1
258142616522;258142616698;176;2;1;1;1
258142616698;258142617188;490;2;1;1;1
258142617188;258142618233;1045;2;1;1;1
258142618233;258142619853;1620;2;1;1;1
258142621312;258142622155;843;2;1;1;1
258142622155;258142622929;774;2;1;1;1
258142622929;258142623290;361;2;1;1;1
258142683599;258142684160;561;2;1;1;1
258142730178;258142730823;645;2;1;1;1
258142796219;258142797248;1029;2;1;1;1
258142870799;258142871354;555;2;1;1;1
258142909151;258142909618;467;2;1;1;1
258142909618;258142910046;428;2;1;1;1
258142910046;258142910425;379;2;1;1;1
258142912387;258142912937;550;2;1;1;1
258143035920;258143036581;661;2;1;1;1
258143037019;258143037726;707;2;1;1;1
258143078766;258143079318;552;2;1;1;1
258143157664;258143158263;599;2;1;1;1
258143244015;258143244563;548;2;1;1;1
258143307571;258143308172;601;2;1;1;1
258143417748;258143418350;602;2;1;1;1
258143507111;258143507629;518;2;1;1;1
258143507629;258143507836;207;2;1;1;1
258143507836;258143507862;26;2;1;1;1
258143507862;258143508563;701;2;1;1;1
258143508563;258143509348;785;2;1;1;1
258143626348;258143628750;2402;2;1;1;1
258143628750;258143632689;3939;2;1;1;1
258143632689;258143634232;1543;2;1;1;1
258143637157;258143637615;458;2;1;1;1
258143637615;258143639140;1525;2;1;1;1
258143639140;258143640936;1796;2;1;1;1
258143640936;258143641076;140;2;1;1;1
258143641076;258143641380;304;2;1;1;1
258143641380;258143642242;862;2;1;1;1
258143642242;258143642414;172;2;1;1;1
258143643219;258143643847;628;2;1;1;1
258143798202;258143798803;601;2;1;1;1
258143918276;258143918919;643;2;1;1;1
258143994154;258143994767;613;2;1;1;1
258144026054;258144026687;633;2;1;1;1
258144064747;258144065308;561;2;1;1;1
258144065432;258144066159;727;2;1;1;1
258144129943;258144130789;846;2;1;1;1
258144131717;258144132266;549;2;1;1;1
258144587021;258144587942;921;2;1;1;1
258144588761;258144589399;638;2;1;1;1
258144632674;258144633365;691;2;1;1;1
258144703171;258144703713;542;2;1;1;1
258144764417;258144764964;547;2;1;1;1
258144813536;258144814156;620;2;1;1;1
258144903191;258144903839;648;2;1;1;1
258144983551;258144984162;611;2;1;1;1
258144984162;258144984199;37;2;1;1;1
258144984199;258144985023;824;2;1;1;1
258145060532;258145061714;1182;2;1;1;1
258145061714;258145062396;682;2;1;1;1
258145062396;258145062867;471;2;1;1;1
258145063526;258145064167;641;2;1;1;1
258145140997;258145141562;565;2;1;1;1
258145213461;258145214096;635;2;1;1;1
258145262411;258145262778;367;2;1;1;1
258145262778;258145263173;395;2;1;1;1
258145263173;258145263550;377;2;1;1;1
258145334098;258145334643;545;2;1;1;1
258145376797;258145377922;1125;2;1;1;1
258145423800;258145424475;675;2;1;1;1
258145494020;258145495390;1370;2;1;1;1
258145495390;258145495652;262;2;1;1;1
258145495652;258145496101;449;2;1;1;1
258145496634;258145497287;653;2;1;1;1
258145539713;258145540312;599;2;1;1;1
258145540312;258145540442;130;2;1;1;1
258145540442;258145540973;531;2;1;1;1
258145705202;258145705976;774;2;1;1;1
258145798440;258145799121;681;2;1;1;1
258145954903;258145955524;621;2;1;1;1
258146152694;258146153314;620;2;1;1;1
258146294500;258146295127;627;2;1;1;1
258146656301;258146656869;568;2;1;1;1
258146700491;258146701347;856;2;1;1;1
258146702099;258146702699;600;2;1;1;1
258146812761;258146813314;553;2;1;1;1
258146853848;258146854498;650;2;1;1;1
258146854598;258146855317;719;2;1;1;1
258146864698;258146865087;389;2;1;1;1
258146865087;258146865312;225;2;1;1;1
258146865312;258146865694;382;2;1;1;1
258147008618;258147009378;760;2;1;1;1
258147009890;258147010669;779;2;1;1;1
258147011628;258147012250;622;2;1;1;1
258147041607;258147043502;1895;2;1;1;1
258147043864;258147044689;825;2;1;1;1
258147045695;258147046297;602;2;1;1;1
258147088022;258147088571;549;2;1;1;1
258147167216;258147167855;639;2;1;1;1
258147214188;258147214805;617;2;1;1;1
258147271201;258147271823;622;2;1;1;1
258147341962;258147342894;932;2;1;1;1
258147343745;258147344288;543;2;1;1;1
258147428118;258147430320;2202;2;1;1;1
258147430320;258147430920;600;2;1;1;1
258147430920;258147431666;746;2;1;1;1
258147431666;258147432113;447;2;1;1;1
258147432113;258147432804;691;2;1;1;1
258147432804;258147432889;85;2;1;1;1
258147432889;258147433655;766;2;1;1;1
258147474857;258147475457;600;2;1;1;1
258147521375;258147522013;638;2;1;1;1
258147568895;258147569798;903;2;1;1;1
258147571175;258147571786;611;2;1;1;1
258147693964;258147694575;611;2;1;1;1
258147737211;258147738057;846;2;1;1;1
258147738273;258147738977;704;2;1;1;1
258147811435;258147812103;668;2;1;1;1
258147812907;258147813449;542;2;1;1;1
258147885047;258147885658;611;2;1;1;1
258148058244;258148058800;556;2;1;1;1
258148105819;258148106452;633;2;1;1;1
258148174560;258148175110;550;2;1;1;1
258148217124;258148217727;603;2;1;1;1
258148292528;258148293200;672;2;1;1;1
258148459811;258148460931;1120;2;1;1;1
258148532176;258148532789;613;2;1;1;1
258148569303;258148569966;663;2;1;1;1
258148612567;258148613204;637;2;1;1;1
258148654200;258148654745;545;2;1;1;1
258148727368;258148728091;723;2;1;1;1
258148728091;258148728456;365;2;1;1;1
258148728456;258148728933;477;2;1;1;1
258148811121;258148811684;563;2;1;1;1
258148860597;258148860878;281;2;1;1;1
258148860878;258148861512;634;2;1;1;1
258148861512;258148861526;14;2;1;1;1
258148947303;258148947899;596;2;1;1;1
258148948793;258148949422;629;2;1;1;1
258148984721;258148985269;548;2;1;1;1
258149042049;258149042694;645;2;1;1;1
258149189251;258149189825;574;2;1;1;1
258149238426;258149239242;816;2;1;1;1
258149240232;258149240783;551;2;1;1;1
258149312009;258149312658;649;2;1;1;1
258149312838;258149313499;661;2;1;1;1
258149386522;258149387112;590;2;1;1;1
258149425657;258149426289;632;2;1;1;1
258149460521;258149461117;596;2;1;1;1
258149461766;258149462363;597;2;1;1;1
258149536458;258149537465;1007;2;1;1;1
258149610264;258149610910;646;2;1;1;1
258149687830;258149688380;550;2;1;1;1
258149747608;258149748292;684;2;1;1;1
258149798681;258149799279;598;2;1;1;1
258149874362;258149875804;1442;2;1;1;1
258149875804;258149876246;442;2;1;1;1
258149876246;258149878004;1758;2;1;1;1
258150010347;258150010987;640;2;1;1;1
258150062794;258150063353;559;2;1;1;1
258150138871;258150139503;632;2;1;1;1
258150180651;258150181194;543;2;1;1;1
258150266191;258150268179;1988;2;1;1;1
258150268827;258150269945;1118;2;1;1;1
258150269945;258150270328;383;2;1;1;1
258150270328;258150272489;2161;2;1;1;1
258150273487;258150274093;606;2;1;1;1
258150274826;258150275429;603;2;1;1;1
258150300298;258150300902;604;2;1;1;1
258150349873;258150352641;2768;2;1;1;1
258150352641;258150353060;419;2;1;1;1
258150353060;258150353713;653;2;1;1;1
258150354959;258150356530;1571;2;1;1;1
258150357020;258150357774;754;2;1;1;1
258150357774;258150358260;486;2;1;1;1
258150358260;258150358544;284;2;1;1;1
258150359277;258150359939;662;2;1;1;1
258150438066;258150438637;571;2;1;1;1
258150489397;258150489965;568;2;1;1;1
258150568232;258150568705;473;2;1;1;1
258150568705;258150568886;181;2;1;1;1
258150568886;258150569840;954;2;1;1;1
258150643481;258150644100;619;2;1;1;1
258150693994;258150695021;1027;2;1;1;1
258150731069;258150731623;554;2;1;1;1
258150779077;258150781282;2205;2;1;1;1
258150781282;258150781567;285;2;1;1;1
258150781567;258150781978;411;2;1;1;1
258150781978;258150784215;2237;2;1;1;1
258150784215;258150784589;374;2;1;1;1
258150786114;258150787635;1521;2;1;1;1
258150790362;258150790378;16;2;1;1;1
258150790378;258150792429;2051;2;1;1;1
258150792429;258150793583;1154;2;1;1;1
258150862985;258150863626;641;2;1;1;1
258150931990;258150932665;675;2;1;1;1
258151010341;258151011322;981;2;1;1;1
258151014357;258151016329;1972;2;1;1;1
258151016716;258151018865;2149;2;1;1;1
258151018950;258151019744;794;2;1;1;1
258151020172;258151020568;396;2;1;1;1
258151020568;258151020963;395;2;1;1;1
258151020963;258151021538;575;2;1;1;1
258151146968;258151147617;649;2;1;1;1
258151185747;258151186174;427;2;1;1;1
258151186174;258151186407;233;2;1;1;1
258151186407;258151187023;616;2;1;1;1
258151234428;258151236060;1632;2;1;1;1
258151300671;258151301809;1138;2;1;1;1
258151350577;258151351203;626;2;1;1;1
258151421559;258151422114;555;2;1;1;1
258151467733;258151468367;634;2;1;1;1
258151659509;258151659928;419;2;1;1;1
258151659928;258151660330;402;2;1;1;1
258151660330;258151660711;381;2;1;1;1
258151821478;258151822064;586;2;1;1;1
258151913696;258151914334;638;2;1;1;1
258151989065;258151989708;643;2;1;1;1
258152229129;258152229603;474;2;1;1;1
258152229603;258152229950;347;2;1;1;1
258152229950;258152230320;370;2;1;1;1
258152344791;258152345396;605;2;1;1;1
258152345827;258152346470;643;2;1;1;1
258152385741;258152386376;635;2;1;1;1
258152467991;258152468883;892;2;1;1;1
258152470917;258152471538;621;2;1;1;1
258152512201;258152512855;654;2;1;1;1
258152567836;258152568469;633;2;1;1;1
258152635827;258152636384;557;2;1;1;1
258152708318;258152708976;658;2;1;1;1
258152709016;258152709889;873;2;1;1;1
258152755919;258152758089;2170;2;1;1;1
258152758089;258152758916;827;2;1;1;1
258152758916;258152760276;1360;2;1;1;1
258152760276;258152761262;986;2;1;1;1
258152761262;258152762404;1142;2;1;1;1
258152762404;258152762435;31;2;1;1;1
258152762435;258152763036;601;2;1;1;1
258152763036;258152766330;3294;2;1;1;1
258152766330;258152767681;1351;2;1;1;1
258152767681;258152767803;122;2;1;1;1
258152767803;258152770315;2512;2;1;1;1
258152772840;258152774214;1374;2;1;1;1
258152775663;258152776059;396;2;1;1;1
258152776059;258152778815;2756;2;1;1;1
258152778815;258152779229;414;2;1;1;1
258152779436;258152780802;1366;2;1;1;1
258152781170;258152781765;595;2;1;1;1
258152781837;258152782585;748;2;1;1;1
258152833133;258152833775;642;2;1;1;1
258152834022;258152834604;582;2;1;1;1
258152910459;258152911108;649;2;1;1;1
258152958042;258152958814;772;2;1;1;1
258152960193;258152960867;674;2;1;1;1
258153041724;258153042288;564;2;1;1;1
258153042748;258153043382;634;2;1;1;1
258153089103;258153089754;651;2;1;1;1
258153138711;258153139345;634;2;1;1;1
258153189339;258153189997;658;2;1;1;1
258153232285;258153234363;2078;2;1;1;1
258153235326;258153235934;608;2;1;1;1
258153236315;258153236964;649;2;1;1;1
258153297661;258153298271;610;2;1;1;1
258153372738;258153373288;550;2;1;1;1
258153469722;258153470322;600;2;1;1;1
258153507506;258153508049;543;2;1;1;1
258153552142;258153552789;647;2;1;1;1
258153599342;258153599973;631;2;1;1;1
258153673137;258153675977;2840;2;1;1;1
258153675977;258153676508;531;2;1;1;1
258153676508;258153677011;503;2;1;1;1
258153679130;258153679774;644;2;1;1;1
258153757472;258153757638;166;2;1;1;1
258153757638;258153758253;615;2;1;1;1
258153758253;258153758632;379;2;1;1;1
258153804872;258153805444;572;2;1;1;1
258153805974;258153806616;642;2;1;1;1
258153853780;258153854380;600;2;1;1;1
258153889967;258153890532;565;2;1;1;1
258153970020;258153970585;565;2;1;1;1
258154030728;258154031722;994;2;1;1;1
258154032083;258154033578;1495;2;1;1;1
258154035574;258154035741;167;2;1;1;1
258154035741;258154036623;882;2;1;1;1
258154036623;258154036646;23;2;1;1;1
258154110020;258154111175;1155;2;1;1;1
258154183127;258154183747;620;2;1;1;1
258154183812;258154184622;810;2;1;1;1
258154222974;258154223858;884;2;1;1;1
258154224090;258154226965;2875;2;1;1;1
258154228765;258154228932;167;2;1;1;1
258154228932;258154229417;485;2;1;1;1
258154229417;258154229834;417;2;1;1;1
258154360830;258154363046;2216;2;1;1;1
258154363046;258154363844;798;2;1;1;1
258154363844;258154364248;404;2;1;1;1
258154364248;258154364848;600;2;1;1;1
258154364848;258154365094;246;2;1;1;1
258154367471;258154368177;706;2;1;1;1
258154432896;258154433530;634;2;1;1;1
258154514115;258154514726;611;2;1;1;1
258154544408;258154545044;636;2;1;1;1
258154677893;258154678519;626;2;1;1;1
258154728648;258154729282;634;2;1;1;1
258154792819;258154793362;543;2;1;1;1
258154862463;258154863106;643;2;1;1;1
258154924944;258154925558;614;2;1;1;1
258154971130;258154971734;604;2;1;1;1
258154972188;258154972820;632;2;1;1;1
258155051999;258155052550;551;2;1;1;1
258155118803;258155119736;933;2;1;1;1
258155120760;258155121437;677;2;1;1;1
258155235139;258155235788;649;2;1;1;1
258155274006;258155274660;654;2;1;1;1
258155315841;258155316447;606;2;1;1;1
258155410337;258155410972;635;2;1;1;1
258155448977;258155449625;648;2;1;1;1
258155496706;258155497330;624;2;1;1;1
258155576467;258155577969;1502;2;1;1;1
258155578390;258155579564;1174;2;1;1;1
258155655342;258155655882;540;2;1;1;1
258155693306;258155693863;557;2;1;1;1
258155802779;258155803397;618;2;1;1;1
258155846443;258155847048;605;2;1;1;1
258155909953;258155910601;648;2;1;1;1
258155991096;258155991745;649;2;1;1;1
258156034863;258156035473;610;2;1;1;1
258156083624;258156084345;721;2;1;1;1
258156085073;258156085621;548;2;1;1;1
258156196167;258156197762;1595;2;1;1;1
258156198759;258156199441;682;2;1;1;1
258156200409;258156200952;543;2;1;1;1
258156274055;258156274222;167;2;1;1;1
258156274222;258156274832;610;2;1;1;1
258156274832;258156275216;384;2;1;1;1
258156320624;258156321253;629;2;1;1;1
258156407304;258156407921;617;2;1;1;1
258156476534;258156477855;1321;2;1;1;1
258156531632;258156532164;532;2;1;1;1
258156532164;258156532293;129;2;1;1;1
258156532293;258156532944;651;2;1;1;1
258156605974;258156606517;543;2;1;1;1
258156709309;258156709883;574;2;1;1;1
258156727202;258156727885;683;2;1;1;1
258156765015;258156765580;565;2;1;1;1
258156966214;258156966821;607;2;1;1;1
258157048621;258157049264;643;2;1;1;1
258157162851;258157163398;547;2;1;1;1
258157281898;258157282461;563;2;1;1;1
258157375785;258157376445;660;2;1;1;1
258157463145;258157463793;648;2;1;1;1
258157547559;258157548173;614;2;1;1;1
258157550258;258157550937;679;2;1;1;1
258157618803;258157619415;612;2;1;1;1
258157653844;258157654384;540;2;1;1;1
258157746711;258157747310;599;2;1;1;1
258157784253;258157784869;616;2;1;1;1
258157824246;258157824792;546;2;1;1;1
258157937461;258157938017;556;2;1;1;1
258157978695;258157979244;549;2;1;1;1
258158032582;258158033218;636;2;1;1;1
258158043506;258158044058;552;2;1;1;1
258158093777;258158094448;671;2;1;1;1
258158095001;258158095638;637;2;1;1;1
258158139510;258158141326;1816;2;1;1;1
258158142101;258158142651;550;2;1;1;1
258158143087;258158143662;575;2;1;1;1
258158185656;258158186616;960;2;1;1;1
258158188488;258158189984;1496;2;1;1;1
258158189984;258158190969;985;2;1;1;1
258158190969;258158197362;6393;2;1;1;1
258158197362;258158197655;293;2;1;1;1
258158197655;258158198920;1265;2;1;1;1
258158200480;258158201096;616;2;1;1;1
258158234063;258158234610;547;2;1;1;1
258158317655;258158318217;562;2;1;1;1
258158408341;258158408885;544;2;1;1;1
258158452415;258158453010;595;2;1;1;1
258158491604;258158492234;630;2;1;1;1
258158647000;258158647630;630;2;1;1;1
258158657023;258158658012;989;2;1;1;1
258158659047;258158660487;1440;2;1;1;1
258158663384;258158663873;489;2;1;1;1
258158663873;258158664573;700;2;1;1;1
258158664573;258158664600;27;2;1;1;1
258158664600;258158665255;655;2;1;1;1
258158665255;258158665453;198;2;1;1;1
258158779896;258158780462;566;2;1;1;1
258158781001;258158781658;657;2;1;1;1
258158826188;258158826834;646;2;1;1;1
258158900436;258158901004;568;2;1;1;1
258158994992;258158995541;549;2;1;1;1
258159004520;258159005073;553;2;1;1;1
258159051459;258159051852;393;2;1;1;1
258159051852;258159052305;453;2;1;1;1
258159052305;258159052425;120;2;1;1;1
258159052425;258159052643;218;2;1;1;1
258159052643;258159052977;334;2;1;1;1
258159052977;258159053351;374;2;1;1;1
258159053351;258159053633;282;2;1;1;1
258159053633;258159054081;448;2;1;1;1
258159054081;258159054371;290;2;1;1;1
258159110413;258159111090;677;2;1;1;1
258159152199;258159153078;879;2;1;1;1
258159155485;258159157703;2218;2;1;1;1
258159157703;258159157781;78;2;1;1;1
258159157781;258159160135;2354;2;1;1;1
258159160135;258159161095;960;2;1;1;1
258159161095;258159162320;1225;2;1;1;1
258159162320;258159163866;1546;2;1;1;1
258159163866;258159164425;559;2;1;1;1
258159164425;258159166670;2245;2;1;1;1
258159166670;258159169532;2862;2;1;1;1
258159170234;258159173106;2872;2;1;1;1
258159174488;258159175707;1219;2;1;1;1
258159175707;258159177054;1347;2;1;1;1
258159177054;258159177489;435;2;1;1;1
258159177489;258159177670;181;2;1;1;1
258159177670;258159178802;1132;2;1;1;1
258159180087;258159181373;1286;2;1;1;1
258159182242;258159182865;623;2;1;1;1
258159182962;258159183680;718;2;1;1;1
258159201586;258159202219;633;2;1;1;1
258159242831;258159243452;621;2;1;1;1
258159284307;258159284927;620;2;1;1;1
258159357720;258159358403;683;2;1;1;1
258159426402;258159426961;559;2;1;1;1
258159466328;258159466883;555;2;1;1;1
258159518667;258159519166;499;2;1;1;1
258159519166;258159519366;200;2;1;1;1
258159519366;258159519841;475;2;1;1;1
258159582447;258159582995;548;2;1;1;1
258159654185;258159654806;621;2;1;1;1
258159654971;258159655811;840;2;1;1;1
258159701735;258159701844;109;2;1;1;1
258159701844;258159702654;810;2;1;1;1
258159702654;258159702909;255;2;1;1;1
258159702909;258159703211;302;2;1;1;1
258159703211;258159703440;229;2;1;1;1
258159703440;258159703635;195;2;1;1;1
258159703635;258159704397;762;2;1;1;1
258159704689;258159705371;682;2;1;1;1
258159763531;258159764085;554;2;1;1;1
258159809082;258159809649;567;2;1;1;1
258159853399;258159854019;620;2;1;1;1
258159936895;258159937499;604;2;1;1;1
258159992701;258159993248;547;2;1;1;1
258160095852;258160098025;2173;2;1;1;1
258160099602;258160099894;292;2;1;1;1
258160099894;258160100584;690;2;1;1;1
258160100584;258160100660;76;2;1;1;1
258160176907;258160177191;284;2;1;1;1
258160177191;258160179334;2143;2;1;1;1
258160179334;258160179633;299;2;1;1;1
258160179633;258160180658;1025;2;1;1;1
258160180658;258160180729;71;2;1;1;1
258160185215;258160185502;287;2;1;1;1
258160185502;258160185984;482;2;1;1;1
258160185984;258160186161;177;2;1;1;1
258160186161;258160186183;22;2;1;1;1
258160186183;258160187019;836;2;1;1;1
258160251532;258160252187;655;2;1;1;1
258160311132;258160311848;716;2;1;1;1
258160311848;258160311910;62;2;1;1;1
258160311910;258160312871;961;2;1;1;1
258160433260;258160433912;652;2;1;1;1
258160434007;258160434821;814;2;1;1;1
258160443867;258160444497;630;2;1;1;1
258160483606;258160484246;640;2;1;1;1
258160518795;258160519478;683;2;1;1;1
258160599938;258160601423;1485;2;1;1;1
258160601423;258160602131;708;2;1;1;1
258160602131;258160602736;605;2;1;1;1
258160602736;258160603354;618;2;1;1;1
258160603354;258160604301;947;2;1;1;1
258160604301;258160605290;989;2;1;1;1
258160605290;258160605713;423;2;1;1;1
258160605713;258160607077;1364;2;1;1;1
258160607077;258160608866;1789;2;1;1;1
258160609314;258160609756;442;2;1;1;1
258160609756;258160610796;1040;2;1;1;1
258160610796;258160611087;291;2;1;1;1
258160611471;258160612104;633;2;1;1;1
258160674183;258160674744;561;2;1;1;1
258160772398;258160773038;640;2;1;1;1
258160808641;258160809285;644;2;1;1;1
258160809870;258160810509;639;2;1;1;1
258160849342;258160849976;634;2;1;1;1
258160894956;258160895580;624;2;1;1;1
258160944982;258160945531;549;2;1;1;1
258161024859;258161025481;622;2;1;1;1
258161070708;258161071349;641;2;1;1;1
258161153535;258161154154;619;2;1;1;1
258161255786;258161256421;635;2;1;1;1
258161256860;258161257565;705;2;1;1;1
258161299059;258161299713;654;2;1;1;1
258161381528;258161382110;582;2;1;1;1
258161382110;258161382219;109;2;1;1;1
258161382219;258161383038;819;2;1;1;1
258161454677;258161455309;632;2;1;1;1
258161500921;258161501485;564;2;1;1;1
258161539757;258161540383;626;2;1;1;1
258161580969;258161581706;737;2;1;1;1
258161582130;258161582771;641;2;1;1;1
258161727604;258161728236;632;2;1;1;1
258161772639;258161773183;544;2;1;1;1
258161847840;258161848388;548;2;1;1;1
258162175246;258162175851;605;2;1;1;1
258162225048;258162225665;617;2;1;1;1
258162268466;258162269119;653;2;1;1;1
258162398886;258162399780;894;2;1;1;1
258162400703;258162401022;319;2;1;1;1
258162401022;258162401430;408;2;1;1;1
258162401430;258162402193;763;2;1;1;1
258162517194;258162517803;609;2;1;1;1
258162869690;258162870452;762;2;1;1;1
258162918159;258162918707;548;2;1;1;1
258162933498;258162934153;655;2;1;1;1
258163008759;258163018814;10055;2;1;1;1
258163018814;258163019448;634;2;1;1;1
258163019448;258163039557;20109;2;1;1;1
258163202905;258163203530;625;2;1;1;1
258163279879;258163280518;639;2;1;1;1
258163374044;258163374665;621;2;1;1;1
258163423331;258163423972;641;2;1;1;1
258163472611;258163473167;556;2;1;1;1
258163509215;258163509696;481;2;1;1;1
258163509696;258163510210;514;2;1;1;1
258163510210;258163510728;518;2;1;1;1
258163647217;258163649185;1968;2;1;1;1
258163650752;258163650903;151;2;1;1;1
258163650903;258163651381;478;2;1;1;1
258163651381;258163651764;383;2;1;1;1
258163709224;258163711184;1960;2;1;1;1
258163712712;258163713089;377;2;1;1;1
258163713089;258163713475;386;2;1;1;1
258163713475;258163714202;727;2;1;1;1
258163819231;258163819839;608;2;1;1;1
258163874676;258163875219;543;2;1;1;1
258163940080;258163940636;556;2;1;1;1
258164014788;258164015423;635;2;1;1;1
258164093507;258164096135;2628;2;1;1;1
258164097884;258164099149;1265;2;1;1;1
258164099149;258164099210;61;2;1;1;1
258164099210;258164101916;2706;2;1;1;1
258164168100;258164170831;2731;2;1;1;1
258164171934;258164174399;2465;2;1;1;1
258164175506;258164176703;1197;2;1;1;1
258164177478;258164178111;633;2;1;1;1
258164204925;258164205556;631;2;1;1;1
258164303549;258164304105;556;2;1;1;1
258164345164;258164345433;269;2;1;1;1
258164345433;258164345919;486;2;1;1;1
258164345919;258164346285;366;2;1;1;1
258164409602;258164410230;628;2;1;1;1
258164558187;258164558795;608;2;1;1;1
258164590246;258164591367;1121;2;1;1;1
258164591825;258164592862;1037;2;1;1;1
258164592862;258164593275;413;2;1;1;1
258164593275;258164594254;979;2;1;1;1
258164596401;258164597381;980;2;1;1;1
258164682541;258164683228;687;2;1;1;1
258164683508;258164684140;632;2;1;1;1
258164701079;258164701723;644;2;1;1;1
258164751655;258164752079;424;2;1;1;1
258164752079;258164752398;319;2;1;1;1
258164752398;258164752740;342;2;1;1;1
258164818826;258164819758;932;2;1;1;1
258164820450;258164821133;683;2;1;1;1
258164821229;258164822673;1444;2;1;1;1
258164901586;258164901766;180;2;1;1;1
258164901766;258164902696;930;2;1;1;1
258164902696;258164902846;150;2;1;1;1
258164902846;258164902873;27;2;1;1;1
258164902873;258164904041;1168;2;1;1;1
258164905168;258164905952;784;2;1;1;1
258165001127;258165001840;713;2;1;1;1
258165002746;258165003292;546;2;1;1;1
258165080083;258165080642;559;2;1;1;1
258165156881;258165158731;1850;2;1;1;1
258165159654;258165160340;686;2;1;1;1
258165161575;258165162194;619;2;1;1;1
258165207424;258165208025;601;2;1;1;1
258165252317;258165254689;2372;2;1;1;1
258165257108;258165257386;278;2;1;1;1
258165257386;258165257700;314;2;1;1;1
258165257700;258165257786;86;2;1;1;1
258165257786;258165258219;433;2;1;1;1
258165258219;258165258731;512;2;1;1;1
258165284400;258165285031;631;2;1;1;1
258165389188;258165390253;1065;2;1;1;1
258165391126;258165393071;1945;2;1;1;1
258165393534;258165394283;749;2;1;1;1
258165459794;258165460397;603;2;1;1;1
258165495282;258165495904;622;2;1;1;1
258165496336;258165496999;663;2;1;1;1
258165539066;258165539705;639;2;1;1;1
258165606229;258165606863;634;2;1;1;1
258165645099;258165645862;763;2;1;1;1
258165645862;258165646242;380;2;1;1;1
258165646242;258165646968;726;2;1;1;1
258165647151;258165647907;756;2;1;1;1
258165706539;258165707176;637;2;1;1;1
258165745321;258165745868;547;2;1;1;1
258165789384;258165790244;860;2;1;1;1
258165868398;258165868944;546;2;1;1;1
258165927184;258165931110;3926;2;1;1;1
258165965856;258165966411;555;2;1;1;1
258166013746;258166014368;622;2;1;1;1
258166056510;258166057642;1132;2;1;1;1
258166059221;258166059899;678;2;1;1;1
258166125468;258166126024;556;2;1;1;1
258166176741;258166177497;756;2;1;1;1
258166180789;258166181535;746;2;1;1;1
258166317427;258166317972;545;2;1;1;1
258166391287;258166391841;554;2;1;1;1
258166401626;258166402251;625;2;1;1;1
258166470784;258166471403;619;2;1;1;1
258166536411;258166537043;632;2;1;1;1
258166596645;258166597866;1221;2;1;1;1
258166597866;258166598555;689;2;1;1;1
258166598555;258166599705;1150;2;1;1;1
258166599848;258166600627;779;2;1;1;1
258166600971;258166601868;897;2;1;1;1
258166677983;258166678972;989;2;1;1;1
258166678972;258166679941;969;2;1;1;1
258166679941;258166680102;161;2;1;1;1
258166680102;258166680214;112;2;1;1;1
258166680214;258166680395;181;2;1;1;1
258166680395;258166680987;592;2;1;1;1
258166680987;258166681729;742;2;1;1;1
258166683176;258166683724;548;2;1;1;1
258166740527;258166741078;551;2;1;1;1
258166795926;258166796608;682;2;1;1;1
258166796681;258166797426;745;2;1;1;1
258166830136;258166831121;985;2;1;1;1
258166831887;258166832421;534;2;1;1;1
258166878218;258166878859;641;2;1;1;1
258166917565;258166918250;685;2;1;1;1
258166920819;258166921410;591;2;1;1;1
258166922317;258166922952;635;2;1;1;1
258166965459;258166966060;601;2;1;1;1
258167014486;258167015040;554;2;1;1;1
258167049531;258167050687;1156;2;1;1;1
258167100374;258167101287;913;2;1;1;1
258167104133;258167104275;142;2;1;1;1
258167104275;258167104938;663;2;1;1;1
258167104938;258167105547;609;2;1;1;1
258167170306;258167170926;620;2;1;1;1
258167260149;258167260699;550;2;1;1;1
258167303047;258167303669;622;2;1;1;1
258167338668;258167339279;611;2;1;1;1
258167421076;258167421630;554;2;1;1;1
258167490771;258167493674;2903;2;1;1;1
258167496492;258167497116;624;2;1;1;1
258167501692;258167502332;640;2;1;1;1
258167550293;258167550928;635;2;1;1;1
258167699894;258167700889;995;2;1;1;1
258167757529;258167758087;558;2;1;1;1
258167851318;258167851972;654;2;1;1;1
258168072537;258168073174;637;2;1;1;1
258168139787;258168140339;552;2;1;1;1
258168201966;258168202580;614;2;1;1;1
258168403645;258168404317;672;2;1;1;1
258168496977;258168497608;631;2;1;1;1
258168601124;258168601759;635;2;1;1;1
258168646992;258168647632;640;2;1;1;1
258168774966;258168775589;623;2;1;1;1
258168816211;258168816815;604;2;1;1;1
258168919330;258168919955;625;2;1;1;1
258168999426;258169000385;959;2;1;1;1
258169163455;258169164088;633;2;1;1;1
258169213627;258169214292;665;2;1;1;1
258169293083;258169293630;547;2;1;1;1
258169368906;258169369450;544;2;1;1;1
258169411055;258169411659;604;2;1;1;1
258169472831;258169473502;671;2;1;1;1
258169624463;258169625191;728;2;1;1;1
258169697357;258169697910;553;2;1;1;1
258169731856;258169732421;565;2;1;1;1
258169818263;258169818814;551;2;1;1;1
258169863441;258169863995;554;2;1;1;1
258170049455;258170050409;954;2;1;1;1
258170143824;258170144285;461;2;1;1;1
258170175840;258170176496;656;2;1;1;1
258170314981;258170315616;635;2;1;1;1
258170316287;258170317179;892;2;1;1;1
258170386844;258170387396;552;2;1;1;1
258170505870;258170506711;841;2;1;1;1
258170649948;258170650504;556;2;1;1;1
258170734604;258170735174;570;2;1;1;1
258170845235;258170845877;642;2;1;1;1
258170915463;258170916022;559;2;1;1;1
258171100917;258171101559;642;2;1;1;1
258171308538;258171309113;575;2;1;1;1
258171389201;258171389842;641;2;1;1;1
258171436117;258171436880;763;2;1;1;1
258171561496;258171562056;560;2;1;1;1
258171606355;258171607030;675;2;1;1;1
258171720781;258171721407;626;2;1;1;1
258171763159;258171763809;650;2;1;1;1
258171946890;258171947517;627;2;1;1;1
258171983640;258171984345;705;2;1;1;1
258172099028;258172099598;570;2;1;1;1
258172146537;258172147092;555;2;1;1;1
258172186507;258172187586;1079;2;1;1;1
258172236163;258172236720;557;2;1;1;1
258172274587;258172275231;644;2;1;1;1
258172356248;258172356885;637;2;1;1;1
258172381622;258172382225;603;2;1;1;1
258172434442;258172435087;645;2;1;1;1
258173752020;258173752580;560;2;1;1;1
258173813864;258173814491;627;2;1;1;1
258173865303;258173865954;651;2;1;1;1
258173906547;258173907096;549;2;1;1;1
258173981944;258173982506;562;2;1;1;1
258174041580;258174043095;1515;2;1;1;1
258174043096;258174043652;556;2;1;1;1
258174043680;258174044421;741;2;1;1;1
258174086025;258174086574;549;2;1;1;1
258174141740;258174142388;648;2;1;1;1
258174176490;258174178951;2461;2;1;1;1
258174284062;258174284671;609;2;1;1;1
258174297671;258174298297;626;2;1;1;1
258174343931;258174344497;566;2;1;1;1
258174440274;258174483905;43631;2;1;1;1
258174508456;258174509220;764;2;1;1;1
258174615549;258174616194;645;2;1;1;1
258174725641;258174727065;1424;2;1;1;1
258174804078;258174804694;616;2;1;1;1
258174853334;258174853906;572;2;1;1;1
258174936820;258174938592;1772;2;1;1;1
258175013127;258175013462;335;2;1;1;1
258175013462;258175013869;407;2;1;1;1
258175013869;258175014110;241;2;1;1;1
258175091629;258175092526;897;2;1;1;1
258175094075;258175095420;1345;2;1;1;1
258175128623;258175133637;5014;2;1;1;1
258175139596;258175140245;649;2;1;1;1
258175252038;258175252731;693;2;1;1;1
258175532996;258175533628;632;2;1;1;1
258175599570;258175600142;572;2;1;1;1
258175699567;258175700358;791;2;1;1;1
258175756176;258175756865;689;2;1;1;1
258175821938;258175822943;1005;2;1;1;1
258175822943;258175823056;113;2;1;1;1
258175823056;258175824465;1409;2;1;1;1
258175909611;258175910266;655;2;1;1;1
258175960836;258175961892;1056;2;1;1;1
258176006870;258176007868;998;2;1;1;1
258176073367;258176073925;558;2;1;1;1
258176217349;258176217915;566;2;1;1;1
258176234692;258176235268;576;2;1;1;1
258176272734;258176273452;718;2;1;1;1
258176312529;258176313095;566;2;1;1;1
258176351777;258176352390;613;2;1;1;1
258176426298;258176426961;663;2;1;1;1
258176478719;258176479359;640;2;1;1;1
258176547932;258176548508;576;2;1;1;1
258176584150;258176584787;637;2;1;1;1
258176629017;258176629680;663;2;1;1;1
258176692131;258176692768;637;2;1;1;1
258176764667;258176765319;652;2;1;1;1
258176879597;258176880166;569;2;1;1;1
258176931274;258176931825;551;2;1;1;1
258177004431;258177005065;634;2;1;1;1
258177079881;258177080529;648;2;1;1;1
258177126162;258177126714;552;2;1;1;1
258177213064;258177213702;638;2;1;1;1
258177257151;258177257649;498;2;1;1;1
258177569821;258177570499;678;2;1;1;1
258177645042;258177645520;478;2;1;1;1
258177723895;258177725002;1107;2;1;1;1
258177769247;258177769897;650;2;1;1;1
258177812849;258177813406;557;2;1;1;1
258177848186;258177848667;481;2;1;1;1
258177927866;258177928396;530;2;1;1;1
258177998765;258177999415;650;2;1;1;1
258178128747;258178129486;739;2;1;1;1
258178190606;258178191130;524;2;1;1;1
258178278035;258178278894;859;2;1;1;1
258178279451;258178280201;750;2;1;1;1
258178346910;258178347382;472;2;1;1;1
258178397234;258178398039;805;2;1;1;1
258178458977;258178459866;889;2;1;1;1
258178542056;258178542605;549;2;1;1;1
258178604331;258178604985;654;2;1;1;1
258178605530;258178606355;825;2;1;1;1
258178694179;258178694740;561;2;1;1;1
258178694740;258178694741;1;2;1;1;1
258178694741;258178695667;926;2;1;1;1
258178767172;258178767737;565;2;1;1;1
258178768447;258178769016;569;2;1;1;1
258178837977;258178838528;551;2;1;1;1
258178923320;258178923983;663;2;1;1;1
258178924938;258178925484;546;2;1;1;1
258178964866;258178965361;495;2;1;1;1
258179022624;258179023175;551;2;1;1;1
258179092151;258179092709;558;2;1;1;1
258179136692;258179137234;542;2;1;1;1
258179207827;258179208506;679;2;1;1;1
258179238556;258179239103;547;2;1;1;1
258179305680;258179306312;632;2;1;1;1
258179351347;258179352371;1024;2;1;1;1
258179388140;258179388609;469;2;1;1;1
258179465297;258179465818;521;2;1;1;1
258179536583;258179537119;536;2;1;1;1
258179582061;258179582700;639;2;1;1;1
258179656026;258179656664;638;2;1;1;1
258179706025;258179706507;482;2;1;1;1
258179707148;258179707796;648;2;1;1;1
258179740096;258179740570;474;2;1;1;1
258179822382;258179822995;613;2;1;1;1
258179823365;258179824022;657;2;1;1;1
258179886050;258179886656;606;2;1;1;1
258179887242;258179887793;551;2;1;1;1
258179951340;258179951959;619;2;1;1;1
258179989989;258179990602;613;2;1;1;1
258180069196;258180069760;564;2;1;1;1
258180142636;258180143193;557;2;1;1;1
258180174586;258180175044;458;2;1;1;1
258180236827;258180237374;547;2;1;1;1
258180308941;258180309492;551;2;1;1;1
258180385635;258180386098;463;2;1;1;1
258180445200;258180445713;513;2;1;1;1
258180511863;258180512385;522;2;1;1;1
258180589443;258180589905;462;2;1;1;1
258180661202;258180661736;534;2;1;1;1
258180705315;258180705862;547;2;1;1;1
258180753153;258180753747;594;2;1;1;1
258180799611;258180800109;498;2;1;1;1
258180839301;258180839857;556;2;1;1;1
258180906768;258180907318;550;2;1;1;1
258180981443;258180981920;477;2;1;1;1
258181060147;258181060701;554;2;1;1;1
258181128884;258181129302;418;2;1;1;1
258181129302;258181129644;342;2;1;1;1
258181129644;258181130001;357;2;1;1;1
258181219676;258181221597;1921;2;1;1;1
258181221597;258181221833;236;2;1;1;1
258181221833;258181223922;2089;2;1;1;1
258181224407;258181224493;86;2;1;1;1
258181224493;258181226041;1548;2;1;1;1
258181226041;258181226999;958;2;1;1;1
258181228172;258181229096;924;2;1;1;1
258181229096;258181229151;55;2;1;1;1
258181229151;258181229907;756;2;1;1;1
258181291623;258181292115;492;2;1;1;1
258181362930;258181363541;611;2;1;1;1
258181456080;258181457037;957;2;1;1;1
258181459280;258181459938;658;2;1;1;1
258181503885;258181504432;547;2;1;1;1
258181567861;258181568482;621;2;1;1;1
258181568607;258181569243;636;2;1;1;1
258181651835;258181652386;551;2;1;1;1
258181699338;258181700393;1055;2;1;1;1
258181734580;258181736178;1598;2;1;1;1
258181808487;258181808960;473;2;1;1;1
258181854564;258181855083;519;2;1;1;1
258181922411;258181922419;8;2;1;1;1
258181922419;258181923119;700;2;1;1;1
258181923119;258181923421;302;2;1;1;1
258181963436;258181964079;643;2;1;1;1
258182038839;258182039456;617;2;1;1;1
258182117909;258182118368;459;2;1;1;1
258182189774;258182190317;543;2;1;1;1
258182239757;258182240333;576;2;1;1;1
258182310143;258182310799;656;2;1;1;1
258182392772;258182393422;650;2;1;1;1
258182435017;258182435657;640;2;1;1;1
258182501543;258182502053;510;2;1;1;1
258182502053;258182502965;912;2;1;1;1
258182502965;258182503722;757;2;1;1;1
258182504624;258182504995;371;2;1;1;1
258182504995;258182505229;234;2;1;1;1
258182505229;258182505690;461;2;1;1;1
258182579323;258182579983;660;2;1;1;1
258182616541;258182617183;642;2;1;1;1
258182659031;258182659578;547;2;1;1;1
258182694119;258182694745;626;2;1;1;1
258182729118;258182729664;546;2;1;1;1
258182781047;258182781658;611;2;1;1;1
258182782337;258182782897;560;2;1;1;1
258182878459;258182879026;567;2;1;1;1
258182965266;258182965768;502;2;1;1;1
258183005437;258183006054;617;2;1;1;1
258183076821;258183077375;554;2;1;1;1
258183114769;258183115312;543;2;1;1;1
258183185070;258183185625;555;2;1;1;1
258183234125;258183234650;525;2;1;1;1
258183313174;258183313650;476;2;1;1;1
258183383073;258183383960;887;2;1;1;1
258183420879;258183421432;553;2;1;1;1
258183421662;258183422248;586;2;1;1;1
258183500936;258183501416;480;2;1;1;1
258183547720;258183548298;578;2;1;1;1
258183813381;258183814940;1559;2;1;1;1
258183818333;258183819070;737;2;1;1;1
258183819140;258183819796;656;2;1;1;1
258183819908;258183820653;745;2;1;1;1
258183921890;258183922448;558;2;1;1;1
258183978439;258183979062;623;2;1;1;1
258183979618;258183980233;615;2;1;1;1
258184048173;258184048686;513;2;1;1;1
258184150311;258184151379;1068;2;1;1;1
258184152445;258184153204;759;2;1;1;1
258184243456;258184244093;637;2;1;1;1
258184348020;258184348677;657;2;1;1;1
258184388826;258184389456;630;2;1;1;1
258184501272;258184502090;818;2;1;1;1
258184556568;258184557894;1326;2;1;1;1
258184558581;258184559338;757;2;1;1;1
258184559415;258184560167;752;2;1;1;1
258184560167;258184560274;107;2;1;1;1
258184560274;258184560902;628;2;1;1;1
258184561813;258184562362;549;2;1;1;1
258184625525;258184626077;552;2;1;1;1
258184689623;258184691043;1420;2;1;1;1
258184726963;258184727514;551;2;1;1;1
258184757722;258184758358;636;2;1;1;1
258184832909;258184835236;2327;2;1;1;1
258184836510;258184837099;589;2;1;1;1
258184837099;258184837171;72;2;1;1;1
258184837171;258184837996;825;2;1;1;1
258184884935;258184885566;631;2;1;1;1
258184962650;258184963691;1041;2;1;1;1
258185064759;258185065365;606;2;1;1;1
258185149134;258185149781;647;2;1;1;1
258185149868;258185150608;740;2;1;1;1
258185216638;258185217470;832;2;1;1;1
258185219230;258185219801;571;2;1;1;1
258185295880;258185296515;635;2;1;1;1
258185355005;258185355635;630;2;1;1;1
258185425349;258185425990;641;2;1;1;1
258185472509;258185473153;644;2;1;1;1
258185549090;258185549734;644;2;1;1;1
258185624546;258185625177;631;2;1;1;1
258185715000;258185716097;1097;2;1;1;1
258185718243;258185718522;279;2;1;1;1
258185718522;258185719007;485;2;1;1;1
258185719007;258185719237;230;2;1;1;1
258185777233;258185777869;636;2;1;1;1
258185859686;258185860243;557;2;1;1;1
258185937828;258185938252;424;2;1;1;1
258185938252;258185938501;249;2;1;1;1
258185938501;258185938932;431;2;1;1;1
258186012196;258186012838;642;2;1;1;1
258186069555;258186070196;641;2;1;1;1
258186114867;258186115471;604;2;1;1;1
258186158581;258186160164;1583;2;1;1;1
258186161122;258186161470;348;2;1;1;1
258186161470;258186161775;305;2;1;1;1
258186161775;258186162237;462;2;1;1;1
258186247190;258186247841;651;2;1;1;1
258186248403;258186249036;633;2;1;1;1
258186308125;258186308614;489;2;1;1;1
258186353424;258186353958;534;2;1;1;1
258186399690;258186400250;560;2;1;1;1
258186446636;258186447163;527;2;1;1;1
258186509368;258186510024;656;2;1;1;1
258186590449;258186591060;611;2;1;1;1
258186591707;258186592380;673;2;1;1;1
258186668109;258186668748;639;2;1;1;1
258186738067;258186738705;638;2;1;1;1
258186808960;258186809604;644;2;1;1;1
258186869340;258186869999;659;2;1;1;1
258186945558;258186946187;629;2;1;1;1
258186990056;258186990614;558;2;1;1;1
258187040936;258187041537;601;2;1;1;1
258187139169;258187139790;621;2;1;1;1
258187222092;258187222603;511;2;1;1;1
258187222603;258187222805;202;2;1;1;1
258187222805;258187223244;439;2;1;1;1
258187255417;258187256067;650;2;1;1;1
258187334760;258187336583;1823;2;1;1;1
258187337822;258187337846;24;2;1;1;1
258187337846;258187338674;828;2;1;1;1
258187338674;258187338686;12;2;1;1;1
258187401157;258187401839;682;2;1;1;1
258187445018;258187445646;628;2;1;1;1
258187564188;258187564730;542;2;1;1;1
258187645779;258187646621;842;2;1;1;1
258187646805;258187699781;52976;2;1;1;1
258187701061;258187701516;455;2;1;1;1
258187735683;258187736319;636;2;1;1;1
258187801841;258187802441;600;2;1;1;1
258187876850;258187877404;554;2;1;1;1
258187960349;258187960972;623;2;1;1;1
258188039669;258188040276;607;2;1;1;1
258188082138;258188082783;645;2;1;1;1
258188157301;258188157845;544;2;1;1;1
258188201155;258188201702;547;2;1;1;1
258188276956;258188277556;600;2;1;1;1
258188278232;258188278860;628;2;1;1;1
258188357607;258188358236;629;2;1;1;1
258188478307;258188478943;636;2;1;1;1
258188553992;258188554542;550;2;1;1;1
258188628048;258188628596;548;2;1;1;1
258188672297;258188672929;632;2;1;1;1
258188683107;258188683655;548;2;1;1;1
258188684670;258188685309;639;2;1;1;1
258188721586;258188722132;546;2;1;1;1
258188811369;258188812090;721;2;1;1;1
258188855953;258188856592;639;2;1;1;1
258188975046;258188975859;813;2;1;1;1
258189004926;258189005391;465;2;1;1;1
258189047943;258189048430;487;2;1;1;1
258189099691;258189100236;545;2;1;1;1
258189211522;258189212647;1125;2;1;1;1
258189284361;258189285311;950;2;1;1;1
258189453738;258189454275;537;2;1;1;1
258189542740;258189543289;549;2;1;1;1
258189643698;258189644206;508;2;1;1;1
258189741495;258189742058;563;2;1;1;1
258189782783;258189783331;548;2;1;1;1
258189922861;258189923517;656;2;1;1;1
258189976177;258189976691;514;2;1;1;1
258190074808;258190075434;626;2;1;1;1
258190153932;258190154571;639;2;1;1;1
258190223208;258190223850;642;2;1;1;1
258190266651;258190267113;462;2;1;1;1
258190346099;258190346753;654;2;1;1;1
258190346936;258190347592;656;2;1;1;1
258190366716;258190367148;432;2;1;1;1
258190367148;258190367416;268;2;1;1;1
258190367416;258190367942;526;2;1;1;1
258190422834;258190423738;904;2;1;1;1
258190532234;258190533061;827;2;1;1;1
258190609441;258190610118;677;2;1;1;1
258190610602;258190611513;911;2;1;1;1
258190668245;258190668875;630;2;1;1;1
258190700688;258190701325;637;2;1;1;1
258190771976;258190772518;542;2;1;1;1
258190848702;258190849371;669;2;1;1;1
258190918330;258190918925;595;2;1;1;1
258190997277;258190999751;2474;2;1;1;1
258191060327;258191060963;636;2;1;1;1
258191166440;258191167085;645;2;1;1;1
258191167125;258191167954;829;2;1;1;1
258191242875;258191243558;683;2;1;1;1
258191309611;258191310171;560;2;1;1;1
258191377195;258191377744;549;2;1;1;1
258191396912;258191397542;630;2;1;1;1
258191470588;258191471235;647;2;1;1;1
258191548685;258191549315;630;2;1;1;1
258191620801;258191621385;584;2;1;1;1
258191621385;258191621458;73;2;1;1;1
258191621458;258191622280;822;2;1;1;1
258191653347;258191653978;631;2;1;1;1
258191708867;258191709567;700;2;1;1;1
258191754774;258191755329;555;2;1;1;1
258191801411;258191801961;550;2;1;1;1
258191911998;258191912625;627;2;1;1;1
258191960135;258191960662;527;2;1;1;1
258191961386;258191961973;587;2;1;1;1
258192037107;258192037711;604;2;1;1;1
258192126200;258192126753;553;2;1;1;1
258192127199;258192127776;577;2;1;1;1
258192200466;258192201024;558;2;1;1;1
258192235937;258192236560;623;2;1;1;1
258192304648;258192305255;607;2;1;1;1
258192391983;258192392658;675;2;1;1;1
258192456592;258192456949;357;2;1;1;1
258192456949;258192458510;1561;2;1;1;1
258192458510;258192458637;127;2;1;1;1
258192460394;258192460997;603;2;1;1;1
258192544811;258192545524;713;2;1;1;1
258192546194;258192546785;591;2;1;1;1
258192630675;258192631629;954;2;1;1;1
258192633631;258192634247;616;2;1;1;1
258192676100;258192676649;549;2;1;1;1
258192677201;258192677846;645;2;1;1;1
258192753023;258192753569;546;2;1;1;1
258193195160;258193195701;541;2;1;1;1
258193277106;258193277711;605;2;1;1;1
258193315479;258193316108;629;2;1;1;1
258193396859;258193397491;632;2;1;1;1
258193451918;258193452462;544;2;1;1;1
258193452655;258193453231;576;2;1;1;1
258193531589;258193532137;548;2;1;1;1
258193617683;258193618360;677;2;1;1;1
258193727566;258193728122;556;2;1;1;1
258193778275;258193778572;297;2;1;1;1
258193778572;258193778890;318;2;1;1;1
258193778890;258193779273;383;2;1;1;1
258193856291;258193856927;636;2;1;1;1
258193938920;258193939477;557;2;1;1;1
258193975988;258193976537;549;2;1;1;1
258194057010;258194060466;3456;2;1;1;1
258194060612;258194061664;1052;2;1;1;1
258194061664;258194061963;299;2;1;1;1
258194061963;258194063277;1314;2;1;1;1
258194144365;258194144997;632;2;1;1;1
258194214287;258194214839;552;2;1;1;1
258194224113;258194224777;664;2;1;1;1
258194293717;258194294653;936;2;1;1;1
258194295739;258194296383;644;2;1;1;1
258194418326;258194418958;632;2;1;1;1
258194422132;258194422683;551;2;1;1;1
258194508078;258194509799;1721;2;1;1;1
258194510660;258194512550;1890;2;1;1;1
258194512664;258194513493;829;2;1;1;1
258194514288;258194514887;599;2;1;1;1
258194555600;258194556238;638;2;1;1;1
258194565983;258194566614;631;2;1;1;1
258194628169;258194628806;637;2;1;1;1
258194716752;258194718058;1306;2;1;1;1
258194718765;258194719116;351;2;1;1;1
258194719116;258194719846;730;2;1;1;1
258194719846;258194719872;26;2;1;1;1
258194860167;258194861006;839;2;1;1;1
258194904938;258194905565;627;2;1;1;1
258194951968;258194953096;1128;2;1;1;1
258195097199;258195097973;774;2;1;1;1
258195157243;258195157939;696;2;1;1;1
258195199756;258195200077;321;2;1;1;1
258195200077;258195200749;672;2;1;1;1
258195200749;258195200930;181;2;1;1;1
258195274107;258195274599;492;2;1;1;1
258195399075;258195399739;664;2;1;1;1
258195439954;258195440884;930;2;1;1;1
258195514875;258195515401;526;2;1;1;1
258195579219;258195579630;411;2;1;1;1
258195579630;258195580004;374;2;1;1;1
258195580004;258195580737;733;2;1;1;1
258195652260;258195653104;844;2;1;1;1
258195734936;258195735483;547;2;1;1;1
258195979035;258195979677;642;2;1;1;1
258195980148;258195980821;673;2;1;1;1
258196011414;258196012102;688;2;1;1;1
258196144812;258196145366;554;2;1;1;1
258196212507;258196213113;606;2;1;1;1
258196268357;258196268886;529;2;1;1;1
258196350392;258196351008;616;2;1;1;1
258196391204;258196392373;1169;2;1;1;1
258196424691;258196425220;529;2;1;1;1
258196485258;258196485798;540;2;1;1;1
258196559595;258196560219;624;2;1;1;1
258196646008;258196646556;548;2;1;1;1
258196656060;258196656615;555;2;1;1;1
258196692643;258196693281;638;2;1;1;1
258196731973;258196732749;776;2;1;1;1
258196733843;258196734532;689;2;1;1;1
258196798204;258196798658;454;2;1;1;1
258196881769;258196881911;142;2;1;1;1
258196881911;258196882459;548;2;1;1;1
258196882459;258196883193;734;2;1;1;1
258196918301;258196919137;836;2;1;1;1
258196920222;258196921769;1547;2;1;1;1
258197080700;258197081164;464;2;1;1;1
258197095495;258197096125;630;2;1;1;1
258197143714;258197144271;557;2;1;1;1
258197144591;258197145186;595;2;1;1;1
258197226864;258197227410;546;2;1;1;1
258197227594;258197228430;836;2;1;1;1
258197281494;258197282124;630;2;1;1;1
258197358985;258197359614;629;2;1;1;1
258197432385;258197433011;626;2;1;1;1
258197467492;258197468089;597;2;1;1;1
258197549974;258197550657;683;2;1;1;1
258197639371;258197640888;1517;2;1;1;1
258197641753;258197642602;849;2;1;1;1
258197643478;258197644027;549;2;1;1;1
258197676104;258197676183;79;2;1;1;1
258197676183;258197676882;699;2;1;1;1
258197676882;258197676909;27;2;1;1;1
258197720762;258197721540;778;2;1;1;1
258197722525;258197723170;645;2;1;1;1
258197808962;258197809510;548;2;1;1;1
258197885485;258197885790;305;2;1;1;1
258197885790;258197886246;456;2;1;1;1
258197886246;258197886460;214;2;1;1;1
258197886909;258197887555;646;2;1;1;1
258197929175;258197929816;641;2;1;1;1
258197977125;258197977803;678;2;1;1;1
258198025582;258198026227;645;2;1;1;1
258198026793;258198027428;635;2;1;1;1
258198094150;258198094764;614;2;1;1;1
258198168025;258198168665;640;2;1;1;1
258198218921;258198220055;1134;2;1;1;1
258198221033;258198221578;545;2;1;1;1
258198222024;258198222667;643;2;1;1;1
258198302792;258198303392;600;2;1;1;1
258198339338;258198339965;627;2;1;1;1
258198420464;258198421029;565;2;1;1;1
258198511919;258198513911;1992;2;1;1;1
258198513911;258198515092;1181;2;1;1;1
258198515092;258198517070;1978;2;1;1;1
258198517070;258198519138;2068;2;1;1;1
258198519138;258198520932;1794;2;1;1;1
258198522879;258198523525;646;2;1;1;1
258198523661;258198524312;651;2;1;1;1
258198548124;258198548677;553;2;1;1;1
258198606763;258198608492;1729;2;1;1;1
258198610742;258198610812;70;2;1;1;1
258198610812;258198611541;729;2;1;1;1
258198611541;258198611571;30;2;1;1;1
258198679032;258198679590;558;2;1;1;1
258198762048;258198763424;1376;2;1;1;1
258198803726;258198804271;545;2;1;1;1
258198867313;258198867915;602;2;1;1;1
258198949264;258198949818;554;2;1;1;1
258198990295;258198990937;642;2;1;1;1
258199060859;258199061421;562;2;1;1;1
258199113035;258199113590;555;2;1;1;1
258199177189;258199177731;542;2;1;1;1
258199255938;258199256571;633;2;1;1;1
258199283916;258199284554;638;2;1;1;1
258199360482;258199361029;547;2;1;1;1
258199361427;258199362088;661;2;1;1;1
258199403976;258199404778;802;2;1;1;1
258199406385;258199406990;605;2;1;1;1
258199482400;258199483026;626;2;1;1;1
258199557427;258199558063;636;2;1;1;1
258199641510;258199642141;631;2;1;1;1
258199764708;258199766325;1617;2;1;1;1
258199767140;258199768517;1377;2;1;1;1
258199820499;258199821065;566;2;1;1;1
258199874128;258199874674;546;2;1;1;1
258199886377;258199886838;461;2;1;1;1
258199950464;258199951026;562;2;1;1;1
258200003794;258200004782;988;2;1;1;1
258200006793;258200007823;1030;2;1;1;1
258200009065;258200010359;1294;2;1;1;1
258200142257;258200142804;547;2;1;1;1
258200143035;258200143635;600;2;1;1;1
258200184221;258200184771;550;2;1;1;1
258200230316;258200230918;602;2;1;1;1
258200230918;258200231136;218;2;1;1;1
258200231136;258200231529;393;2;1;1;1
258200302251;258200302884;633;2;1;1;1
258200396643;258200397269;626;2;1;1;1
258200440560;258200441109;549;2;1;1;1
258200513539;258200514181;642;2;1;1;1
258200596305;258200596925;620;2;1;1;1
258200714941;258200716113;1172;2;1;1;1
258200780237;258200780799;562;2;1;1;1
258200830194;258200830670;476;2;1;1;1
258200879666;258200882069;2403;2;1;1;1
258201031530;258201032374;844;2;1;1;1
258201110568;258201111220;652;2;1;1;1
258201132825;258201133435;610;2;1;1;1
258201134142;258201134780;638;2;1;1;1
258201252899;258201253518;619;2;1;1;1
258201322770;258201323401;631;2;1;1;1
258201363488;258201364756;1268;2;1;1;1
258201364756;258201365049;293;2;1;1;1
258201365049;258201365796;747;2;1;1;1
258201366774;258201371136;4362;2;1;1;1
258201514990;258201515627;637;2;1;1;1
258201561219;258201561683;464;2;1;1;1
258201614702;258201615254;552;2;1;1;1
258201715216;258201716165;949;2;1;1;1
258201759278;258201763473;4195;2;1;1;1
258201825474;258201825998;524;2;1;1;1
258201912411;258201913044;633;2;1;1;1
258202029296;258202029929;633;2;1;1;1
258202165301;258202165769;468;2;1;1;1
258202205716;258202212999;7283;2;1;1;1
258202251065;258202251579;514;2;1;1;1
258202302838;258202303464;626;2;1;1;1
258202344800;258202345431;631;2;1;1;1
258202394207;258202395767;1560;2;1;1;1
258202430744;258202431582;838;2;1;1;1
258202431582;258202431944;362;2;1;1;1
258202431944;258202433560;1616;2;1;1;1
258202434126;258202434773;647;2;1;1;1
258202471636;258202472577;941;2;1;1;1
258202517596;258202518201;605;2;1;1;1
258202567962;258202568512;550;2;1;1;1
258202623015;258202623612;597;2;1;1;1
258202623749;258202624545;796;2;1;1;1
258202663947;258202664577;630;2;1;1;1
258202802659;258202804173;1514;2;1;1;1
258202813829;258202814840;1011;2;1;1;1
258202817026;258202817659;633;2;1;1;1
258202869055;258202869607;552;2;1;1;1
258202869607;258202869758;151;2;1;1;1
258202869758;258202870277;519;2;1;1;1
258203032021;258203032742;721;2;1;1;1
258203043855;258203044482;627;2;1;1;1
258203090562;258203090953;391;2;1;1;1
258203090953;258203091402;449;2;1;1;1
258203091402;258203092251;849;2;1;1;1
258203164668;258203165302;634;2;1;1;1
258203196051;258203196684;633;2;1;1;1
258203276709;258203277358;649;2;1;1;1
258203277568;258203278149;581;2;1;1;1
258203354481;258203356612;2131;2;1;1;1
258203403597;258203404200;603;2;1;1;1
258203450172;258203450795;623;2;1;1;1
258203499138;258203499790;652;2;1;1;1
258203544950;258203545581;631;2;1;1;1
258203592730;258203593374;644;2;1;1;1
258203662487;258203663034;547;2;1;1;1
258203724239;258203724787;548;2;1;1;1
258203776346;258203776947;601;2;1;1;1
258203857577;258203858211;634;2;1;1;1
258203877805;258203878435;630;2;1;1;1
258203880052;258203880610;558;2;1;1;1
258203953299;258203956497;3198;2;1;1;1
258203956497;258203957566;1069;2;1;1;1
258203957566;258203959136;1570;2;1;1;1
258203959136;258203959417;281;2;1;1;1
258203959417;258203960221;804;2;1;1;1
258203961288;258203961624;336;2;1;1;1
258203961624;258203962040;416;2;1;1;1
258203962040;258203962437;397;2;1;1;1
258204029464;258204030042;578;2;1;1;1
258204031001;258204031608;607;2;1;1;1
258204151699;258204152257;558;2;1;1;1
258204207395;258204207786;391;2;1;1;1
258204207786;258204207913;127;2;1;1;1
258204207913;258204208250;337;2;1;1;1
258204208250;258204208654;404;2;1;1;1
258204208654;258204209493;839;2;1;1;1
258204249949;258204250511;562;2;1;1;1
258204439287;258204439989;702;2;1;1;1
258204439989;258204440130;141;2;1;1;1
258204440130;258204440978;848;2;1;1;1
258204474380;258204474980;600;2;1;1;1
258204532525;258204533090;565;2;1;1;1
258204563251;258204563855;604;2;1;1;1
258204603412;258204603968;556;2;1;1;1
258204642350;258204642896;546;2;1;1;1
258204726691;258204727242;551;2;1;1;1
258204787215;258204787816;601;2;1;1;1
258204824462;258204825096;634;2;1;1;1
258204897226;258204897829;603;2;1;1;1
258204932797;258204933423;626;2;1;1;1
258204976074;258204976625;551;2;1;1;1
258205056321;258205056957;636;2;1;1;1
258205189752;258205190699;947;2;1;1;1
258205191923;258205192706;783;2;1;1;1
258205192706;258205193038;332;2;1;1;1
258205193038;258205193409;371;2;1;1;1
258205194133;258205194690;557;2;1;1;1
258205233087;258205233573;486;2;1;1;1
258205394988;258205395617;629;2;1;1;1
258205424630;258205425188;558;2;1;1;1
258205436008;258205436501;493;2;1;1;1
258205532893;258205533532;639;2;1;1;1
258205595612;258205596320;708;2;1;1;1
258205596956;258205597599;643;2;1;1;1
258205671353;258205672036;683;2;1;1;1
258205672719;258205673337;618;2;1;1;1
258205742650;258205743730;1080;2;1;1;1
258205744239;258205744845;606;2;1;1;1
258205797997;258205798688;691;2;1;1;1
258205798688;258205800859;2171;2;1;1;1
258205800859;258205802143;1284;2;1;1;1
258205803034;258205804502;1468;2;1;1;1
258205805172;258205806590;1418;2;1;1;1
258205806590;258205806614;24;2;1;1;1
258205806614;258205807743;1129;2;1;1;1
258205872943;258205873619;676;2;1;1;1
258205937192;258205939246;2054;2;1;1;1
258205939612;258205940832;1220;2;1;1;1
258205941783;258205942416;633;2;1;1;1
258205984499;258205985138;639;2;1;1;1
258206022396;258206023027;631;2;1;1;1
258206071966;258206072499;533;2;1;1;1
258206157094;258206157650;556;2;1;1;1
258206275686;258206279103;3417;2;1;1;1
258206308371;258206308861;490;2;1;1;1
258206355440;258206355927;487;2;1;1;1
258206356666;258206357305;639;2;1;1;1
258206430053;258206430788;735;2;1;1;1
258206499244;258206499867;623;2;1;1;1
258206539829;258206540441;612;2;1;1;1
258206573384;258206573853;469;2;1;1;1
258206626301;258206626955;654;2;1;1;1
258206671356;258206671924;568;2;1;1;1
258206719424;258206720081;657;2;1;1;1
258206763649;258206764182;533;2;1;1;1
258206839815;258206841201;1386;2;1;1;1
258207110371;258207111427;1056;2;1;1;1
258207157864;258207158494;630;2;1;1;1
258207194626;258207195701;1075;2;1;1;1
258207274325;258207274863;538;2;1;1;1
258207408694;258207409247;553;2;1;1;1
258207466352;258207466988;636;2;1;1;1
258207478629;258207479265;636;2;1;1;1
258207613041;258207613649;608;2;1;1;1
258207680970;258207682586;1616;2;1;1;1
258207759012;258207759483;471;2;1;1;1
258207802746;258207803296;550;2;1;1;1
258207881636;258207882240;604;2;1;1;1
258207946997;258207947679;682;2;1;1;1
258208021529;258208022160;631;2;1;1;1
258208063913;258208064559;646;2;1;1;1
258208115013;258208116231;1218;2;1;1;1
258208160520;258208161167;647;2;1;1;1
258208215795;258208216344;549;2;1;1;1
258208319765;258208320400;635;2;1;1;1
258208320495;258208321334;839;2;1;1;1
258208358615;258208360084;1469;2;1;1;1
258208441715;258208442366;651;2;1;1;1
258208453594;258208454151;557;2;1;1;1
258208499141;258208499709;568;2;1;1;1
258208548829;258208549327;498;2;1;1;1
258208549327;258208549559;232;2;1;1;1
258208549559;258208549944;385;2;1;1;1
258208617185;258208617813;628;2;1;1;1
258208693538;258208694325;787;2;1;1;1
258208695461;258208696098;637;2;1;1;1
258208760719;258208761324;605;2;1;1;1
258208839413;258208839972;559;2;1;1;1
258208899934;258208900868;934;2;1;1;1
258208991121;258208991694;573;2;1;1;1
258209049192;258209049851;659;2;1;1;1
258209050013;258209050571;558;2;1;1;1
258209089917;258209090725;808;2;1;1;1
258209090725;258209092820;2095;2;1;1;1
258209092820;258209097051;4231;2;1;1;1
258209097051;258209098126;1075;2;1;1;1
258209098126;258209098484;358;2;1;1;1
258209100797;258209101441;644;2;1;1;1
258209128035;258209128589;554;2;1;1;1
258209158655;258209159287;632;2;1;1;1
258209226262;258209226816;554;2;1;1;1
258209306368;258209306989;621;2;1;1;1
258209351747;258209352401;654;2;1;1;1
258209440566;258209441219;653;2;1;1;1
258209502752;258209504335;1583;2;1;1;1
258209504686;258209505455;769;2;1;1;1
258209506216;258209506838;622;2;1;1;1
258209608578;258209609132;554;2;1;1;1
258209696790;258209697321;531;2;1;1;1
258209743032;258209743637;605;2;1;1;1
258209785628;258209786227;599;2;1;1;1
258209857674;258209858293;619;2;1;1;1
258209868360;258209868982;622;2;1;1;1
258209952080;258209952724;644;2;1;1;1
258210035018;258210035652;634;2;1;1;1
258210081286;258210081843;557;2;1;1;1
258210141717;258210142445;728;2;1;1;1
258210145567;258210147768;2201;2;1;1;1
258210149920;258210150623;703;2;1;1;1
258210151195;258210151591;396;2;1;1;1
258210151591;258210151888;297;2;1;1;1
258210151888;258210152355;467;2;1;1;1
258210176864;258210177493;629;2;1;1;1
258210212111;258210213605;1494;2;1;1;1
258210215260;258210215795;535;2;1;1;1
258210293021;258210293705;684;2;1;1;1
258210338164;258210338792;628;2;1;1;1
258210372171;258210372827;656;2;1;1;1
258210373084;258210373830;746;2;1;1;1
258210449074;258210449744;670;2;1;1;1
258210449968;258210450553;585;2;1;1;1
258210532965;258210533527;562;2;1;1;1
258210639882;258210640524;642;2;1;1;1
258210757085;258210757867;782;2;1;1;1
258210768934;258210769616;682;2;1;1;1
258210804689;258210805740;1051;2;1;1;1
258210873637;258210874278;641;2;1;1;1
258211009016;258211009565;549;2;1;1;1
258211056615;258211057391;776;2;1;1;1
258211094886;258211095607;721;2;1;1;1
258211142959;258211143512;553;2;1;1;1
258211179001;258211179695;694;2;1;1;1
258211215966;258211216594;628;2;1;1;1
258211258333;258211259163;830;2;1;1;1
258211259715;258211260309;594;2;1;1;1
258211275880;258211276434;554;2;1;1;1
258211328940;258211329411;471;2;1;1;1
258211379473;258211395143;15670;2;1;1;1
258211493654;258211494270;616;2;1;1;1
258211512011;258211512569;558;2;1;1;1
258211554110;258211555268;1158;2;1;1;1
258211556102;258211556521;419;2;1;1;1
258211556521;258211557141;620;2;1;1;1
258211557141;258211557535;394;2;1;1;1
258211669528;258211670070;542;2;1;1;1
258211710260;258211711364;1104;2;1;1;1
258211712367;258211713025;658;2;1;1;1
258211756179;258211756724;545;2;1;1;1
258211826843;258211828771;1928;2;1;1;1
258211828771;258211829238;467;2;1;1;1
258211829238;258211831726;2488;2;1;1;1
258211833648;258211834550;902;2;1;1;1
258211836510;258211837070;560;2;1;1;1
258211894374;258211895092;718;2;1;1;1
258211895459;258211896547;1088;2;1;1;1
258211940487;258211941126;639;2;1;1;1
258211986613;258211987268;655;2;1;1;1
258212020668;258212021915;1247;2;1;1;1
258212054557;258212055167;610;2;1;1;1
258212097019;258212098312;1293;2;1;1;1
258212099132;258212099686;554;2;1;1;1
258212142485;258212144360;1875;2;1;1;1
258212205831;258212206594;763;2;1;1;1
258212206594;258212206799;205;2;1;1;1
258212206799;258212214164;7365;2;1;1;1
258212289514;258212290630;1116;2;1;1;1
258212327346;258212327893;547;2;1;1;1
258212406969;258212407875;906;2;1;1;1
258212408313;258212409135;822;2;1;1;1
258212472016;258212472560;544;2;1;1;1
258212512491;258212513160;669;2;1;1;1
258212551690;258212552227;537;2;1;1;1
258212587369;258212587910;541;2;1;1;1
258212628267;258212628906;639;2;1;1;1
258212737380;258212737868;488;2;1;1;1
258212806848;258212813651;6803;2;1;1;1
258212890639;258212891129;490;2;1;1;1
258212939665;258212940290;625;2;1;1;1
258212990860;258212991431;571;2;1;1;1
258213060301;258213061824;1523;2;1;1;1
258213061824;258213061896;72;2;1;1;1
258213061896;258213062681;785;2;1;1;1
258213129671;258213130305;634;2;1;1;1
258213176001;258213176531;530;2;1;1;1
258213187290;258213187836;546;2;1;1;1
258213230355;258213230853;498;2;1;1;1
258213270182;258213271196;1014;2;1;1;1
258213349699;258213354307;4608;2;1;1;1
258213386090;258213386625;535;2;1;1;1
258213472472;258213473009;537;2;1;1;1
258213515735;258213516578;843;2;1;1;1
258213565266;258213566071;805;2;1;1;1
258213566268;258213568685;2417;2;1;1;1
258213643253;258213643868;615;2;1;1;1
258213684079;258213684760;681;2;1;1;1
258213731757;258213732396;639;2;1;1;1
258213802801;258213804670;1869;2;1;1;1
258213851221;258213851773;552;2;1;1;1
258213898710;258213899316;606;2;1;1;1
258213937320;258213938203;883;2;1;1;1
258213971443;258213972006;563;2;1;1;1
258213972006;258213973222;1216;2;1;1;1
258213973222;258213973725;503;2;1;1;1
258214043871;258214044456;585;2;1;1;1
258214045366;258214046003;637;2;1;1;1
258214106452;258214107085;633;2;1;1;1
258214185618;258214186264;646;2;1;1;1
258214230745;258214231636;891;2;1;1;1
258214291432;258214292686;1254;2;1;1;1
258214328511;258214329113;602;2;1;1;1
258214375503;258214376136;633;2;1;1;1
258214424408;258214426370;1962;2;1;1;1
258214467817;258214468365;548;2;1;1;1
258214513256;258214513932;676;2;1;1;1
258214554710;258214555267;557;2;1;1;1
258214615538;258214616349;811;2;1;1;1
258214616389;258214617374;985;2;1;1;1
258214674720;258214675356;636;2;1;1;1
258214745353;258214745990;637;2;1;1;1
258214786502;258214787136;634;2;1;1;1
258214835441;258214836040;599;2;1;1;1
258214908654;258214909204;550;2;1;1;1
258214987477;258214988018;541;2;1;1;1
258215150411;258215150979;568;2;1;1;1
258215221621;258215222261;640;2;1;1;1
258215293230;258215293828;598;2;1;1;1
258215343649;258215347415;3766;2;1;1;1
258215348326;258215349079;753;2;1;1;1
258215349155;258215349597;442;2;1;1;1
258215349597;258215350359;762;2;1;1;1
258215350359;258215350371;12;2;1;1;1
258215410343;258215410990;647;2;1;1;1
258215411325;258215412072;747;2;1;1;1
258215490639;258215491196;557;2;1;1;1
258215536363;258215536994;631;2;1;1;1
258215575740;258215576373;633;2;1;1;1
258215628540;258215629233;693;2;1;1;1
258215629233;258215630015;782;2;1;1;1
258215630015;258215630562;547;2;1;1;1
258215631901;258215632538;637;2;1;1;1
258215676272;258215676803;531;2;1;1;1
258215715971;258215716525;554;2;1;1;1
258215762732;258215763229;497;2;1;1;1
258215803919;258215804486;567;2;1;1;1
258215872465;258215873069;604;2;1;1;1
258215964125;258215964762;637;2;1;1;1
258216032140;258216032745;605;2;1;1;1
258216070206;258216071602;1396;2;1;1;1
258216147975;258216148664;689;2;1;1;1
258216192184;258216193082;898;2;1;1;1
258216227682;258216228272;590;2;1;1;1
258216296418;258216296969;551;2;1;1;1
258216332103;258216332757;654;2;1;1;1
258216440136;258216440811;675;2;1;1;1
258216478324;258216479497;1173;2;1;1;1
258216540779;258216541427;648;2;1;1;1
258216696064;258216696695;631;2;1;1;1
258216737931;258216738541;610;2;1;1;1
258216788356;258216788905;549;2;1;1;1
258216849681;258216850163;482;2;1;1;1
258216860746;258216861730;984;2;1;1;1
258216904817;258216906893;2076;2;1;1;1
258216933627;258216934186;559;2;1;1;1
258217161573;258217162123;550;2;1;1;1
258217232148;258217233172;1024;2;1;1;1
258217281925;258217282420;495;2;1;1;1
258217615505;258217616004;499;2;1;1;1
258217662142;258217662639;497;2;1;1;1
258217731993;258217732525;532;2;1;1;1
258217791260;258217791815;555;2;1;1;1
258217791929;258217792832;903;2;1;1;1
258217869437;258217869904;467;2;1;1;1
258217917979;258217918438;459;2;1;1;1
258217969332;258217969967;635;2;1;1;1
258218002863;258218003325;462;2;1;1;1
258218064487;258218065141;654;2;1;1;1
258218227244;258218228054;810;2;1;1;1
258218230735;258218231625;890;2;1;1;1
258218304114;258218304758;644;2;1;1;1
258218389959;258218395384;5425;2;1;1;1
258218432905;258218434114;1209;2;1;1;1
258218453759;258218454361;602;2;1;1;1
258218564569;258218565214;645;2;1;1;1
258218637221;258218637690;469;2;1;1;1
258218677579;258218678725;1146;2;1;1;1
258218720856;258218721331;475;2;1;1;1
258218792743;258218793898;1155;2;1;1;1
258218832984;258218833535;551;2;1;1;1
258218878353;258218879310;957;2;1;1;1
258218882073;258218883065;992;2;1;1;1
258218883427;258218884323;896;2;1;1;1
258218921825;258218922419;594;2;1;1;1
258218968665;258218969162;497;2;1;1;1
258219048825;258219049375;550;2;1;1;1
258219088710;258219089261;551;2;1;1;1
258219124730;258219125288;558;2;1;1;1
258219135923;258219136469;546;2;1;1;1
258219247174;258219247775;601;2;1;1;1
258219247775;258219247842;67;2;1;1;1
258219247842;258219248633;791;2;1;1;1
258219322374;258219322840;466;2;1;1;1
258219361677;258219362140;463;2;1;1;1
258219438654;258219439253;599;2;1;1;1
258219547251;258219547804;553;2;1;1;1
258219609394;258219610257;863;2;1;1;1
258219672368;258219672933;565;2;1;1;1
258219736187;258219736733;546;2;1;1;1
258219775882;258219776432;550;2;1;1;1
258219829736;258219830393;657;2;1;1;1
258219832696;258219833708;1012;2;1;1;1
258219916537;258219917077;540;2;1;1;1
258219954957;258219956090;1133;2;1;1;1
258219992263;258219992861;598;2;1;1;1
258220074560;258220075204;644;2;1;1;1
258220075565;258220076227;662;2;1;1;1
258220112594;258220113195;601;2;1;1;1
258220168126;258220168754;628;2;1;1;1
258220219403;258220219964;561;2;1;1;1
258220266545;258220267193;648;2;1;1;1
258220397940;258220398790;850;2;1;1;1
258220441217;258220441821;604;2;1;1;1
258220442328;258220442964;636;2;1;1;1
258220480706;258220482134;1428;2;1;1;1
258220567794;258220568766;972;2;1;1;1
258220635286;258220635840;554;2;1;1;1
258220681258;258220681837;579;2;1;1;1
258220721763;258220722523;760;2;1;1;1
258220733479;258220734048;569;2;1;1;1
258220774406;258220775008;602;2;1;1;1
258220837452;258220837852;400;2;1;1;1
258220837852;258220838399;547;2;1;1;1
258220838399;258220839633;1234;2;1;1;1
258220880928;258220881565;637;2;1;1;1
258220959522;258220960084;562;2;1;1;1
258221026213;258221026849;636;2;1;1;1
258221068673;258221069236;563;2;1;1;1
258221111866;258221112499;633;2;1;1;1
258221155908;258221156526;618;2;1;1;1
258221202429;258221203033;604;2;1;1;1
258221264385;258221264950;565;2;1;1;1
258221265405;258221266034;629;2;1;1;1
258221302235;258221302862;627;2;1;1;1
258221348429;258221349060;631;2;1;1;1
258221405239;258221405859;620;2;1;1;1
258221453280;258221453750;470;2;1;1;1
258221519195;258221519858;663;2;1;1;1
258221570475;258221571004;529;2;1;1;1
258221635015;258221635585;570;2;1;1;1
258221715982;258221716914;932;2;1;1;1
258221718172;258221718972;800;2;1;1;1
258221854010;258221854487;477;2;1;1;1
258221900448;258221901054;606;2;1;1;1
258221957889;258221958926;1037;2;1;1;1
258221992471;258221992994;523;2;1;1;1
258222038056;258222039136;1080;2;1;1;1
258222080934;258222083072;2138;2;1;1;1
258222110536;258222111180;644;2;1;1;1
258222153662;258222154286;624;2;1;1;1
258222195242;258222196481;1239;2;1;1;1
258222267559;258222268117;558;2;1;1;1
258222311460;258222312450;990;2;1;1;1
258222331183;258222331865;682;2;1;1;1
258222373219;258222373819;600;2;1;1;1
258222431341;258222431973;632;2;1;1;1
258222565261;258222565822;561;2;1;1;1
258222614660;258222615976;1316;2;1;1;1
258222688857;258222689424;567;2;1;1;1
258222689451;258222690326;875;2;1;1;1
258222763667;258222764218;551;2;1;1;1
258222820465;258222821110;645;2;1;1;1
258222880002;258222881407;1405;2;1;1;1
258222926522;258222927075;553;2;1;1;1
258223003308;258223004175;867;2;1;1;1
258223034135;258223034745;610;2;1;1;1
258223081622;258223082228;606;2;1;1;1
258223121943;258223122778;835;2;1;1;1
258223279681;258223280223;542;2;1;1;1
258223349868;258223350703;835;2;1;1;1
258223351359;258223351979;620;2;1;1;1
258223382037;258223383399;1362;2;1;1;1
258223453545;258223454072;527;2;1;1;1
258223561757;258223562381;624;2;1;1;1
258223604124;258223605845;1721;2;1;1;1
258223691484;258223691931;447;2;1;1;1
258223691931;258223692572;641;2;1;1;1
258223692572;258223693178;606;2;1;1;1
258223742353;258223744302;1949;2;1;1;1
258223829050;258223829693;643;2;1;1;1
258223902776;258223903255;479;2;1;1;1
258223934469;258223934923;454;2;1;1;1
258223965577;258223966045;468;2;1;1;1
258223966498;258223967119;621;2;1;1;1
258223984807;258223984954;147;2;1;1;1
258223984954;258223986313;1359;2;1;1;1
258223986313;258223986603;290;2;1;1;1
258223986603;258223986774;171;2;1;1;1
258223986774;258223988320;1546;2;1;1;1
258224017515;258224018752;1237;2;1;1;1
258224086277;258224087400;1123;2;1;1;1
258224088427;258224088956;529;2;1;1;1
258224175673;258224176312;639;2;1;1;1
258224217797;258224218431;634;2;1;1;1
258224265075;258224265617;542;2;1;1;1
258224308817;258224309371;554;2;1;1;1
258224352820;258224353344;524;2;1;1;1
258224383107;258224383674;567;2;1;1;1
258224424548;258224424792;244;2;1;1;1
258224424792;258224425345;553;2;1;1;1
258224425345;258224425717;372;2;1;1;1
258224566074;258224566785;711;2;1;1;1
258224608405;258224609038;633;2;1;1;1
258224609814;258224610608;794;2;1;1;1
258224649019;258224649682;663;2;1;1;1
258224813687;258224814502;815;2;1;1;1
258224855078;258224855629;551;2;1;1;1
258224883955;258224884586;631;2;1;1;1
258224938715;258224939421;706;2;1;1;1
258224940347;258224940980;633;2;1;1;1
258224998515;258224999442;927;2;1;1;1
258225050330;258225051397;1067;2;1;1;1
258225172277;258225172833;556;2;1;1;1
258225237203;258225237744;541;2;1;1;1
258225336327;258225336888;561;2;1;1;1
258225337321;258225337985;664;2;1;1;1
258225372770;258225388312;15542;2;1;1;1
258225408656;258225409207;551;2;1;1;1
258225451649;258225452330;681;2;1;1;1
258225452437;258225453469;1032;2;1;1;1
258225520217;258225520849;632;2;1;1;1
258225558469;258225558935;466;2;1;1;1
258225735604;258225736066;462;2;1;1;1
258225774297;258225774842;545;2;1;1;1
258225856163;258225856792;629;2;1;1;1
258225910717;258225911185;468;2;1;1;1
258225955731;258225956324;593;2;1;1;1
258225956363;258225957158;795;2;1;1;1
258225998898;258225999456;558;2;1;1;1
258226096201;258226097031;830;2;1;1;1
258226167332;258226167877;545;2;1;1;1
258226213414;258226214046;632;2;1;1;1
258226307587;258226308870;1283;2;1;1;1
258226309688;258226310362;674;2;1;1;1
258226310832;258226311541;709;2;1;1;1
258226350069;258226350635;566;2;1;1;1
258226350806;258226351467;661;2;1;1;1
258226399141;258226399703;562;2;1;1;1
258226437547;258226438184;637;2;1;1;1
258226484767;258226485320;553;2;1;1;1
258226535707;258226536336;629;2;1;1;1
258226574794;258226575420;626;2;1;1;1
258226612297;258226612943;646;2;1;1;1
258226655472;258226701854;46382;2;1;1;1
258226716993;258226717629;636;2;1;1;1
258226756538;258226757142;604;2;1;1;1
258226830078;258226830690;612;2;1;1;1
258226876461;258226877097;636;2;1;1;1
258226962649;258226963181;532;2;1;1;1
258227003300;258227003399;99;2;1;1;1
258227003399;258227004055;656;2;1;1;1
258227004055;258227004129;74;2;1;1;1
258227004719;258227005541;822;2;1;1;1
258227046514;258227047026;512;2;1;1;1
258227093231;258227093696;465;2;1;1;1
258227144365;258227144994;629;2;1;1;1
258227194845;258227195795;950;2;1;1;1
258227196717;258227197350;633;2;1;1;1
258227314492;258227315441;949;2;1;1;1
258227351847;258227352390;543;2;1;1;1
258227392075;258227392563;488;2;1;1;1
258227437417;258227437888;471;2;1;1;1
258227460613;258227461171;558;2;1;1;1
258227510367;258227511012;645;2;1;1;1
258227680521;258227681133;612;2;1;1;1
258227810581;258227811219;638;2;1;1;1
258227852769;258227853592;823;2;1;1;1
258227864318;258227864946;628;2;1;1;1
258227903958;258227904511;553;2;1;1;1
258227943659;258227944183;524;2;1;1;1
258227989963;258227991100;1137;2;1;1;1
258228038827;258228039371;544;2;1;1;1
258228075227;258228075862;635;2;1;1;1
258228155624;258228156828;1204;2;1;1;1
258228282568;258228284436;1868;2;1;1;1
258228285954;258228286971;1017;2;1;1;1
258228378955;258228380051;1096;2;1;1;1
258228484803;258228485623;820;2;1;1;1
258228485654;258228487712;2058;2;1;1;1
258228495188;258228495741;553;2;1;1;1
258228540695;258228542027;1332;2;1;1;1
258228604021;258228604627;606;2;1;1;1
258228696753;258228697403;650;2;1;1;1
258228741642;258228742170;528;2;1;1;1
258228784180;258228784776;596;2;1;1;1
258228865372;258228867107;1735;2;1;1;1
258228903444;258228904053;609;2;1;1;1
258228942861;258228943328;467;2;1;1;1
258228974250;258228974870;620;2;1;1;1
258228978315;258228978858;543;2;1;1;1
258229094564;258229096028;1464;2;1;1;1
258229097527;258229097765;238;2;1;1;1
258229097765;258229098352;587;2;1;1;1
258229098352;258229098982;630;2;1;1;1
258229161737;258229162674;937;2;1;1;1
258229209467;258229210119;652;2;1;1;1
258229239373;258229240204;831;2;1;1;1
258229291544;258229292102;558;2;1;1;1
258229323700;258229324254;554;2;1;1;1
258229357748;258229358347;599;2;1;1;1
258229386813;258229387365;552;2;1;1;1
258229440488;258229441110;622;2;1;1;1
258229602768;258229603846;1078;2;1;1;1
258229686674;258229687485;811;2;1;1;1
258229760909;258229761548;639;2;1;1;1
258229787850;258229788482;632;2;1;1;1
258229841445;258229843105;1660;2;1;1;1
258229955155;258229955700;545;2;1;1;1
258229997877;258229998659;782;2;1;1;1
258230000268;258230000885;617;2;1;1;1
258230010020;258230010444;424;2;1;1;1
258230010444;258230011302;858;2;1;1;1
258230011302;258230012095;793;2;1;1;1
258230054777;258230055336;559;2;1;1;1
258230101758;258230102308;550;2;1;1;1
258230136517;258230137030;513;2;1;1;1
258230207287;258230207320;33;2;1;1;1
258230207320;258230208133;813;2;1;1;1
258230208133;258230214912;6779;2;1;1;1
258230214912;258230215518;606;2;1;1;1
258230215518;258230215539;21;2;1;1;1
258230257162;258230257719;557;2;1;1;1
258230297535;258230297651;116;2;1;1;1
258230297651;258230299253;1602;2;1;1;1
258230299253;258230300503;1250;2;1;1;1
258230334401;258230335056;655;2;1;1;1
258230376830;258230377461;631;2;1;1;1
258230413634;258230414092;458;2;1;1;1
258230459739;258230460381;642;2;1;1;1
258230505920;258230506542;622;2;1;1;1
258230555930;258230557854;1924;2;1;1;1
258230558532;258230560816;2284;2;1;1;1
258230562554;258230563577;1023;2;1;1;1
258230563577;258230564009;432;2;1;1;1
258230564009;258230564461;452;2;1;1;1
258230564461;258230564866;405;2;1;1;1
258230564866;258230567220;2354;2;1;1;1
258230633776;258230634459;683;2;1;1;1
258230645224;258230646069;845;2;1;1;1
258230693082;258230693684;602;2;1;1;1
258230771344;258230771966;622;2;1;1;1
258230810220;258230810944;724;2;1;1;1
258230810992;258230812005;1013;2;1;1;1
258230855509;258230856138;629;2;1;1;1
258230903476;258230904524;1048;2;1;1;1
258230944520;258230944732;212;2;1;1;1
258230944732;258230945761;1029;2;1;1;1
258230945761;258230946526;765;2;1;1;1
258230991728;258230992225;497;2;1;1;1
258230992225;258230992443;218;2;1;1;1
258230992443;258230992806;363;2;1;1;1
258231052410;258231052954;544;2;1;1;1
258231113043;258231113601;558;2;1;1;1
258231158964;258231159513;549;2;1;1;1
258231191748;258231192397;649;2;1;1;1
258231229033;258231229588;555;2;1;1;1
258231300516;258231301149;633;2;1;1;1
258231347738;258231348359;621;2;1;1;1
258231348886;258231349519;633;2;1;1;1
258231387541;258231388099;558;2;1;1;1
258231433595;258231434143;548;2;1;1;1
258231482378;258231482987;609;2;1;1;1
258231534763;258231535483;720;2;1;1;1
258231535590;258231536569;979;2;1;1;1
258231568768;258231569369;601;2;1;1;1
258231602656;258231603339;683;2;1;1;1
258231651785;258231652341;556;2;1;1;1
258231652631;258231653250;619;2;1;1;1
258231686429;258231687018;589;2;1;1;1
258231731710;258231732366;656;2;1;1;1
258231732889;258231733472;583;2;1;1;1
258231778490;258231779148;658;2;1;1;1
258231779921;258231780527;606;2;1;1;1
258231846836;258231847355;519;2;1;1;1
258231888287;258231888831;544;2;1;1;1
258231930575;258231931201;626;2;1;1;1
258232014670;258232015318;648;2;1;1;1
258232134899;258232137195;2296;2;1;1;1
258232140650;258232141287;637;2;1;1;1
258232145309;258232145942;633;2;1;1;1
258232194073;258232194701;628;2;1;1;1
258232268819;258232269360;541;2;1;1;1
258232392831;258232393375;544;2;1;1;1
258232454540;258232455005;465;2;1;1;1
258232506675;258232507640;965;2;1;1;1
258232507640;258232507659;19;2;1;1;1
258232507659;258232508345;686;2;1;1;1
258232615111;258232615651;540;2;1;1;1
258232660224;258232660787;563;2;1;1;1
258232731317;258232732146;829;2;1;1;1
258232732281;258232734791;2510;2;1;1;1
258232767848;258232768622;774;2;1;1;1
258232777880;258232778511;631;2;1;1;1
258232825293;258232825846;553;2;1;1;1
258232893688;258232894325;637;2;1;1;1
258232928718;258232929336;618;2;1;1;1
258232929434;258232930197;763;2;1;1;1
258233046747;258233047622;875;2;1;1;1
258233097029;258233097640;611;2;1;1;1
258233141177;258233141839;662;2;1;1;1
258233196306;258233197330;1024;2;1;1;1
258233269900;258233271335;1435;2;1;1;1
258233272766;258233274151;1385;2;1;1;1
258233344175;258233344790;615;2;1;1;1
258233430691;258233431177;486;2;1;1;1
258233441887;258233442553;666;2;1;1;1
258233485478;258233486522;1044;2;1;1;1
258233529863;258233530354;491;2;1;1;1
258233571401;258233571944;543;2;1;1;1
258233677169;258233677798;629;2;1;1;1
258233714932;258233715537;605;2;1;1;1
258233762920;258233763838;918;2;1;1;1
258233815255;258233815787;532;2;1;1;1
258233846889;258233847441;552;2;1;1;1
258233922311;258233922872;561;2;1;1;1
258233924063;258233924581;518;2;1;1;1
258233954474;258233955936;1462;2;1;1;1
258233957705;258233958236;531;2;1;1;1
258233958236;258233958424;188;2;1;1;1
258233958424;258233974371;15947;2;1;1;1
258233995836;258233996389;553;2;1;1;1
258234031335;258234032037;702;2;1;1;1
258234032076;258234032966;890;2;1;1;1
258234061300;258234061956;656;2;1;1;1
258234166293;258234167788;1495;2;1;1;1
258234177472;258234178497;1025;2;1;1;1
258234224732;258234225260;528;2;1;1;1
258234327543;258234328179;636;2;1;1;1
258234338813;258234340078;1265;2;1;1;1
258234343361;258234344182;821;2;1;1;1
258234344182;258234344301;119;2;1;1;1
258234344301;258234346267;1966;2;1;1;1
258234368991;258234369610;619;2;1;1;1
258234412528;258234413160;632;2;1;1;1
258234543227;258234543830;603;2;1;1;1
258234599248;258234599889;641;2;1;1;1
258234668670;258234669133;463;2;1;1;1
258234706974;258234708450;1476;2;1;1;1
258234751230;258234751862;632;2;1;1;1
258234790424;258234790987;563;2;1;1;1
258234881463;258234882323;860;2;1;1;1
258234955443;258234956231;788;2;1;1;1
258235008645;258235009208;563;2;1;1;1
258235019540;258235020589;1049;2;1;1;1
258235081709;258235082539;830;2;1;1;1
258235083614;258235084171;557;2;1;1;1
258235126995;258235127604;609;2;1;1;1
258235175188;258235175816;628;2;1;1;1
258235209660;258235210124;464;2;1;1;1
258235287291;258235287947;656;2;1;1;1
258235331024;258235331566;542;2;1;1;1
258235375124;258235375678;554;2;1;1;1
258235446869;258235447402;533;2;1;1;1
258235530589;258235531236;647;2;1;1;1
258235642064;258235642973;909;2;1;1;1
258235683590;258235684187;597;2;1;1;1
258235695566;258235696107;541;2;1;1;1
258235740157;258235740965;808;2;1;1;1
258235802034;258235802597;563;2;1;1;1
258235831273;258235831846;573;2;1;1;1
258235892220;258235892779;559;2;1;1;1
258235941911;258235942953;1042;2;1;1;1
258235975320;258235975952;632;2;1;1;1
258236021602;258236024573;2971;2;1;1;1
258236025478;258236026267;789;2;1;1;1
258236027836;258236028489;653;2;1;1;1
258236103549;258236104518;969;2;1;1;1
258236105444;258236105996;552;2;1;1;1
258236178177;258236178809;632;2;1;1;1
258236223646;258236224248;602;2;1;1;1
258236268798;258236269427;629;2;1;1;1
258236313618;258236314225;607;2;1;1;1
258236361795;258236362349;554;2;1;1;1
258236393638;258236394196;558;2;1;1;1
258236442076;258236442675;599;2;1;1;1
258236482483;258236483043;560;2;1;1;1
258236519168;258236519817;649;2;1;1;1
258236862335;258236863924;1589;2;1;1;1
258236864588;258236865075;487;2;1;1;1
258236865075;258236865282;207;2;1;1;1
258236865282;258236865662;380;2;1;1;1
258236961279;258236961833;554;2;1;1;1
258236971455;258236971960;505;2;1;1;1
258236972039;258236972887;848;2;1;1;1
258237017518;258237018108;590;2;1;1;1
258237063744;258237064422;678;2;1;1;1
258237096161;258237096792;631;2;1;1;1
258237145586;258237146145;559;2;1;1;1
258237211549;258237212592;1043;2;1;1;1
258237260796;258237261483;687;2;1;1;1
258237301916;258237302548;632;2;1;1;1
258237346918;258237347547;629;2;1;1;1
258237520243;258237520943;700;2;1;1;1
258237521087;258237522793;1706;2;1;1;1
258237564378;258237565009;631;2;1;1;1
258237611798;258237612576;778;2;1;1;1
258237613817;258237616315;2498;2;1;1;1
258237686187;258237686811;624;2;1;1;1
258237732959;258237733874;915;2;1;1;1
258237778375;258237779054;679;2;1;1;1
258237817629;258237818244;615;2;1;1;1
258237908126;258237908979;853;2;1;1;1
258237980727;258237997456;16729;2;1;1;1
258238032189;258238033037;848;2;1;1;1
258238085718;258238086272;554;2;1;1;1
258238128363;258238129032;669;2;1;1;1
258238164860;258238165904;1044;2;1;1;1
258238235225;258238236529;1304;2;1;1;1
258238356094;258238357228;1134;2;1;1;1
258238357228;258238357476;248;2;1;1;1
258238357476;258238358431;955;2;1;1;1
258238369674;258238370352;678;2;1;1;1
258238422511;258238424138;1627;2;1;1;1
258238424138;258238425054;916;2;1;1;1
258238425054;258238425633;579;2;1;1;1
258238426541;258238427893;1352;2;1;1;1
258238468392;258238469026;634;2;1;1;1
258238524429;258238524977;548;2;1;1;1
258238562080;258238562607;527;2;1;1;1
258238641736;258238642211;475;2;1;1;1
258238681058;258238682494;1436;2;1;1;1
258238774877;258238775428;551;2;1;1;1
258238835121;258238835611;490;2;1;1;1
258238900964;258238901602;638;2;1;1;1
258238950886;258238951515;629;2;1;1;1
258238991578;258238992385;807;2;1;1;1
258239054291;258239055718;1427;2;1;1;1
258239128132;258239128765;633;2;1;1;1
258239156386;258239156933;547;2;1;1;1
258239211791;258239212252;461;2;1;1;1
258239289197;258239289922;725;2;1;1;1
258239289922;258239290148;226;2;1;1;1
258239290148;258239291736;1588;2;1;1;1
258239324389;258239324938;549;2;1;1;1
258239364143;258239365317;1174;2;1;1;1
258239365317;258239365941;624;2;1;1;1
258239365941;258239366195;254;2;1;1;1
258239366848;258239367487;639;2;1;1;1
258239368306;258239368942;636;2;1;1;1
258239467646;258239469703;2057;2;1;1;1
258239508516;258239509065;549;2;1;1;1
258239549257;258239550331;1074;2;1;1;1
258239577892;258239578567;675;2;1;1;1
258239620088;258239620646;558;2;1;1;1
258239673237;258239674359;1122;2;1;1;1
258239676228;258239677019;791;2;1;1;1
258239677019;258239677408;389;2;1;1;1
258239677408;258239678432;1024;2;1;1;1
258239707900;258239708530;630;2;1;1;1
258239759262;258239760191;929;2;1;1;1
258239760191;258239760265;74;2;1;1;1
258239760265;258239761174;909;2;1;1;1
258239761582;258239762220;638;2;1;1;1
258239789257;258239790217;960;2;1;1;1
258239790620;258239791673;1053;2;1;1;1
258239883595;258239884067;472;2;1;1;1
258239956949;258239957444;495;2;1;1;1
258239997335;258239997859;524;2;1;1;1
258240033926;258240034533;607;2;1;1;1
258240078948;258240079467;519;2;1;1;1
258240116194;258240116744;550;2;1;1;1
258240188418;258240189037;619;2;1;1;1
258240234311;258240235545;1234;2;1;1;1
258240301407;258240301961;554;2;1;1;1
258240343658;258240344216;558;2;1;1;1
258240387925;258240392459;4534;2;1;1;1
258240434247;258240435178;931;2;1;1;1
258240435256;258240436008;752;2;1;1;1
258240436377;258240437025;648;2;1;1;1
258240469949;258240470581;632;2;1;1;1
258240517064;258240517614;550;2;1;1;1
258240560236;258240560786;550;2;1;1;1
258240600475;258240601090;615;2;1;1;1
258240637344;258240637979;635;2;1;1;1
258240682551;258240683085;534;2;1;1;1
258240786093;258240786590;497;2;1;1;1
258240786590;258240786820;230;2;1;1;1
258240786820;258240787178;358;2;1;1;1
258240811512;258240812069;557;2;1;1;1
258240872335;258240873890;1555;2;1;1;1
258240883921;258240884479;558;2;1;1;1
258240884479;258240884594;115;2;1;1;1
258240884594;258240885053;459;2;1;1;1
258240933328;258240934264;936;2;1;1;1
258240935973;258240936941;968;2;1;1;1
258240977964;258240978593;629;2;1;1;1
258241041916;258241042459;543;2;1;1;1
258241078817;258241079447;630;2;1;1;1
258241157191;258241157971;780;2;1;1;1
258241158856;258241159465;609;2;1;1;1
258241205320;258241205946;626;2;1;1;1
258241253492;258241254167;675;2;1;1;1
258241254670;258241255239;569;2;1;1;1
258241337572;258241338206;634;2;1;1;1
258241374861;258241375489;628;2;1;1;1
258241431782;258241432403;621;2;1;1;1
258241483452;258241484057;605;2;1;1;1
258241522172;258241522765;593;2;1;1;1
258241522765;258241522842;77;2;1;1;1
258241522842;258241523664;822;2;1;1;1
258241555223;258241555852;629;2;1;1;1
258241593126;258241593599;473;2;1;1;1
258241593599;258241594052;453;2;1;1;1
258241594052;258241594449;397;2;1;1;1
258241595108;258241595663;555;2;1;1;1
258241839725;258241840277;552;2;1;1;1
258241883881;258241884483;602;2;1;1;1
258241924088;258241924639;551;2;1;1;1
258241982570;258241983206;636;2;1;1;1
258242036116;258242037186;1070;2;1;1;1
258242084131;258242084677;546;2;1;1;1
258242128741;258242129607;866;2;1;1;1
258242130970;258242131595;625;2;1;1;1
258242166729;258242167370;641;2;1;1;1
258242236116;258242236656;540;2;1;1;1
258242273885;258242274874;989;2;1;1;1
258242275420;258242280006;4586;2;1;1;1
258242344559;258242346073;1514;2;1;1;1
258242346073;258242346742;669;2;1;1;1
258242346742;258242350181;3439;2;1;1;1
258242433616;258242434378;762;2;1;1;1
258242434957;258242435732;775;2;1;1;1
258242523507;258242524058;551;2;1;1;1
258242588491;258242588957;466;2;1;1;1
258242671247;258242671859;612;2;1;1;1
258242715533;258242716056;523;2;1;1;1
258242754036;258242754678;642;2;1;1;1
258242766078;258242766708;630;2;1;1;1
258242766737;258242767541;804;2;1;1;1
258242800460;258242801245;785;2;1;1;1
258242840961;258242841876;915;2;1;1;1
258242911550;258242918863;7313;2;1;1;1
258242986689;258242987181;492;2;1;1;1
258243034024;258243035478;1454;2;1;1;1
258243035982;258243037192;1210;2;1;1;1
258243037896;258243041280;3384;2;1;1;1
258243265743;258243266235;492;2;1;1;1
258243303519;258243303993;474;2;1;1;1
258243388967;258243389518;551;2;1;1;1
258243443984;258243444615;631;2;1;1;1
258243502807;258243503394;587;2;1;1;1
258243503394;258243503769;375;2;1;1;1
258243503769;258243504214;445;2;1;1;1
258243504683;258243505273;590;2;1;1;1
258243534635;258243535251;616;2;1;1;1
258243608854;258243609392;538;2;1;1;1
258243609993;258243610662;669;2;1;1;1
258243685410;258243686115;705;2;1;1;1
258243841831;258243842420;589;2;1;1;1
258243842420;258243842939;519;2;1;1;1
258243842939;258243847502;4563;2;1;1;1
258243895559;258243896183;624;2;1;1;1
258243954273;258243954807;534;2;1;1;1
258243987071;258243987608;537;2;1;1;1
258244055530;258244056065;535;2;1;1;1
258244105672;258244106220;548;2;1;1;1
258244161427;258244162086;659;2;1;1;1
258244192832;258244193990;1158;2;1;1;1
258244194596;258244195583;987;2;1;1;1
258244196352;258244196900;548;2;1;1;1
258244224476;258244225033;557;2;1;1;1
258244288440;258244288994;554;2;1;1;1
258244289375;258244289985;610;2;1;1;1
258244322444;258244330023;7579;2;1;1;1
258244358898;258244359455;557;2;1;1;1
258244359875;258244360454;579;2;1;1;1
258244504675;258244505909;1234;2;1;1;1
258244506397;258244507424;1027;2;1;1;1
258244508399;258244509076;677;2;1;1;1
258244536926;258244537839;913;2;1;1;1
258244643519;258244644839;1320;2;1;1;1
258244712356;258244712982;626;2;1;1;1
258244756071;258244756536;465;2;1;1;1
258244824116;258244826162;2046;2;1;1;1
258244827465;258244828370;905;2;1;1;1
258244828487;258244829806;1319;2;1;1;1
258244857558;258244858189;631;2;1;1;1
258244905063;258244905769;706;2;1;1;1
258244951938;258244952767;829;2;1;1;1
258244984457;258244984959;502;2;1;1;1
258245047400;258245047957;557;2;1;1;1
258245085283;258245085933;650;2;1;1;1
258245134420;258245135032;612;2;1;1;1
258245213757;258245214312;555;2;1;1;1
258245262219;258245262774;555;2;1;1;1
258245296661;258245297300;639;2;1;1;1
258245341193;258245341740;547;2;1;1;1
258245397405;258245397964;559;2;1;1;1
258245460392;258245461654;1262;2;1;1;1
258245555081;258245555660;579;2;1;1;1
258245587908;258245588518;610;2;1;1;1
258245588677;258245589452;775;2;1;1;1
258245620586;258245621144;558;2;1;1;1
258245656371;258245657441;1070;2;1;1;1
258245658149;258245658797;648;2;1;1;1
258245743745;258245744396;651;2;1;1;1
258245744846;258245746040;1194;2;1;1;1
258245752080;258245752627;547;2;1;1;1
258245873128;258245874250;1122;2;1;1;1
258245911810;258245912693;883;2;1;1;1
258245955601;258245956204;603;2;1;1;1
258245990531;258245991399;868;2;1;1;1
258245992286;258245992930;644;2;1;1;1
258246054992;258246055545;553;2;1;1;1
258246055545;258246055769;224;2;1;1;1
258246055769;258246056179;410;2;1;1;1
258246056606;258246057261;655;2;1;1;1
258246097633;258246098263;630;2;1;1;1
258246143793;258246144353;560;2;1;1;1
258246208008;258246208652;644;2;1;1;1
258246287490;258246288129;639;2;1;1;1
258246332725;258246333333;608;2;1;1;1
258246378011;258246378562;551;2;1;1;1
258246429212;258246431208;1996;2;1;1;1
258246432340;258246433014;674;2;1;1;1
258246433109;258246434111;1002;2;1;1;1
258246473687;258246474235;548;2;1;1;1
258246600279;258246600905;626;2;1;1;1
258246653118;258246653793;675;2;1;1;1
258246705704;258246706313;609;2;1;1;1
258246755577;258246756291;714;2;1;1;1
258246757331;258246757960;629;2;1;1;1
258246802261;258246802899;638;2;1;1;1
258246849658;258246850386;728;2;1;1;1
258246851425;258246852075;650;2;1;1;1
258246935425;258246936057;632;2;1;1;1
258246969293;258246969863;570;2;1;1;1
258247004736;258247005406;670;2;1;1;1
258247095413;258247095760;347;2;1;1;1
258247095760;258247096036;276;2;1;1;1
258247096036;258247096641;605;2;1;1;1
258247103742;258247104380;638;2;1;1;1
258247167368;258247167995;627;2;1;1;1
258247234563;258247235226;663;2;1;1;1
258247235226;258247235240;14;2;1;1;1
258247235240;258247236041;801;2;1;1;1
258247374772;258247375955;1183;2;1;1;1
258247403501;258247404923;1422;2;1;1;1
258247440156;258247440795;639;2;1;1;1
258247481180;258247481814;634;2;1;1;1
258247526229;258247527980;1751;2;1;1;1
258247528532;258247529242;710;2;1;1;1
258247578209;258247582365;4156;2;1;1;1
258247615413;258247616960;1547;2;1;1;1
258247618887;258247619448;561;2;1;1;1
258247734733;258247735578;845;2;1;1;1
258247817911;258247818527;616;2;1;1;1
258247898130;258247898942;812;2;1;1;1
258247945873;258247947359;1486;2;1;1;1
258247981215;258247981706;491;2;1;1;1
258248029286;258248029510;224;2;1;1;1
258248029510;258248030598;1088;2;1;1;1
258248030598;258248031610;1012;2;1;1;1
258248033332;258248034532;1200;2;1;1;1
258248034574;258248035444;870;2;1;1;1
258248147202;258248147827;625;2;1;1;1
258248354962;258248355498;536;2;1;1;1
258248526417;258248527934;1517;2;1;1;1
258248565723;258248566343;620;2;1;1;1
258248566838;258248567485;647;2;1;1;1
258248580208;258248580767;559;2;1;1;1
258248610645;258248611267;622;2;1;1;1
258248659590;258248660152;562;2;1;1;1
258248871180;258248871882;702;2;1;1;1
258248871882;258248872208;326;2;1;1;1
258248872208;258248872817;609;2;1;1;1
258248913718;258248914375;657;2;1;1;1
258248981545;258248982147;602;2;1;1;1
258249195407;258249196712;1305;2;1;1;1
258249230942;258249231442;500;2;1;1;1
258249270808;258249271476;668;2;1;1;1
258249338400;258249339031;631;2;1;1;1
258249359721;258249360338;617;2;1;1;1
258249398823;258249399372;549;2;1;1;1
258249436560;258249437196;636;2;1;1;1
258249496342;258249497486;1144;2;1;1;1
258249541089;258249541641;552;2;1;1;1
258249714145;258249714709;564;2;1;1;1
258249752932;258249753566;634;2;1;1;1
258249883015;258249886910;3895;2;1;1;1
258249922371;258249923015;644;2;1;1;1
258249962948;258249963484;536;2;1;1;1
258250085269;258250085921;652;2;1;1;1
258250204863;258250205609;746;2;1;1;1
258250217812;258250218556;744;2;1;1;1
258250309823;258250310370;547;2;1;1;1
258250359362;258250359869;507;2;1;1;1
258250433302;258250434281;979;2;1;1;1
258250445237;258250445845;608;2;1;1;1
258250485894;258250486709;815;2;1;1;1
258250519115;258250519757;642;2;1;1;1
258250556144;258250556833;689;2;1;1;1
258250557495;258250573843;16348;2;1;1;1
258250596513;258250597069;556;2;1;1;1
258250642963;258250643594;631;2;1;1;1
258250684466;258250685103;637;2;1;1;1
258250728188;258250728726;538;2;1;1;1
258250773260;258250773805;545;2;1;1;1
258250882192;258250882938;746;2;1;1;1
258250927313;258250927513;200;2;1;1;1
258250927513;258250928120;607;2;1;1;1
258250928120;258250932287;4167;2;1;1;1
258250961201;258250961830;629;2;1;1;1
258250993763;258250994232;469;2;1;1;1
258250994653;258250995250;597;2;1;1;1
258251071985;258251072589;604;2;1;1;1
258251110596;258251111220;624;2;1;1;1
258251238123;258251238683;560;2;1;1;1
258251281178;258251281641;463;2;1;1;1
258251331346;258251331982;636;2;1;1;1
258251380275;258251382314;2039;2;1;1;1
258251435836;258251436480;644;2;1;1;1
258251478669;258251480363;1694;2;1;1;1
258251524677;258251525525;848;2;1;1;1
258251569084;258251570011;927;2;1;1;1
258251570011;258251573445;3434;2;1;1;1
258251573445;258251573834;389;2;1;1;1
258251617567;258251618118;551;2;1;1;1
258251661453;258251665481;4028;2;1;1;1
258251706467;258251711166;4699;2;1;1;1
258251766413;258251766960;547;2;1;1;1
258251821257;258251821890;633;2;1;1;1
258251841259;258251842378;1119;2;1;1;1
258251883555;258251884167;612;2;1;1;1
258251934659;258251935270;611;2;1;1;1
258251979160;258251979859;699;2;1;1;1
258252019220;258252020023;803;2;1;1;1
258252020140;258252020957;817;2;1;1;1
258252062498;258252063054;556;2;1;1;1
258252153252;258252157287;4035;2;1;1;1
258252185080;258252185764;684;2;1;1;1
258252248247;258252248800;553;2;1;1;1
258252295280;258252295351;71;2;1;1;1
258252295351;258252296006;655;2;1;1;1
258252296006;258252296300;294;2;1;1;1
258252378135;258252379041;906;2;1;1;1
258252436943;258252438304;1361;2;1;1;1
258252441276;258252441829;553;2;1;1;1
258252460682;258252461310;628;2;1;1;1
258252499851;258252500507;656;2;1;1;1
258252545396;258252545883;487;2;1;1;1
258252715051;258252716494;1443;2;1;1;1
258252745025;258252745647;622;2;1;1;1
258252792379;258252793648;1269;2;1;1;1
258252837498;258252838138;640;2;1;1;1
258252881600;258252882235;635;2;1;1;1
258252959483;258252960018;535;2;1;1;1
258252996920;258252997476;556;2;1;1;1
258253077778;258253078279;501;2;1;1;1
258253078279;258253079006;727;2;1;1;1
258253079006;258253079937;931;2;1;1;1
258253113692;258253157472;43780;2;1;1;1
258253157472;258253158098;626;2;1;1;1
258253158098;258253158171;73;2;1;1;1
258253208620;258253209256;636;2;1;1;1
258253244116;258253244575;459;2;1;1;1
258253336846;258253337372;526;2;1;1;1
258253337770;258253338351;581;2;1;1;1
258253441878;258253442514;636;2;1;1;1
258253521057;258253521618;561;2;1;1;1
258253532243;258253532851;608;2;1;1;1
258253745757;258253746307;550;2;1;1;1
258253784904;258253785880;976;2;1;1;1
258253846340;258253847429;1089;2;1;1;1
258253888511;258253889143;632;2;1;1;1
258253933968;258253935447;1479;2;1;1;1
258254119599;258254120139;540;2;1;1;1
258254162621;258254163148;527;2;1;1;1
258254252226;258254252796;570;2;1;1;1
258254282660;258254283206;546;2;1;1;1
258254324846;258254326039;1193;2;1;1;1
258254375659;258254376656;997;2;1;1;1
258254377677;258254378851;1174;2;1;1;1
258254412123;258254412738;615;2;1;1;1
258254440776;258254441358;582;2;1;1;1
258254484087;258254484722;635;2;1;1;1
258254514790;258254515336;546;2;1;1;1
258254604933;258254605561;628;2;1;1;1
258254605949;258254606530;581;2;1;1;1
258254641878;258254642730;852;2;1;1;1
258254643797;258254644349;552;2;1;1;1
258254689818;258254690469;651;2;1;1;1
258254690697;258254691282;585;2;1;1;1
258254731819;258254732460;641;2;1;1;1
258254776751;258254777354;603;2;1;1;1
258254823697;258254824276;579;2;1;1;1
258254887938;258254888541;603;2;1;1;1
258254957233;258254962396;5163;2;1;1;1
258255015898;258255015979;81;2;1;1;1
258255015979;258255016782;803;2;1;1;1
258255016782;258255016800;18;2;1;1;1
258255100858;258255102958;2100;2;1;1;1
258255104534;258255105182;648;2;1;1;1
258255105280;258255105433;153;2;1;1;1
258255105433;258255106221;788;2;1;1;1
258255106221;258255106520;299;2;1;1;1
258255178178;258255178921;743;2;1;1;1
258255179916;258255180607;691;2;1;1;1
258255194877;258255198795;3918;2;1;1;1
258255312820;258255313445;625;2;1;1;1
258255359013;258255359577;564;2;1;1;1
258255444206;258255444753;547;2;1;1;1
258255561633;258255563217;1584;2;1;1;1
258255573052;258255574527;1475;2;1;1;1
258255616412;258255617047;635;2;1;1;1
258255664535;258255668853;4318;2;1;1;1
258255676623;258255677174;551;2;1;1;1
258255756630;258255757191;561;2;1;1;1
258255757596;258255758249;653;2;1;1;1
258255790202;258255790764;562;2;1;1;1
258255835616;258255836577;961;2;1;1;1
258255882100;258255883914;1814;2;1;1;1
258255884118;258255885688;1570;2;1;1;1
258255957822;258255958281;459;2;1;1;1
258255968939;258255969455;516;2;1;1;1
258256012600;258256013148;548;2;1;1;1
258256050329;258256050947;618;2;1;1;1
258256051432;258256052067;635;2;1;1;1
258256059919;258256060530;611;2;1;1;1
258256130268;258256130837;569;2;1;1;1
258256164127;258256164746;619;2;1;1;1
258256202173;258256202803;630;2;1;1;1
258256240712;258256241588;876;2;1;1;1
258256243406;258256243952;546;2;1;1;1
258256277583;258256278125;542;2;1;1;1
258256326703;258256328325;1622;2;1;1;1
258256328325;258256330416;2091;2;1;1;1
258256330416;258256330783;367;2;1;1;1
258256330783;258256330959;176;2;1;1;1
258256330959;258256331945;986;2;1;1;1
258256331945;258256332340;395;2;1;1;1
258256332340;258256332499;159;2;1;1;1
258256367732;258256368278;546;2;1;1;1
258256415940;258256416495;555;2;1;1;1
258256459083;258256459646;563;2;1;1;1
258256501096;258256501645;549;2;1;1;1
258256561305;258256561956;651;2;1;1;1
258256606184;258256606775;591;2;1;1;1
258256670752;258256671318;566;2;1;1;1
258256764470;258256765102;632;2;1;1;1
258256801912;258256802456;544;2;1;1;1
258256850428;258256850980;552;2;1;1;1
258256889152;258256889705;553;2;1;1;1
258256970819;258256971492;673;2;1;1;1
258257017306;258257017934;628;2;1;1;1
258257026714;258257027266;552;2;1;1;1
258257075343;258257075940;597;2;1;1;1
258257112201;258257112690;489;2;1;1;1
258257160238;258257160776;538;2;1;1;1
258257326570;258257327566;996;2;1;1;1
258257327566;258257328309;743;2;1;1;1
258257328309;258257328494;185;2;1;1;1
258257329681;258257330323;642;2;1;1;1
258257354141;258257354765;624;2;1;1;1
258257403121;258257403972;851;2;1;1;1
258257448835;258257450509;1674;2;1;1;1
258257451187;258257452520;1333;2;1;1;1
258257510348;258257510993;645;2;1;1;1
258257511504;258257512196;692;2;1;1;1
258257551711;258257552859;1148;2;1;1;1
258257595489;258257603182;7693;2;1;1;1
258257638455;258257642709;4254;2;1;1;1
258257674172;258257674946;774;2;1;1;1
258257717966;258257718509;543;2;1;1;1
258257804800;258257805432;632;2;1;1;1
258257881851;258257882789;938;2;1;1;1
258257882861;258257883808;947;2;1;1;1
258257883808;258257884470;662;2;1;1;1
258257884470;258257884623;153;2;1;1;1
258257919629;258257920099;470;2;1;1;1
258257962286;258257963166;880;2;1;1;1
258258047527;258258048890;1363;2;1;1;1
258258094072;258258095125;1053;2;1;1;1
258258139810;258258140369;559;2;1;1;1
258258297122;258258297642;520;2;1;1;1
258258346351;258258347185;834;2;1;1;1
258258355714;258258356361;647;2;1;1;1
258258429962;258258431417;1455;2;1;1;1
258258471183;258258471779;596;2;1;1;1
258258531162;258258531945;783;2;1;1;1
258258618096;258258618648;552;2;1;1;1
258258688320;258258688948;628;2;1;1;1
258258750682;258258751328;646;2;1;1;1
258258876008;258258876640;632;2;1;1;1
258258923514;258258925695;2181;2;1;1;1
258258968500;258258969129;629;2;1;1;1
258259008132;258259008981;849;2;1;1;1
258259008981;258259009326;345;2;1;1;1
258259009326;258259009527;201;2;1;1;1
258259010175;258259010950;775;2;1;1;1
258259040286;258259044220;3934;2;1;1;1
258259074991;258259075554;563;2;1;1;1
258259111729;258259112365;636;2;1;1;1
258259113930;258259114532;602;2;1;1;1
258259143140;258259143693;553;2;1;1;1
258259177506;258259178056;550;2;1;1;1
258259209954;258259210183;229;2;1;1;1
258259210183;258259210798;615;2;1;1;1
258259210798;258259211179;381;2;1;1;1
258259238771;258259239370;599;2;1;1;1
258259332948;258259350042;17094;2;1;1;1
258259455501;258259455993;492;2;1;1;1
258259501875;258259508078;6203;2;1;1;1
258259546319;258259547284;965;2;1;1;1
258259753365;258259753828;463;2;1;1;1
258259788311;258259788837;526;2;1;1;1
258259799818;258259801109;1291;2;1;1;1
258259892667;258259893221;554;2;1;1;1
258259937651;258259938120;469;2;1;1;1
258259997555;258259998192;637;2;1;1;1
258260041567;258260042177;610;2;1;1;1
258260077815;258260078334;519;2;1;1;1
258260122482;258260123074;592;2;1;1;1
258260161688;258260162168;480;2;1;1;1
258260201595;258260202147;552;2;1;1;1
258260236521;258260237598;1077;2;1;1;1
258260273642;258260274789;1147;2;1;1;1
258260307002;258260307644;642;2;1;1;1
258260350921;258260351455;534;2;1;1;1
258260463334;258260463887;553;2;1;1;1
258260511895;258260512536;641;2;1;1;1
258260521608;258260522723;1115;2;1;1;1
258260575778;258260576413;635;2;1;1;1
258260607111;258260607739;628;2;1;1;1
258260690436;258260691020;584;2;1;1;1
258260735807;258260736362;555;2;1;1;1
258260789687;258260791961;2274;2;1;1;1
258260822561;258260823166;605;2;1;1;1
258260861822;258260862461;639;2;1;1;1
258260892192;258260892744;552;2;1;1;1
258260959391;258260960090;699;2;1;1;1
258261000404;258261001063;659;2;1;1;1
258261074971;258261076106;1135;2;1;1;1
258261119617;258261120178;561;2;1;1;1
258261182794;258261183331;537;2;1;1;1
258261218328;258261218961;633;2;1;1;1
258261266398;258261266948;550;2;1;1;1
258261385803;258261386756;953;2;1;1;1
258261491465;258261492286;821;2;1;1;1
258261534006;258261534568;562;2;1;1;1
258261771839;258261772845;1006;2;1;1;1
258261774567;258261775534;967;2;1;1;1
258261780171;258261780920;749;2;1;1;1
258261780920;258261782850;1930;2;1;1;1
258261782850;258261784002;1152;2;1;1;1
258261784419;258261785990;1571;2;1;1;1
258261785990;258261786689;699;2;1;1;1
258261786689;258261787695;1006;2;1;1;1
258261787695;258261789449;1754;2;1;1;1
258261789449;258261789953;504;2;1;1;1
258261789953;258261790480;527;2;1;1;1
258261790480;258261791240;760;2;1;1;1
258261792523;258261793424;901;2;1;1;1
258261827317;258261827793;476;2;1;1;1
258261862986;258261863616;630;2;1;1;1
258261901097;258261901655;558;2;1;1;1
258261942152;258261942695;543;2;1;1;1
258261986774;258261987422;648;2;1;1;1
258262019942;258262020592;650;2;1;1;1
258262024770;258262025242;472;2;1;1;1
258262069516;258262070173;657;2;1;1;1
258262203428;258262204080;652;2;1;1;1
258262329862;258262330427;565;2;1;1;1
258262408662;258262409597;935;2;1;1;1
258262457416;258262457970;554;2;1;1;1
258262495503;258262496135;632;2;1;1;1
258262528656;258262529288;632;2;1;1;1
258262626152;258262626650;498;2;1;1;1
258262626650;258262626877;227;2;1;1;1
258262626877;258262627319;442;2;1;1;1
258262668631;258262669438;807;2;1;1;1
258262704831;258262705531;700;2;1;1;1
258262746285;258262746847;562;2;1;1;1
258262884033;258262885028;995;2;1;1;1
258262968152;258262968721;569;2;1;1;1
258262978335;258262978888;553;2;1;1;1
258263014983;258263015616;633;2;1;1;1
258263052571;258263053224;653;2;1;1;1
258263197417;258263198188;771;2;1;1;1
258263259040;258263260437;1397;2;1;1;1
258263260551;258263261577;1026;2;1;1;1
258263311427;258263312265;838;2;1;1;1
258263392199;258263393310;1111;2;1;1;1
258263443414;258263444245;831;2;1;1;1
258263457183;258263457838;655;2;1;1;1
258263497859;258263499075;1216;2;1;1;1
258263563185;258263563957;772;2;1;1;1
258263648625;258263649273;648;2;1;1;1
258263736769;258263738003;1234;2;1;1;1
258263739157;258263743171;4014;2;1;1;1
258263786631;258263787320;689;2;1;1;1
258263866566;258263867401;835;2;1;1;1
258263913846;258263914477;631;2;1;1;1
258263967884;258263968903;1019;2;1;1;1
258264046539;258264047177;638;2;1;1;1
258264081627;258264083151;1524;2;1;1;1
258264083874;258264084920;1046;2;1;1;1
258264086871;258264087825;954;2;1;1;1
258264113116;258264120440;7324;2;1;1;1
258264178919;258264179489;570;2;1;1;1
258264245843;258264246475;632;2;1;1;1
258264294371;258264294913;542;2;1;1;1
258264332575;258264333130;555;2;1;1;1
258264362143;258264362761;618;2;1;1;1
258264426453;258264426997;544;2;1;1;1
258264508361;258264508991;630;2;1;1;1
258264545635;258264546628;993;2;1;1;1
258264621499;258264621977;478;2;1;1;1
258264663345;258264663891;546;2;1;1;1
258264717368;258264717920;552;2;1;1;1
258264804988;258264855738;50750;2;1;1;1
258264885599;258264886145;546;2;1;1;1
258264971902;258264973502;1600;2;1;1;1
258264974030;258264974528;498;2;1;1;1
258264974528;258264974752;224;2;1;1;1
258264974752;258264975108;356;2;1;1;1
258265008090;258265008644;554;2;1;1;1
258265041199;258265041833;634;2;1;1;1
258265092655;258265094236;1581;2;1;1;1
258265094424;258265095119;695;2;1;1;1
258265095377;258265095963;586;2;1;1;1
258265137448;258265138075;627;2;1;1;1
258265169163;258265169725;562;2;1;1;1
258265241554;258265242110;556;2;1;1;1
258265276365;258265276893;528;2;1;1;1
258265353412;258265354024;612;2;1;1;1
258265411119;258265411646;527;2;1;1;1
258265447519;258265448165;646;2;1;1;1
258265524306;258265524858;552;2;1;1;1
258265559695;258265560347;652;2;1;1;1
258265642807;258265643281;474;2;1;1;1
258265689340;258265689986;646;2;1;1;1
258265720875;258265721429;554;2;1;1;1
258265847195;258265847667;472;2;1;1;1
258265881940;258265883625;1685;2;1;1;1
258265922718;258265923185;467;2;1;1;1
258265958444;258265958905;461;2;1;1;1
258265993953;258265994410;457;2;1;1;1
258266055273;258266055914;641;2;1;1;1
258266089005;258266089565;560;2;1;1;1
258266135672;258266136201;529;2;1;1;1
258266136395;258266137062;667;2;1;1;1
258266173400;258266189006;15606;2;1;1;1
258266246049;258266246595;546;2;1;1;1
258266285806;258266286478;672;2;1;1;1
258266331191;258266331723;532;2;1;1;1
258266379667;258266380131;464;2;1;1;1
258266436441;258266436984;543;2;1;1;1
258266482192;258266482808;616;2;1;1;1
258266529213;258266529751;538;2;1;1;1
258266617190;258266617651;461;2;1;1;1
258266660576;258266661069;493;2;1;1;1
258266697126;258266697688;562;2;1;1;1
258266736749;258266737336;587;2;1;1;1
258266739058;258266739937;879;2;1;1;1
258266904392;258266911293;6901;2;1;1;1
258266951789;258266952424;635;2;1;1;1
258267000479;258267001107;628;2;1;1;1
258267149405;258267150036;631;2;1;1;1
258267224194;258267224721;527;2;1;1;1
258267291602;258267292236;634;2;1;1;1
258267341528;258267342838;1310;2;1;1;1
258267383604;258267384395;791;2;1;1;1
258267428501;258267429132;631;2;1;1;1
258267505712;258267506186;474;2;1;1;1
258267570038;258267570507;469;2;1;1;1
258267629378;258267629856;478;2;1;1;1
258267680467;258267680929;462;2;1;1;1
258267756987;258267758103;1116;2;1;1;1
258267759564;258267760818;1254;2;1;1;1
258267776837;258267777474;637;2;1;1;1
258267823391;258267824004;613;2;1;1;1
258267838707;258267839353;646;2;1;1;1
258267883160;258267883665;505;2;1;1;1
258267883665;258267883721;56;2;1;1;1
258267883721;258267884444;723;2;1;1;1
258267959368;258267959940;572;2;1;1;1
258268058091;258268059280;1189;2;1;1;1
258268137037;258268137869;832;2;1;1;1
258268184251;258268184888;637;2;1;1;1
258268260662;258268261226;564;2;1;1;1
258268304824;258268305386;562;2;1;1;1
258268370620;258268371176;556;2;1;1;1
258268455735;258268456190;455;2;1;1;1
258268576842;258268577392;550;2;1;1;1
258268658624;258268660172;1548;2;1;1;1
258268707015;258268707649;634;2;1;1;1
258268773721;258268774282;561;2;1;1;1
258268819958;258268820520;562;2;1;1;1
258268870089;258268870776;687;2;1;1;1
258268974579;258268975207;628;2;1;1;1
258269118056;258269119123;1067;2;1;1;1
258269161961;258269162611;650;2;1;1;1
258269166075;258269166844;769;2;1;1;1
258269239783;258269243350;3567;2;1;1;1
258269246936;258269248172;1236;2;1;1;1
258269249863;258269251600;1737;2;1;1;1
258269259062;258269259109;47;2;1;1;1
258269259109;258269262066;2957;2;1;1;1
258269262066;258269263092;1026;2;1;1;1
258269263092;258269264146;1054;2;1;1;1
258269264146;258269264830;684;2;1;1;1
258269264830;258269265436;606;2;1;1;1
258269265436;258269266578;1142;2;1;1;1
258269268396;258269270577;2181;2;1;1;1
258269270577;258269271346;769;2;1;1;1
258269271346;258269272586;1240;2;1;1;1
258269272586;258269273218;632;2;1;1;1
258269273218;258269278309;5091;2;1;1;1
258269279147;258269282568;3421;2;1;1;1
258269283297;258269286146;2849;2;1;1;1
258269286146;258269286307;161;2;1;1;1
258269286307;258269289466;3159;2;1;1;1
258269296728;258269302860;6132;2;1;1;1
258269304276;258269322571;18295;2;1;1;1
258269485804;258269486437;633;2;1;1;1
258269488174;258269488776;602;2;1;1;1
258269593193;258269593755;562;2;1;1;1
258269667930;258269669458;1528;2;1;1;1
258269672312;258269673986;1674;2;1;1;1
258269674427;258269675379;952;2;1;1;1
258269680070;258269682949;2879;2;1;1;1
258269686831;258269687440;609;2;1;1;1
258269687440;258269687643;203;2;1;1;1
258269687643;258269688665;1022;2;1;1;1
258269688665;258269690067;1402;2;1;1;1
258269690067;258269691085;1018;2;1;1;1
258269697775;258269698916;1141;2;1;1;1
258269699747;258269700497;750;2;1;1;1
258269704709;258269745431;40722;2;1;1;1
258269745431;258269745951;520;2;1;1;1
258269745951;258269753865;7914;2;1;1;1
258269784852;258269785402;550;2;1;1;1
258269804182;258269804813;631;2;1;1;1
258269861665;258269862365;700;2;1;1;1
258269862841;258269863485;644;2;1;1;1
258269866982;258269867614;632;2;1;1;1
258269868194;258269868825;631;2;1;1;1
258269877188;258269882924;5736;2;1;1;1
258269962051;258269962941;890;2;1;1;1
258269963647;258269964819;1172;2;1;1;1
258269996952;258269997509;557;2;1;1;1
258270060089;258270061187;1098;2;1;1;1
258270064257;258270065161;904;2;1;1;1
258270065161;258270065951;790;2;1;1;1
258270065951;258270066204;253;2;1;1;1
258270069522;258270070676;1154;2;1;1;1
258270073697;258270078189;4492;2;1;1;1
258270078189;258270079177;988;2;1;1;1
258270079177;258270082166;2989;2;1;1;1
258270083480;258270085317;1837;2;1;1;1
258270086695;258270088827;2132;2;1;1;1
258270088827;258270090086;1259;2;1;1;1
258270090086;258270090191;105;2;1;1;1
258270090191;258270092097;1906;2;1;1;1
258270092097;258270096241;4144;2;1;1;1
258270096241;258270096538;297;2;1;1;1
258270096538;258270098012;1474;2;1;1;1
258270098012;258270098518;506;2;1;1;1
258270098518;258270099127;609;2;1;1;1
258270099127;258270100860;1733;2;1;1;1
258270100860;258270101291;431;2;1;1;1
258270104905;258270105983;1078;2;1;1;1
258270106326;258270107824;1498;2;1;1;1
258270108394;258270110176;1782;2;1;1;1
258270157237;258270157792;555;2;1;1;1
258270187775;258270188293;518;2;1;1;1
258270234051;258270234609;558;2;1;1;1
258270235742;258270236375;633;2;1;1;1
258270255785;258270256315;530;2;1;1;1
258270306786;258270308264;1478;2;1;1;1
258270309334;258270309816;482;2;1;1;1
258270311124;258270311699;575;2;1;1;1
258270535851;258270536476;625;2;1;1;1
258270669554;258270670190;636;2;1;1;1
258270706526;258270706911;385;2;1;1;1
258270706911;258270707044;133;2;1;1;1
258270707044;258270707801;757;2;1;1;1
258270795445;258270796103;658;2;1;1;1
258270803857;258270804911;1054;2;1;1;1
258270897842;258270898394;552;2;1;1;1
258270899666;258270900203;537;2;1;1;1
258270935228;258270935858;630;2;1;1;1
258270981743;258270982579;836;2;1;1;1
258271025807;258271026278;471;2;1;1;1
258271076950;258271077503;553;2;1;1;1
258271117260;258271117749;489;2;1;1;1
258271163424;258271163891;467;2;1;1;1
258271231892;258271232550;658;2;1;1;1
258271304738;258271305514;776;2;1;1;1
258271345342;258271345900;558;2;1;1;1
258271395685;258271396306;621;2;1;1;1
258271443104;258271443733;629;2;1;1;1
258271508828;258271509444;616;2;1;1;1
258271564087;258271564711;624;2;1;1;1
258271576173;258271576735;562;2;1;1;1
258271621832;258271622371;539;2;1;1;1
258271674253;258271675084;831;2;1;1;1
258271751837;258271753365;1528;2;1;1;1
258271828940;258271829476;536;2;1;1;1
258271863647;258271864182;535;2;1;1;1
258271921659;258271922151;492;2;1;1;1
258271999888;258272000423;535;2;1;1;1
258272084724;258272085267;543;2;1;1;1
258272122563;258272123103;540;2;1;1;1
258272168718;258272169371;653;2;1;1;1
258272217061;258272217686;625;2;1;1;1
258272625345;258272626212;867;2;1;1;1
258272744765;258272746957;2192;2;1;1;1
258272748498;258272750013;1515;2;1;1;1
258272754693;258272756103;1410;2;1;1;1
258272757227;258272758727;1500;2;1;1;1
258272759473;258272760521;1048;2;1;1;1
258272763730;258272764357;627;2;1;1;1
258272802565;258272803120;555;2;1;1;1
258272839934;258272840484;550;2;1;1;1
258272921689;258272922375;686;2;1;1;1
258272923472;258272923958;486;2;1;1;1
258272950109;258272950782;673;2;1;1;1
258272988006;258272988631;625;2;1;1;1
258273011897;258273012338;441;2;1;1;1
258273012338;258273012455;117;2;1;1;1
258273012455;258273012863;408;2;1;1;1
258273069187;258273069725;538;2;1;1;1
258273114608;258273115213;605;2;1;1;1
258273180863;258273181411;548;2;1;1;1
258273184756;258273185347;591;2;1;1;1
258273228121;258273228764;643;2;1;1;1
258273275057;258273275869;812;2;1;1;1
258273342127;258273342663;536;2;1;1;1
258273379171;258273379806;635;2;1;1;1
258273419851;258273420413;562;2;1;1;1
258273653452;258273654231;779;2;1;1;1
258273700158;258273701307;1149;2;1;1;1
258273730225;258273731137;912;2;1;1;1
258273766430;258273766984;554;2;1;1;1
258273776627;258273777110;483;2;1;1;1
258273823534;258273824248;714;2;1;1;1
258273862031;258273862967;936;2;1;1;1
258273889501;258273890427;926;2;1;1;1
258273942262;258273942867;605;2;1;1;1
258273962123;258273962687;564;2;1;1;1
258274002485;258274002642;157;2;1;1;1
258274002642;258274003295;653;2;1;1;1
258274003295;258274003394;99;2;1;1;1
258274054534;258274055302;768;2;1;1;1
258274055910;258274056439;529;2;1;1;1
258274127822;258274128437;615;2;1;1;1
258274161940;258274162735;795;2;1;1;1
258274195940;258274196438;498;2;1;1;1
258274266306;258274267018;712;2;1;1;1
258274267018;258274267513;495;2;1;1;1
258274267513;258274268225;712;2;1;1;1
258274294210;258274294699;489;2;1;1;1
258274334687;258274335318;631;2;1;1;1
258274363358;258274363975;617;2;1;1;1
258274483272;258274483900;628;2;1;1;1
258274551459;258274552016;557;2;1;1;1
258274553671;258274555211;1540;2;1;1;1
258274600542;258274601010;468;2;1;1;1
258274640217;258274640851;634;2;1;1;1
258274640908;258274641701;793;2;1;1;1
258274684713;258274685278;565;2;1;1;1
258274733965;258274734566;601;2;1;1;1
258274797365;258274798005;640;2;1;1;1
258274835446;258274836074;628;2;1;1;1
258274880062;258274880627;565;2;1;1;1
258274965434;258274966062;628;2;1;1;1
258275017354;258275017873;519;2;1;1;1
258275017902;258275018600;698;2;1;1;1
258275049404;258275050307;903;2;1;1;1
258275094216;258275094765;549;2;1;1;1
258275137621;258275138224;603;2;1;1;1
258275221237;258275221779;542;2;1;1;1
258275280115;258275280580;465;2;1;1;1
258275347256;258275347873;617;2;1;1;1
258275399615;258275400106;491;2;1;1;1
258275444128;258275444680;552;2;1;1;1
258275444986;258275445629;643;2;1;1;1
258275543271;258275544021;750;2;1;1;1
258275585905;258275586216;311;2;1;1;1
258275586216;258275586432;216;2;1;1;1
258275586432;258275587020;588;2;1;1;1
258275627936;258275628486;550;2;1;1;1
258275672548;258275673017;469;2;1;1;1
258275740522;258275741047;525;2;1;1;1
258275777801;258275778428;627;2;1;1;1
258275779900;258275780367;467;2;1;1;1
258275821437;258275822056;619;2;1;1;1
258275859329;258275859902;573;2;1;1;1
258275902812;258275903275;463;2;1;1;1
258275951171;258275951723;552;2;1;1;1
258275996682;258275997311;629;2;1;1;1
258276070558;258276071218;660;2;1;1;1
258276117798;258276118427;629;2;1;1;1
258276118427;258276118553;126;2;1;1;1
258276118553;258276118774;221;2;1;1;1
258276118774;258276119133;359;2;1;1;1
258276119133;258276120070;937;2;1;1;1
258276151610;258276152080;470;2;1;1;1
258276212665;258276213273;608;2;1;1;1
258276252471;258276253020;549;2;1;1;1
258276294011;258276295240;1229;2;1;1;1
258276371004;258276371559;555;2;1;1;1
258276371781;258276372381;600;2;1;1;1
258276405418;258276406152;734;2;1;1;1
258276485685;258276486773;1088;2;1;1;1
258276529146;258276529636;490;2;1;1;1
258276568163;258276568725;562;2;1;1;1
258276643520;258276644083;563;2;1;1;1
258276691256;258276691741;485;2;1;1;1
258276747746;258276748359;613;2;1;1;1
258276824155;258276824790;635;2;1;1;1
258276890930;258276891507;577;2;1;1;1
258276940728;258276941214;486;2;1;1;1
258276982491;258276983014;523;2;1;1;1
258277017938;258277018430;492;2;1;1;1
258277054417;258277055016;599;2;1;1;1
258277055530;258277056081;551;2;1;1;1
258277094338;258277097586;3248;2;1;1;1
258277132801;258277133771;970;2;1;1;1
258277169038;258277169311;273;2;1;1;1
258277169311;258277169802;491;2;1;1;1
258277169802;258277170635;833;2;1;1;1
258277244016;258277244487;471;2;1;1;1
258277389753;258277390278;525;2;1;1;1
258277567241;258277568090;849;2;1;1;1
258277568090;258277568529;439;2;1;1;1
258277568529;258277570257;1728;2;1;1;1
258277621573;258277622107;534;2;1;1;1
258277732596;258277733085;489;2;1;1;1
258277777346;258277777872;526;2;1;1;1
258277814961;258277815458;497;2;1;1;1
258277888415;258277889844;1429;2;1;1;1
258277929276;258277929902;626;2;1;1;1
258277971685;258277972299;614;2;1;1;1
258278004940;258278005812;872;2;1;1;1
258278006283;258278006989;706;2;1;1;1
258278059214;258278059999;785;2;1;1;1
258278131193;258278131869;676;2;1;1;1
258278191755;258278192934;1179;2;1;1;1
258278194440;258278195045;605;2;1;1;1
258278269657;258278270476;819;2;1;1;1
258278325609;258278326065;456;2;1;1;1
258278376758;258278377554;796;2;1;1;1
258278419805;258278420451;646;2;1;1;1
258278464502;258278464987;485;2;1;1;1
258278503394;258278504018;624;2;1;1;1
258278514901;258278521743;6842;2;1;1;1
258278579350;258278579924;574;2;1;1;1
258278612448;258278613014;566;2;1;1;1
258278664931;258278665549;618;2;1;1;1
258278665899;258278666576;677;2;1;1;1
258278704158;258278704716;558;2;1;1;1
258278752658;258278753260;602;2;1;1;1
258278808999;258278809561;562;2;1;1;1
258278860819;258278861756;937;2;1;1;1
258278868287;258278872780;4493;2;1;1;1
258278911289;258278912483;1194;2;1;1;1
258279005965;258279006596;631;2;1;1;1
258279047976;258279048582;606;2;1;1;1
258279085879;258279086877;998;2;1;1;1
258279087057;258279087611;554;2;1;1;1
258279089193;258279089809;616;2;1;1;1
258279125863;258279126474;611;2;1;1;1
258279151937;258279152486;549;2;1;1;1
258279192220;258279193010;790;2;1;1;1
258279193010;258279193491;481;2;1;1;1
258279193491;258279194303;812;2;1;1;1
258279195406;258279196085;679;2;1;1;1
258279219832;258279220473;641;2;1;1;1
258279308844;258279309478;634;2;1;1;1
258279372510;258279373064;554;2;1;1;1
258279418690;258279419492;802;2;1;1;1
258279420995;258279421490;495;2;1;1;1
258279488821;258279489351;530;2;1;1;1
258279542386;258279543314;928;2;1;1;1
258279543661;258279545379;1718;2;1;1;1
258279612521;258279613150;629;2;1;1;1
258279645983;258279646612;629;2;1;1;1
258279681750;258279682304;554;2;1;1;1
258279714953;258279715255;302;2;1;1;1
258279715255;258279715781;526;2;1;1;1
258279715781;258279717313;1532;2;1;1;1
258279743404;258279745163;1759;2;1;1;1
258279779342;258279779941;599;2;1;1;1
258279809318;258279809950;632;2;1;1;1
258279851536;258279851706;170;2;1;1;1
258279851706;258279852466;760;2;1;1;1
258279852466;258279853209;743;2;1;1;1
258279853976;258279854523;547;2;1;1;1
258279891271;258279891933;662;2;1;1;1
258279891933;258279892118;185;2;1;1;1
258279892118;258279892657;539;2;1;1;1
258279933769;258279934397;628;2;1;1;1
258280002875;258280003091;216;2;1;1;1
258280003091;258280003308;217;2;1;1;1
258280003308;258280003760;452;2;1;1;1
258280003760;258280003886;126;2;1;1;1
258280003886;258280004545;659;2;1;1;1
258280024287;258280024840;553;2;1;1;1
258280089189;258280089741;552;2;1;1;1
258280123910;258280124534;624;2;1;1;1
258280194580;258280195115;535;2;1;1;1
258280239294;258280240337;1043;2;1;1;1
258280280500;258280281053;553;2;1;1;1
258280363944;258280364475;531;2;1;1;1
258280395682;258280396313;631;2;1;1;1
258280438449;258280438994;545;2;1;1;1
258280511337;258280511823;486;2;1;1;1
258280561189;258280561732;543;2;1;1;1
258280600493;258280601962;1469;2;1;1;1
258280602560;258280603111;551;2;1;1;1
258280603153;258280603804;651;2;1;1;1
258280634179;258280634734;555;2;1;1;1
258280709892;258280710447;555;2;1;1;1
258280750635;258280750790;155;2;1;1;1
258280750790;258280751677;887;2;1;1;1
258280751677;258280751700;23;2;1;1;1
258280786987;258280787454;467;2;1;1;1
258280920795;258280921352;557;2;1;1;1
258280961026;258280961555;529;2;1;1;1
258281009735;258281010211;476;2;1;1;1
258281133226;258281133759;533;2;1;1;1
258281208242;258281208768;526;2;1;1;1
258281303322;258281304997;1675;2;1;1;1
258281305499;258281308172;2673;2;1;1;1
258281564854;258281565455;601;2;1;1;1
258281594569;258281595482;913;2;1;1;1
258281665859;258281666320;461;2;1;1;1
258281674492;258281675700;1208;2;1;1;1
258281723001;258281723475;474;2;1;1;1
258281761599;258281762464;865;2;1;1;1
258281834946;258281835471;525;2;1;1;1
258281898793;258281900202;1409;2;1;1;1
258281984192;258281985089;897;2;1;1;1
258282089765;258282091056;1291;2;1;1;1
258282145753;258282146380;627;2;1;1;1
258282266375;258282267107;732;2;1;1;1
258282323082;258282323956;874;2;1;1;1
258282358279;258282359058;779;2;1;1;1
258282403658;258282405571;1913;2;1;1;1
258282456832;258282457433;601;2;1;1;1
258282507779;258282508332;553;2;1;1;1
258282530741;258282532107;1366;2;1;1;1
258282542143;258282542905;762;2;1;1;1
258282581714;258282582265;551;2;1;1;1
258282618822;258282619381;559;2;1;1;1
258282669215;258282669955;740;2;1;1;1
258282737632;258282738275;643;2;1;1;1
258282784136;258282784816;680;2;1;1;1
258282820531;258282821147;616;2;1;1;1
258282852933;258282853482;549;2;1;1;1
258282898069;258282898694;625;2;1;1;1
258282946379;258282946927;548;2;1;1;1
258282986106;258282986676;570;2;1;1;1
258282987262;258282987889;627;2;1;1;1
258283036571;258283037145;574;2;1;1;1
258283077206;258283077746;540;2;1;1;1
258283127170;258283127774;604;2;1;1;1
258283173988;258283174593;605;2;1;1;1
258283252777;258283253407;630;2;1;1;1
258283325861;258283326534;673;2;1;1;1
258283370697;258283371264;567;2;1;1;1
258283418577;258283419099;522;2;1;1;1
258283465993;258283466526;533;2;1;1;1
258283508853;258283509401;548;2;1;1;1
258283554407;258283555041;634;2;1;1;1
258283681137;258283681777;640;2;1;1;1
258283727634;258283728267;633;2;1;1;1
258283820873;258283821526;653;2;1;1;1
258283821526;258283822403;877;2;1;1;1
258283822403;258283822439;36;2;1;1;1
258283822439;258283822543;104;2;1;1;1
258283822543;258283822884;341;2;1;1;1
258283823524;258283824208;684;2;1;1;1
258283922393;258283922881;488;2;1;1;1
258283966606;258283967158;552;2;1;1;1
258283968120;258283968671;551;2;1;1;1
258283970556;258283971187;631;2;1;1;1
258284009469;258284010569;1100;2;1;1;1
258284012630;258284013429;799;2;1;1;1
258284047618;258284049008;1390;2;1;1;1
258284050501;258284051058;557;2;1;1;1
258284087413;258284087966;553;2;1;1;1
258284168082;258284168712;630;2;1;1;1
258284198077;258284198707;630;2;1;1;1
258284238317;258284238870;553;2;1;1;1
258284281394;258284282023;629;2;1;1;1
258284335537;258284336345;808;2;1;1;1
258284364954;258284365578;624;2;1;1;1
258284367604;258284368721;1117;2;1;1;1
258284414105;258284414572;467;2;1;1;1
258284451252;258284451805;553;2;1;1;1
258284455864;258284456522;658;2;1;1;1
258284497821;258284498282;461;2;1;1;1
258284531691;258284532312;621;2;1;1;1
258284620440;258284621083;643;2;1;1;1
258284665282;258284665931;649;2;1;1;1
258284721822;258284722367;545;2;1;1;1
258284769290;258284770726;1436;2;1;1;1
258284823186;258284823647;461;2;1;1;1
258284868401;258284869022;621;2;1;1;1
258284939448;258284939668;220;2;1;1;1
258284939668;258284940254;586;2;1;1;1
258284940254;258284940669;415;2;1;1;1
258285066850;258285067479;629;2;1;1;1
258285113626;258285114258;632;2;1;1;1
258285158802;258285174498;15696;2;1;1;1
258285208205;258285208674;469;2;1;1;1
258285277087;258285278091;1004;2;1;1;1
258285320050;258285320534;484;2;1;1;1
258285361198;258285361716;518;2;1;1;1
258285427401;258285427877;476;2;1;1;1
258285540823;258285541357;534;2;1;1;1
258285646521;258285647022;501;2;1;1;1
258285687319;258285687501;182;2;1;1;1
258285687501;258285687922;421;2;1;1;1
258285687922;258285688914;992;2;1;1;1
258285842477;258285843118;641;2;1;1;1
258286094539;258286095029;490;2;1;1;1
258286303181;258286303822;641;2;1;1;1
258286350282;258286350817;535;2;1;1;1
258286383841;258286384490;649;2;1;1;1
258286384490;258286384547;57;2;1;1;1
258286384547;258286385490;943;2;1;1;1
258286460980;258286461611;631;2;1;1;1
258286551071;258286552122;1051;2;1;1;1
258286584837;258286585302;465;2;1;1;1
258286633112;258286633638;526;2;1;1;1
258286678057;258286679676;1619;2;1;1;1
258286792185;258286792864;679;2;1;1;1
258286861778;258286862691;913;2;1;1;1
258286863850;258286864408;558;2;1;1;1
258286881703;258286882724;1021;2;1;1;1
258286929610;258286930281;671;2;1;1;1
258286976864;258286977483;619;2;1;1;1
258287050427;258287050984;557;2;1;1;1
258287063923;258287064552;629;2;1;1;1
258287101390;258287102027;637;2;1;1;1
258287153168;258287154377;1209;2;1;1;1
258287200754;258287201407;653;2;1;1;1
258287241971;258287242524;553;2;1;1;1
258287294748;258287295378;630;2;1;1;1
258287402905;258287404070;1165;2;1;1;1
258287433261;258287433874;613;2;1;1;1
258287492801;258287493433;632;2;1;1;1
258287529372;258287529980;608;2;1;1;1
258287566381;258287566899;518;2;1;1;1
258287597944;258287598496;552;2;1;1;1
258287646441;258287647073;632;2;1;1;1
258287690986;258287691553;567;2;1;1;1
258287745215;258287745840;625;2;1;1;1
258287756269;258287756948;679;2;1;1;1
258287865913;258287866461;548;2;1;1;1
258287909915;258287910542;627;2;1;1;1
258287957650;258287957957;307;2;1;1;1
258287957957;258287958357;400;2;1;1;1
258287958357;258287958725;368;2;1;1;1
258288047999;258288049147;1148;2;1;1;1
258288165651;258288166354;703;2;1;1;1
258288241893;258288242520;627;2;1;1;1
258288257829;258288258499;670;2;1;1;1
258288307352;258288308787;1435;2;1;1;1
258288339752;258288340319;567;2;1;1;1
258288410353;258288410987;634;2;1;1;1
258288453848;258288454398;550;2;1;1;1
258288503625;258288504832;1207;2;1;1;1
258288582519;258288583994;1475;2;1;1;1
258288619290;258288619774;484;2;1;1;1
258288657001;258288657642;641;2;1;1;1
258288733140;258288733729;589;2;1;1;1
258288777335;258288777949;614;2;1;1;1
258288777949;258288778643;694;2;1;1;1
258288778643;258288778989;346;2;1;1;1
258288865154;258288865700;546;2;1;1;1
258288910058;258288910539;481;2;1;1;1
258288912651;258288913279;628;2;1;1;1
258288951322;258288951956;634;2;1;1;1
258289211306;258289211856;550;2;1;1;1
258289270399;258289270969;570;2;1;1;1
258289311445;258289312063;618;2;1;1;1
258289313320;258289313877;557;2;1;1;1
258289357747;258289358443;696;2;1;1;1
258289381088;258289381727;639;2;1;1;1
258289456863;258289457500;637;2;1;1;1
258289458252;258289459907;1655;2;1;1;1
258289459907;258289460446;539;2;1;1;1
258289460446;258289465095;4649;2;1;1;1
258289497952;258289498565;613;2;1;1;1
258289539891;258289540941;1050;2;1;1;1
258289615739;258289616376;637;2;1;1;1
258289617525;258289618022;497;2;1;1;1
258289655545;258289656130;585;2;1;1;1
258289656939;258289657573;634;2;1;1;1
258289733363;258289733925;562;2;1;1;1
258289787207;258289787813;606;2;1;1;1
258289826881;258289827358;477;2;1;1;1
258289925229;258289930669;5440;2;1;1;1
258289984077;258289984626;549;2;1;1;1
258290066181;258290066786;605;2;1;1;1
258290084564;258290085177;613;2;1;1;1
258290294403;258290295907;1504;2;1;1;1
258290305753;258290306376;623;2;1;1;1
258290343199;258290344033;834;2;1;1;1
258290353303;258290353935;632;2;1;1;1
258290391972;258290392598;626;2;1;1;1
258290434569;258290435488;919;2;1;1;1
258290569683;258290570165;482;2;1;1;1
258290646306;258290646836;530;2;1;1;1
258290693070;258290694296;1226;2;1;1;1
258290727007;258290727872;865;2;1;1;1
258290825049;258290830597;5548;2;1;1;1
258290867732;258290868415;683;2;1;1;1
258290997102;258290997728;626;2;1;1;1
258291080561;258291082026;1465;2;1;1;1
258291090478;258291091040;562;2;1;1;1
258291138095;258291138893;798;2;1;1;1
258291193661;258291194218;557;2;1;1;1
258291237535;258291238162;627;2;1;1;1
258291304890;258291305632;742;2;1;1;1
258291360193;258291361017;824;2;1;1;1
258291434450;258291435061;611;2;1;1;1
258291471883;258291472575;692;2;1;1;1
258291501612;258291502164;552;2;1;1;1
258291540027;258291540599;572;2;1;1;1
258291582561;258291583131;570;2;1;1;1
258291583622;258291584252;630;2;1;1;1
258291656245;258291657123;878;2;1;1;1
258291685692;258291686571;879;2;1;1;1
258291696253;258291696896;643;2;1;1;1
258291755759;258291756314;555;2;1;1;1
258291797383;258291798205;822;2;1;1;1
258291838332;258291839343;1011;2;1;1;1
258291877619;258291878169;550;2;1;1;1
258291897557;258291898172;615;2;1;1;1
258291951816;258291952364;548;2;1;1;1
258291994121;258291994748;627;2;1;1;1
258292030983;258292031755;772;2;1;1;1
258292066830;258292067450;620;2;1;1;1
258292107185;258292107736;551;2;1;1;1
258292149735;258292150289;554;2;1;1;1
258292216527;258292217049;522;2;1;1;1
258292258074;258292258564;490;2;1;1;1
258292395335;258292399321;3986;2;1;1;1
258292464553;258292465202;649;2;1;1;1
258292506071;258292506708;637;2;1;1;1
258292591030;258292591583;553;2;1;1;1
258292632228;258292632869;641;2;1;1;1
258292675401;258292676008;607;2;1;1;1
258292747486;258292748298;812;2;1;1;1
258292750703;258292751289;586;2;1;1;1
258292751936;258292752584;648;2;1;1;1
258292785633;258292786172;539;2;1;1;1
258292825464;258292826880;1416;2;1;1;1
258292865173;258292865777;604;2;1;1;1
258292883210;258292883736;526;2;1;1;1
258292950496;258292951123;627;2;1;1;1
258292991082;258292991544;462;2;1;1;1
258293036585;258293037192;607;2;1;1;1
258293072434;258293072989;555;2;1;1;1
258293122646;258293123138;492;2;1;1;1
258293163001;258293169774;6773;2;1;1;1
258293202934;258293204176;1242;2;1;1;1
258293239229;258293240380;1151;2;1;1;1
258293276422;258293277065;643;2;1;1;1
258293315258;258293315886;628;2;1;1;1
258293390017;258293391077;1060;2;1;1;1
258293435357;258293435911;554;2;1;1;1
258293474160;258293474766;606;2;1;1;1
258293529266;258293531683;2417;2;1;1;1
258293576199;258293576878;679;2;1;1;1
258293676804;258293678151;1347;2;1;1;1
258293711102;258293713714;2612;2;1;1;1
258293753467;258293754592;1125;2;1;1;1
258293764528;258293765158;630;2;1;1;1
258293816101;258293816734;633;2;1;1;1
258293851146;258293851772;626;2;1;1;1
258293909110;258293909514;404;2;1;1;1
258293909514;258293909642;128;2;1;1;1
258293909642;258293910347;705;2;1;1;1
258293966523;258293968483;1960;2;1;1;1
258293971690;258293972153;463;2;1;1;1
258294031031;258294031607;576;2;1;1;1
258294035269;258294035877;608;2;1;1;1
258294064010;258294064476;466;2;1;1;1
258294147930;258294148459;529;2;1;1;1
258294186625;258294187188;563;2;1;1;1
258294229627;258294230132;505;2;1;1;1
258294261256;258294262072;816;2;1;1;1
258294263057;258294263603;546;2;1;1;1
258294344069;258294344626;557;2;1;1;1
258294355385;258294355915;530;2;1;1;1
258294415616;258294417132;1516;2;1;1;1
258294573895;258294575506;1611;2;1;1;1
258294583264;258294585312;2048;2;1;1;1
258294585312;258294585873;561;2;1;1;1
258294585873;258294586312;439;2;1;1;1
258294625830;258294626355;525;2;1;1;1
258294665044;258294665692;648;2;1;1;1
258294737626;258294738509;883;2;1;1;1
258294811697;258294812166;469;2;1;1;1
258294879266;258294879749;483;2;1;1;1
258294961051;258294961449;398;2;1;1;1
258294961449;258294962003;554;2;1;1;1
258294962003;258294963099;1096;2;1;1;1
258294993959;258294994506;547;2;1;1;1
258295030545;258295031237;692;2;1;1;1
258295075629;258295077659;2030;2;1;1;1
258295166958;258295167562;604;2;1;1;1
258295175421;258295176974;1553;2;1;1;1
258295226032;258295226550;518;2;1;1;1
258295274502;258295275025;523;2;1;1;1
258295378960;258295379886;926;2;1;1;1
258295417408;258295418121;713;2;1;1;1
258295499154;258295500653;1499;2;1;1;1
258295613747;258295614474;727;2;1;1;1
258295637268;258295637828;560;2;1;1;1
258295677289;258295678537;1248;2;1;1;1
258295816029;258295816162;133;2;1;1;1
258295816162;258295816642;480;2;1;1;1
258295816642;258295816844;202;2;1;1;1
258295817638;258295818334;696;2;1;1;1
258295858393;258295858954;561;2;1;1;1
258295892389;258295893032;643;2;1;1;1
258295929131;258295929987;856;2;1;1;1
258295974354;258295975317;963;2;1;1;1
258296004382;258296005010;628;2;1;1;1
258296023425;258296024077;652;2;1;1;1
258296071890;258296072523;633;2;1;1;1
258296110729;258296111296;567;2;1;1;1
258296159403;258296159956;553;2;1;1;1
258296206980;258296207661;681;2;1;1;1
258296252107;258296252713;606;2;1;1;1
258296343661;258296344626;965;2;1;1;1
258296374019;258296374641;622;2;1;1;1
258296412628;258296413462;834;2;1;1;1
258296415386;258296416894;1508;2;1;1;1
258296456138;258296456691;553;2;1;1;1
258296507025;258296507554;529;2;1;1;1
258296571035;258296571673;638;2;1;1;1
258296636888;258296637594;706;2;1;1;1
258296687965;258296688519;554;2;1;1;1
258296732651;258296733199;548;2;1;1;1
258296799861;258296800501;640;2;1;1;1
258296876107;258296876728;621;2;1;1;1
258296954077;258296954715;638;2;1;1;1
258296996317;258296996879;562;2;1;1;1
258297043303;258297043993;690;2;1;1;1
258297146974;258297147627;653;2;1;1;1
258297197099;258297198279;1180;2;1;1;1
258297213077;258297213792;715;2;1;1;1
258297277421;258297278326;905;2;1;1;1
258297325201;258297325713;512;2;1;1;1
258297325713;258297325889;176;2;1;1;1
258297325889;258297326299;410;2;1;1;1
258297428462;258297429363;901;2;1;1;1
258297486722;258297487899;1177;2;1;1;1
258297560435;258297560966;531;2;1;1;1
258297571318;258297571799;481;2;1;1;1
258297726274;258297726805;531;2;1;1;1
258297727206;258297728049;843;2;1;1;1
258297770585;258297771149;564;2;1;1;1
258297823842;258297824477;635;2;1;1;1
258297877062;258297877604;542;2;1;1;1
258297975645;258297976115;470;2;1;1;1
258298017221;258298017856;635;2;1;1;1
258298053939;258298054545;606;2;1;1;1
258298115744;258298116357;613;2;1;1;1
258298160932;258298161430;498;2;1;1;1
258298215167;258298215797;630;2;1;1;1
258298258899;258298259539;640;2;1;1;1
258298300869;258298301427;558;2;1;1;1
258298340977;258298341501;524;2;1;1;1
258298390121;258298390749;628;2;1;1;1
258298435826;258298436287;461;2;1;1;1
258298478994;258298479552;558;2;1;1;1
258298522327;258298524219;1892;2;1;1;1
258298573240;258298573763;523;2;1;1;1
258298701885;258298702380;495;2;1;1;1
258298714377;258298714895;518;2;1;1;1
258298751451;258298752267;816;2;1;1;1
258298829845;258298841855;12010;2;1;1;1
258298856012;258298856627;615;2;1;1;1
258298857485;258298858054;569;2;1;1;1
258298889160;258298890166;1006;2;1;1;1
258298930352;258298931343;991;2;1;1;1
258298996580;258298997085;505;2;1;1;1
258299037396;258299037940;544;2;1;1;1
258299084408;258299086910;2502;2;1;1;1
258299109945;258299112212;2267;2;1;1;1
258299145888;258299146379;491;2;1;1;1
258299188180;258299188647;467;2;1;1;1
258299220816;258299221309;493;2;1;1;1
258299222142;258299222770;628;2;1;1;1
258299271028;258299272012;984;2;1;1;1
258299309481;258299310143;662;2;1;1;1
258299340869;258299345082;4213;2;1;1;1
258299379718;258299388133;8415;2;1;1;1
258299479951;258299481713;1762;2;1;1;1
258299490683;258299492888;2205;2;1;1;1
258299527595;258299528223;628;2;1;1;1
258299566855;258299567750;895;2;1;1;1
258299606096;258299606639;543;2;1;1;1
258299666087;258299667230;1143;2;1;1;1
258299729242;258299729827;585;2;1;1;1
258299765290;258299765945;655;2;1;1;1
258299766430;258299767102;672;2;1;1;1
258299808500;258299809069;569;2;1;1;1
258299855765;258299856232;467;2;1;1;1
258299897763;258299898270;507;2;1;1;1
258299945678;258299946312;634;2;1;1;1
258300052734;258300053221;487;2;1;1;1
258300145204;258300145702;498;2;1;1;1
258300156869;258300158291;1422;2;1;1;1
258300203703;258300204356;653;2;1;1;1
258300204488;258300205305;817;2;1;1;1
258300287614;258300288165;551;2;1;1;1
258300318226;258300318514;288;2;1;1;1
258300318514;258300318911;397;2;1;1;1
258300318911;258300319721;810;2;1;1;1
258300396005;258300396556;551;2;1;1;1
258300466963;258300467493;530;2;1;1;1
258300479237;258300480086;849;2;1;1;1
258300481603;258300482308;705;2;1;1;1
258300540716;258300541276;560;2;1;1;1
258300588822;258300589450;628;2;1;1;1
258300629778;258300630630;852;2;1;1;1
258300643421;258300644051;630;2;1;1;1
258300990556;258300991199;643;2;1;1;1
258301063302;258301063795;493;2;1;1;1
258301136315;258301136923;608;2;1;1;1
258301230439;258301231098;659;2;1;1;1
258301263209;258301263682;473;2;1;1;1
258301305668;258301306312;644;2;1;1;1
258301306681;258301307330;649;2;1;1;1
258301477461;258301478071;610;2;1;1;1
258301539905;258301540442;537;2;1;1;1
258301610857;258301611493;636;2;1;1;1
258301655448;258301656420;972;2;1;1;1
258301656999;258301720570;63571;2;1;1;1
258301720570;258301721103;533;2;1;1;1
258301721103;258301742286;21183;2;1;1;1
258301742286;258301742846;560;2;1;1;1
258301742846;258301860095;117249;2;1;1;1
258301860095;258301860721;626;2;1;1;1
258301860721;258301906648;45927;2;1;1;1
258301906648;258301907212;564;2;1;1;1
258301907212;258301979422;72210;2;1;1;1
258301979422;258301980069;647;2;1;1;1
258301980069;258301995931;15862;2;1;1;1
258301995931;258301996567;636;2;1;1;1
258301996567;258302038311;41744;2;1;1;1
258302038311;258302038941;630;2;1;1;1
258302038941;258302042580;3639;2;1;1;1
258302042580;258302043135;555;2;1;1;1
258302043135;258302084647;41512;2;1;1;1
258302084647;258302085262;615;2;1;1;1
258302085262;258302116668;31406;2;1;1;1
258302116668;258302117142;474;2;1;1;1
258302117142;258302153086;35944;2;1;1;1
258302153086;258302155232;2146;2;1;1;1
258302155232;258302156191;959;2;1;1;1
258302156191;258302241849;85658;2;1;1;1
258302241849;258302242536;687;2;1;1;1
258302242536;258302299707;57171;2;1;1;1
258302299707;258302300557;850;2;1;1;1
258302300557;258302335141;34584;2;1;1;1
258302335141;258302335699;558;2;1;1;1
258302335699;258302411880;76181;2;1;1;1
258302411880;258302412888;1008;2;1;1;1
258302412888;258302450443;37555;2;1;1;1
258302450443;258302461793;11350;2;1;1;1
258302461793;258302462369;576;2;1;1;1
258302462369;258302463018;649;2;1;1;1
258302463018;258302463639;621;2;1;1;1
258302463639;258302510364;46725;2;1;1;1
258302510364;258302510990;626;2;1;1;1
258302510990;258302546706;35716;2;1;1;1
258302546706;258302547563;857;2;1;1;1
258302547563;258302700855;153292;2;1;1;1
258302700855;258302701777;922;2;1;1;1
258302701777;258302702495;718;2;1;1;1
258302702495;258302703742;1247;2;1;1;1
258302703742;258302747427;43685;2;1;1;1
258302747427;258302748056;629;2;1;1;1
258302748056;258302838381;90325;2;1;1;1
258302838381;258302839229;848;2;1;1;1
258302839229;258302929979;90750;2;1;1;1
258302929979;258302930779;800;2;1;1;1
258302930779;258302932200;1421;2;1;1;1
258302932200;258302932827;627;2;1;1;1
258302932827;258303000683;67856;2;1;1;1
258303000683;258303004311;3628;2;1;1;1
258303004311;258303073682;69371;2;1;1;1
258303073682;258303074320;638;2;1;1;1
258303074320;258303202295;127975;2;1;1;1
258303202295;258303203064;769;2;1;1;1
258303203064;258303281596;78532;2;1;1;1
258303281596;258303282612;1016;2;1;1;1
258303282612;258303314081;31469;2;1;1;1
258303314081;258303314638;557;2;1;1;1
258303314638;258303327003;12365;2;1;1;1
258303327003;258303327537;534;2;1;1;1
258303327537;258303408340;80803;2;1;1;1
258303408340;258303409569;1229;2;1;1;1
258303409569;258303410125;556;2;1;1;1
258303410125;258303410809;684;2;1;1;1
258303410809;258303449341;38532;2;1;1;1
258303449341;258303450259;918;2;1;1;1
258303450259;258303527152;76893;2;1;1;1
258303527152;258303527656;504;2;1;1;1
258303527656;258303615630;87974;2;1;1;1
258303615630;258303622854;7224;2;1;1;1
258303622854;258303677228;54374;2;1;1;1
258303677228;258303681211;3983;2;1;1;1
258303681211;258303710894;29683;2;1;1;1
258303710894;258303711362;468;2;1;1;1
258303711362;258303763537;52175;2;1;1;1
258303763537;258303764162;625;2;1;1;1
258303764162;258303810296;46134;2;1;1;1
258303810296;258303811534;1238;2;1;1;1
258303811534;258303890016;78482;2;1;1;1
258303890016;258303890577;561;2;1;1;1
258303890577;258303940418;49841;2;1;1;1
258303940418;258303941077;659;2;1;1;1
258303941077;258303996177;55100;2;1;1;1
258303996177;258303996746;569;2;1;1;1
258303996746;258304046273;49527;2;1;1;1
258304046273;258304049016;2743;2;1;1;1
258304049016;258304084459;35443;2;1;1;1
258304084459;258304085011;552;2;1;1;1
258304085011;258304085495;484;2;1;1;1
258304085495;258304086114;619;2;1;1;1
258304086114;258304134186;48072;2;1;1;1
258304134186;258304134818;632;2;1;1;1
258304134818;258304137265;2447;2;1;1;1
258304137265;258304137796;531;2;1;1;1
258304137796;258304168115;30319;2;1;1;1
258304168115;258304168598;483;2;1;1;1
258304168598;258304202928;34330;2;1;1;1
258304202928;258304204276;1348;2;1;1;1
258304204276;258304212531;8255;2;1;1;1
258304212531;258304212545;14;2;1;1;1
258304212545;258304213663;1118;2;1;1;1
258304213663;258304214215;552;2;1;1;1
258304214215;258304255551;41336;2;1;1;1
258304255551;258304256975;1424;2;1;1;1
258304256975;258304304856;47881;2;1;1;1
258304304856;258304305413;557;2;1;1;1
258304305413;258304332686;27273;2;1;1;1
258304332686;258304333438;752;2;1;1;1
258304333438;258304361011;27573;2;1;1;1
258304371836;258304372484;648;2;1;1;1
258304407318;258304407872;554;2;1;1;1
258304408590;258304409273;683;2;1;1;1
258305862070;258305862617;547;2;1;1;1
258305864432;258305864998;566;2;1;1;1
258305917273;258305917943;670;2;1;1;1
258305954610;258305955210;600;2;1;1;1
258305955210;258305955227;17;2;1;1;1
258305955227;258305955244;17;2;1;1;1
258305955244;258305955761;517;2;1;1;1
258305955761;258305955859;98;2;1;1;1
258305998369;258305998921;552;2;1;1;1
258306041978;258306042556;578;2;1;1;1
258306084265;258306084898;633;2;1;1;1
258306140479;258306141122;643;2;1;1;1
258306141138;258306141304;166;2;1;1;1
258306141304;258306141666;362;2;1;1;1
258306141666;258306141950;284;2;1;1;1
258306187301;258306187934;633;2;1;1;1
258306333769;258306337329;3560;2;1;1;1
258306375046;258306375604;558;2;1;1;1
258306422174;258306422733;559;2;1;1;1
258306441750;258306442588;838;2;1;1;1
258306515540;258306516167;627;2;1;1;1
258306557356;258306557890;534;2;1;1;1
258306594067;258306594623;556;2;1;1;1
258306668214;258306668893;679;2;1;1;1
258306678995;258306679567;572;2;1;1;1
258306766217;258306767291;1074;2;1;1;1
258306800995;258306801555;560;2;1;1;1
258307055494;258307056125;631;2;1;1;1
258307119091;258307119741;650;2;1;1;1
258307170352;258307170997;645;2;1;1;1
258307181532;258307182278;746;2;1;1;1
258307258452;258307259017;565;2;1;1;1
258307330822;258307331718;896;2;1;1;1
258307395017;258307395536;519;2;1;1;1
258307395874;258307396467;593;2;1;1;1
258307444201;258307445390;1189;2;1;1;1
258307445831;258307446676;845;2;1;1;1
258307489620;258307490273;653;2;1;1;1
258307733409;258307733950;541;2;1;1;1
258307783288;258307783808;520;2;1;1;1
258307827313;258307827948;635;2;1;1;1
258307864432;258307864965;533;2;1;1;1
258307928995;258307931823;2828;2;1;1;1
258307951676;258307953016;1340;2;1;1;1
258307978067;258307978622;555;2;1;1;1
258308011311;258308012347;1036;2;1;1;1
258308061144;258308061762;618;2;1;1;1
258308102614;258308104145;1531;2;1;1;1
258308211901;258308212600;699;2;1;1;1
258308306820;258308307632;812;2;1;1;1
258308353246;258308354323;1077;2;1;1;1
258308411961;258308412520;559;2;1;1;1
258308461502;258308463130;1628;2;1;1;1
258308471951;258308472929;978;2;1;1;1
258308580742;258308581827;1085;2;1;1;1
258308591098;258308592553;1455;2;1;1;1
258308622220;258308622856;636;2;1;1;1
258308664334;258308664945;611;2;1;1;1
258308704775;258308705322;547;2;1;1;1
258308745763;258308746486;723;2;1;1;1
258308746486;258308747258;772;2;1;1;1
258308747258;258308747468;210;2;1;1;1
258308797987;258308798748;761;2;1;1;1
258308837320;258308837852;532;2;1;1;1
258308884640;258308885264;624;2;1;1;1
258308895161;258308895712;551;2;1;1;1
258308926664;258308927260;596;2;1;1;1
258308962209;258308966579;4370;2;1;1;1
258309007509;258309008145;636;2;1;1;1
258309076098;258309076711;613;2;1;1;1
258309079912;258309080467;555;2;1;1;1
258309163060;258309163612;552;2;1;1;1
258309193277;258309193733;456;2;1;1;1
258309196803;258309197350;547;2;1;1;1
258309197350;258309197369;19;2;1;1;1
258309197369;258309198116;747;2;1;1;1
258309206817;258309207449;632;2;1;1;1
258309262878;258309263415;537;2;1;1;1
258309281662;258309282524;862;2;1;1;1
258309370095;258309370621;526;2;1;1;1
258309371676;258309372302;626;2;1;1;1
258309417277;258309417898;621;2;1;1;1
258309476091;258309476714;623;2;1;1;1
258309513658;258309514181;523;2;1;1;1
258309582049;258309582436;387;2;1;1;1
258309582436;258309583095;659;2;1;1;1
258309583095;258309583642;547;2;1;1;1
258309585141;258309585691;550;2;1;1;1
258309638211;258309638833;622;2;1;1;1
258309692335;258309692965;630;2;1;1;1
258309741647;258309742272;625;2;1;1;1
258309764497;258309765032;535;2;1;1;1
258309794234;258309794756;522;2;1;1;1
258309823713;258309824262;549;2;1;1;1
258309884003;258309884530;527;2;1;1;1
258309928879;258309929434;555;2;1;1;1
258309974941;258309975489;548;2;1;1;1
258310070935;258310071493;558;2;1;1;1
258310109280;258310109815;535;2;1;1;1
258310169491;258310176385;6894;2;1;1;1
258310193572;258310194174;602;2;1;1;1
258310239985;258310240661;676;2;1;1;1
258310289825;258310290377;552;2;1;1;1
258310377196;258310377267;71;2;1;1;1
258310377267;258310377840;573;2;1;1;1
258310377840;258310386859;9019;2;1;1;1
258310386859;258310387744;885;2;1;1;1
258310387744;258310388081;337;2;1;1;1
258310388081;258310388831;750;2;1;1;1
258310388831;258310394164;5333;2;1;1;1
258310434043;258310434646;603;2;1;1;1
258310448400;258310448911;511;2;1;1;1
258310491307;258310491851;544;2;1;1;1
258310536698;258310537278;580;2;1;1;1
258310537657;258310538478;821;2;1;1;1
258310675144;258310675599;455;2;1;1;1
258310721256;258310721743;487;2;1;1;1
258310734237;258310734783;546;2;1;1;1
258310860878;258310861538;660;2;1;1;1
258310956518;258310957123;605;2;1;1;1
258310974283;258310974823;540;2;1;1;1
258311026169;258311026792;623;2;1;1;1
258311092097;258311094144;2047;2;1;1;1
258311123691;258311124295;604;2;1;1;1
258311172057;258311173792;1735;2;1;1;1
258311277341;258311278073;732;2;1;1;1
258311278202;258311279195;993;2;1;1;1
258311325488;258311326345;857;2;1;1;1
258311556963;258311559874;2911;2;1;1;1
258311560591;258311562421;1830;2;1;1;1
258311627927;258311628475;548;2;1;1;1
258311740429;258311744302;3873;2;1;1;1
258311781765;258311782374;609;2;1;1;1
258311794169;258311795131;962;2;1;1;1
258311804403;258311805303;900;2;1;1;1
258311826210;258311826670;460;2;1;1;1
258311836779;258311837659;880;2;1;1;1
258311903858;258311904943;1085;2;1;1;1
258311905640;258311907450;1810;2;1;1;1
258311952983;258311953602;619;2;1;1;1
258311963320;258311964019;699;2;1;1;1
258312003827;258312004361;534;2;1;1;1
258312045172;258312047462;2290;2;1;1;1
258312052337;258312054401;2064;2;1;1;1
258312061014;258312064771;3757;2;1;1;1
258312195165;258312195776;611;2;1;1;1
258312240104;258312241343;1239;2;1;1;1
258312243731;258312244351;620;2;1;1;1
258312324199;258312324922;723;2;1;1;1
258312391375;258312391974;599;2;1;1;1
258312437821;258312438680;859;2;1;1;1
258312457094;258312457714;620;2;1;1;1
258312495565;258312496098;533;2;1;1;1
258312496482;258312497146;664;2;1;1;1
258312528056;258312528655;599;2;1;1;1
258312594389;258312594848;459;2;1;1;1
258312642672;258312643545;873;2;1;1;1
258312698577;258312699512;935;2;1;1;1
258312752062;258312752685;623;2;1;1;1
258312798786;258312799382;596;2;1;1;1
258312857286;258312857836;550;2;1;1;1
258312920090;258312920728;638;2;1;1;1
258312948856;258312950683;1827;2;1;1;1
258312950790;258312952051;1261;2;1;1;1
258313000673;258313001316;643;2;1;1;1
258313001503;258313002173;670;2;1;1;1
258313041603;258313042225;622;2;1;1;1
258313091394;258313092041;647;2;1;1;1
258313137419;258313138021;602;2;1;1;1
258313180901;258313181514;613;2;1;1;1
258313223475;258313224079;604;2;1;1;1
258313273560;258313274180;620;2;1;1;1
258313313639;258313314184;545;2;1;1;1
258313358131;258313358750;619;2;1;1;1
258313407181;258313407803;622;2;1;1;1
258313489801;258313490418;617;2;1;1;1
258313533275;258313533857;582;2;1;1;1
258313588171;258313588790;619;2;1;1;1
258313628371;258313629045;674;2;1;1;1
258313629891;258313630447;556;2;1;1;1
258313660948;258313661555;607;2;1;1;1
258313699198;258313699812;614;2;1;1;1
258313700535;258313701143;608;2;1;1;1
258313745488;258313746088;600;2;1;1;1
258313799968;258313800440;472;2;1;1;1
258313806160;258313813344;7184;2;1;1;1
258313862542;258313868560;6018;2;1;1;1
258313896303;258313896917;614;2;1;1;1
258313899231;258313899654;423;2;1;1;1
258313899654;258313899934;280;2;1;1;1
258313899934;258313900291;357;2;1;1;1
258313934010;258313934501;491;2;1;1;1
258313935869;258313936504;635;2;1;1;1
258313994733;258313994856;123;2;1;1;1
258313994856;258313995255;399;2;1;1;1
258313995255;258313995448;193;2;1;1;1
258314023232;258314024979;1747;2;1;1;1
258314110593;258314111228;635;2;1;1;1
258314120379;258314121419;1040;2;1;1;1
258314160194;258314160755;561;2;1;1;1
258314298284;258314299001;717;2;1;1;1
258314300974;258314303569;2595;2;1;1;1
258314309621;258314312411;2790;2;1;1;1
258314340370;258314340838;468;2;1;1;1
258314374345;258314374808;463;2;1;1;1
258314411583;258314412110;527;2;1;1;1
258314453176;258314454328;1152;2;1;1;1
258314599350;258314599916;566;2;1;1;1
258314644003;258314645987;1984;2;1;1;1
258314725014;258314725711;697;2;1;1;1
258314753128;258314754618;1490;2;1;1;1
258314755504;258314756331;827;2;1;1;1
258314794903;258314795700;797;2;1;1;1
258314869457;258314870014;557;2;1;1;1
258314905605;258314906327;722;2;1;1;1
258314907685;258314908576;891;2;1;1;1
258314960657;258314961486;829;2;1;1;1
258315007702;258315008461;759;2;1;1;1
258315042573;258315043294;721;2;1;1;1
258315083917;258315084455;538;2;1;1;1
258315138509;258315139047;538;2;1;1;1
258315188715;258315189345;630;2;1;1;1
258315249262;258315250050;788;2;1;1;1
258315316696;258315317318;622;2;1;1;1
258315325070;258315325958;888;2;1;1;1
258315387038;258315387574;536;2;1;1;1
258315401207;258315401884;677;2;1;1;1
258315402066;258315402842;776;2;1;1;1
258315403053;258315403311;258;2;1;1;1
258315403311;258315403697;386;2;1;1;1
258315403697;258315404065;368;2;1;1;1
258315438068;258315439125;1057;2;1;1;1
258315519193;258315524397;5204;2;1;1;1
258315541755;258315542837;1082;2;1;1;1
258315575419;258315575974;555;2;1;1;1
258315610999;258315611924;925;2;1;1;1
258315662998;258315667104;4106;2;1;1;1
258315695477;258315696176;699;2;1;1;1
258315737021;258315738862;1841;2;1;1;1
258315741559;258315743978;2419;2;1;1;1
258315776347;258315777210;863;2;1;1;1
258315822100;258315822632;532;2;1;1;1
258315858729;258315860204;1475;2;1;1;1
258315899846;258315900743;897;2;1;1;1
258315901677;258315902271;594;2;1;1;1
258315975149;258315975751;602;2;1;1;1
258316021287;258316021907;620;2;1;1;1
258316082772;258316083391;619;2;1;1;1
258316125766;258316126369;603;2;1;1;1
258316180178;258316180740;562;2;1;1;1
258316219079;258316219641;562;2;1;1;1
258316267249;258316267847;598;2;1;1;1
258316354875;258316356629;1754;2;1;1;1
258316396401;258316396923;522;2;1;1;1
258316429948;258316431901;1953;2;1;1;1
258316467029;258316467544;515;2;1;1;1
258316510694;258316511331;637;2;1;1;1
258316612203;258316612671;468;2;1;1;1
258316674620;258316675170;550;2;1;1;1
258316719194;258316719750;556;2;1;1;1
258316805918;258316806464;546;2;1;1;1
258316844492;258316845880;1388;2;1;1;1
258316894662;258316895187;525;2;1;1;1
258316934107;258316934705;598;2;1;1;1
258316934705;258316934749;44;2;1;1;1
258316934749;258316935458;709;2;1;1;1
258316976813;258316977367;554;2;1;1;1
258317027307;258317027826;519;2;1;1;1
258317101193;258317101796;603;2;1;1;1
258317134393;258317135950;1557;2;1;1;1
258317144256;258317144802;546;2;1;1;1
258317178448;258317178900;452;2;1;1;1
258317268567;258317269103;536;2;1;1;1
258317341270;258317341791;521;2;1;1;1
258317441215;258317441677;462;2;1;1;1
258317474508;258317475047;539;2;1;1;1
258317543545;258317544654;1109;2;1;1;1
258317630159;258317630623;464;2;1;1;1
258317631224;258317631787;563;2;1;1;1
258317679597;258317680319;722;2;1;1;1
258317680947;258317681779;832;2;1;1;1
258317747133;258317749195;2062;2;1;1;1
258317778114;258317779546;1432;2;1;1;1
258317831811;258317832548;737;2;1;1;1
258317842340;258317842883;543;2;1;1;1
258317893462;258317894276;814;2;1;1;1
258317973251;258317974143;892;2;1;1;1
258317974971;258317977000;2029;2;1;1;1
258318018954;258318019412;458;2;1;1;1
258318056821;258318058160;1339;2;1;1;1
258318113954;258318114582;628;2;1;1;1
258318160693;258318161451;758;2;1;1;1
258318201273;258318201878;605;2;1;1;1
258318264975;258318265570;595;2;1;1;1
258318311947;258318312502;555;2;1;1;1
258318357147;258318357658;511;2;1;1;1
258318372948;258318373616;668;2;1;1;1
258318425362;258318426631;1269;2;1;1;1
258318471244;258318471790;546;2;1;1;1
258318516895;258318517645;750;2;1;1;1
258318567602;258318569547;1945;2;1;1;1
258318628675;258318629299;624;2;1;1;1
258318674729;258318675251;522;2;1;1;1
258318704997;258318705629;632;2;1;1;1
258318754917;258318755423;506;2;1;1;1
258318828728;258318834468;5740;2;1;1;1
258318834468;258318835151;683;2;1;1;1
258318835151;258318835944;793;2;1;1;1
258318863042;258318864179;1137;2;1;1;1
258318864632;258318866339;1707;2;1;1;1
258318908094;258318909220;1126;2;1;1;1
258318909318;258318910054;736;2;1;1;1
258318910054;258318910354;300;2;1;1;1
258318910354;258318910806;452;2;1;1;1
258318933795;258318934474;679;2;1;1;1
258318953977;258318954604;627;2;1;1;1
258318981245;258318981850;605;2;1;1;1
258318982873;258318983423;550;2;1;1;1
258319032280;258319033522;1242;2;1;1;1
258319034859;258319037944;3085;2;1;1;1
258319096258;258319096853;595;2;1;1;1
258319181241;258319181775;534;2;1;1;1
258319222559;258319223105;546;2;1;1;1
258319320666;258319321577;911;2;1;1;1
258319359556;258319360482;926;2;1;1;1
258319389221;258319390137;916;2;1;1;1
258319430673;258319431920;1247;2;1;1;1
258319483651;258319484501;850;2;1;1;1
258319525432;258319525956;524;2;1;1;1
258319578915;258319580862;1947;2;1;1;1
258319638231;258319638819;588;2;1;1;1
258319638819;258319639023;204;2;1;1;1
258319639023;258319639585;562;2;1;1;1
258319679421;258319680270;849;2;1;1;1
258319708170;258319708996;826;2;1;1;1
258319766306;258319767258;952;2;1;1;1
258319830935;258319832434;1499;2;1;1;1
258319841487;258319842030;543;2;1;1;1
258319941421;258319942234;813;2;1;1;1
258319942398;258319943416;1018;2;1;1;1
258319991937;258319993142;1205;2;1;1;1
258320024787;258320025410;623;2;1;1;1
258320110817;258320111341;524;2;1;1;1
258320167820;258320170095;2275;2;1;1;1
258320270126;258320270622;496;2;1;1;1
258320292762;258320293268;506;2;1;1;1
258320293268;258320294171;903;2;1;1;1
258320294171;258320294625;454;2;1;1;1
258320295672;258320296564;892;2;1;1;1
258320297819;258320299367;1548;2;1;1;1
258320358193;258320358815;622;2;1;1;1
258320401521;258320402051;530;2;1;1;1
258320428943;258320429405;462;2;1;1;1
258320466364;258320467364;1000;2;1;1;1
258320535711;258320537064;1353;2;1;1;1
258320639697;258320640364;667;2;1;1;1
258320693349;258320694292;943;2;1;1;1
258320703869;258320704393;524;2;1;1;1
258320745970;258320746505;535;2;1;1;1
258320805478;258320806023;545;2;1;1;1
258320880748;258320883108;2360;2;1;1;1
258320902395;258320903027;632;2;1;1;1
258320951317;258320951844;527;2;1;1;1
258321004898;258321005359;461;2;1;1;1
258321075723;258321076276;553;2;1;1;1
258321111392;258321112344;952;2;1;1;1
258321161156;258321161803;647;2;1;1;1
258321204043;258321204667;624;2;1;1;1
258321243950;258321244574;624;2;1;1;1
258321288393;258321288957;564;2;1;1;1
258321337394;258321338067;673;2;1;1;1
258321381451;258321381918;467;2;1;1;1
258321480851;258321481511;660;2;1;1;1
258321539345;258321539879;534;2;1;1;1
258321600251;258321601256;1005;2;1;1;1
258321660389;258321661004;615;2;1;1;1
258321707271;258321707873;602;2;1;1;1
258321778689;258321779308;619;2;1;1;1
258321812793;258321813336;543;2;1;1;1
258321893321;258321893782;461;2;1;1;1
258321925455;258321926075;620;2;1;1;1
258321971889;258321972443;554;2;1;1;1
258322061326;258322061858;532;2;1;1;1
258322099410;258322100157;747;2;1;1;1
258322150664;258322159679;9015;2;1;1;1
258322222041;258322222725;684;2;1;1;1
258322223379;258322223977;598;2;1;1;1
258322254542;258322255003;461;2;1;1;1
258322308890;258322309435;545;2;1;1;1
258322349155;258322349687;532;2;1;1;1
258322437548;258322438555;1007;2;1;1;1
258322509055;258322509622;567;2;1;1;1
258322553712;258322554178;466;2;1;1;1
258322590983;258322592491;1508;2;1;1;1
258322648033;258322648576;543;2;1;1;1
258322689791;258322691206;1415;2;1;1;1
258322752552;258322753951;1399;2;1;1;1
258322754131;258322754917;786;2;1;1;1
258322802068;258322803614;1546;2;1;1;1
258322858900;258322862045;3145;2;1;1;1
258322900542;258322901305;763;2;1;1;1
258322901687;258322902602;915;2;1;1;1
258322929562;258322930171;609;2;1;1;1
258323019216;258323022764;3548;2;1;1;1
258323022764;258323022825;61;2;1;1;1
258323022825;258323023407;582;2;1;1;1
258323053375;258323054228;853;2;1;1;1
258323242877;258323244025;1148;2;1;1;1
258323288791;258323289388;597;2;1;1;1
258323346797;258323350009;3212;2;1;1;1
258323401394;258323401963;569;2;1;1;1
258323403840;258323404386;546;2;1;1;1
258323463276;258323463774;498;2;1;1;1
258323535255;258323535934;679;2;1;1;1
258323557983;258323558625;642;2;1;1;1
258323558625;258323560823;2198;2;1;1;1
258323560823;258323566112;5289;2;1;1;1
258323620930;258323621494;564;2;1;1;1
258323670871;258323672053;1182;2;1;1;1
258323714779;258323715480;701;2;1;1;1
258323752974;258323753594;620;2;1;1;1
258323765562;258323772913;7351;2;1;1;1
258323786412;258323787635;1223;2;1;1;1
258323817951;258323818570;619;2;1;1;1
258323882439;258323882967;528;2;1;1;1
258323903037;258323903660;623;2;1;1;1
258323905454;258323906076;622;2;1;1;1
258323906941;258323907410;469;2;1;1;1
258323976891;258323977483;592;2;1;1;1
258323998746;258323999298;552;2;1;1;1
258324072893;258324073458;565;2;1;1;1
258324130813;258324131429;616;2;1;1;1
258324156285;258324156822;537;2;1;1;1
258324246181;258324246902;721;2;1;1;1
258324291827;258324293564;1737;2;1;1;1
258324330353;258324330979;626;2;1;1;1
258324393953;258324394769;816;2;1;1;1
258324432252;258324436401;4149;2;1;1;1
258324495480;258324495982;502;2;1;1;1
258324519489;258324520053;564;2;1;1;1
258324532322;258324532815;493;2;1;1;1
258324578850;258324579541;691;2;1;1;1
258324725836;258324727222;1386;2;1;1;1
258324768695;258324769558;863;2;1;1;1
258324809361;258324810104;743;2;1;1;1
258324872850;258324873324;474;2;1;1;1
258324929753;258324930545;792;2;1;1;1
258324971878;258324972751;873;2;1;1;1
258325026049;258325026788;739;2;1;1;1
258325195923;258325198632;2709;2;1;1;1
258325198632;258325199098;466;2;1;1;1
258325199098;258325202854;3756;2;1;1;1
258325255696;258325256368;672;2;1;1;1
258325305357;258325307170;1813;2;1;1;1
258325330704;258325331391;687;2;1;1;1
258325389978;258325391257;1279;2;1;1;1
258325392787;258325394186;1399;2;1;1;1
258325434155;258325434903;748;2;1;1;1
258325443626;258325444993;1367;2;1;1;1
258325446054;258325446661;607;2;1;1;1
258325496435;258325496484;49;2;1;1;1
258325496484;258325497029;545;2;1;1;1
258325497029;258325497660;631;2;1;1;1
258325541816;258325542350;534;2;1;1;1
258325585372;258325585889;517;2;1;1;1
258325595263;258325595758;495;2;1;1;1
258325639574;258325640549;975;2;1;1;1
258325697028;258325698517;1489;2;1;1;1
258325739478;258325740047;569;2;1;1;1
258325782515;258325782979;464;2;1;1;1
258325828616;258325829169;553;2;1;1;1
258325869717;258325870599;882;2;1;1;1
258325913885;258325914356;471;2;1;1;1
258325957166;258325963000;5834;2;1;1;1
258326009152;258326009799;647;2;1;1;1
258326020789;258326021436;647;2;1;1;1
258326065430;258326065984;554;2;1;1;1
258326091380;258326094848;3468;2;1;1;1
258326130460;258326131087;627;2;1;1;1
258326173445;258326174067;622;2;1;1;1
258326215561;258326216189;628;2;1;1;1
258326366718;258326369366;2648;2;1;1;1
258326404739;258326405289;550;2;1;1;1
258326440882;258326441424;542;2;1;1;1
258326486753;258326487277;524;2;1;1;1
258326521010;258326521565;555;2;1;1;1
258326531441;258326532062;621;2;1;1;1
258326598121;258326598689;568;2;1;1;1
258326641541;258326642005;464;2;1;1;1
258326721177;258326723095;1918;2;1;1;1
258326866181;258326874137;7956;2;1;1;1
258326910463;258326910936;473;2;1;1;1
258326996443;258326997071;628;2;1;1;1
258327033834;258327034555;721;2;1;1;1
258327044630;258327045164;534;2;1;1;1
258327106314;258327106987;673;2;1;1;1
258327117306;258327117770;464;2;1;1;1
258327235098;258327236544;1446;2;1;1;1
258327263045;258327265064;2019;2;1;1;1
258327384701;258327385322;621;2;1;1;1
258327454659;258327455562;903;2;1;1;1
258327468615;258327469858;1243;2;1;1;1
258327484575;258327485381;806;2;1;1;1
258327567158;258327567790;632;2;1;1;1
258327579189;258327580210;1021;2;1;1;1
258327638437;258327642136;3699;2;1;1;1
258327720526;258327721170;644;2;1;1;1
258327722864;258327727647;4783;2;1;1;1
258327760683;258327761428;745;2;1;1;1
258327841953;258327843888;1935;2;1;1;1
258327881021;258327881579;558;2;1;1;1
258327927490;258327928279;789;2;1;1;1
258327928279;258327928633;354;2;1;1;1
258327928633;258327930475;1842;2;1;1;1
258327935998;258327936549;551;2;1;1;1
258327948583;258327949125;542;2;1;1;1
258327988117;258327988750;633;2;1;1;1
258328019567;258328020122;555;2;1;1;1
258328067548;258328068097;549;2;1;1;1
258328117353;258328119146;1793;2;1;1;1
258328155469;258328155970;501;2;1;1;1
258328200608;258328200612;4;2;1;1;1
258328200612;258328201093;481;2;1;1;1
258328201093;258328201181;88;2;1;1;1
258328253700;258328255307;1607;2;1;1;1
258328261887;258328270172;8285;2;1;1;1
258328336242;258328336763;521;2;1;1;1
258328446843;258328449819;2976;2;1;1;1
258328482471;258328484962;2491;2;1;1;1
258328492293;258328494869;2576;2;1;1;1
258328598806;258328599376;570;2;1;1;1
258328648552;258328649048;496;2;1;1;1
258328697886;258328698445;559;2;1;1;1
258328753264;258328753724;460;2;1;1;1
258328804830;258328805508;678;2;1;1;1
258328879070;258328879603;533;2;1;1;1
258328892174;258328893402;1228;2;1;1;1
258328936517;258328937013;496;2;1;1;1
258328949857;258328950484;627;2;1;1;1
258328984244;258328984772;528;2;1;1;1
258329011933;258329012464;531;2;1;1;1
258329013259;258329013814;555;2;1;1;1
258329072501;258329073108;607;2;1;1;1
258329132289;258329133681;1392;2;1;1;1
258329201365;258329201984;619;2;1;1;1
258329252994;258329253663;669;2;1;1;1
258329253663;258329253879;216;2;1;1;1
258329253879;258329254277;398;2;1;1;1
258329307843;258329308603;760;2;1;1;1
258329309391;258329311554;2163;2;1;1;1
258329311554;258329311562;8;2;1;1;1
258329311562;258329313233;1671;2;1;1;1
258329313767;258329314361;594;2;1;1;1
258329314494;258329315230;736;2;1;1;1
258329336156;258329337062;906;2;1;1;1
258329407562;258329408501;939;2;1;1;1
258329409290;258329414469;5179;2;1;1;1
258329436649;258329437096;447;2;1;1;1
258329437096;258329437204;108;2;1;1;1
258329437204;258329438248;1044;2;1;1;1
258329475891;258329476713;822;2;1;1;1
258329491295;258329491948;653;2;1;1;1
258329557053;258329557655;602;2;1;1;1
258329557737;258329558586;849;2;1;1;1
258329596494;258329597183;689;2;1;1;1
258329649231;258329650152;921;2;1;1;1
258329651328;258329651965;637;2;1;1;1
258329678607;258329679173;566;2;1;1;1
258329716219;258329716748;529;2;1;1;1
258329748028;258329748579;551;2;1;1;1
258329794398;258329795088;690;2;1;1;1
258329845775;258329846303;528;2;1;1;1
258329935854;258329936388;534;2;1;1;1
258329976147;258329976764;617;2;1;1;1
258330100529;258330101323;794;2;1;1;1
258330184621;258330191150;6529;2;1;1;1
258330211276;258330212292;1016;2;1;1;1
258330213341;258330214102;761;2;1;1;1
258330221736;258330222633;897;2;1;1;1
258330267174;258330268729;1555;2;1;1;1
258330301850;258330302347;497;2;1;1;1
258330319128;258330319682;554;2;1;1;1
258330354160;258330354704;544;2;1;1;1
258330463038;258330464137;1099;2;1;1;1
258330513585;258330514055;470;2;1;1;1
258330601513;258330602037;524;2;1;1;1
258330622417;258330623034;617;2;1;1;1
258330708864;258330709495;631;2;1;1;1
258330764085;258330764613;528;2;1;1;1
258330800944;258330801475;531;2;1;1;1
258330853318;258330854405;1087;2;1;1;1
258330876071;258330876627;556;2;1;1;1
258330923934;258330925049;1115;2;1;1;1
258330959319;258330960876;1557;2;1;1;1
258330960876;258330961368;492;2;1;1;1
258330961368;258330961758;390;2;1;1;1
258331005351;258331005883;532;2;1;1;1
258331006330;258331006886;556;2;1;1;1
258331056695;258331057452;757;2;1;1;1
258331105354;258331106138;784;2;1;1;1
258331191208;258331191894;686;2;1;1;1
258331249519;258331250151;632;2;1;1;1
258331294374;258331294999;625;2;1;1;1
258331309123;258331309960;837;2;1;1;1
258331349557;258331350181;624;2;1;1;1
258331410765;258331415973;5208;2;1;1;1
258331432865;258331433410;545;2;1;1;1
258331484732;258331485256;524;2;1;1;1
258331610792;258331611331;539;2;1;1;1
258331620692;258331621824;1132;2;1;1;1
258331672951;258331673588;637;2;1;1;1
258331712644;258331714517;1873;2;1;1;1
258331760311;258331760943;632;2;1;1;1
258331848297;258331849583;1286;2;1;1;1
258331853830;258331855898;2068;2;1;1;1
258331900873;258331901153;280;2;1;1;1
258331901153;258331901779;626;2;1;1;1
258331901779;258331902491;712;2;1;1;1
258331915944;258331916441;497;2;1;1;1
258331976831;258331977889;1058;2;1;1;1
258332070559;258332071642;1083;2;1;1;1
258332135076;258332137934;2858;2;1;1;1
258332188787;258332193149;4362;2;1;1;1
258332197729;258332198354;625;2;1;1;1
258332262818;258332263278;460;2;1;1;1
258332273914;258332274442;528;2;1;1;1
258332320222;258332321070;848;2;1;1;1
258332338620;258332343367;4747;2;1;1;1
258332363393;258332363860;467;2;1;1;1
258332422703;258332425876;3173;2;1;1;1
258332436890;258332437671;781;2;1;1;1
258332527809;258332528336;527;2;1;1;1
258332529225;258332529896;671;2;1;1;1
258332577606;258332578225;619;2;1;1;1
258332595715;258332596264;549;2;1;1;1
258332642455;258332643081;626;2;1;1;1
258332678925;258332679386;461;2;1;1;1
258332698513;258332699143;630;2;1;1;1
258332799992;258332800625;633;2;1;1;1
258332821756;258332822589;833;2;1;1;1
258332876690;258332877322;632;2;1;1;1
258332921271;258332921807;536;2;1;1;1
258332947437;258332948001;564;2;1;1;1
258333010993;258333011536;543;2;1;1;1
258333171108;258333171717;609;2;1;1;1
258333213514;258333214149;635;2;1;1;1
258333223685;258333224784;1099;2;1;1;1
258333262228;258333262789;561;2;1;1;1
258333311032;258333311672;640;2;1;1;1
258333377674;258333381148;3474;2;1;1;1
258333381148;258333381413;265;2;1;1;1
258333381413;258333381900;487;2;1;1;1
258333382899;258333383574;675;2;1;1;1
258333384130;258333384600;470;2;1;1;1
258333425261;258333425889;628;2;1;1;1
258333485072;258333485619;547;2;1;1;1
258333520603;258333521255;652;2;1;1;1
258333537946;258333538480;534;2;1;1;1
258333626337;258333626833;496;2;1;1;1
258333639556;258333640083;527;2;1;1;1
258333649223;258333649723;500;2;1;1;1
258333687395;258333687943;548;2;1;1;1
258333767635;258333768167;532;2;1;1;1
258333808049;258333808574;525;2;1;1;1
258333808886;258333809461;575;2;1;1;1
258333893453;258333894010;557;2;1;1;1
258333932009;258333932640;631;2;1;1;1
258333942689;258333943238;549;2;1;1;1
258333981554;258333983179;1625;2;1;1;1
258333984451;258333984976;525;2;1;1;1
258334023355;258334023991;636;2;1;1;1
258334060815;258334061488;673;2;1;1;1
258334071333;258334071863;530;2;1;1;1
258334110151;258334110713;562;2;1;1;1
258334150534;258334151483;949;2;1;1;1
258334184757;258334185364;607;2;1;1;1
258334224693;258334225329;636;2;1;1;1
258334246384;258334247062;678;2;1;1;1
258334279336;258334279907;571;2;1;1;1
258334291074;258334291630;556;2;1;1;1
258334319810;258334320569;759;2;1;1;1
258334354342;258334355790;1448;2;1;1;1
258334452339;258334453452;1113;2;1;1;1
258334497129;258334497677;548;2;1;1;1
258334531100;258334531653;553;2;1;1;1
258334575838;258334576473;635;2;1;1;1
258334617234;258334617781;547;2;1;1;1
258334656155;258334656838;683;2;1;1;1
258334696805;258334697432;627;2;1;1;1
258334744409;258334744937;528;2;1;1;1
258334753007;258334754919;1912;2;1;1;1
258334785447;258334786074;627;2;1;1;1
258334819731;258334820197;466;2;1;1;1
258334837494;258334838127;633;2;1;1;1
258334887731;258334888370;639;2;1;1;1
258334942840;258334943477;637;2;1;1;1
258334977189;258334977820;631;2;1;1;1
258334994952;258334995476;524;2;1;1;1
258335006362;258335006987;625;2;1;1;1
258335119099;258335119578;479;2;1;1;1
258335240258;258335241414;1156;2;1;1;1
258335264927;258335267626;2699;2;1;1;1
258335267626;258335268092;466;2;1;1;1
258335268092;258335268265;173;2;1;1;1
258335394170;258335394724;554;2;1;1;1
258335413159;258335413644;485;2;1;1;1
258335420086;258335420700;614;2;1;1;1
258335452091;258335452770;679;2;1;1;1
258335461546;258335462095;549;2;1;1;1
258335488278;258335488747;469;2;1;1;1
258335499365;258335499834;469;2;1;1;1
258335529841;258335530370;529;2;1;1;1
258335577594;258335578053;459;2;1;1;1
258335608903;258335609600;697;2;1;1;1
258335685141;258335685995;854;2;1;1;1
258335694076;258335697959;3883;2;1;1;1
258335728864;258335729491;627;2;1;1;1
258335840089;258335840620;531;2;1;1;1
258335854578;258335855131;553;2;1;1;1
258335895488;258335896013;525;2;1;1;1
258335923592;258335924236;644;2;1;1;1
258335934037;258335935127;1090;2;1;1;1
258335972960;258335973517;557;2;1;1;1
258336001626;258336002192;566;2;1;1;1
258336017514;258336019209;1695;2;1;1;1
258336019920;258336020444;524;2;1;1;1
258336055872;258336056363;491;2;1;1;1
258336097143;258336097678;535;2;1;1;1
258336155838;258336156468;630;2;1;1;1
258336299506;258336299949;443;2;1;1;1
258336338083;258336338718;635;2;1;1;1
258336371185;258336372964;1779;2;1;1;1
258336380788;258336381421;633;2;1;1;1
258336402847;258336403410;563;2;1;1;1
258336412439;258336414665;2226;2;1;1;1
258336474151;258336474783;632;2;1;1;1
258336509447;258336510061;614;2;1;1;1
258336512028;258336513027;999;2;1;1;1
258336513138;258336514340;1202;2;1;1;1
258336550415;258336551443;1028;2;1;1;1
258336610458;258336611142;684;2;1;1;1
258336683299;258336683848;549;2;1;1;1
258336713558;258336714027;469;2;1;1;1
258337082364;258337082867;503;2;1;1;1
258337083854;258337084480;626;2;1;1;1
258337163760;258337163776;16;2;1;1;1
258337163776;258337164611;835;2;1;1;1
258337164611;258337165076;465;2;1;1;1
258337221909;258337222373;464;2;1;1;1
258337277177;258337278179;1002;2;1;1;1
258337313734;258337316125;2391;2;1;1;1
258337327493;258337330396;2903;2;1;1;1
258337360577;258337361213;636;2;1;1;1
258337407250;258337407742;492;2;1;1;1
258337438141;258337438697;556;2;1;1;1
258337454034;258337454661;627;2;1;1;1
258337530319;258337530509;190;2;1;1;1
258337530509;258337530846;337;2;1;1;1
258337530846;258337531139;293;2;1;1;1
258337569881;258337570706;825;2;1;1;1
258337604974;258337605613;639;2;1;1;1
258337686880;258337687374;494;2;1;1;1
258337726076;258337726708;632;2;1;1;1
258337738220;258337738859;639;2;1;1;1
258337761848;258337765733;3885;2;1;1;1
258337776434;258337776956;522;2;1;1;1
258337818194;258337818885;691;2;1;1;1
258337818885;258337819039;154;2;1;1;1
258337819039;258337819978;939;2;1;1;1
258337879480;258337880101;621;2;1;1;1
258337880826;258337881450;624;2;1;1;1
258337938452;258337939165;713;2;1;1;1
258337957390;258337957952;562;2;1;1;1
258338094818;258338095446;628;2;1;1;1
258338131913;258338132535;622;2;1;1;1
258338138820;258338141280;2460;2;1;1;1
258338174390;258338174887;497;2;1;1;1
258338211670;258338212300;630;2;1;1;1
258338231342;258338231958;616;2;1;1;1
258338345261;258338346126;865;2;1;1;1
258338347059;258338350457;3398;2;1;1;1
258338396541;258338397003;462;2;1;1;1
258338397441;258338397972;531;2;1;1;1
258338437576;258338438162;586;2;1;1;1
258338447835;258338448975;1140;2;1;1;1
258338479883;258338480361;478;2;1;1;1
258338489538;258338490156;618;2;1;1;1
258338491586;258338492113;527;2;1;1;1
258338493711;258338494248;537;2;1;1;1
258338543217;258338543703;486;2;1;1;1
258338582666;258338583664;998;2;1;1;1
258338683671;258338684327;656;2;1;1;1
258338719416;258338723679;4263;2;1;1;1
258338729258;258338729894;636;2;1;1;1
258338786372;258338786919;547;2;1;1;1
258338812152;258338812887;735;2;1;1;1
258338853936;258338854476;540;2;1;1;1
258338870398;258338871094;696;2;1;1;1
258338871729;258338872368;639;2;1;1;1
258338873116;258338873743;627;2;1;1;1
258338884482;258338892257;7775;2;1;1;1
258338993919;258338994471;552;2;1;1;1
258339051610;258339052489;879;2;1;1;1
258339053189;258339054846;1657;2;1;1;1
258339068256;258339068879;623;2;1;1;1
258339100308;258339100942;634;2;1;1;1
258339101251;258339101717;466;2;1;1;1
258339119641;258339120631;990;2;1;1;1
258339134957;258339135963;1006;2;1;1;1
258339137552;258339138332;780;2;1;1;1
258339221137;258339221589;452;2;1;1;1
258339229509;258339233232;3723;2;1;1;1
258339236800;258339237982;1182;2;1;1;1
258339262426;258339266730;4304;2;1;1;1
258339272290;258339272814;524;2;1;1;1
258339279301;258339281501;2200;2;1;1;1
258339333928;258339345227;11299;2;1;1;1
258339345227;258339345830;603;2;1;1;1
258339345830;258339345996;166;2;1;1;1
258339345996;258339346809;813;2;1;1;1
258339346809;258339350496;3687;2;1;1;1
258339396306;258339396769;463;2;1;1;1
258339418149;258339418681;532;2;1;1;1
258339418681;258339420702;2021;2;1;1;1
258339420702;258339432686;11984;2;1;1;1
258339432686;258339438779;6093;2;1;1;1
258339438779;258339453215;14436;2;1;1;1
261202488151;261202489250;1099;11;1;1;1
262773352176;262773353270;1094;11;1;1;1
